GEOID,TOTAL_POP,TOTAL_VAP,WHITE_VAP,HISPANIC_VAP,BLACK_VAP,NATIVE_VAP,ASIAN_VAP,PACIFIC_VAP,MINORITY_VAP
34007043046,1568,1294,792,232,76,11,184,6,502
34007043036,1685,1278,865,27,29,8,337,0,413
34007175001,1557,1301,1119,70,50,12,31,1,182
34007175003,1302,1052,895,36,82,12,24,0,157
34007040402,1672,1150,36,831,319,23,4,7,1114
34007135005,1115,894,518,198,134,21,45,4,376
34007005005,1238,1012,855,43,61,13,34,3,157
34007043022,1433,1083,944,46,39,3,46,5,139
34007080014,820,669,588,38,23,5,14,0,81
34007090007,1262,993,913,23,15,22,15,0,80
34007020001,2201,1708,1088,123,40,29,418,1,620
34007030003,2686,2172,1692,175,141,44,125,4,480
34007180102,1969,1677,1238,160,240,17,26,1,439
34007170018,2434,1985,893,112,243,26,707,1,1092
34007170004,2185,1986,1178,100,288,10,413,1,808
34007175008,852,702,640,19,27,14,7,0,62
34007175006,878,699,607,32,23,17,11,0,92
34007040303,1952,1384,110,749,561,43,23,11,1274
34007135014,1638,1284,261,451,545,50,41,2,1023
34007135010,1334,1057,403,275,262,20,119,3,654
34007125002,1181,964,869,42,18,14,17,0,95
34007055002,1330,1123,1014,39,31,5,39,0,109
34015120002,1774,1276,1063,29,107,21,46,0,213
34015045001,1162,932,793,55,42,20,20,3,139
34033035001,1066,853,652,53,108,20,11,6,201
34015045004,1423,1090,762,86,198,18,31,0,328
34015120003,933,709,597,38,39,9,24,0,112
34015050002,1250,996,892,37,17,15,31,0,104
34015050004,1546,1319,1148,42,71,20,32,0,171
34015075004,1386,1083,1023,20,23,7,12,0,60
34015090011,1037,803,693,35,19,5,47,0,110
34015070004,1061,817,603,70,124,13,15,0,214
34015070005,995,768,527,68,136,21,12,1,241
34015100001,1377,1098,842,55,142,14,46,1,256
34015095003,571,444,419,9,2,5,7,0,25
34007077302,1801,1405,1013,282,45,27,40,1,392
34007180106,1242,960,456,94,370,28,30,0,504
34007180104,1705,1400,1028,85,214,26,49,2,372
34007045001,1536,1270,561,143,530,25,20,2,709
34007180202,1588,1276,800,97,324,33,50,1,476
34007180105,1727,1371,1061,112,142,27,36,3,310
34007180205,1310,1090,827,96,128,15,20,0,263
34007180401,1140,966,713,88,147,20,20,2,253
34007005007,885,698,633,23,17,4,21,0,65
34007090002,798,656,579,19,14,10,24,3,77
34007110001,1892,1513,935,216,297,32,64,4,578
34007110002,1904,1473,802,260,372,24,45,4,671
34007140005,1961,1560,1110,132,248,33,47,3,450
34007050001,1753,1378,741,199,364,44,57,3,637
34007075028,2238,1727,692,161,773,34,116,1,1035
34007075037,964,686,207,74,385,10,26,0,479
34007077101,1690,1182,789,172,140,35,52,3,393
34007077201,1190,824,600,92,80,16,34,0,224
34007077301,2079,1561,1152,170,156,33,57,6,409
34007043027,1283,989,750,24,66,7,140,0,239
34007043013,1268,959,852,31,14,8,46,1,107
34007180306,1588,1171,286,67,717,15,96,2,885
34007180201,2340,1762,547,122,946,18,162,1,1215
34007040106,2064,1440,111,540,832,50,8,9,1329
34007040110,2133,1492,121,585,809,41,11,1,1371
34007040109,2050,1391,75,437,921,28,6,2,1316
34007043026,2032,1578,1238,54,83,13,205,1,340
34007043033,1789,1309,987,53,70,17,175,1,322
34015025010,1633,1349,1143,78,91,29,13,2,206
34015025002,1468,1142,987,41,83,15,15,1,155
34015025011,1595,1264,1035,70,92,45,18,5,229
34015055404,1058,794,624,64,69,19,24,3,170
34015055411,698,570,423,36,80,19,11,6,147
34031075009,2453,2077,1810,142,37,10,58,5,267
34031075012,2034,1740,1475,135,36,51,28,2,265
34031010205,1921,1553,950,328,41,14,226,0,603
34031010118,1744,1477,864,249,51,20,296,0,613
34031010101,1338,1092,651,239,42,10,167,0,441
34031005003,1279,1034,849,132,16,18,16,1,185
34031005004,1747,1492,1224,184,13,14,52,2,268
34031010307,1565,1233,352,773,99,23,38,3,881
34031070104,1544,1200,912,168,48,7,70,2,288
34031070105,1220,944,797,87,18,4,43,1,147
34007075005,2009,1625,1113,152,227,36,115,2,512
34007075007,1552,1234,1036,91,63,13,37,2,198
34041110003,1317,1061,882,67,72,11,25,0,179
34031010302,1069,866,317,449,69,22,54,0,549
34031010106,1846,1326,937,213,43,8,126,0,389
34031010123,2478,1688,1098,310,65,11,195,1,590
34031040605,2569,1934,141,1664,183,51,19,1,1793
34031010110,1205,988,567,219,71,1,150,2,421
34031020402,1848,1526,1162,252,44,6,58,0,364
34015015007,2815,1903,1442,97,187,12,166,0,461
34015050012,1505,1249,1061,66,43,33,32,4,188
34015015001,1618,1233,1012,50,113,11,33,1,221
34015070001,1622,1151,432,166,566,15,11,1,719
34015100004,1108,884,783,26,40,11,11,0,101
34015035001,673,488,421,16,32,12,9,0,67
34015010014,1786,1299,860,96,117,5,233,2,439
34015010003,1749,1353,1038,70,143,18,79,1,315
34015010008,1279,1047,855,85,72,11,18,1,192
34015090007,1645,1264,675,131,407,14,67,1,589
34015105001,1405,1104,849,98,70,26,42,2,255
34015010019,1647,1347,857,139,281,29,53,0,490
34015035002,922,719,642,29,22,9,13,1,77
34007170001,2092,1681,992,137,286,34,281,5,689
34007170012,1375,1073,666,97,129,13,188,1,407
34007055001,852,666,601,24,19,6,14,3,65
34007155003,1024,823,389,118,278,10,46,1,434
34007015002,1230,1007,844,69,69,13,28,0,163
34007100001,1103,873,654,63,116,12,23,0,219
34007160005,1341,1032,386,220,330,30,102,5,646
34007040407,1867,1313,27,1074,260,61,20,5,1286
34007075019,1928,1503,1024,90,297,18,79,4,479
34007180204,1314,989,597,59,300,14,33,1,392
34007155004,1114,917,590,91,193,17,41,2,327
34007040401,1540,1091,69,691,360,24,13,15,1022
34041005004,1450,1189,983,100,49,27,36,0,206
34041005001,1818,1526,1264,114,73,8,68,0,262
34041005002,1107,919,766,68,25,4,45,0,153
34031020401,1723,1342,880,318,61,26,50,2,462
34031040102,3166,2144,61,1204,990,52,19,10,2083
34031010105,2709,2336,1289,484,200,25,363,3,1047
34015025003,1845,1435,1096,92,188,22,32,3,339
34015120001,1846,1312,962,60,207,21,67,2,350
34015055120,1194,978,732,53,149,15,21,4,246
34015055124,1294,1007,684,57,213,25,42,3,323
34031055005,1506,1202,974,133,23,14,47,3,228
34031055008,1230,944,795,89,24,10,32,0,149
34031055004,1831,1440,1232,108,51,22,36,3,208
34031055002,1286,1061,872,125,16,9,35,0,189
34031035304,2538,1607,893,481,138,46,86,5,714
34041110002,923,737,667,46,13,4,9,0,70
34041065001,1672,1367,1174,92,22,21,23,2,193
34041065002,1222,1026,911,53,15,17,25,0,115
34041095703,756,599,477,63,39,14,11,1,122
34031070101,1565,1227,859,245,52,27,49,1,368
34015020003,1438,1145,1003,54,44,15,18,2,142
34015080001,1146,828,728,22,53,3,16,0,100
34015090006,2160,1720,1331,58,165,20,134,1,389
34015090009,1255,926,741,31,77,6,71,0,185
34015090001,1226,1065,925,29,49,19,40,1,140
34015095002,782,637,595,16,9,4,7,1,42
34015010010,1684,1312,1075,98,77,39,38,0,237
34015010021,2017,1599,1039,98,186,19,264,1,560
34015010001,1389,1144,899,60,116,19,60,0,245
34015090002,1243,1010,870,33,45,6,48,2,140
34015055123,2145,1613,1149,89,309,18,52,0,464
34015070002,1321,945,227,107,585,46,21,3,718
34015030009,4898,4741,3125,540,769,40,306,11,1616
34041010001,1273,1038,914,68,28,14,12,1,124
34041010002,1055,848,728,55,30,12,24,1,120
34041095101,1730,1295,878,194,182,32,24,4,417
34041095201,1682,1235,733,253,225,27,25,1,502
34041095601,1178,948,777,88,66,15,7,3,171
34041095501,1443,1028,675,172,148,18,20,1,353
34031010102,3516,2899,1363,886,200,19,479,3,1536
34031010506,2326,1961,983,669,151,37,178,8,978
34031010504,1567,1219,292,688,186,39,108,0,927
34031010505,1922,1533,553,715,110,38,171,8,980
34031010502,2046,1647,305,973,233,57,216,2,1342
34031010503,1606,1203,316,734,60,47,103,1,887
34031040103,2499,1819,43,823,1014,33,22,8,1776
34031070207,1730,1407,963,185,69,5,185,0,444
34031040610,2516,1925,833,812,119,33,151,4,1092
34031040609,2302,1643,736,703,112,35,107,3,907
34031010404,2182,1650,439,1053,160,39,80,2,1211
34031010405,1337,1019,285,675,65,25,17,0,734
34031010401,2438,1857,452,1292,130,84,39,2,1405
34031040603,2606,2004,88,1630,305,39,21,16,1916
34031055007,1255,1046,798,60,64,123,15,0,248
34031055003,1077,856,754,62,10,14,5,2,102
34011035001,1393,1116,892,96,81,33,25,0,224
34011035002,1372,1111,864,133,70,46,15,0,247
34011005301,931,699,320,237,114,58,17,4,379
34011025003,1375,1100,688,162,185,96,3,4,412
34011005202,1639,1031,47,248,738,52,10,1,984
34027110023,1018,770,551,84,52,10,71,1,219
34027110018,1192,974,817,47,62,6,44,1,157
34027110022,1341,1061,815,74,51,14,94,0,246
34027135012,817,595,369,77,26,4,112,1,226
34015110301,702,581,504,21,29,4,12,2,77
34033040001,1924,1326,365,396,582,34,8,2,961
34033070002,2051,1663,1516,61,34,29,10,0,147
34033010001,1347,1037,918,38,37,28,10,3,119
34015110202,978,681,189,133,367,22,4,1,492
34015110101,1420,977,398,176,374,38,29,1,579
34015085002,1455,1042,538,223,227,31,26,2,504
34031025008,843,739,603,87,7,4,33,1,136
34031040204,2661,1999,274,945,317,35,505,5,1725
34033000705,2004,1581,711,333,496,40,33,2,870
34033050005,1678,1321,1067,97,91,40,31,2,254
34011015001,3136,2433,1686,341,299,102,31,4,747
34033020001,812,672,625,15,14,11,3,0,47
34033001501,1001,834,744,27,42,10,8,3,90
34027100002,1504,1253,732,344,90,18,76,1,521
34027100003,1263,1005,485,374,66,20,71,0,520
34027190012,1370,1064,959,55,21,8,25,0,105
34027190006,880,657,579,38,9,7,22,0,78
34015020004,1234,980,797,69,63,34,12,0,183
34015025005,1382,1125,953,58,50,22,17,1,172
34015100015,1351,1057,908,66,65,12,8,0,149
34015100007,1668,1341,1124,60,91,33,30,1,217
34011060001,1312,1062,937,45,37,42,7,1,125
34011010004,1434,1065,859,74,71,44,10,0,206
34011010003,1479,1134,914,98,73,38,6,2,220
34011005101,5215,3211,142,2616,473,281,26,5,3069
34011005302,1366,980,213,540,215,76,13,0,767
34011065002,2350,1701,1011,239,395,57,34,1,690
34027075005,1052,849,745,39,5,7,46,2,104
34027180401,1467,1176,1007,93,12,2,51,1,169
34027145024,2941,2290,714,90,64,15,1405,6,1576
34027145020,1036,828,581,45,20,12,172,0,247
34031010204,2232,1658,715,694,158,36,137,0,943
34031040503,3263,2312,42,1933,462,34,18,16,2270
34031040504,3347,2501,40,1527,1062,59,13,5,2461
34031040602,2246,1659,65,1407,268,55,22,6,1594
34031040509,2671,2187,72,1899,323,29,11,5,2115
34031040211,2220,1553,122,1172,257,41,49,6,1431
34031040507,3332,2345,104,1681,599,40,32,4,2241
34031045001,1829,1481,1089,239,47,25,86,2,392
34031045003,1573,1212,914,189,49,24,60,1,298
34031045004,1749,1412,1103,199,19,15,81,0,309
34031075011,2079,1705,1449,136,51,46,33,1,256
34031075001,1773,1423,1219,127,18,34,20,1,204
34027070013,1072,864,783,54,3,11,10,0,81
34027070011,1041,817,699,50,22,5,37,1,118
34031075010,2779,2212,1851,178,68,56,50,1,361
34011070303,1526,988,53,852,108,26,6,1,935
34011050202,1095,827,373,155,286,16,10,2,454
34023077101,1007,803,524,164,62,15,42,0,279
34023085203,1621,1318,344,92,284,11,608,0,974
34023085209,1033,830,264,52,106,2,404,0,566
34023090004,1494,1118,408,31,43,9,635,1,710
34023090005,3106,2370,441,129,186,15,1613,5,1929
34023005017,1372,1100,346,332,140,23,279,4,754
34023065211,646,636,573,16,16,3,25,4,63
34023065209,651,577,451,9,23,0,93,1,126
34023025054,799,593,214,31,10,8,336,1,379
34023025044,1041,841,235,29,19,12,564,0,606
34023025050,995,809,307,18,18,1,465,0,502
34023077103,1103,885,624,134,75,17,43,0,261
34023080610,1626,1170,125,997,87,25,8,2,1045
34023080602,1399,1026,53,938,104,45,27,4,973
34023090008,1192,861,211,43,85,4,518,0,650
34023085304,1484,1169,225,103,547,7,282,2,944
34023020038,1276,1010,590,96,51,18,255,2,420
34023055007,1617,1277,911,187,66,19,89,0,366
34031030006,1564,1253,988,159,31,16,64,0,265
34031030001,1903,1589,1289,158,41,15,96,0,300
34031035306,1927,1486,293,968,203,45,112,5,1193
34031040505,3012,2209,41,1521,749,36,24,10,2168
34031005005,604,523,405,50,11,16,42,3,118
34031005002,1871,1521,1183,224,31,12,61,5,338
34031005001,2276,1887,1431,257,52,31,105,1,456
34031060006,1614,1341,1016,209,41,11,76,4,325
34031070603,1589,1312,1046,110,53,14,94,0,266
34031070602,1486,1149,875,101,18,0,149,1,274
34031070605,863,724,610,29,2,0,77,0,114
34041030001,1174,952,865,48,23,11,8,0,87
34041045001,1598,1296,1174,77,18,8,11,1,122
34041105002,2426,1887,1370,208,217,50,46,0,517
34027040401,1267,950,687,63,44,14,146,0,263
34027040301,1788,1421,1043,107,50,12,206,0,378
34027040403,1874,1449,1087,88,73,15,183,0,362
34023025012,1765,1332,384,147,183,29,610,3,948
34023025010,986,763,465,149,57,6,105,3,298
34023025011,1598,1329,699,169,149,10,314,1,630
34011035003,1626,1356,972,162,151,66,15,0,384
34027075001,2031,1607,1313,107,31,5,144,1,294
34027065002,843,648,538,32,33,5,40,0,110
34011025002,1418,1139,120,137,824,107,6,0,1019
34011005501,2621,1685,248,1156,273,89,9,7,1437
34027170002,1118,869,634,139,42,12,38,0,235
34027100001,1248,1035,676,245,52,8,56,0,359
34015120005,2022,1355,1060,71,128,17,96,0,295
34015120004,1401,988,675,61,130,17,106,2,313
34015015005,1348,823,717,25,18,9,54,2,106
34015015006,1883,1283,1066,47,73,16,82,0,217
34015090016,1505,1191,1038,29,35,10,73,4,153
34015030002,793,577,114,62,395,16,5,1,463
34015010004,1527,1335,916,84,220,9,96,0,419
34015010020,1885,1538,1116,52,209,17,149,0,422
34015050009,1296,1041,921,28,46,16,22,0,120
34015050010,1752,1377,1218,44,76,6,24,0,159
34035070015,1545,1192,440,317,366,22,81,2,752
34035030003,2171,1603,627,297,129,22,539,1,976
34035030014,1466,1157,661,199,99,16,202,1,496
34035090009,1057,810,296,302,135,18,83,0,514
34035010008,1194,854,666,50,23,5,109,3,188
34035105004,1192,953,707,38,20,8,168,2,246
34035030005,1682,1219,278,57,30,7,839,1,941
34035030034,1502,1166,550,59,50,6,507,0,616
34035050001,788,654,555,36,14,3,36,0,99
34035050030,963,771,655,34,17,13,38,3,116
34035050008,781,629,566,29,22,11,8,0,63
34035070011,921,696,247,190,228,15,27,1,449
34021055N11,1124,817,39,153,610,17,21,3,778
34021055E09,3466,2467,273,1680,504,99,21,7,2194
34021055N05,2543,2086,1059,550,426,33,83,4,1027
34021035005,1719,1355,741,285,244,29,78,2,614
34021035006,1160,894,644,128,61,16,52,0,250
34035030008,1921,1453,597,611,78,25,160,0,856
34035065017,1747,1263,393,57,91,9,722,1,870
34035065010,1636,1179,369,84,139,6,593,2,810
34035065012,1140,875,496,15,26,7,337,0,379
34035090008,2023,1694,613,534,327,48,215,12,1081
34035040439,2041,1407,115,552,664,33,123,1,1292
34035040440,1772,1336,51,536,708,39,67,0,1285
34035030004,1220,941,724,48,36,7,120,1,217
34035040551,1562,1266,478,192,304,9,299,1,788
34021055W15,1853,1371,34,227,1127,27,16,3,1337
34021055N12,2214,1847,209,829,832,41,22,3,1638
34021055N02,1547,1144,111,309,726,32,9,2,1033
34021055N09,1452,1037,93,554,409,42,12,7,944
34021055N06,1411,1177,219,211,759,24,13,1,958
34023077508,1877,1609,1067,156,108,13,258,2,542
34023077207,1012,848,584,52,40,8,168,2,264
34023077503,804,616,454,94,22,10,45,0,162
34023110011,1197,953,544,203,85,27,107,1,409
34023015001,1140,867,425,311,92,17,37,3,442
34023110014,1449,1155,781,175,111,25,80,2,374
34023005005,1313,1026,271,430,137,11,196,1,755
34023050010,1580,1226,749,104,114,18,266,2,477
34023125410,1857,1542,294,109,68,15,1057,0,1248
34023125412,806,676,121,68,19,9,460,1,555
34023077604,933,779,593,92,42,5,50,0,186
34023077605,1205,949,707,141,57,9,50,1,242
34023020014,1721,1360,968,97,60,8,232,2,392
34023020022,1059,848,480,84,69,8,214,0,368
34023050006,966,767,466,85,39,2,180,0,301
34023025057,1087,904,365,106,140,9,289,2,539
34023075002,1511,1188,574,211,139,35,265,4,614
34023075021,3336,2522,536,906,843,53,271,3,1986
34023075011,1699,1399,737,131,95,12,417,5,662
34023105025,2043,1475,365,55,57,10,995,0,1110
34023105016,1937,1646,591,73,108,7,872,0,1055
34023120005,1672,1357,1020,153,72,16,96,1,337
34023020006,675,519,344,65,40,5,66,0,175
34023115009,1626,1183,534,427,123,10,28,3,649
34023115007,1590,1213,571,433,91,17,12,0,642
34023110007,1474,1200,640,253,210,21,86,1,560
34023125508,1175,943,704,105,27,2,93,1,239
34023125512,1384,1111,750,126,35,9,188,2,361
34023077608,2296,1680,815,169,97,15,582,5,865
34027135020,1541,1172,833,191,58,24,80,2,339
34027135017,1491,1181,866,103,81,8,113,0,315
34027195001,1808,1551,685,638,89,24,139,0,866
34027160017,1915,1495,1151,110,39,14,164,0,344
34025155018,1357,1107,972,72,9,9,23,5,135
34025140022,1300,1007,755,34,13,4,201,1,252
34025080012,2417,1834,1335,128,46,9,316,2,499
34011020002,523,407,363,19,5,17,1,0,44
34011050303,908,646,265,123,241,26,6,0,381
34011050301,1211,805,208,159,423,40,12,2,597
34011070501,1176,906,164,523,225,20,22,2,742
34011070403,1407,1030,109,739,199,45,29,0,921
34011070504,1551,1100,109,729,273,33,35,2,991
34011070405,1474,1191,334,630,216,17,20,2,857
34011065001,1887,1451,929,230,254,50,24,1,522
34011070506,916,669,314,239,95,28,21,0,355
34011050302,1025,897,680,101,86,32,12,11,217
34025015007,864,846,667,65,85,7,21,1,179
34025005001,472,402,377,14,6,1,4,0,25
34025250002,1319,1044,873,86,40,13,17,1,171
34025090005,2073,1539,1178,60,25,5,271,1,361
34025047002,1707,1310,1096,96,25,8,74,2,214
34025247007,1196,979,713,62,84,6,111,0,266
34001010301,1404,1073,56,161,864,20,18,4,1017
34001010202,2615,1842,106,352,1325,31,87,4,1736
34027025007,1242,886,692,39,17,2,133,0,194
34027025009,1028,667,560,7,3,2,90,0,107
34001110004,1504,1303,1097,100,38,14,41,2,206
34001110005,1861,1536,1105,197,54,12,174,2,431
34001110003,1679,1482,1235,146,40,11,43,0,247
34001015101,2094,1767,1639,40,17,17,45,4,128
34001015201,1647,1504,1347,60,28,23,40,1,157
34025003009,1226,954,678,111,79,11,85,1,276
34025155011,881,704,646,33,6,5,7,0,58
34025155013,2025,1632,1423,115,17,21,41,1,209
34025260009,2292,1819,1652,65,22,11,55,1,167
34025260011,1571,1297,1223,34,11,10,10,4,74
34027175202,899,741,479,130,40,8,86,2,262
34027175203,1029,797,561,93,52,7,94,0,236
34027045103,1556,1189,227,832,112,38,51,1,962
34027110006,919,708,563,40,8,2,93,1,145
34027082003,1386,1119,822,173,18,12,90,3,297
34027082001,1630,1255,967,97,8,4,156,0,288
34027015005,1289,1029,857,120,16,12,32,0,172
34027015004,2358,1953,1564,252,62,20,70,0,389
34027045102,1761,1427,205,1136,86,29,30,0,1222
34027045203,1856,1478,151,1231,93,54,30,0,1327
34027050004,1550,1282,1023,85,26,10,145,1,259
34027145026,1481,1302,757,191,120,4,234,0,545
34001060006,1758,1381,1034,102,175,36,28,0,347
34001060012,1329,1138,868,127,110,22,28,1,270
34001040004,1947,1552,1320,103,59,26,25,1,232
34001040021,2634,2061,1568,154,106,32,205,1,493
34001075001,893,797,774,10,8,4,5,0,23
34001042201,815,633,349,141,126,10,19,2,284
34001060008,1923,1527,1181,141,165,42,31,2,346
34001060007,2803,2309,1378,281,562,42,75,3,931
34001060011,2727,2103,815,365,812,35,135,2,1288
34001060001,1812,1402,966,137,189,34,82,0,436
34027135021,2410,1789,955,161,200,10,460,3,834
34027190007,1613,1345,1045,78,63,12,136,1,300
34027070001,3177,2420,1505,324,97,16,450,3,915
34027070005,1303,1061,903,86,23,18,21,0,158
34027110021,897,693,544,63,23,6,51,0,149
34027110010,1455,1162,969,50,28,2,103,1,193
34027145014,1056,875,393,125,35,14,315,0,482
34027045202,1188,923,230,627,88,39,17,0,693
34027045101,1344,1096,268,720,86,42,56,0,828
34027120301,1014,760,395,257,60,32,34,2,365
34027070003,1417,1180,997,113,29,14,21,1,183
34027170001,1424,1161,778,241,60,16,63,0,383
34027115006,903,759,564,74,57,2,59,0,195
34027145006,1088,860,597,75,23,2,149,0,263
34027145009,788,606,435,39,25,6,98,2,171
34027135010,2290,1789,938,383,229,18,229,2,851
34027013004,1947,1711,1280,168,93,3,173,0,431
34027130003,1488,1264,1018,119,37,18,69,2,246
34027135007,2168,1840,1193,335,186,17,119,0,647
34027005101,981,776,550,99,28,8,87,3,226
34027175201,1652,1372,810,219,100,12,265,3,562
34027190009,1185,912,770,85,11,14,35,4,142
34027190003,1846,1431,1209,66,31,17,97,1,222
34027160004,1056,779,639,49,15,12,62,0,140
34027160003,1094,786,633,54,16,4,70,0,153
34027110014,916,717,602,44,30,4,38,0,115
34027155003,1256,1002,861,79,18,11,34,2,141
34027155009,951,786,719,55,1,2,8,2,67
34027085006,956,736,555,107,22,14,45,0,181
34033020002,905,714,679,8,3,23,6,0,35
34033050006,1862,1473,1288,73,33,25,41,1,185
34033042001,1413,1183,962,99,68,31,20,1,221
34033035002,844,622,568,20,18,2,3,0,54
34015120008,2083,1320,936,81,204,19,94,2,384
34033055002,1326,1064,824,54,122,53,14,7,240
34027070008,1048,895,820,43,12,7,8,1,75
34027070006,1419,1179,1023,81,39,18,19,0,156
34027015002,1245,1023,799,157,14,19,44,0,224
34027015003,1226,985,801,114,11,15,54,0,184
34027120302,868,662,436,167,31,22,26,1,226
34027175604,624,531,487,32,4,2,5,1,44
34027105016,1042,792,547,52,16,0,169,3,245
34027015001,1929,1520,1067,336,44,42,49,0,453
34027105017,1186,962,690,62,13,4,183,1,272
34027105006,1535,1181,834,92,20,5,232,1,347
34027175101,1143,868,239,528,45,21,70,1,629
34027110011,959,766,671,21,21,0,41,0,95
34027110012,890,692,562,41,36,2,43,0,130
34027065003,1087,885,775,42,9,5,45,0,110
34027025001,991,847,677,60,4,2,92,0,170
34027180204,845,747,577,83,26,15,62,0,170
34027180105,1071,821,574,148,42,8,58,1,247
34027160006,1556,1185,670,263,81,8,167,1,515
34027120203,1814,1454,572,546,216,79,105,0,882
34027120202,1407,1063,72,659,319,56,23,1,991
34027145005,1094,854,707,36,32,7,66,1,147
34027145007,1600,1219,641,102,38,11,429,0,578
34027040302,1223,960,769,103,16,9,54,0,191
34027145008,1514,1198,781,147,24,11,225,0,417
34027125005,668,510,366,36,2,1,98,0,144
34027125001,1203,881,650,25,10,2,191,0,231
34035100010,1268,1030,777,57,27,5,142,2,253
34035010020,1106,874,705,54,12,9,88,2,169
34035040213,1145,937,586,107,137,6,101,4,351
34035040214,1101,892,386,111,132,11,271,1,506
34035040212,1227,1158,783,93,101,8,158,2,375
34035040215,1212,1009,410,93,195,14,300,1,599
34035040216,920,873,592,50,77,7,158,0,281
34027160012,1645,1210,895,148,60,12,98,2,315
34027190013,1151,852,749,40,10,3,38,1,103
34027095003,1009,730,650,31,11,3,25,0,80
34027175301,1889,1533,1045,245,127,24,94,7,488
34027180201,1145,940,678,175,44,5,38,1,262
34001040010,2579,2047,859,514,263,51,438,8,1188
34001040020,2859,2156,803,373,333,30,655,4,1353
34001060009,2778,2214,1225,238,323,50,423,2,989
34001055013,1273,1145,943,61,90,10,44,0,202
34001060004,2646,2045,693,432,814,22,126,2,1352
34001060010,1933,1595,1092,171,167,29,160,3,503
34001070101,2048,1653,1413,63,27,18,120,1,240
34001105203,1075,884,684,69,87,13,48,0,200
34023105007,1092,837,289,51,28,1,467,0,548
34023105024,1091,875,467,72,77,6,245,2,408
34027135013,1032,769,557,110,44,13,43,1,212
34027180406,1115,923,761,77,24,5,42,1,162
34027105018,1101,846,520,47,20,7,240,0,326
34027105011,1136,832,579,53,6,13,189,0,253
34027105008,997,775,607,54,7,4,92,1,168
34023070101,1822,1491,199,666,345,22,321,3,1292
34023070106,1668,1460,382,493,303,11,294,4,1078
34023070201,1546,1533,517,272,186,12,505,3,1016
34023070104,1128,935,397,235,206,22,117,0,538
34023075006,1915,1706,602,535,199,38,341,7,1104
34023085410,775,666,372,49,68,10,164,0,294
34023085404,2226,2217,567,196,179,3,1163,1,1650
34023085302,1047,825,302,119,162,8,251,1,523
34023085301,1565,1252,580,137,228,11,306,0,672
34023025028,2802,1936,115,105,161,3,1561,0,1821
34023125105,1003,792,484,187,61,15,57,4,308
34023125101,1194,976,448,324,108,22,94,2,528
34023125104,1257,999,588,227,72,12,119,1,411
34023055008,1261,1021,721,150,41,17,109,1,300
34023125201,986,784,223,308,154,13,107,4,561
34023125214,2043,1555,115,1329,162,34,10,8,1440
34023070105,1065,844,395,289,103,14,51,1,449
34023025055,884,689,366,114,46,11,178,0,323
34023025017,928,734,297,119,48,2,282,1,437
34023035002,835,674,476,71,48,4,60,0,198
34023125503,906,718,486,83,36,0,102,0,232
34023080501,1482,1015,41,908,137,31,2,6,974
34023080503,3965,2717,243,1352,1094,52,139,9,2474
34023125204,1042,870,469,239,61,7,98,0,401
34023125513,1045,825,592,103,50,6,82,0,233
34039010404,1300,1032,864,113,10,3,28,1,168
34023125209,947,768,408,139,83,6,132,1,360
34023125107,3062,2306,745,266,302,14,986,3,1561
34023125112,1638,1349,441,437,311,22,176,2,908
34023125215,1801,1337,248,107,182,3,796,0,1089
34023090006,1321,1022,161,54,100,9,711,0,861
34023090010,1067,837,257,21,14,1,538,0,580
34023020012,941,696,484,57,38,8,125,6,212
34023110009,1195,910,633,142,66,10,65,0,277
34023025046,738,583,335,101,57,22,79,5,248
34023025006,1509,1245,288,231,272,4,449,3,957
34023125401,3751,2853,581,157,432,16,1668,1,2272
34023125111,1047,836,466,208,82,17,106,2,370
34023125305,4171,3616,1236,830,932,34,617,5,2380
34023125312,726,563,87,83,255,11,149,0,476
34023125306,2751,2028,611,425,599,18,432,0,1417
34023125302,1519,1250,689,249,113,19,197,3,561
34023065106,444,440,346,18,37,0,37,0,94
34023077205,1884,1504,1053,121,79,13,246,1,451
34001060002,1701,1381,1157,71,100,27,35,5,224
34001055004,1608,1335,933,186,161,44,39,2,402
34001015301,2039,1847,1647,92,45,18,49,1,200
34001045001,1668,1339,1233,38,22,22,4,0,106
34039025004,973,725,557,41,49,8,67,0,168
34039070202,962,743,90,288,367,27,22,5,653
34039065201,1272,1012,289,381,353,21,17,2,723
34039065603,1711,1422,699,333,301,26,103,0,723
34039095043,1487,1191,463,133,308,3,262,0,728
34039085001,1324,1100,656,144,153,7,125,0,444
34039095040,1312,1025,225,141,538,18,121,1,800
34039095027,1635,1267,123,166,956,19,29,2,1144
34039002067,3011,2240,154,1143,907,40,41,17,2086
34039080009,1083,841,602,79,82,12,67,1,239
34039050005,841,667,551,51,16,3,41,2,116
34039090103,1251,940,398,361,96,14,79,0,542
34039090101,898,682,435,126,44,4,69,0,247
34039060210,664,546,159,75,298,10,29,3,387
34039095026,1196,996,347,231,294,14,110,1,649
34039095042,947,758,148,157,360,9,88,0,610
34039015023,716,499,440,17,10,5,15,0,59
34039015028,699,514,427,58,11,1,15,1,87
34001040019,2312,1908,1337,167,169,27,213,2,571
34001040009,3399,2504,1288,450,291,56,455,4,1216
34001040008,3330,2562,1105,704,482,46,281,6,1457
34001040016,2220,1749,728,588,297,43,136,3,1021
34001040017,2744,2075,1579,173,123,23,180,6,496
34001040007,2077,1479,901,152,144,16,276,3,578
34001040005,2351,1876,1559,129,85,26,79,0,317
34033000702,1886,1535,1132,101,267,16,26,0,403
34033000703,1494,1220,836,154,193,22,32,0,384
34023125110,1733,1377,579,504,186,22,121,4,798
34021055N03,2602,1913,70,260,1576,42,15,2,1843
34021015025,1749,1429,871,283,196,20,91,4,558
34021050008,936,743,527,54,34,18,125,1,216
34035010018,1401,1084,729,61,17,0,278,0,355
34035010013,1402,1150,759,74,31,6,281,0,391
34033004203,1073,853,719,45,43,25,17,3,134
34011050506,1244,967,694,88,122,32,29,2,273
34011070402,1682,1215,295,680,246,43,22,1,920
34011005401,1646,1088,318,583,182,59,14,2,770
34011005402,2018,1492,341,643,482,82,35,1,1151
34027145003,782,614,383,46,7,4,162,0,231
34027145018,983,767,541,54,28,6,133,0,226
34027145031,1469,1180,683,120,29,15,336,5,497
34027145030,784,665,316,86,31,6,229,1,349
34027180102,1149,942,700,136,42,7,61,1,242
34027180202,1341,1059,655,254,37,21,75,4,404
34027145010,1151,957,455,78,25,4,398,0,502
34027145011,1379,1161,611,112,21,9,412,1,550
34027040103,1342,1050,929,47,8,14,38,0,121
34027040102,1345,1066,919,65,10,10,53,0,147
34027040101,1324,1132,1017,40,8,1,62,0,115
34027050006,1344,1089,875,96,11,5,110,0,214
34027145027,1115,912,575,45,9,7,272,0,337
34027010004,778,606,537,25,5,1,41,1,69
34027175602,1210,983,838,46,20,13,60,2,145
34023035010,1030,736,576,77,23,6,56,0,160
34001010502,3397,2539,522,970,148,43,915,36,2017
34001060005,1789,1315,839,159,284,17,19,0,476
34001060003,1565,1193,740,172,208,32,30,3,453
34001010403,1015,785,99,118,559,25,13,1,686
34001010402,869,638,27,95,534,21,12,4,611
34001010602,1613,1200,339,363,218,21,278,3,861
34001010104,1191,832,130,177,527,23,34,11,702
34001095202,2690,2042,285,951,750,52,110,9,1757
34001025001,1869,1506,1176,139,136,16,19,2,330
34001025003,1809,1454,751,243,450,41,18,6,703
34001025004,1573,1264,1000,126,81,29,22,8,264
34001020001,2184,1750,1064,447,189,36,53,3,686
34001042102,589,459,240,93,100,8,30,1,219
34001100101,548,440,410,14,3,4,9,0,30
34001100201,553,428,400,14,2,5,8,1,28
34001055005,2259,1711,858,260,272,14,298,1,853
34001055016,2587,1991,892,297,259,44,524,2,1099
34001055012,2803,2208,1070,214,201,21,720,3,1138
34001055006,2240,1800,1049,163,116,27,421,1,751
34001055008,2034,1637,1283,116,83,16,102,1,354
34001055001,2022,1603,1252,133,91,36,85,2,351
34001010603,1328,1111,381,297,70,10,364,4,730
34001010601,2673,2243,709,639,275,35,665,9,1534
34001010604,1341,1133,690,195,71,12,184,5,443
34001105104,1715,1469,1017,230,152,12,67,0,452
34023065116,1594,1210,608,37,31,4,519,0,602
34023065117,2516,1659,442,77,76,10,1057,0,1217
34023065215,773,736,633,18,17,5,64,0,103
34023065210,1512,1132,405,62,47,4,612,2,727
34023065214,820,811,675,16,28,0,83,0,136
34025140019,1359,1020,702,49,15,3,248,0,318
34025247005,1767,1365,1142,67,62,8,85,2,223
34025065006,1358,911,796,30,48,11,22,0,115
34025030001,981,850,753,58,7,9,14,0,97
34025245003,1131,998,902,63,12,14,13,1,96
34025260012,1658,1318,1215,43,14,13,26,0,103
34025155009,1951,1575,1400,116,21,11,22,4,175
34015100006,682,533,484,27,15,4,4,0,49
34021060001,1603,1227,911,74,43,18,168,0,316
34021065013,1987,1534,647,62,87,6,745,2,887
34021010005,1142,930,199,129,593,29,22,1,731
34021055W07,1136,956,219,78,649,13,23,0,737
34021015047,1529,1304,1116,99,44,10,34,0,188
34035010012,1238,889,676,41,8,10,145,0,213
34025003003,1369,1095,754,186,130,23,34,4,341
34025003004,2428,1993,1310,268,262,43,121,6,683
34025115001,1187,899,817,37,5,13,30,5,82
34025082004,1171,990,806,83,31,9,62,0,184
34025260004,1518,1276,1121,81,33,5,34,5,155
34025245002,1010,795,743,29,6,12,6,0,52
34025115007,784,568,529,18,1,2,19,0,39
34025172001,1177,994,705,182,73,18,19,0,289
34025080001,659,516,442,30,11,4,24,0,74
34033060E02,1398,1034,221,94,719,28,5,0,813
34033005501,1254,1017,750,74,146,20,14,0,267
34033030001,1475,1200,859,108,184,23,16,3,341
34035050026,1060,817,588,37,19,7,157,1,229
34035050029,1000,783,565,43,30,6,145,1,218
34035050003,1472,1127,821,58,21,3,198,0,306
34021005004,3196,2812,1209,473,282,42,835,3,1603
34021055W10,1581,1151,141,106,910,23,9,2,1010
34021055W01,1815,1434,112,138,1180,27,9,4,1322
34021010019,2026,1771,1346,120,192,52,69,6,425
34021055W13,1268,952,10,98,855,19,6,1,942
34021055S02,3262,2798,604,1043,1187,41,38,10,2194
34021055S03,2879,2025,216,1386,439,84,33,5,1809
34021015022,790,636,492,72,35,9,22,0,144
34035025015,1107,877,651,54,33,7,123,1,226
34021015016,1650,1259,478,378,344,32,58,3,781
34021055E04,2357,1699,98,790,821,54,17,3,1601
34021035002,1213,962,662,96,103,14,94,1,300
34021005002,2176,1613,464,76,69,6,996,5,1149
34021005006,1533,1194,698,98,93,7,299,2,496
34021005003,870,764,508,121,62,25,72,1,256
34021035003,1476,1124,441,217,400,17,70,1,683
34021010004,1805,1458,761,143,455,22,86,0,697
34035040211,3529,3059,1556,153,348,20,991,0,1503
34035100002,936,754,633,35,2,5,75,0,121
34035040104,1679,1343,323,75,293,7,652,2,1020
34035040102,1207,1011,676,59,103,14,168,1,335
34035040103,1553,1158,199,43,119,7,790,1,959
34035030013,898,678,515,52,15,1,91,0,163
34035105001,1411,1110,891,58,21,10,130,4,219
34021065004,6099,4444,1286,309,406,53,2449,6,3158
34021055E05,5056,3478,305,2659,539,161,47,3,3173
34021015040,906,710,603,56,22,7,29,0,107
34021015010,1133,994,863,42,46,7,38,0,131
34021015046,912,736,624,51,22,10,37,0,112
34021015033,1127,910,670,133,70,12,32,0,240
34021015045,1228,992,871,37,22,4,57,1,121
34021015037,944,808,618,78,69,8,36,0,190
34021015014,1673,1338,733,362,195,18,37,2,605
34021015053,1019,840,733,45,31,3,27,0,107
34021015064,1197,988,812,86,43,10,38,0,176
34035040544,2425,1819,231,801,586,73,225,0,1588
34035040545,1816,1434,282,719,352,33,106,0,1152
34035065005,1136,858,402,33,22,5,388,0,456
34001080003,1244,1114,1052,29,5,4,19,3,62
34001055017,2985,2447,1344,330,500,34,285,8,1103
34001055011,2334,1875,990,304,420,16,161,8,885
34001055002,2094,1689,1444,84,81,25,48,1,245
34001115001,1146,954,842,54,11,11,19,1,112
34001010304,2290,1657,76,243,1311,35,63,10,1581
34001010302,1358,1002,210,319,303,19,188,28,792
34029090002,3078,2729,2114,217,248,41,114,1,615
34029090005,938,913,824,39,17,8,24,3,89
34029090040,1788,1568,1368,92,62,16,25,2,200
34029090024,2815,2169,1624,269,145,44,90,4,545
34029120015,1355,1060,975,55,4,7,8,7,85
34029120009,996,830,791,24,2,1,4,1,39
34029030053,1085,879,783,43,18,12,19,1,96
34029090034,901,896,828,29,32,5,7,0,68
34029020004,1543,1193,1028,119,22,8,9,0,165
34029035020,1476,1161,979,86,33,9,45,3,182
34029035055,1392,1211,1063,87,18,9,15,0,148
34029070009,4064,2592,1025,984,520,74,60,2,1567
34029020006,1339,997,842,98,22,10,19,2,155
34029020007,1056,800,670,63,26,3,33,1,130
34029123002,1168,966,813,108,3,11,23,0,153
34029050001,898,759,714,12,2,15,5,2,45
34029050002,752,614,552,24,8,7,13,0,62
34021055E03,2633,1882,138,1399,352,106,12,13,1744
34035055005,2173,1687,994,523,102,29,67,2,693
34035055007,1144,960,647,234,35,13,47,1,313
34035055003,1375,1037,562,353,68,26,36,6,475
34035070013,1041,815,317,234,217,15,44,1,498
34021060003,1409,1110,706,56,44,13,299,2,404
34021015006,1805,1493,806,297,275,24,122,1,687
34021015017,2016,1555,646,465,379,27,62,1,909
34021015049,1344,1104,929,62,32,21,63,3,175
34035015003,1548,1154,633,434,19,64,60,2,521
34035010002,1119,831,658,85,8,2,72,0,173
34035010006,1030,735,644,30,7,9,36,0,91
34035030009,1016,798,663,55,32,2,52,0,135
34009140004,1256,1014,617,316,66,25,13,1,397
34009040303,532,465,430,11,12,6,0,0,35
34029080008,892,822,760,35,0,9,13,2,62
34029060001,2113,1616,1393,121,24,35,34,1,223
34029060009,1882,1479,1341,71,31,17,22,1,138
34029060002,1994,1595,1404,105,22,24,20,0,191
34029030034,1833,1501,1051,309,43,52,55,4,450
34029035013,1138,878,709,62,33,15,52,0,169
34021015018,2033,1521,502,694,281,38,47,7,1019
34021055S08,2590,1901,317,1236,360,62,26,9,1584
34021015027,1778,1455,1155,148,45,13,88,4,300
34021015021,798,672,465,111,54,12,26,3,207
34021005005,2069,1664,814,190,149,14,488,1,850
34035055004,1915,1527,846,487,115,19,68,2,681
34035050017,1582,1221,851,138,69,13,160,7,370
34035040435,990,819,207,146,387,20,82,1,612
34035010022,1067,795,223,25,8,2,530,0,572
34021010011,1337,1178,797,83,251,3,60,0,381
34021010009,1195,932,192,234,489,23,28,0,740
34029035032,2243,1779,1346,255,80,22,77,2,433
34029120014,1037,814,737,55,11,7,3,0,77
34029130001,2440,1971,1385,372,130,62,37,1,586
34029025103,615,582,550,19,2,2,4,0,32
34029035026,1331,1222,1146,57,2,15,2,0,76
34035050007,3906,3109,1828,334,259,22,658,8,1281
34035040523,1605,1321,605,155,269,10,302,1,716
34021015003,1118,898,783,54,18,11,33,0,115
34021015057,1169,1019,846,83,51,15,27,1,173
34021055N01,2521,2069,347,750,987,21,13,0,1722
34021050010,1127,960,621,107,76,11,155,0,339
34021050011,2346,1871,1262,160,115,19,319,4,609
34021010006,1358,1092,477,144,417,19,48,1,615
34021015009,1302,1048,860,85,44,16,50,6,188
34021030011,1216,950,640,43,20,3,240,0,310
34035090003,997,832,367,199,147,12,106,0,465
34035090004,730,614,311,164,77,11,49,1,303
34039065602,993,789,365,203,175,20,53,2,424
34039065604,1038,879,578,151,83,15,48,1,301
34039080019,1027,729,528,57,23,5,102,1,201
34039060205,684,552,143,87,312,1,12,0,409
34039060303,816,654,84,90,447,13,30,0,570
34039023811,1787,1421,142,1059,227,44,20,4,1279
34039095015,1176,912,265,198,306,10,147,0,647
34039095010,1460,1211,396,228,344,14,230,1,815
34039015007,950,745,634,51,21,6,34,0,111
34039070303,949,724,46,201,453,11,16,0,678
34039070501,1300,1031,155,288,577,22,42,6,876
34025170015,1098,931,656,62,155,8,44,0,275
34025260002,1497,1192,1083,45,21,10,23,1,109
34017035307,1467,1076,302,650,41,29,27,7,774
34017035306,1423,1152,470,504,41,22,67,7,682
34025130019,1663,1264,974,139,54,5,101,1,290
34025003008,1341,1125,739,203,121,23,61,0,386
34025250004,1389,1095,857,164,18,6,48,0,238
34025250003,1021,815,682,81,23,15,16,1,133
34025240003,593,544,527,11,3,4,0,0,17
34025240001,774,671,610,22,10,6,17,0,61
34025240002,670,556,519,18,2,2,7,1,37
34025035002,1235,1077,974,70,18,19,4,0,103
34025055001,1306,1058,689,149,99,19,83,4,369
34039075201,1339,1000,512,330,79,11,76,1,488
34019060001,1682,1364,1160,100,62,20,21,4,204
34019110005,1297,1020,828,83,26,9,68,2,192
34019110014,717,572,517,21,3,3,24,1,55
34019105008,900,684,559,43,11,10,53,5,125
34013025001,952,761,649,49,15,4,43,0,112
34013030513,1162,1006,110,116,777,19,16,0,896
34013055009,891,688,258,83,292,13,49,1,430
34013055003,1410,952,706,56,129,11,52,0,246
34013010112,1533,1243,606,384,172,18,83,3,637
34013080206,1545,1240,833,222,52,15,134,1,407
34013075001,2137,1601,1333,60,14,5,178,1,268
34013075004,1264,932,810,54,22,2,45,0,122
34013095008,1137,822,483,53,227,12,58,1,339
34013095009,1313,1112,688,85,282,8,60,0,424
34013095002,829,628,206,39,352,14,38,1,422
34013100003,985,733,575,112,16,6,30,0,158
34013065203,940,665,506,65,38,12,37,1,159
34013050011,1648,1243,773,58,44,6,358,5,470
34013050026,992,778,477,33,33,1,225,0,301
34039065403,1061,839,72,215,517,22,30,1,767
34039065405,559,434,45,82,311,5,6,1,389
34039010302,874,651,565,44,5,4,28,0,86
34039010201,930,757,627,87,8,3,25,1,130
34025155025,1061,844,740,65,0,1,33,0,104
34025095019,1661,1359,1084,152,53,19,49,1,275
34029030029,1829,1428,1021,218,142,24,36,0,407
34025130016,1218,1032,858,55,15,7,95,0,174
34025265003,879,700,588,47,18,6,24,0,112
34025015001,1432,1156,296,333,520,28,14,2,860
34025155004,1699,1323,1080,97,86,25,32,2,243
34025105003,1366,1100,824,167,75,16,31,0,276
34025082003,1663,1378,1150,152,27,29,21,1,228
34025082011,1192,971,796,105,19,17,37,1,175
34025025002,1271,1041,896,89,19,8,31,0,145
34025003013,1128,914,762,62,48,5,49,0,152
34025100001,828,707,666,14,2,6,8,0,41
34029030026,648,618,581,18,2,1,8,0,37
34041075002,1254,981,811,68,43,11,36,4,170
34041075001,1246,1047,889,57,70,11,23,1,158
34031065004,1134,927,741,86,29,16,42,1,186
34031040202,2979,2134,93,1141,253,50,723,8,2041
34039020108,2847,1900,87,1316,535,51,22,11,1813
34039020105,2971,2138,256,1147,706,56,58,6,1882
34039100201,1421,1084,765,134,93,16,83,3,319
34039100101,948,720,626,34,22,3,33,0,94
34039025003,1362,1053,757,79,103,6,105,2,296
34039025007,1164,846,682,48,33,6,76,1,164
34039080011,915,650,532,39,32,4,47,0,118
34031040408,3157,2169,48,888,1281,37,17,2,2121
34031040409,2628,1865,19,1103,808,67,4,3,1846
34031050001,1061,756,95,471,195,14,32,0,661
34031040502,3033,2183,29,1865,412,43,8,5,2154
34031040212,1555,1130,180,718,219,58,29,9,950
34031040601,2201,1701,361,1107,232,32,56,6,1340
34031040210,3062,2382,555,1263,309,37,320,7,1827
34025095027,2008,1779,1522,128,45,18,51,1,257
34025095001,2209,1759,1427,163,77,34,50,2,332
34025260015,1384,1020,735,62,177,8,35,0,285
34025170001,1042,996,861,63,42,15,11,0,135
34019080002,894,750,698,18,6,13,9,1,52
34005110002,1046,838,797,21,1,6,6,1,41
34005110004,1079,806,721,34,16,13,21,3,85
34005080003,1396,1136,975,26,57,8,53,0,161
34005040001,2675,2049,1022,215,644,35,98,5,1027
34039085006,2022,1638,1093,198,182,6,154,0,545
34039085007,1122,896,736,61,47,8,52,0,160
34039065204,764,612,275,142,133,9,60,4,337
34025185012,2042,1764,1391,87,141,21,111,1,373
34025185013,2688,2142,539,609,684,18,276,2,1603
34025090010,1874,1503,1042,65,38,14,346,0,461
34025047001,844,647,584,19,5,6,36,1,63
34025140012,1116,810,687,64,17,2,37,0,123
34025172002,1500,1299,1011,157,71,17,45,0,288
34025125002,1481,1231,905,111,78,6,38,0,326
34025125003,1901,1553,998,254,117,16,53,0,555
34029070008,7684,3497,2438,827,159,89,16,0,1059
34029035004,2277,1766,1402,165,57,28,120,0,364
34029085002,1301,1207,1119,51,10,5,18,1,88
34029085001,1162,1074,1036,16,1,2,14,0,38
34029030010,1876,1533,1222,178,62,16,45,3,311
34027020004,1066,750,572,72,12,4,77,1,178
34027145019,1636,1436,295,113,59,10,954,0,1141
34027190011,1052,824,655,65,25,5,74,0,169
34041040006,2151,1634,1100,304,75,12,146,1,534
34027190008,1311,1015,775,117,39,13,68,0,240
34027190010,1499,1108,991,50,17,4,40,0,117
34027080402,1575,1294,1000,143,22,10,118,0,294
34027075004,2178,1640,1331,133,20,7,123,2,309
34019045003,1574,1184,772,289,27,23,95,2,412
34019105007,1004,790,602,47,25,3,118,1,188
34019040004,761,641,587,17,10,12,16,1,54
34019105013,1093,834,715,35,16,8,55,1,119
34037080002,1191,981,838,84,5,16,13,0,143
34037030001,1515,1227,1053,106,34,19,14,3,174
34027050008,1094,918,669,45,22,2,182,0,249
34027060005,1358,1020,731,88,14,9,183,1,289
34027040303,2533,1982,1660,120,28,21,139,0,322
34027105005,1287,984,697,75,15,8,192,1,287
34027105013,887,664,441,33,3,0,185,1,223
34027105010,1336,1073,722,33,20,1,291,1,351
34019125003,1254,1074,863,52,29,14,100,0,211
34019125002,1219,958,826,71,24,2,19,0,132
34019125001,1091,875,771,60,10,4,27,1,104
34019005003,1296,1069,944,54,18,22,9,1,125
34019005001,1098,896,801,40,13,24,13,0,95
34019075003,932,751,693,29,10,11,6,0,58
34005195001,1544,1278,1098,46,66,30,27,3,180
34005180004,1903,1515,1362,55,33,17,31,0,153
34005185001,693,594,513,50,7,18,6,0,81
34005170003,1671,1275,1111,59,40,28,29,4,164
34005075103,1167,923,696,42,106,16,62,2,227
34005075102,1096,858,703,32,44,12,71,0,155
34005190001,2917,2210,891,195,932,29,198,4,1319
34005192035,1086,909,85,93,743,1,21,1,824
34005065012,1101,879,771,32,32,14,30,2,108
34005150006,4142,2889,1608,456,619,91,148,30,1281
34029090001,1192,907,808,29,30,11,20,0,99
34029025414,1046,1041,970,42,13,2,5,0,71
34029090008,968,958,871,31,31,8,16,0,87
34029060008,1483,1190,1057,83,14,18,12,1,133
34029145001,1004,734,285,171,228,27,49,1,449
34029145003,975,707,432,165,101,12,10,0,275
34029145002,1664,1211,706,316,177,35,15,0,505
34029015001,1027,927,843,72,7,7,1,0,84
34029055029,709,692,606,47,19,2,16,0,86
34029055034,930,900,808,52,17,8,21,3,92
34029055017,1981,1588,1168,181,111,7,107,3,420
34025080011,1987,1724,1468,105,46,13,84,0,256
34029055032,1094,871,679,109,44,17,19,0,192
34029055002,2659,2041,1575,225,144,27,78,0,466
34029035012,1379,1186,1094,55,13,9,9,1,92
34029003012,1061,1036,942,32,28,9,22,2,94
34029003007,1872,1516,1307,83,54,17,50,4,209
34039060306,839,689,46,135,502,17,14,1,643
34023110006,1477,1170,708,226,149,21,84,2,462
34039060204,1883,1289,43,737,486,25,22,1,1246
34039005007,1403,1052,808,52,12,0,172,2,244
34039090104,853,698,507,63,60,5,68,0,191
34039045504,1126,829,14,159,646,9,26,0,815
34039045503,705,629,137,210,263,7,8,2,492
34037040001,1257,982,842,82,16,10,32,0,140
34037120002,1588,1359,1127,136,43,19,29,0,232
34037010005,821,686,605,35,15,14,9,1,81
34039045404,1032,832,99,281,445,11,17,2,733
34039045403,699,542,50,147,340,8,11,0,492
34039045701,1088,852,313,303,203,16,29,0,539
34039045601,1283,1038,442,329,219,18,65,2,596
34039045602,1349,1092,451,401,210,8,43,2,641
34039100104,1609,1123,977,47,14,5,76,0,146
34039075402,1541,1224,424,418,168,25,221,1,800
34039100102,1142,829,720,35,10,3,50,0,109
34039050006,677,518,440,33,1,2,38,0,78
34039080017,1026,734,472,57,57,6,151,2,262
34039080023,733,552,392,29,29,7,92,0,160
34041095701,1305,887,662,109,94,6,12,1,225
34041020003,1112,881,750,47,16,16,24,5,131
34041020002,1010,837,765,36,9,6,12,0,72
34039090205,820,537,417,22,13,5,75,0,120
34039095005,1639,1316,151,161,880,26,135,2,1165
34039015021,1152,949,719,92,89,9,39,1,230
34039040004,1417,1100,758,188,53,10,70,0,342
34025082015,834,680,512,112,23,8,25,1,168
34025025003,982,778,662,64,13,11,28,0,116
34025025001,1192,1040,921,73,22,8,14,1,119
34025055003,1408,1203,812,87,115,13,167,1,391
34025095014,1160,927,719,115,40,13,21,0,208
34025095031,2675,2201,1602,318,123,29,119,1,599
34025070001,1504,1201,954,106,72,23,50,5,247
34029095001,331,296,276,12,1,0,5,2,20
34029025319,665,664,611,36,6,5,3,0,53
34029025412,779,769,705,41,7,4,12,0,64
34029035029,1232,1032,902,78,10,1,25,0,130
34029030024,1651,1472,1319,65,34,9,30,2,153
34029035002,1369,1117,808,138,121,8,47,0,309
34029030022,1528,1241,1087,103,22,11,15,1,154
34029110002,1160,915,809,44,17,18,18,0,106
34029080005,1414,1117,979,72,20,17,28,0,138
34029080016,979,822,735,51,12,9,7,2,87
34029030042,1495,1213,1055,70,27,16,32,0,158
34005115005,987,756,660,30,33,4,32,1,96
34005115008,897,710,614,32,32,5,26,0,96
34005005001,1355,1103,1000,54,11,23,10,0,103
34005150004,2948,2249,1247,295,533,84,150,7,1002
34005140003,523,429,377,19,23,7,5,0,52
34005150001,1758,1408,1043,134,166,31,37,2,365
34005150014,1354,1069,796,92,126,13,45,5,273
34005150013,1246,975,711,75,124,23,34,1,264
34005030011,1034,835,205,86,456,9,86,3,630
34005020001,3196,2373,1161,222,483,37,482,3,1212
34005070001,526,404,307,27,54,14,7,1,97
34005095002,1552,1183,943,68,56,22,90,2,240
34005170002,1799,1451,1304,76,32,25,12,1,147
34039010204,892,697,594,61,10,1,33,0,103
34039080016,1975,1647,1160,130,183,4,164,1,487
34039085014,677,533,376,44,39,4,69,1,157
34039020202,1947,1525,266,977,249,26,42,3,1259
34039002211,1543,1152,270,747,72,9,49,3,882
34039095017,3401,3113,1302,647,916,15,286,3,1811
34039005001,1470,1119,874,80,12,12,131,1,245
34039015013,1047,875,617,120,64,13,62,0,258
34039015008,831,678,513,70,33,1,64,0,165
34005170005,1877,1842,1679,39,63,18,35,6,163
34005125026,2407,2047,1114,146,461,33,325,3,933
34005015201,1378,1172,911,94,121,21,22,1,261
34005020003,1228,988,772,99,64,16,41,1,216
34005020002,1191,971,804,53,47,18,45,0,167
34005050304,903,663,553,27,27,6,26,0,110
34005125011,1542,1143,798,52,161,19,118,2,345
34005192004,840,644,77,86,461,9,25,0,567
34005075301,1795,1455,782,102,281,27,298,2,673
34005075302,1277,989,679,91,171,24,31,2,310
34039010104,683,532,449,65,2,1,15,0,83
34039020506,1835,1360,149,812,323,30,46,2,1211
34039020510,1872,1396,109,847,446,22,19,6,1287
34039010101,1020,803,691,64,5,4,32,1,112
34023025067,1207,939,419,44,19,3,452,1,520
34039095032,1026,825,453,156,114,10,91,1,372
34039060304,1507,1242,167,291,774,20,13,1,1075
34019110001,1257,970,800,92,17,9,52,0,170
34035005002,794,661,547,46,7,2,49,0,114
34019110003,1047,884,743,78,24,5,34,3,141
34019110011,1534,1314,1115,95,25,15,54,0,199
34019110013,1180,961,708,65,28,1,152,0,253
34019110002,1055,903,799,55,4,5,36,0,104
34019120001,1112,959,858,41,10,16,31,1,101
34035005003,841,662,551,68,11,5,30,1,111
34009030004,1113,902,757,44,70,9,19,1,145
34009040401,475,434,418,7,3,1,2,0,16
34009040204,648,496,393,48,22,4,25,1,103
34009040203,532,446,352,39,36,9,6,1,94
34009040202,583,488,399,23,58,1,5,1,89
34009040101,569,486,477,1,0,3,5,1,9
34009040104,831,710,635,33,24,10,3,0,75
34009040103,834,687,657,15,4,6,4,0,30
34009040105,558,492,454,15,10,5,4,1,38
34009030013,1267,1047,828,135,31,21,35,4,219
34009065001,540,481,454,14,3,8,1,0,27
34009025302,853,716,646,32,18,10,10,1,70
34009140005,648,548,426,91,17,12,8,0,122
34009040404,735,629,606,4,1,7,0,1,23
34009020008,993,855,771,29,19,11,9,0,84
34009005002,365,348,336,4,0,0,5,0,12
34009040405,453,407,385,4,3,5,1,0,22
34013050018,931,670,412,35,39,0,175,0,258
34013050021,959,688,511,23,27,1,127,0,177
34013050024,900,657,424,24,17,2,177,0,233
34013070C04,1156,904,9,152,766,6,7,2,895
34013070C05,1054,746,14,161,587,3,3,0,732
34013070N12,2283,1568,32,873,701,24,15,0,1536
34013070N20,1698,1115,13,632,501,26,8,4,1102
34013070N10,2034,1499,48,1236,264,43,14,2,1451
34013070E19,2107,1740,423,890,70,31,24,3,1317
34013005405,993,781,263,340,78,11,101,2,518
34013005201,1046,808,264,387,72,21,101,2,544
34013070S21,1381,987,15,133,859,11,2,2,972
34013037003,1925,1517,1331,103,5,2,60,1,186
34013037001,1289,988,841,75,10,8,56,1,147
34013037004,1526,1220,1027,104,13,13,63,0,193
34013037005,1141,834,690,75,8,2,52,0,144
34013045N01,1446,1076,52,127,901,15,5,0,1024
34013100004,1595,1225,994,119,47,6,71,0,231
34013110501,1193,853,80,309,454,16,14,2,773
34013110302,1493,1098,85,462,513,32,26,9,1013
34013080305,2998,2348,1333,267,115,21,621,1,1015
34013080304,1485,1141,807,162,55,15,124,3,334
34013030302,1240,964,23,78,870,29,10,3,941
34039025002,769,557,426,52,25,5,53,1,131
34019095004,1256,1037,923,53,20,7,19,2,114
34019055001,1370,1110,967,69,17,12,25,1,143
34019080003,994,813,750,21,5,8,18,0,63
34019080001,1192,941,868,35,11,8,12,0,73
34025247002,1959,1594,1162,127,188,12,111,1,432
34025090003,1757,1373,945,72,30,6,320,0,428
34025140026,1486,1103,428,41,7,2,624,0,675
34025080005,1503,1126,970,62,27,3,60,2,156
34025125017,1235,941,410,240,190,44,24,3,531
34025082016,1390,1083,884,107,32,7,37,0,199
34009005001,550,493,484,2,1,0,4,0,9
34009030014,1776,1414,1056,180,100,21,47,3,358
34009030009,1002,838,724,48,28,20,24,2,114
34009030016,529,473,384,57,26,2,3,2,89
34009025305,1019,859,790,22,18,14,5,0,69
34009075004,628,561,509,27,6,9,10,0,52
34025095030,1621,1293,869,199,70,25,134,0,424
34025080016,2122,1781,1318,219,134,13,93,0,463
34025080020,1862,1525,929,276,206,26,110,5,596
34029135002,852,790,722,36,10,8,7,2,68
34029080011,1883,1640,1522,46,16,23,25,1,118
34029080001,1018,831,742,52,8,18,15,2,89
34029102002,833,668,587,27,15,12,8,1,81
34029060010,2399,1895,1699,105,16,25,43,0,196
34029003005,882,846,762,34,11,24,3,0,84
34029010001,930,803,755,23,5,3,18,2,48
34029070015,11792,5117,3987,642,220,25,91,1,1130
34029070037,6405,2721,2451,136,66,18,7,0,270
34029035048,885,805,693,46,26,9,27,0,112
34029035058,2774,1817,1319,218,158,6,113,0,498
34029080013,1382,1126,955,66,41,17,46,1,171
34029003015,588,558,528,11,8,3,8,1,30
34029150019,1579,1205,1071,80,10,20,18,0,134
34029003013,2335,1874,1592,129,66,23,61,4,282
34029150005,2038,1706,1484,110,52,18,33,0,222
34029150009,1414,1111,987,57,20,23,23,0,124
34029055020,2555,1919,1519,185,100,21,81,4,400
34029065001,2636,2044,1390,347,210,51,99,0,654
34025030002,952,840,758,46,19,5,13,2,82
34005020007,832,660,580,23,30,7,22,0,80
34005150007,1383,1134,773,106,190,29,56,2,361
34005080004,691,536,448,30,29,10,19,0,88
34005050102,926,729,579,46,32,17,14,0,150
34037120008,1156,933,843,51,2,16,17,0,90
34037100001,1495,1236,1123,58,16,16,18,0,113
34037115001,7,4,4,0,0,0,0,0,0
34013030309,1704,1464,102,114,1249,21,26,2,1362
34013070S30,1564,1152,9,72,1093,5,1,0,1143
34013040005,682,456,353,25,28,6,32,0,103
34013070N28,2425,1787,103,1430,210,48,41,5,1684
34013070C32,3614,2766,123,1103,1575,67,104,10,2643
34013070C39,2653,1950,49,504,1427,9,24,0,1901
34029123003,1383,1210,1092,66,18,5,23,1,118
34037060002,902,782,637,89,30,21,17,0,145
34013070N26,1687,1283,136,870,172,53,74,1,1147
34013070E03,11783,10929,2501,3035,4680,54,127,12,8428
34013070E09,2474,1919,754,638,94,42,11,9,1165
34013070S49,1655,1386,47,358,998,25,6,1,1339
34013070E25,576,533,113,85,289,10,40,0,420
34013070C44,1906,1796,546,271,792,23,217,6,1250
34013070C49,1672,1289,145,613,406,24,51,3,1144
34013060007,1562,1140,721,48,24,4,315,1,419
34037090010,977,849,740,47,19,12,29,0,109
34037110007,1127,929,815,72,14,18,7,1,114
34037020001,1353,1088,942,83,31,9,20,0,146
34037090001,1887,1455,1248,105,32,10,55,0,207
34037020002,1317,1075,956,45,11,21,38,0,119
34037020005,1058,821,708,52,19,3,25,2,113
34037120004,1612,1284,1101,109,24,15,14,0,183
34039075501,1140,933,462,264,102,2,96,0,471
34039085010,1512,1184,892,113,81,6,81,0,292
34039085011,2364,1893,1090,147,348,21,294,1,803
34009030002,1361,1166,1012,48,86,7,11,0,154
34009080001,1118,872,502,163,198,20,2,1,370
34009080002,1010,760,349,180,212,18,7,3,411
34009020007,1044,817,740,17,7,24,12,0,77
34009055001,836,647,592,12,6,21,2,1,55
34009055008,1114,825,771,15,7,21,7,3,54
34039090211,885,629,421,60,32,8,105,2,208
34003015008,1427,1128,339,341,104,21,346,3,789
34003025001,1107,931,579,226,28,14,91,2,352
34003185003,979,770,363,333,23,17,52,0,407
34003075204,4086,3491,1192,547,620,24,1165,7,2299
34003075403,2045,1535,61,579,849,34,114,3,1474
34003075404,2199,1739,367,672,574,29,157,3,1372
34003050005,1690,1374,766,271,57,10,299,7,608
34003050009,1737,1389,775,256,76,14,295,0,614
34003175004,1392,1148,924,144,30,9,51,3,224
34003350005,1337,978,835,41,14,6,86,0,143
34003105301,2822,2127,772,1105,215,41,84,3,1355
34003295001,2701,2124,937,895,168,15,157,3,1187
34003310001,61,44,21,16,8,0,1,1,23
34003105302,2474,1895,844,828,207,38,55,5,1051
34003067010,2539,2054,1155,550,139,26,233,0,899
34003067001,2562,2067,1141,519,170,26,270,1,926
34003105402,2240,1743,1218,408,90,30,49,1,525
34003255012,1311,908,725,63,10,6,101,0,183
34003165003,2045,1578,1081,243,58,39,167,1,497
34003165010,2145,1751,1197,156,71,23,306,0,554
34003165009,846,636,322,91,95,64,69,0,314
34003050001,1656,1374,832,312,54,19,175,3,542
34003015002,1913,1514,570,438,136,5,395,1,944
34003100006,1691,1244,1045,49,16,1,129,1,199
34003120002,1756,1344,911,91,17,4,311,0,433
34003035003,1611,1225,677,129,25,9,379,1,548
34003040003,2249,1642,1051,104,33,6,442,1,591
34003150001,1416,1159,568,398,49,17,164,1,591
34003150006,1691,1357,547,510,108,18,190,1,810
34003025002,1393,1114,694,264,34,14,112,0,420
34013070S22,1899,1370,20,70,1300,9,4,1,1350
34013070S24,1241,904,1,88,829,14,6,2,903
34013060002,1277,948,672,63,33,5,171,3,276
34013060012,1642,1131,646,6,28,3,433,2,485
34013060006,1344,934,536,53,35,3,308,0,398
34013065407,1338,998,244,77,620,27,48,0,754
34013070E06,1483,1111,159,507,306,33,14,3,952
34013070E04,4450,3337,616,1790,364,54,45,1,2721
34013070E02,3558,2792,963,1044,153,42,40,4,1829
34013025010,1562,1298,900,207,119,16,72,1,398
34013030503,2091,1594,26,284,1296,19,22,11,1568
34013070W10,1246,889,24,275,601,17,9,0,865
34013010106,1702,1324,402,566,272,18,99,1,922
34013035001,885,650,561,35,16,8,39,0,89
34013090101,1010,774,619,50,34,2,60,0,155
34013035002,1359,1027,904,48,24,11,52,0,123
34013045S08,1773,1335,23,142,1182,14,10,2,1312
34039035101,2145,1692,117,279,1241,21,25,1,1575
34013050010,2386,1858,1173,94,101,7,482,0,685
34013070W26,1370,1006,14,111,903,33,4,3,992
34013025007,1668,1342,1000,99,41,10,190,1,342
34013025008,1292,1044,708,148,86,13,128,1,336
34013050019,1571,1147,662,73,32,6,377,1,485
34013080203,1547,1205,999,139,8,10,55,4,206
34013045N08,1135,872,8,57,827,8,3,2,864
34013045E01,1818,1359,31,113,1213,13,22,1,1328
34013045N09,972,728,2,43,694,11,6,0,726
34013060016,1359,957,545,26,25,3,353,0,412
34023077201,385,312,227,28,18,1,34,0,85
34023077206,205,164,127,11,3,0,22,0,37
34023080612,1777,1383,185,1113,121,29,20,2,1198
34023080603,1525,1199,146,967,120,30,30,1,1053
34023095006,549,459,339,75,35,7,8,1,120
34003095012,2926,2485,820,361,213,19,1093,5,1665
34003095011,1291,1076,282,220,59,11,526,10,794
34003095013,1390,1210,475,186,52,8,501,1,735
34003255008,1186,839,579,93,19,6,152,0,260
34003300010,1801,1282,1028,80,87,4,40,0,254
34003300009,1657,1199,956,70,103,8,50,0,243
34003105101,2069,1560,567,825,141,63,68,1,993
34003325003,2420,1996,1174,362,150,27,330,0,822
34003035006,1734,1271,633,57,14,5,533,3,638
34003280008,1653,1222,810,159,66,21,189,0,412
34003280009,1521,1192,758,193,55,17,173,5,434
34029025332,1058,1053,988,42,9,2,10,0,65
34029090030,779,724,660,31,18,2,8,0,64
34029090029,938,902,783,44,49,5,17,0,119
34029090039,2363,1845,1378,209,127,11,123,0,467
34029090028,672,661,600,29,17,0,8,0,61
34029035014,1498,1182,850,153,67,20,107,0,332
34029105001,1932,1613,1388,108,58,39,5,2,225
34029025104,2023,1584,1343,158,30,17,37,1,241
34029120002,1204,993,916,54,5,3,12,0,77
34029060007,2228,1802,1607,127,23,5,21,0,195
34029060006,1575,1255,1091,103,27,25,20,2,164
34029025326,1120,1113,1047,38,10,8,12,2,66
34029070011,2676,1512,1396,41,9,7,10,3,116
34029035063,1103,844,631,111,32,12,57,1,213
34029035021,2054,1670,1202,197,112,16,148,1,468
34029055007,2034,1116,812,202,69,14,15,1,304
34029030013,1582,1280,1101,103,32,28,26,5,179
34029070024,854,851,779,21,41,7,6,0,72
34029070031,821,818,774,19,6,2,17,0,44
34029070028,589,576,475,59,21,2,20,3,101
34029070034,508,508,470,16,17,1,2,0,38
34029030021,1214,955,820,90,22,9,16,1,135
34029140001,1098,982,916,43,1,3,12,0,66
34023075013,855,689,344,97,61,13,177,1,345
34023075007,1989,1557,706,367,143,24,337,5,851
34023020026,1359,1041,629,80,25,10,273,1,412
34023070502,2148,1432,96,1196,125,80,38,3,1336
34023120004,877,667,519,64,40,25,27,0,148
34023025073,1508,1180,411,99,95,16,577,4,769
34023025058,3937,2650,136,122,384,5,2009,0,2514
34023005007,1542,1188,223,535,166,30,275,2,965
34023095022,718,603,482,68,26,15,21,0,121
34023020029,1361,1084,476,89,58,12,448,3,608
34023020003,1746,1317,692,316,96,17,229,1,625
34023085206,1777,1457,490,160,316,15,488,0,967
34023105013,1386,1097,363,93,204,4,431,2,734
34023105014,1349,1064,299,64,101,2,601,2,765
34023095021,911,716,434,138,95,9,54,2,282
34023077303,3163,2496,580,338,716,39,853,4,1916
34023125514,594,482,269,12,15,1,179,0,213
34023125404,1433,1133,268,104,51,19,699,3,865
34023125406,972,781,292,36,50,9,399,0,489
34023065203,734,725,652,12,23,2,34,0,73
34003115101,1721,1426,365,693,241,25,167,1,1061
34003115102,2651,2222,399,1364,336,42,165,3,1823
34003250007,1715,1347,497,674,122,35,115,3,850
34003250005,1164,868,298,371,103,17,120,5,570
34037080001,1067,856,712,99,17,15,15,0,144
34037110016,931,759,697,33,18,8,2,0,62
34037100002,1472,1219,1111,57,13,18,20,0,108
34037050002,1354,1100,1022,33,6,20,7,2,78
34037025002,1228,1054,949,54,7,19,13,1,105
34037120005,1549,1217,1065,73,16,21,24,0,152
34037070001,1047,863,758,43,22,17,9,0,105
34037090003,1747,1277,1061,107,27,11,58,0,216
34037055005,844,674,597,29,18,11,21,2,77
34037060006,1608,1307,989,179,63,20,53,0,318
34037060012,833,683,479,127,45,8,36,1,204
34017045102,1576,1393,614,413,169,17,215,0,779
34017045205,1324,1123,381,312,74,12,360,6,742
34017045103,4607,3677,808,589,269,27,2040,8,2869
34017035405,1191,950,375,411,51,18,27,2,575
34017035407,2178,1753,739,758,60,41,92,5,1014
34017035206,3035,2598,640,1167,489,32,170,7,1958
34017060308,2065,1671,82,1546,58,59,29,5,1589
34017025506,3530,2883,2097,323,116,9,337,3,786
34017005316,1479,1139,464,380,200,33,110,2,675
34017030A16,1206,953,152,302,373,25,115,4,801
34017050106,2521,1790,74,1644,101,117,49,9,1716
34017040405,1406,1044,163,769,56,45,87,3,881
34017040505,2535,1966,383,1372,136,56,118,3,1583
34017045201,1828,1449,747,297,42,12,355,0,702
34003245004,2073,1659,474,444,29,24,711,1,1185
34017040403,1645,1282,236,967,47,39,51,1,1046
34005115017,1283,907,621,34,35,3,210,0,286
34005115019,810,590,415,10,16,8,146,0,175
34005115020,1617,1249,858,27,43,4,314,0,391
34005115018,1661,1234,890,32,47,5,262,0,344
34005115015,1217,938,796,36,41,15,50,1,142
34005095008,925,737,619,40,45,12,29,1,118
34025055004,1594,1271,948,137,87,14,91,6,323
34025247015,1029,870,714,49,28,11,62,0,156
34025247001,1709,1387,1123,75,80,7,100,4,264
34025025004,969,778,688,30,15,12,25,3,90
34025095003,1352,1004,771,124,55,19,41,1,233
34025095007,2338,1721,1396,205,53,27,45,0,325
34025080019,1579,1368,1190,45,50,7,75,3,178
34005030013,1606,1254,776,81,223,14,179,1,478
34005030015,1050,810,291,57,360,3,100,0,519
34005030018,730,588,359,42,114,14,60,2,229
34005030014,1574,1159,590,107,308,16,143,7,569
34005115010,983,686,567,20,50,6,42,1,119
34005115012,1072,846,647,50,117,10,14,0,199
34005115011,1042,773,487,27,206,9,45,1,286
34005095003,1506,1157,842,64,81,12,159,1,315
34005025402,787,604,212,99,281,18,14,0,392
34013027E04,2059,1517,23,347,1165,50,16,1,1494
34013070E13,3352,2419,560,1050,342,56,13,2,1859
34013070E12,2918,2059,280,1015,401,50,27,1,1779
34013045E05,2509,1710,19,367,1333,13,9,1,1691
34013045E02,1610,1294,22,91,1185,16,23,0,1272
34013025004,1395,1108,899,65,30,5,104,0,209
34013025005,1028,892,704,67,34,2,88,0,188
34013030501,1319,919,14,224,686,21,18,4,905
34013030403,357,253,3,28,228,4,0,0,250
34013070W07,2318,1617,23,368,1280,36,11,4,1594
34013070S27,1621,1233,10,191,1037,20,6,4,1223
34013005202,944,775,326,291,47,8,112,1,449
34013010203,1460,1168,591,238,172,19,188,2,577
34013030404,883,644,1,45,588,7,7,1,643
34013100006,1319,927,785,63,27,6,44,4,142
34013080102,1183,915,551,216,34,12,109,1,364
34023025027,1320,991,736,82,48,10,117,1,255
34023025049,1040,736,504,79,21,2,121,0,232
34025105002,1885,1434,938,222,218,36,54,7,496
34025155036,1817,1415,1223,116,22,23,29,3,192
34025140027,2064,1706,1258,40,23,11,375,0,448
34019125004,2943,2646,1870,260,435,6,78,1,776
34019075005,883,697,630,32,14,8,15,1,67
34019085002,1242,1057,869,121,25,24,13,1,188
34019130002,1477,1241,1130,46,14,6,30,1,111
34019030007,1133,862,721,62,29,5,39,6,141
34019030001,949,788,690,28,10,10,29,0,98
34019030004,2251,2039,996,368,603,19,65,1,1043
34019030009,891,745,641,33,13,8,42,0,104
34019030011,1042,797,684,31,18,1,51,2,113
34019105017,1057,824,691,44,11,10,62,2,133
34019105021,1275,947,678,70,52,3,144,1,269
34019035002,796,661,617,21,6,1,6,0,44
34019030010,995,768,650,57,24,5,28,1,118
34003240007,1670,1214,1015,57,19,4,109,0,199
34003240004,1240,938,802,97,8,4,25,2,136
34003155008,2336,1871,844,683,172,37,185,2,1027
34003125006,1198,959,647,180,46,7,87,1,312
34003125005,1325,1051,672,195,36,13,155,2,379
34003300012,2075,1436,1174,74,115,1,47,2,262
34013105001,1004,754,651,43,12,2,29,0,103
34013095011,1104,944,499,105,268,11,80,1,445
34013070C35,2602,1853,32,1382,477,74,19,7,1821
34013070S40,1124,877,5,47,832,10,7,1,872
34013010208,1613,1248,766,210,95,4,190,2,482
34013110203,1909,1499,356,587,509,40,81,7,1143
34013110204,829,664,207,132,288,7,36,1,457
34013027W05,2692,1972,101,760,1099,40,37,4,1871
34013055005,1058,777,459,59,216,7,56,1,318
34037035001,778,632,555,40,10,3,19,0,77
34037070002,1064,864,733,62,26,14,22,0,131
34037045001,1368,1127,904,112,50,22,37,0,223
34037045002,1898,1566,1297,128,53,19,58,1,269
34037050001,1666,1328,1219,54,6,12,20,0,109
34037100003,1037,850,793,33,6,10,6,0,57
34037060011,1321,1088,792,195,44,22,30,0,296
34037110011,856,665,539,66,23,19,13,0,126
34037025001,1332,1116,1004,58,25,13,15,1,112
34037035003,700,571,504,27,4,7,16,0,67
34037005001,595,498,415,45,21,7,6,1,83
34037085001,1977,1612,1456,72,14,20,45,3,156
34037055001,1552,1328,1099,74,71,4,73,0,229
34037110001,1145,920,755,97,26,16,28,0,165
34037090006,1096,799,702,56,11,15,13,0,97
34003220006,1414,1089,884,72,16,3,105,1,205
34003015014,1315,1041,309,299,114,15,359,1,732
34003015012,1857,1409,571,419,138,9,309,3,838
34003040005,1071,764,448,72,2,3,237,0,316
34003345005,4038,3130,1646,393,228,16,847,4,1484
34003160008,1421,1160,725,267,40,29,104,0,435
34003085005,1406,1084,888,86,23,5,87,0,196
34003280012,1379,1067,646,193,43,18,189,0,421
34003170001,1505,1297,606,333,133,8,244,0,691
34003170002,1403,1131,664,278,41,17,144,1,467
34003155012,1895,1550,737,554,123,28,161,1,813
34003285004,1399,1110,772,229,34,22,80,2,338
34003015001,1041,839,293,231,57,7,259,0,546
34003195007,2798,2281,1536,548,48,25,112,2,745
34013005404,2033,1679,578,791,163,15,150,5,1101
34003280010,1560,1221,845,170,38,11,147,3,376
34003205001,2826,2250,1367,157,36,9,687,0,883
34003245003,2878,2298,1074,613,69,16,517,1,1224
34003315003,1661,1268,987,63,30,6,177,1,281
34003180003,3045,2272,1639,178,68,13,384,0,633
34003165013,1774,1493,1117,92,48,18,220,3,376
34003165002,1825,1416,1132,81,52,22,136,0,284
34003165001,2283,1886,1398,140,43,11,286,0,488
34003165004,1265,1094,889,45,12,2,139,1,205
34003165014,1488,1342,1103,99,23,2,103,2,239
34003165008,3986,3652,2585,360,263,28,418,5,1067
34017005210,1346,1017,460,314,131,31,108,2,557
34017055203,1243,1009,506,325,70,12,112,0,503
34017050501,1818,1465,105,1291,78,62,43,12,1360
34017050305,1010,887,456,318,47,20,88,4,431
34005100005,895,728,621,36,38,19,13,0,107
34005030007,1057,852,598,72,105,25,54,0,254
34005065014,1728,1412,928,89,155,11,237,0,484
34005050106,1019,814,621,51,53,11,31,0,193
34005050201,640,481,347,30,69,6,18,0,134
34005192011,1595,1296,251,111,866,36,47,1,1045
34037065001,669,551,508,22,10,8,5,0,43
34037110008,1106,909,828,51,7,13,8,1,81
34037060008,1448,1154,805,240,50,24,42,0,349
34037060005,1048,837,635,136,40,4,22,0,202
34037110005,807,642,585,35,8,11,2,1,57
34037110017,964,785,669,65,18,16,2,0,116
34037020004,1195,961,801,102,22,12,24,0,160
34037090011,1450,1058,880,86,25,6,53,0,178
34037090012,2526,1829,1369,176,94,21,155,1,460
34005120003,1743,1312,782,203,262,23,59,3,530
34005055003,2041,1605,824,205,459,22,124,0,781
34005100001,1095,899,772,57,27,17,28,1,127
34005192034,746,612,76,59,476,16,24,0,536
34005090006,782,630,333,18,189,2,82,1,297
34017050603,1773,1323,98,1138,66,53,71,3,1225
34017030E23,4522,3935,886,185,108,14,2721,4,3049
34017030E22,6573,5796,828,250,264,17,4441,5,4968
34005175001,1580,1248,1036,68,59,20,58,5,212
34005135002,5183,3490,2271,504,460,105,159,32,1219
34005120004,1583,1226,846,130,221,31,51,3,380
34037055003,1173,1025,904,66,6,11,23,0,121
34013110414,1655,1458,858,87,283,12,232,2,600
34013050017,1194,853,569,28,43,3,198,0,284
34013110405,1926,1574,877,130,352,14,207,2,697
34013070S29,1651,1211,10,200,1000,23,14,4,1201
34013040004,1325,885,719,56,25,6,70,2,166
34013070W17,2563,1873,44,364,1481,28,9,3,1829
34005125021,2014,1531,1238,54,49,13,181,5,293
34039100403,1357,958,818,29,5,5,93,0,140
34005045005,961,739,381,53,263,21,43,1,358
34039045901,1169,939,472,269,136,22,69,2,467
34039045902,976,734,468,162,77,5,18,1,266
34005160001,859,679,554,55,49,15,9,2,125
34017005205,1147,1030,606,287,100,15,36,2,424
34017045104,833,687,332,199,43,12,123,2,355
34017025401,1698,1385,905,112,34,14,308,2,480
34017025406,1340,1168,774,257,28,7,97,0,394
34017025402,1458,1171,753,76,28,5,298,0,418
34017025405,1144,928,729,42,5,0,144,1,199
34017030B21,903,689,145,209,165,20,192,1,544
34017020101,1356,1054,200,508,54,33,274,4,854
34017010002,1438,1139,247,629,44,24,173,2,892
34017030E17,1010,850,535,120,37,8,149,0,315
34017030F16,1398,1013,46,265,724,8,18,2,967
34017030F04,1227,929,40,198,679,14,34,4,889
34017030F22,1097,855,109,176,514,20,67,10,746
34017030F05,718,513,17,83,403,8,8,0,496
34017030F01,1808,1409,361,525,488,23,80,0,1048
34017030A33,1143,804,32,211,572,8,6,4,772
34017030C01,1481,1219,307,467,126,28,349,3,912
34017025306,1527,1254,859,174,63,16,143,2,395
34017025304,2126,1749,1236,193,52,19,236,5,513
34017025305,1625,1406,928,92,92,6,264,9,478
34017025607,1142,1027,785,107,36,7,83,0,242
34017025101,959,836,465,256,52,8,60,0,371
34017025102,2810,2388,1490,327,76,16,475,1,898
34017025602,1335,1286,344,155,563,1,148,20,942
34017020202,4174,3862,1118,527,367,32,1795,9,2744
34017020201,2534,2098,481,650,151,37,725,8,1617
34017030C13,1244,1044,379,170,152,20,364,4,665
34007170013,1967,1601,1105,93,121,18,269,1,496
34007005001,1129,875,727,67,51,11,9,2,148
34007085004,1027,708,648,12,9,3,30,0,60
34007025003,1823,1403,1147,55,91,11,100,1,256
34007077103,923,738,664,47,11,10,7,1,74
34007140002,1985,1500,1087,175,166,56,53,3,413
34007110007,2715,1944,217,1062,652,28,45,3,1727
34007110005,3454,2471,411,982,1037,51,73,3,2060
34007110009,1582,1173,382,354,418,44,27,7,791
34007043003,1777,1394,875,180,138,15,192,1,519
34007043009,2709,2191,1289,188,321,27,367,3,902
34007025001,1426,1155,933,65,63,16,28,3,222
34007130001,818,687,568,42,38,6,29,2,119
34007043018,1049,883,706,45,60,4,61,0,177
34007043043,1078,830,692,37,43,1,50,1,138
34007043047,1857,1518,1035,67,153,14,250,1,483
34007120003,1218,955,529,224,155,10,60,2,426
34007170006,1716,1323,997,51,90,11,175,2,326
34007020002,1816,1469,1150,129,71,25,97,0,319
34007030002,914,697,406,67,169,14,47,0,291
34007040103,1855,1345,164,409,805,34,35,3,1181
34007040101,1018,704,10,241,476,5,2,0,694
34007040211,1158,830,8,258,596,24,5,1,822
34007180402,2777,2108,844,224,1011,32,43,5,1264
34007120001,1563,1211,828,170,204,32,28,2,383
34007135009,1689,1377,622,456,275,19,45,8,755
34007180404,1743,1377,704,160,510,25,28,4,673
34007080002,860,692,614,25,23,2,25,0,78
34007175005,1619,1268,956,117,125,25,41,2,312
34015120006,809,760,655,24,53,5,22,1,105
34015120007,1709,1315,921,52,239,8,81,0,394
34015090039,2166,1778,1247,127,252,19,132,1,531
34015090010,883,674,617,12,21,5,16,1,57
34015035006,1178,1007,906,33,31,20,10,2,101
34015105002,1542,1224,929,98,139,16,45,3,295
34015105003,1317,1034,782,91,106,23,33,1,252
34015030006,1197,988,783,82,82,14,38,1,205
34007040308,2124,1548,43,1065,440,63,72,18,1505
34007043019,1211,958,651,73,83,10,143,3,307
34007043020,2868,2411,1877,173,206,12,153,6,534
34007040102,1981,1662,134,658,900,20,17,4,1528
34007180405,2233,1696,610,189,793,16,108,4,1086
34007180304,1834,1397,313,186,834,64,41,5,1084
34007043010,1025,806,616,61,51,4,76,1,190
34007043005,1628,1302,832,93,135,14,231,1,470
34007043035,1411,1053,942,29,26,8,38,0,111
34007170017,690,652,577,16,19,2,42,0,75
34007170007,919,700,555,30,32,5,84,2,145
34007170019,1347,1219,945,22,127,6,122,1,274
34007170009,1764,1422,1081,63,101,16,163,2,341
34007040209,2568,1699,59,529,1165,35,15,9,1640
34007040105,1879,1415,118,708,591,27,51,6,1297
34015005001,1654,1232,813,95,291,35,16,4,419
34015045002,1924,1361,1022,48,232,4,53,1,339
34015040004,1562,1199,1076,26,27,2,56,1,123
34015100019,1916,1459,1137,67,146,26,97,1,322
34015100016,855,834,788,6,34,1,3,1,46
34015075006,1190,967,908,30,8,6,9,0,59
34015090008,1160,879,766,19,34,4,48,0,113
34007075017,3158,2409,1031,311,881,41,135,10,1378
34015015004,1596,1172,973,54,65,17,57,1,199
34015040003,1225,874,665,51,72,11,80,1,209
34031025001,1424,1189,935,145,27,9,69,2,254
34031025002,1816,1466,1147,182,44,14,88,1,319
34031015006,1850,1462,526,626,197,30,141,1,936
34041095702,991,814,619,79,81,25,31,6,195
34041100003,720,581,485,44,26,16,15,1,96
34041025002,1086,882,761,34,27,13,45,2,121
34041025003,928,731,621,42,23,9,28,4,110
34019015001,792,658,573,36,22,8,12,1,85
34041025001,954,793,681,41,19,14,30,1,112
34019010004,873,695,615,34,15,6,21,0,80
34015030012,1224,958,722,46,102,9,70,0,236
34015090029,903,701,589,14,41,4,36,0,112
34015030005,3878,3561,2181,477,737,50,151,4,1380
34015010006,1718,1456,935,110,298,38,58,1,521
34015055326,1660,1241,772,75,347,18,45,1,469
34031040403,2411,1726,19,893,866,14,10,5,1707
34031075013,1304,1060,936,66,24,25,14,0,124
34031020302,1047,841,647,124,20,8,29,0,194
34031020303,1317,1037,836,138,30,4,32,1,201
34031075002,1553,1240,1073,108,19,28,16,3,167
34041040004,1436,1145,849,205,38,12,43,1,296
34041115001,531,507,436,24,37,8,8,0,71
34007075010,1302,1045,821,79,71,20,44,1,224
34007025002,1663,1311,1139,35,56,18,53,1,172
34007170003,1621,1251,825,34,111,7,284,1,426
34041035002,1227,946,814,44,37,10,39,0,132
34041100001,1001,824,705,40,34,17,15,0,119
34041055001,884,719,640,45,4,12,11,1,79
34031020304,1030,831,699,85,29,7,17,0,132
34031040110,920,777,68,382,334,7,20,4,709
34007150005,1825,1522,1125,117,190,21,94,2,397
34007040406,2333,1554,30,1286,262,76,26,4,1524
34007155001,2070,1665,1024,133,332,35,167,3,641
34007100002,875,716,617,36,37,12,10,1,99
34007160002,1158,958,826,41,46,10,28,2,132
34007075006,2361,1893,1339,169,287,10,98,1,554
34007160004,1295,1029,929,43,26,20,14,1,100
34007160003,1249,998,671,93,160,13,74,0,327
34007135020,1048,814,41,356,426,24,30,1,773
34007040208,2626,1795,64,586,1215,19,9,4,1731
34007150003,1083,868,736,50,32,7,44,2,132
34007075013,2605,2034,1219,169,575,42,70,1,815
34007075002,1070,870,740,68,43,10,22,4,130
34031020201,1827,1486,951,391,96,40,52,4,535
34007180301,2276,1687,312,186,1209,44,22,2,1375
34007040306,1705,1234,21,676,564,50,25,7,1213
34007135001,1884,1380,218,605,418,25,178,11,1162
34007135024,1186,862,62,475,277,36,76,0,800
34007025004,1730,1354,1146,82,54,31,51,1,208
34007040309,2764,1957,15,1310,545,54,174,5,1942
34007080011,1110,855,781,27,17,5,25,0,74
34007043006,1198,940,630,95,53,13,144,2,310
34007043048,859,773,493,117,115,10,58,2,280
34007043024,1734,1305,842,110,111,5,233,1,463
34007080003,1394,1072,1006,30,7,5,21,3,66
34007085009,1524,1058,948,22,9,10,66,0,110
34007080001,1312,1049,962,32,24,9,19,0,87
34015030010,1142,952,655,69,144,28,67,0,297
34041055002,951,803,729,41,13,8,10,0,74
34041070001,1094,913,825,41,16,19,11,0,88
34041080005,947,709,522,83,34,14,53,1,187
34041080004,971,787,671,65,19,20,12,1,116
34041110004,976,734,562,79,49,5,35,0,172
34041075003,1229,1008,746,96,94,10,59,1,262
34041095602,1672,1266,861,170,163,20,52,1,405
34031010117,1474,1260,468,342,177,11,297,1,792
34031070206,1390,1082,828,128,21,7,109,0,254
34031075008,2030,1568,1358,116,29,11,47,0,210
34027075003,1096,800,708,19,9,4,50,0,92
34031075005,999,807,635,104,24,19,15,2,172
34031040411,1695,1253,38,977,290,104,17,2,1215
34015010002,1445,1178,927,54,125,8,71,0,251
34015060004,559,473,431,17,15,8,5,0,42
34015055210,1204,922,610,82,186,27,21,0,312
34015055216,1535,1190,836,110,212,32,26,1,354
34015055319,1382,1061,854,47,99,16,43,0,207
34015055213,1649,1297,1082,59,124,16,22,3,215
34023110004,2933,2290,851,227,188,40,981,2,1439
34023020008,1202,908,589,84,41,5,192,1,319
34013070E07,2292,1553,198,803,388,17,15,6,1355
34013050013,1194,879,492,30,24,2,318,0,387
34013010306,1851,1513,368,394,603,25,170,4,1145
34013030109,1617,1236,20,237,1002,21,7,0,1216
34013030506,1574,1249,34,161,1058,25,11,1,1215
34013070C34,3673,2650,90,1547,1108,92,22,8,2560
34013070W43,2661,1833,27,877,1013,41,10,7,1806
34013070C15,2603,2401,654,320,938,30,558,3,1747
34013070C43,2278,2090,669,407,846,16,225,26,1421
34013005403,1531,1228,341,710,71,18,105,4,887
34013005406,1739,1414,489,622,135,37,157,2,925
34015005003,1610,1207,894,64,191,45,17,4,313
34015090037,1226,934,764,27,40,29,78,0,170
34027010005,919,722,631,32,4,3,48,0,91
34027180303,882,690,595,29,20,3,44,0,95
34027085001,942,704,625,20,8,0,44,0,79
34027145034,1552,1229,615,153,54,18,391,0,614
34027145033,1223,969,554,125,45,17,234,0,415
34023125202,1488,1154,408,605,107,28,75,0,746
34023125203,1386,1093,516,385,111,22,90,1,577
34023125206,929,768,435,199,85,7,55,2,333
34023005015,1075,848,288,214,116,11,232,2,560
34023125413,810,657,271,77,54,4,258,0,386
34023125313,1584,1297,613,248,169,24,267,0,684
34023125402,1235,1005,331,105,112,5,453,1,674
34023095010,1244,1049,353,88,80,6,527,0,696
34023125303,1141,937,575,186,65,6,99,5,362
34023115012,1437,1134,628,275,140,18,19,0,506
34023125310,2180,1852,626,390,368,27,481,1,1226
34023125407,1611,1284,458,214,114,7,503,0,826
34023120002,1158,942,739,93,43,19,54,1,203
34023060003,627,508,421,47,8,9,18,1,87
34023005011,1343,1075,365,305,110,20,296,1,710
34023050005,1050,800,606,56,40,11,96,1,194
34023025036,1855,1657,607,171,179,6,690,1,1050
34023125408,1195,1000,349,161,111,3,385,1,651
34023110012,1531,1207,868,140,57,18,132,1,339
34023025059,889,689,307,91,22,7,262,7,382
34023110010,2269,1795,681,341,284,23,459,3,1114
34023120003,921,739,606,86,14,9,26,2,133
34023080605,1643,1248,191,991,92,36,32,7,1057
34023125311,2759,1961,266,209,289,7,1193,3,1695
34023060009,583,449,382,36,7,3,20,0,67
34023095032,1254,1010,598,104,87,5,212,0,412
34023095030,1761,1401,747,221,215,9,210,4,654
34023085409,704,572,55,42,244,13,226,2,517
34023065204,1602,1206,819,79,43,22,237,0,387
34023025052,773,637,332,107,24,9,166,1,305
34023025019,981,773,317,155,82,16,226,7,456
34023085101,1811,1410,134,383,801,33,102,2,1276
34023085408,1441,1187,325,113,144,19,598,1,862
34023025076,1879,1502,333,112,97,10,963,0,1169
34003135003,1719,1360,1116,121,21,16,78,2,244
34003330005,1522,1193,1003,69,20,6,93,0,190
34003180002,1581,1196,981,91,22,6,112,1,215
34003180001,1077,850,663,46,25,4,110,2,187
34005110003,1076,791,740,18,10,10,11,0,51
34001005101,1240,977,789,75,61,15,46,0,188
34001085201,1895,1572,1310,164,57,23,17,3,262
34001070203,1107,827,719,33,13,10,51,1,108
34001105204,1924,1595,1149,206,131,20,96,2,446
34001080001,1526,1310,1231,29,15,3,27,0,79
34001080002,1601,1399,1312,35,12,11,17,1,87
34001042202,652,504,283,103,83,15,32,0,221
34001042101,688,519,184,178,161,18,12,2,335
34011040001,3087,2403,1831,282,221,74,14,0,572
34041075007,1309,1095,843,101,91,12,47,0,252
34041115006,777,669,613,15,21,9,9,0,56
34031010403,2250,1603,367,1140,98,64,26,2,1236
34027035001,996,764,631,64,19,7,42,0,133
34027160013,1311,1002,783,75,42,5,91,1,219
34011045001,1738,1420,1224,84,65,45,10,1,196
34011050102,1812,1304,603,384,289,43,15,1,701
34031040108,2175,1730,161,883,728,33,39,3,1569
34027055009,1251,1011,840,27,27,3,106,1,171
34027055008,1471,1258,1026,67,41,2,114,3,232
34027055001,1122,886,718,55,16,4,77,1,168
34011070604,2236,1740,1077,333,199,19,120,2,663
34011070404,1196,913,422,333,162,15,8,3,491
34011055001,444,372,321,24,17,10,6,1,51
34011050502,1136,823,467,126,198,28,18,1,356
34011050401,1446,1031,342,265,433,25,5,3,689
34011050505,1632,1354,1068,111,103,58,28,2,286
34011010002,833,689,521,30,117,21,6,0,168
34011010001,923,703,478,48,151,29,3,0,225
34031020103,1265,1023,786,137,26,15,62,0,237
34031035401,2522,1880,67,1468,225,70,190,11,1813
34031010109,1604,1307,742,335,58,22,183,2,565
34031075006,1552,1273,1128,86,26,16,14,0,145
34031075004,1886,1563,1346,123,25,14,45,0,217
34031025007,1145,1017,841,97,27,7,54,3,176
34031025009,2160,2143,913,433,656,5,142,0,1230
34031025006,1147,923,758,72,26,12,54,1,165
34031040104,2597,1827,83,863,903,48,25,1,1744
34011070608,2690,2186,1535,322,223,63,33,1,651
34011050403,1970,1502,814,317,351,36,29,3,688
34011070603,1375,1127,663,343,90,19,14,0,464
34027145025,2110,1617,589,154,58,19,805,1,1028
34027145036,1105,867,462,80,25,5,297,2,405
34027145035,831,640,361,74,34,4,168,7,279
34027155001,1417,1042,854,133,8,4,37,0,188
34031070601,808,673,464,99,7,1,96,0,209
34027110019,1403,1112,819,100,77,4,97,7,293
34027180305,768,585,513,26,9,0,37,0,72
34027180306,1065,786,571,81,39,5,79,2,215
34027135008,940,695,468,91,49,10,73,1,227
34001040001,1339,1138,1054,27,18,14,24,0,84
34001105103,705,566,473,48,21,7,15,0,93
34001025002,1782,1506,1301,114,65,11,19,5,205
34023095008,884,752,517,106,71,7,53,0,235
34023095005,1377,1130,682,247,141,12,58,2,448
34023085303,933,786,369,63,195,12,163,1,417
34023085207,1926,1495,366,105,322,17,703,1,1129
34023105017,2640,1962,609,283,337,16,732,0,1353
34023025004,719,552,279,17,14,1,243,0,273
34023050001,1293,971,691,90,27,4,159,0,280
34023025035,1101,878,336,29,39,5,474,0,542
34023025062,829,630,258,7,12,1,350,0,372
34023115011,1246,959,588,209,88,6,35,0,371
34023020011,794,595,368,94,56,22,79,0,227
34027160002,875,626,514,39,12,1,51,0,112
34027110017,746,543,432,30,33,7,37,0,111
34027185001,1582,1189,154,854,177,26,34,4,1035
34001090104,1163,933,729,102,49,13,28,2,204
34001115002,1468,1315,1118,67,82,25,18,2,197
34001042103,845,667,400,130,125,13,23,1,267
34001110001,2377,2016,1275,353,110,7,267,5,741
34001040018,1922,1501,1278,66,62,25,69,2,223
34001040003,2358,1804,1233,223,186,49,132,1,571
34001040002,1810,1418,1125,138,88,35,38,4,293
34001095104,2593,1883,117,1006,770,74,41,7,1766
34001040014,1198,909,226,278,336,37,77,3,683
34001085101,1762,1376,803,394,136,19,17,6,573
34011050101,1154,853,421,134,288,35,6,2,432
34011050103,1715,1300,617,243,404,64,19,5,683
34011045002,4480,4197,2007,483,1648,30,16,3,2190
34011020001,876,727,655,24,17,19,5,0,72
34011070607,2704,2113,1392,324,287,42,89,2,721
34011050504,1438,1174,968,83,80,36,10,0,206
34011070106,1697,1366,533,529,308,30,16,1,833
34011005201,860,576,56,227,296,35,5,1,520
34011070602,1918,1483,892,288,176,21,122,0,591
34023105022,1637,1232,337,40,54,3,793,0,895
34023025071,1220,904,183,36,17,7,666,0,721
34023075008,20,16,10,0,3,0,1,0,6
34023075014,725,564,231,242,71,10,31,2,333
34023095031,3629,2844,1255,453,518,24,612,1,1589
34023095034,1214,958,335,111,154,11,364,1,623
34023077304,2294,1810,659,290,393,21,492,3,1151
34023125102,1235,991,677,153,79,17,79,1,314
34023020002,2748,2090,799,135,158,13,986,0,1291
34023077601,1619,1244,797,210,97,31,111,2,447
34027055006,2674,2427,1703,315,277,20,134,5,724
34027055003,836,638,556,28,3,4,40,0,82
34027085014,1420,1128,826,156,31,13,100,0,302
34027055007,1265,1055,832,49,11,3,147,1,223
34027085002,986,705,597,37,15,4,49,0,108
34027145039,2560,2112,1052,214,151,14,667,3,1060
34027175503,1239,942,704,119,36,11,76,0,238
34027175502,914,736,492,79,26,5,129,0,244
34027175501,937,737,559,62,35,5,67,2,178
34027070002,1477,1224,1012,118,29,14,27,1,212
34023080609,1193,910,162,631,149,20,9,1,748
34023080613,1687,1345,173,944,277,27,26,5,1172
34001090103,1032,840,635,113,32,5,54,3,205
34027055004,2519,2009,1295,144,299,5,252,1,714
34027155010,1075,825,734,49,2,5,26,1,91
34027085004,1197,949,524,306,67,5,44,0,425
34027085010,984,693,573,47,11,3,53,0,120
34015060003,952,751,673,22,21,21,4,3,78
34023077406,1486,1240,878,143,83,17,138,3,362
34023125502,1038,839,414,133,120,7,165,1,425
34023125517,1004,806,506,120,68,16,102,1,300
34023077204,1874,1447,547,100,114,0,675,2,900
34023077507,1728,1417,850,146,109,8,324,1,567
34023077208,1216,948,660,71,31,11,186,1,288
34023085103,1373,1101,211,251,442,8,218,3,890
34023085104,1358,1028,296,222,306,28,201,4,732
34023010003,1049,814,543,24,22,6,219,2,271
34023070102,1099,895,215,372,225,9,113,4,680
34023060001,717,551,430,68,23,12,23,1,121
34023020025,1019,747,472,46,25,6,196,0,275
34023060004,657,521,403,75,16,6,29,1,118
34023065114,4038,2865,785,112,101,5,1869,0,2080
34023065109,769,745,609,52,38,8,33,0,136
34023065110,630,623,517,31,35,5,32,0,106
34023100102,1248,959,688,173,71,24,23,0,271
34023100301,449,336,228,64,20,4,13,1,108
34023100201,874,707,472,176,54,11,10,2,235
34023095004,1073,893,575,141,50,15,114,4,318
34023095026,1167,944,508,131,106,4,201,1,436
34023085308,1437,1120,291,80,173,13,577,1,829
34023085310,928,754,344,99,95,9,205,1,410
34023005016,984,825,322,250,86,7,181,2,503
34023095027,2327,1785,734,244,261,26,520,1,1051
34023080611,1749,1298,150,1095,105,41,12,12,1148
34023085403,1366,1096,263,133,236,22,456,2,833
34023040001,1525,1244,754,260,101,21,120,1,490
34023040004,1552,1246,835,221,120,29,73,2,411
34023125409,1994,1569,566,193,151,18,661,1,1003
34007080004,904,713,626,38,20,8,16,0,87
34023105015,1786,1433,518,60,74,6,776,3,915
34023105030,1462,1104,383,64,98,9,563,1,721
34023125211,1310,1038,492,333,110,21,97,2,546
34023105004,1438,1145,682,83,62,13,310,0,463
34023080302,1847,1453,61,1287,254,41,18,1,1392
34023070206,1670,1207,76,974,157,59,27,5,1131
34007180203,2347,1967,1343,113,431,29,64,2,624
34007175004,1136,943,871,23,12,19,8,0,72
34007180101,1539,1364,1084,221,36,17,12,1,280
34007170011,1269,949,747,47,58,14,79,0,202
34007150002,1495,1195,1019,95,35,16,27,0,176
34007043039,1403,1013,798,22,25,3,162,0,215
34007110003,1502,1164,538,279,312,36,34,2,626
34007170002,1872,1519,1015,95,122,21,263,4,504
34001095102,2434,1808,132,824,840,51,28,2,1676
34001095201,2674,1888,102,1022,792,51,35,2,1786
34001065006,2052,1576,967,539,42,27,22,1,609
34001055015,2030,1620,1181,159,114,31,153,2,439
34001055003,2267,1855,1369,197,119,31,121,0,486
34001005103,1760,1441,1140,126,58,13,97,1,301
34035065007,1632,1168,599,75,30,14,447,0,569
34035040328,1103,887,523,89,140,17,146,2,364
34035040326,1150,934,560,54,92,17,224,2,374
34021035013,2134,2020,1224,277,341,20,165,3,796
34021010001,661,587,510,20,37,6,10,0,77
34021010024,2174,1783,858,132,526,11,288,0,925
34021035021,954,734,540,43,64,5,85,1,194
34035040331,1907,1528,254,173,641,19,468,1,1274
34035040329,952,754,334,68,162,19,190,0,420
34035040330,1430,1091,220,217,512,6,154,3,871
34035070001,3601,2714,204,2197,222,70,90,3,2510
34035070010,2476,1841,373,1084,340,67,48,2,1468
34035040222,1437,1228,451,95,229,14,451,2,777
34035040221,1243,1015,468,73,244,7,229,0,547
34035065008,1198,897,548,59,35,7,244,7,349
34021010002,939,778,456,85,208,8,38,1,322
34035050005,1449,1094,660,77,59,4,286,2,434
34035090007,976,728,510,92,53,18,67,4,218
34035040327,883,739,405,32,91,4,199,0,334
34035040548,726,592,140,72,284,14,101,0,452
34035030002,1622,1264,861,132,36,10,201,6,403
34035030001,1545,1221,836,112,16,23,231,1,385
34035040110,1262,1032,376,64,230,10,377,1,656
34021015038,1280,1053,758,161,93,24,44,1,295
34021015063,1042,844,487,142,174,16,38,1,357
34021065003,1584,1177,474,23,25,1,650,2,703
34033004202,1206,962,861,23,22,7,45,1,101
34033042009,1477,1201,1083,32,28,39,18,3,118
34033004208,1584,1225,1087,45,38,27,17,0,138
34033042007,1216,1012,884,30,41,24,23,1,128
34025140002,1336,1047,737,61,30,3,202,0,310
34033045001,1436,1108,961,41,59,18,22,0,147
34033045002,1361,1091,988,47,24,18,7,2,103
34035100005,1358,1043,761,78,11,6,188,0,282
34021015056,1210,963,813,55,22,13,50,0,150
34021050013,1591,1229,899,61,28,6,212,1,330
34021050012,856,719,484,74,43,15,111,3,235
34025105004,1695,1312,926,206,122,25,39,0,386
34025105005,1487,1168,826,200,91,28,36,0,342
34025200008,2172,1571,478,871,192,80,41,1,1093
34025200005,1120,1032,837,134,20,15,34,2,195
34025095018,1588,1183,962,99,31,4,64,0,221
34025155001,1395,1056,890,60,20,11,68,0,166
34025075005,2060,1522,287,857,350,90,50,6,1235
34025170012,1693,1357,324,99,906,25,36,1,1033
34025130013,1115,871,732,44,16,8,62,2,139
34025130026,1037,883,727,38,12,7,95,1,156
34025015004,2684,2159,959,545,610,44,49,1,1200
34025015005,1934,1696,812,447,393,37,37,1,884
34025210003,1323,909,855,21,1,6,11,0,54
34025225003,1817,1429,1292,40,18,13,51,1,137
34025225001,1299,953,870,22,18,1,30,0,83
34025190001,1837,1575,1128,344,60,17,26,1,447
34025080009,1440,1091,655,141,85,18,197,0,436
34025170016,1049,888,801,36,11,13,21,0,87
34021010023,1124,890,376,193,264,25,56,6,514
34021010025,1315,1105,319,123,584,23,70,0,786
34035020003,2002,1621,525,739,214,31,135,2,1096
34035040109,1367,1113,319,132,348,10,335,1,794
34021015042,1021,799,702,64,10,7,15,0,97
34035030011,1214,972,595,108,49,8,218,0,377
34035100004,1128,901,650,42,29,2,174,2,251
34035085001,743,553,479,37,5,4,28,0,74
34025090004,1951,1492,1071,79,34,9,299,1,421
34025140003,2167,1633,1099,88,51,13,384,4,534
34025145001,934,733,441,123,75,14,81,0,292
34025003001,2869,2370,1535,316,324,15,192,4,835
34025140001,2620,1948,1115,80,46,16,668,0,833
34025047007,1998,1534,1333,70,26,15,96,0,201
34025170003,1240,1168,1018,64,54,3,18,5,150
34025155033,1590,1262,1079,99,32,18,32,4,183
34025155016,1230,943,823,75,15,1,23,0,120
34025185005,851,673,576,39,10,9,32,0,97
34025185014,1207,1023,525,127,288,25,83,2,498
34025095011,1413,1074,805,122,64,16,62,1,269
34025130027,1477,1399,1243,72,32,6,42,3,156
34025130001,1091,874,603,108,55,3,97,2,271
34025130025,3674,2510,1728,107,71,7,603,2,782
34025130021,1828,1419,1104,105,63,9,126,2,315
34025110002,1190,926,607,206,84,17,29,1,319
34025035003,1702,1393,1062,248,45,30,23,0,331
34025170004,959,817,744,31,9,4,17,0,73
34025082014,718,571,489,37,7,7,34,2,82
34025003007,998,762,614,80,13,7,46,1,148
34025170002,775,725,631,50,24,4,13,0,94
34025235001,1697,1429,1070,234,76,28,33,2,359
34025170019,1311,1066,220,112,688,13,36,0,846
34025080018,1928,1502,1180,132,76,12,115,0,322
34025255003,1919,1485,1200,100,64,8,102,1,285
34025170009,3041,2198,151,494,1590,48,36,0,2047
34025010002,1151,901,800,31,39,14,16,2,101
34025105006,1638,1243,770,228,192,21,37,2,473
34025250001,774,624,523,70,10,2,10,2,101
34025110005,944,796,560,151,51,6,19,0,236
34025140020,1311,947,742,59,31,4,111,0,205
34025130014,1512,1172,961,83,25,0,93,1,211
34035010004,1014,785,377,32,3,5,368,0,408
34035010024,1198,860,318,26,12,3,492,0,542
34021055N07,1317,884,30,337,528,22,8,2,854
34021055S07,3126,2094,264,1283,536,82,31,11,1830
34021055S05,3699,2467,206,1808,481,101,27,3,2261
34021055S06,1434,1069,138,739,208,35,7,5,931
34025265002,1499,1173,886,112,22,10,32,2,287
34025125011,3491,2707,1045,997,431,100,78,3,1662
34025155007,2651,2087,1668,237,83,39,69,3,419
34039070203,1344,1056,63,278,701,30,14,1,993
34039045904,1006,765,445,172,120,4,36,0,320
34039055007,1001,706,509,57,13,7,112,0,197
34039045501,1253,988,241,584,149,26,22,1,747
34039020102,3931,2721,135,1919,716,59,23,7,2586
34039020101,1820,1307,108,1029,176,36,37,6,1199
34039020207,2504,1747,198,1010,562,30,46,5,1549
34039020206,2805,2067,444,1359,202,56,44,2,1623
34039055011,1189,867,603,65,25,1,172,3,264
34039005004,1140,846,620,67,12,5,137,0,226
34039005008,1825,1383,887,103,82,5,289,0,496
34039020204,1874,1399,188,1035,167,51,44,1,1211
34039020209,1838,1428,153,1023,253,29,37,4,1275
34019030005,1209,949,844,47,8,8,42,0,105
34019025002,1459,1145,901,105,25,19,81,1,244
34019025001,1314,1017,787,93,29,10,104,1,230
34019120003,1084,862,752,26,16,5,49,0,110
34019095001,1283,1044,918,42,11,17,36,0,126
34019010002,1010,795,694,43,14,10,24,0,101
34037075004,1678,1329,974,154,85,22,78,0,355
34029035022,1501,1450,1338,59,17,7,21,1,112
34029035015,1013,968,848,81,9,4,16,0,120
34037060001,1311,1131,866,160,57,16,32,0,265
34037060004,1298,1092,844,145,45,26,33,0,248
34037010006,1125,935,771,72,18,21,56,0,164
34039100401,1940,1393,1093,100,87,9,94,1,300
34039065601,1238,990,357,264,303,13,85,0,633
34039075202,1376,1094,573,325,82,8,109,0,521
34039035103,1731,1450,331,375,550,26,72,2,1119
34039035201,3039,2358,583,704,798,20,74,0,1775
34039095012,1212,953,296,220,283,16,133,5,657
34039020313,2339,1830,233,1244,311,75,64,1,1597
34039035303,1710,1350,338,400,484,15,39,0,1012
34039070403,1088,829,92,247,465,25,32,0,737
34039075301,1233,961,354,419,124,21,55,1,607
34039070401,1988,1581,194,520,867,55,25,1,1387
34039045804,1211,930,163,389,339,16,51,0,767
34039045803,957,767,24,137,615,13,7,3,743
34037025004,1584,1262,1124,56,28,11,38,0,138
34039035202,1524,1254,47,179,1005,7,25,0,1207
34039020303,1304,1055,488,450,52,15,61,0,567
34005150005,1183,898,549,109,173,36,43,8,349
34005180002,910,720,638,40,10,20,14,0,82
34005180003,1664,1276,1181,30,23,13,18,1,95
34005165002,1988,1554,1406,42,34,20,30,1,148
34005105006,3196,2785,2433,118,97,37,91,4,352
34005090001,995,828,665,69,47,28,41,4,163
34039095016,1186,1092,499,186,310,3,79,2,593
34029025211,1539,1212,949,154,56,41,25,1,263
34029035017,1813,1399,1164,129,43,27,38,1,235
34029035034,1580,1253,1030,127,23,18,44,1,223
34029035011,1408,1128,936,122,25,22,24,0,192
34029030006,2449,1876,1163,480,93,83,93,5,713
34029150001,1324,1048,787,190,22,35,26,1,261
34029150021,1142,918,793,93,10,9,20,3,125
34029150003,1512,1373,1297,40,6,23,8,1,76
34029150015,1260,1014,896,66,6,15,24,1,118
34029155001,1243,1121,1084,20,5,2,9,0,37
34029035023,1143,865,741,61,19,8,28,2,124
34005140008,823,626,162,100,332,17,33,0,464
34005065008,2493,1883,1507,48,87,13,234,0,376
34005065030,2317,1898,1438,62,164,4,240,3,460
34005065021,2237,1695,1393,47,66,3,184,0,302
34005065032,1714,1399,1071,106,112,12,96,5,328
34005065025,1252,1002,681,82,136,6,101,1,321
34005190002,1332,1009,638,86,222,14,66,7,371
34005080001,1221,930,710,63,112,11,43,2,220
34005015101,601,473,391,40,20,3,13,0,82
34005165004,1444,1149,1012,68,30,15,11,0,137
34009025309,676,582,542,14,8,10,3,0,40
34009025204,634,530,467,26,15,9,15,2,63
34009075003,688,599,549,24,7,17,3,2,50
34009140001,879,712,551,98,30,28,7,0,161
34009140002,1369,1041,621,294,113,18,11,0,420
34003060001,2799,2368,1037,614,243,37,479,6,1331
34003125009,1098,867,432,203,65,4,178,1,435
34003305009,1387,971,631,81,21,2,239,2,340
34003085009,1641,1257,713,247,53,8,255,4,544
34003220002,1282,1029,784,99,10,4,137,0,245
34003220001,1403,1020,769,92,24,1,127,0,251
34003190003,1884,1534,922,269,79,12,268,0,612
34003075304,1563,1295,61,434,758,29,100,2,1234
34003300014,2180,1742,72,386,1234,41,136,2,1670
34003255009,1382,1043,734,85,30,9,192,1,309
34003095005,1718,1391,535,234,66,18,560,5,856
34039020106,3200,2330,67,1926,357,60,27,5,2263
34039020109,2971,2037,84,1660,303,64,21,8,1953
34039030001,1334,1103,857,141,39,6,42,0,246
34039030003,1078,889,704,124,24,14,36,2,185
34039030004,832,696,539,110,8,8,28,0,157
34003095003,2358,2004,1131,167,62,6,625,0,873
34003235005,1833,1532,1186,182,40,13,118,5,346
34031010308,2247,1760,659,905,164,43,84,0,1101
34003170005,1321,1074,691,211,58,10,100,1,383
34005065026,1162,942,796,26,43,12,74,0,146
34005065022,1133,836,776,21,14,8,14,1,60
34005192005,1095,799,82,116,598,26,18,4,717
34009040305,536,495,471,11,0,7,4,0,24
34009055007,786,582,541,17,9,1,8,1,41
34009055014,772,589,547,12,11,12,4,1,42
34009030006,956,839,744,38,35,8,13,0,95
34009050002,403,371,361,5,0,1,4,0,10
34009050001,393,336,326,5,1,0,1,1,10
34005120002,1020,783,570,82,82,13,38,0,213
34005060002,682,565,359,63,101,19,25,0,206
34005075101,1669,1259,757,71,230,14,191,0,502
34005075203,1461,1227,970,63,117,11,66,1,257
34005075202,1479,1171,680,67,209,13,200,1,491
34005075201,1675,1410,1018,85,208,11,98,4,392
34005190003,1151,914,587,111,199,4,29,0,327
34005120007,1353,1068,541,160,307,50,50,4,527
34005065018,1695,1331,1076,68,115,10,64,2,255
34005015301,843,694,574,25,48,13,26,1,120
34003135002,1651,1243,895,226,29,30,77,1,348
34003135004,2015,1525,1181,155,27,9,143,2,344
34003345001,1097,876,671,94,7,2,96,0,205
34003050007,1552,1179,693,242,59,11,203,0,486
34003190004,2064,1583,876,265,53,18,388,4,707
34003115504,1287,1044,356,361,234,15,99,0,688
34003335003,921,733,571,87,16,6,45,0,162
34003215002,2110,1611,1002,97,29,3,482,1,609
34003235001,1682,1286,1037,120,27,11,91,1,249
34003045003,1620,1149,820,61,17,6,237,0,329
34003045002,1723,1296,749,56,15,3,456,1,547
34003015016,1489,1204,425,295,127,7,387,2,779
34003305010,1085,749,505,43,15,2,178,2,244
34003050003,1395,1100,723,181,25,8,165,0,377
34003050008,1780,1389,777,279,53,14,263,0,612
34005160002,810,610,572,17,8,7,11,0,38
34005950009,1358,1049,743,73,183,15,49,1,306
34005150009,1179,947,614,119,150,31,39,1,333
34013070E29,1898,1445,85,769,526,24,28,0,1360
34013070N25,1423,1037,31,445,549,10,9,1,1006
34013070C46,1642,1237,29,1094,140,44,19,2,1208
34013045S03,2118,1598,29,130,1443,14,19,3,1569
34013060004,1244,857,535,15,15,7,276,0,322
34013060005,875,626,398,23,6,2,187,0,228
34013065202,984,754,532,58,121,17,47,0,222
34013037002,1991,1620,1398,118,17,7,71,1,222
34027020001,1040,724,589,42,15,2,65,0,135
34027020002,1108,775,602,62,20,3,80,2,173
34013045S07,2123,1583,23,178,1393,22,19,3,1560
34013030211,1797,1395,22,125,1245,42,13,0,1373
34013065401,1215,974,531,76,259,17,86,2,443
34013065408,1015,827,356,114,272,16,66,1,471
34013065304,800,601,319,39,203,7,46,4,282
34013080205,1133,933,605,179,32,7,112,1,328
34013005203,1306,1088,474,353,67,26,197,0,614
34013080103,2029,1650,967,374,99,21,203,6,683
34009035101,711,648,627,8,7,1,2,3,21
34009075002,747,633,548,51,30,4,9,1,85
34005115006,1038,762,639,48,13,12,56,1,123
34005115009,865,722,597,11,23,5,86,0,125
34003240005,1982,1465,1271,74,5,5,105,0,194
34003175001,1603,1292,1085,106,17,6,72,0,207
34003330001,1833,1422,1183,99,24,9,106,4,239
34003020002,1765,1398,452,673,188,21,144,7,946
34003085010,1575,1211,783,194,45,7,182,1,428
34003305007,1772,1309,542,146,51,4,568,5,767
34003085004,1248,1026,748,86,15,5,162,5,278
34003120001,1329,1015,791,47,8,6,155,0,224
34003335002,1534,1204,907,176,19,11,90,1,297
34003265001,2123,1661,1329,97,30,15,189,4,332
34003105201,2495,1950,988,766,176,27,53,1,962
34003105103,2467,1858,778,875,191,43,48,1,1080
34003300020,1317,858,489,63,192,12,112,1,369
34003105102,1203,909,256,524,134,6,25,0,653
34003067004,1713,1381,456,359,336,13,168,2,925
34003067003,1512,1209,651,268,98,25,217,3,558
34003250008,1879,1487,664,593,90,53,168,4,823
34003300021,1877,1549,551,304,324,23,389,0,998
34003095007,3964,3277,1218,317,112,17,1602,5,2059
34003300007,2116,1721,601,389,559,21,232,8,1120
34003325004,2067,1710,1409,152,36,10,98,0,301
34003105403,1355,1056,724,282,45,4,20,0,332
34003040001,1471,1073,635,65,10,7,357,0,438
34003040006,1093,787,454,72,15,5,248,0,333
34003040002,1783,1353,792,66,22,12,465,0,561
34003300018,1875,1419,753,276,251,14,119,1,666
34003300004,1716,1276,682,204,247,14,134,1,594
34003070001,1493,1121,905,84,23,5,108,4,216
34003150003,2010,1648,702,525,74,19,347,3,946
34003150002,1201,984,421,282,68,6,220,1,563
34003280006,1486,1224,633,262,48,13,264,2,591
34029003002,3220,2421,1873,276,147,53,85,0,548
34029003004,2062,1477,1027,232,174,37,33,1,450
34029070013,4699,2235,1604,422,143,30,17,4,631
34029030057,1169,930,754,80,51,16,18,1,176
34029030039,1953,1552,1238,141,102,28,44,2,314
34013055013,1875,1544,505,141,813,5,97,1,1039
34013027W03,2619,1824,71,1002,750,51,27,1,1753
34013080105,1334,1121,750,220,45,4,97,2,371
34013015004,1231,1021,768,107,43,4,85,2,253
34013055002,1476,1010,814,56,77,4,55,0,196
34019090001,1665,1380,1148,91,65,9,61,1,232
34003170004,1361,1070,707,195,55,11,125,1,363
34003300008,1869,1388,779,280,212,29,138,6,609
34003030004,1940,1618,952,342,63,30,263,2,666
34003175003,1447,1151,993,73,22,11,50,0,158
34003230003,1393,1097,704,92,32,6,264,0,393
34003110006,1448,1036,781,63,20,7,165,0,255
34003110007,1743,1230,866,84,8,7,260,1,364
34003085014,1259,908,698,77,32,12,92,1,210
34005040013,1048,826,700,23,27,4,70,0,126
34019035001,1046,860,765,53,18,9,11,0,95
34003325005,2531,2101,1711,290,41,19,57,1,390
34003075203,1905,1444,803,300,165,12,197,2,641
34003095016,2698,2040,475,248,120,11,1225,1,1565
34003080001,2083,1645,612,114,33,3,886,0,1033
34003095006,2643,2119,736,210,82,6,1090,1,1383
34003095018,839,687,275,115,15,5,283,0,412
34013030510,1921,1414,34,179,1199,17,12,9,1380
34013010202,1235,1008,539,203,168,11,102,0,469
34013070C20,2113,1569,66,334,1110,11,60,5,1503
34013100005,1422,1030,905,50,24,7,42,2,125
34013065307,1039,714,528,42,94,6,44,0,186
34003340003,1332,1011,823,65,12,4,99,0,188
34003340002,1591,1201,982,82,20,10,108,1,219
34003090001,2272,1736,405,1137,41,65,110,0,1331
34003090006,254,254,68,171,3,3,11,0,186
34013027S05,1808,1349,94,106,1152,11,11,0,1255
34013030103,1033,806,37,71,670,18,33,5,769
34019050003,1041,830,741,33,18,7,22,0,89
34019030002,1130,918,809,39,7,5,51,0,109
34019030008,873,686,577,37,18,8,35,3,109
34025047003,1132,880,737,36,17,3,77,3,143
34025080023,1413,1026,717,67,46,8,187,0,309
34025260003,1516,1253,1045,147,34,12,12,2,208
34029090037,906,901,811,50,17,2,27,0,90
34029025424,910,907,840,42,4,2,17,0,67
34025170014,1293,1018,623,108,219,16,68,0,395
34025155044,1461,1030,867,55,24,7,78,0,163
34025170007,2261,1743,709,470,547,34,24,4,1034
34025035001,647,582,498,56,12,10,17,0,84
34025050001,900,723,595,88,7,6,13,1,128
34029080012,671,644,621,8,4,10,5,0,23
34029060014,1679,1393,1232,77,14,14,33,3,161
34029060015,924,829,763,20,2,13,24,0,66
34029035043,591,586,555,13,6,0,11,0,31
34029035024,2293,1752,1356,138,60,21,171,0,396
34029030044,1143,983,831,86,20,10,32,0,152
34029160001,2079,1709,1467,140,28,35,35,0,242
34029160002,1498,1264,1138,64,23,16,21,3,126
34009010003,629,589,532,8,29,7,5,0,57
34009035201,400,372,357,8,3,1,0,1,15
34009030007,1245,1007,782,107,85,15,22,0,225
34009030010,1027,805,722,35,20,11,11,0,83
34009035102,520,480,459,8,6,2,6,3,21
34039065302,971,792,434,186,148,18,40,0,358
34039020503,2442,1658,51,1030,594,46,19,3,1607
34017030A01,2307,1855,293,420,457,34,673,13,1562
34017050703,1654,1333,104,1162,61,57,41,0,1229
34017030F07,1331,1086,275,374,237,17,205,5,811
34017030C10,2746,2110,615,499,292,34,719,2,1495
34017030F06,3504,2994,656,510,368,32,1466,1,2338
34039020505,1496,1063,54,587,383,11,26,2,1009
34017060310,1759,1571,731,291,78,12,421,0,840
34017060302,1295,1062,282,536,86,20,176,5,780
34017020402,1464,1180,353,473,57,32,213,2,827
34017030C22,2232,1801,417,210,104,12,1105,0,1384
34019105009,1141,885,765,35,16,6,57,1,120
34019105011,1217,982,736,74,60,5,92,0,246
34019105018,1283,1054,815,79,30,0,128,3,239
34005065017,637,477,411,33,18,10,4,1,66
34005065005,923,754,555,60,60,16,55,1,199
34005192007,919,715,60,101,535,21,41,2,655
34005130001,6367,5691,2419,1059,2144,64,143,28,3272
34017030A02,3357,2627,519,298,644,24,1185,0,2108
34017055201,1955,1546,740,282,103,17,410,2,806
34037060003,1423,1193,933,168,41,11,44,0,260
34003225009,2624,2226,445,365,63,26,1366,5,1781
34003020001,1366,1090,397,527,100,20,103,0,693
34003300006,1688,1387,558,350,313,35,184,4,829
34003300005,1544,1185,308,396,318,30,206,2,877
34003230012,1730,1415,890,127,39,2,351,3,525
34003230013,818,682,434,68,6,3,172,0,248
34003255018,1455,1084,767,58,13,4,244,1,317
34003255015,1360,953,652,50,23,3,220,0,301
34003090005,2695,2117,634,1270,72,105,124,2,1483
34003030001,2124,1650,628,757,84,48,132,3,1022
34003005004,2094,1629,1328,89,16,6,188,1,301
34005025401,699,573,374,53,98,12,27,1,199
34003320003,1581,1201,936,168,18,5,72,0,265
34003155001,2765,2263,1034,813,229,26,220,0,1229
34003185002,1395,1120,670,244,9,15,189,1,450
34003185001,759,596,182,362,11,5,49,0,414
34003125002,1525,1226,833,201,63,16,129,0,393
34003245001,1999,1742,740,432,49,30,524,3,1002
34003225010,1965,1625,380,393,37,12,808,0,1245
34003195008,1084,917,609,221,22,14,63,0,308
34003025003,1259,1006,649,212,33,9,97,1,357
34003060002,2049,1627,968,433,95,27,156,7,659
34003165005,1161,932,772,64,11,4,71,0,160
34003100001,1552,1178,944,86,28,2,120,3,234
34003255003,1361,956,693,58,6,6,184,1,263
34003300017,1847,1502,288,381,762,20,145,4,1214
34003035005,1348,1043,525,120,15,10,386,7,518
34003105501,3577,2800,1795,794,118,37,100,8,1005
34003165012,983,859,698,40,12,8,96,0,161
34003165011,2273,1854,1540,96,37,10,163,1,314
34017030B09,1525,1243,159,290,545,17,254,0,1084
34017035203,1610,1316,522,485,70,27,138,3,794
34017040503,1602,1316,184,1017,59,13,77,0,1132
34017040502,1319,1018,129,831,62,29,41,4,889
34017030C14,2689,2237,493,258,144,10,1361,3,1744
34017005314,1393,1056,452,245,188,11,178,0,604
34017035302,938,728,420,215,14,4,52,3,308
34017035305,1269,1034,554,318,41,15,62,5,480
34017040306,1512,1235,254,871,84,53,56,5,981
34003230002,1512,1237,710,123,27,8,365,0,527
34003160002,1380,1116,638,324,51,33,98,0,478
34003100003,1483,1170,943,77,33,1,114,0,227
34003270002,1323,1075,649,233,62,10,130,1,426
34003125008,1678,1299,742,311,68,19,193,2,557
34003125007,1382,1115,692,187,36,9,204,1,423
34003225008,2362,2005,407,248,48,11,1310,2,1598
34003080003,1332,1062,468,65,40,0,488,0,594
34003080002,807,617,318,32,12,2,257,0,299
34003080004,1120,905,450,49,12,0,387,0,455
34003350006,1623,1225,1060,80,9,14,49,1,165
34003350008,1728,1301,1120,73,14,1,93,2,181
34003235003,1339,1025,855,64,3,4,89,0,170
34003335005,1092,856,650,142,20,4,41,3,206
34003335007,1075,837,663,94,14,6,49,1,174
34003255011,1457,1082,768,77,31,3,201,1,314
34003120003,1656,1229,861,47,7,3,300,0,368
34003325002,2027,1591,1099,397,66,10,46,5,492
34031035101,2400,1708,290,1250,218,76,3,3,1418
34003075201,1109,860,637,68,85,1,69,5,223
34003075101,2135,1656,1053,303,162,16,135,1,603
34005050104,917,719,610,46,23,12,14,0,109
34003075302,2278,1825,481,624,636,17,131,6,1344
34017030E20,5848,5068,2014,305,136,27,2564,9,3054
34017030E05,2426,2057,730,298,370,17,655,7,1327
34017030E18,1954,1604,940,135,85,8,421,1,664
34017030E19,1871,1532,933,167,148,14,274,1,599
34017050402,1901,1481,138,1250,121,47,63,4,1343
34003085017,1447,1099,790,118,49,10,127,2,309
34003115202,2577,2069,416,910,607,48,187,2,1653
34003070004,1570,1288,958,153,22,5,153,5,330
34003070003,1085,869,633,95,21,7,109,1,236
34003045001,1638,1247,675,69,7,4,484,1,572
34017050303,2406,1818,114,1643,81,116,34,5,1704
34017040202,1264,1041,160,809,52,42,56,0,881
34017040104,1542,1409,714,365,94,16,234,4,695
34017050202,1868,1411,69,1272,143,70,27,2,1342
34017005301,1365,1034,495,300,84,18,159,1,539
34017005212,1527,1193,588,401,158,21,89,5,605
34017030A30,1269,1149,380,167,319,21,267,2,769
34009030015,1394,1164,1043,36,39,12,35,0,121
34009030018,725,586,536,14,19,13,10,0,50
34009025108,778,633,529,59,14,12,8,1,104
34009040402,458,408,393,5,0,0,7,0,15
34009040403,630,565,553,3,2,3,3,1,12
34009020003,731,537,487,9,8,18,2,1,50
34009060001,609,543,459,22,45,9,6,0,84
34009040304,574,506,474,24,1,8,2,0,32
34037065003,736,597,514,52,12,4,17,1,83
34037050004,1063,926,795,51,16,13,30,1,131
34037110018,1962,1689,1448,170,33,24,20,0,241
34037095002,1410,1142,909,132,36,13,51,1,233
34009040102,419,374,346,2,12,0,12,1,28
34009020001,589,473,444,7,0,16,2,0,29
34009025306,458,420,390,13,4,6,7,0,30
34009075005,381,318,313,2,0,1,2,0,5
34017005109,1395,1087,585,350,128,21,32,7,502
34017030C08,878,767,281,160,71,7,269,1,486
34029035007,2551,2007,1610,257,57,33,53,1,397
34029080010,1774,1408,1170,134,50,38,6,0,238
34029090009,722,696,640,37,4,9,6,3,56
34029090027,875,868,785,38,25,3,6,0,83
34029025236,1708,1259,1047,104,22,16,71,0,212
34029035001,1024,850,616,94,76,9,49,0,234
34029080007,1051,1006,937,38,9,9,4,0,69
34003320006,1492,1114,904,111,13,6,85,0,210
34003175005,1517,1171,1046,60,26,5,38,0,125
34017030D16,1126,902,259,274,79,12,302,1,643
34017055101,2547,2225,1383,287,132,14,400,9,842
34003255010,1335,1003,609,163,106,24,111,2,394
34003245002,1772,1425,553,387,58,9,434,0,872
34003260001,1812,1369,850,162,41,9,300,0,519
34003190005,1866,1543,828,276,69,12,374,0,715
34003115103,2746,2100,210,1641,284,85,50,0,1890
34003160014,1372,1066,699,280,51,4,40,0,367
34003085023,1546,1213,812,195,61,17,147,1,401
34003280002,2246,1840,1048,302,273,19,237,1,792
34003265004,1465,1127,917,82,21,4,105,0,210
34003265002,2718,2161,1694,164,42,7,245,1,467
34003135005,1733,1381,1088,92,19,5,174,2,293
34003195005,2001,1635,957,516,47,45,59,3,678
34003160007,1340,1066,718,238,24,18,71,0,348
34003075402,1823,1436,35,515,912,23,33,5,1401
34003040004,1488,1149,744,66,24,1,316,0,405
34029075001,1010,941,883,29,5,8,3,0,58
34029150006,1738,1338,1164,99,34,17,24,1,174
34029150020,1491,1139,1001,58,44,12,14,1,138
34029150012,1473,1156,1012,90,16,9,29,0,144
34029123004,1504,1297,1115,135,14,16,15,2,182
34029030016,1539,1206,915,195,35,38,39,0,291
34029035019,1159,883,778,45,13,12,24,1,105
34029055009,2146,1546,1098,237,123,33,80,1,448
34029090012,696,689,629,33,4,2,16,0,60
34029060017,950,777,710,36,5,6,6,0,67
34007135016,1351,973,47,536,372,23,52,1,926
34007015003,1470,1139,983,56,51,17,27,4,156
34007105001,1343,1079,92,85,897,21,19,1,987
34007130004,882,701,658,15,8,8,12,1,43
34007010001,991,865,826,16,8,8,5,0,39
34007040210,1248,830,24,339,495,8,16,6,806
34007040202,1136,765,9,103,660,17,1,0,756
34007043001,1400,1115,929,57,50,10,64,0,186
34007130003,957,769,652,59,19,10,28,7,117
34007180305,1787,1423,309,123,912,43,86,0,1114
34007180303,2080,1425,223,256,913,29,43,1,1202
34015075001,1534,1247,1100,71,25,16,20,0,147
34015070003,1197,856,354,119,361,30,16,6,502
34007043014,1032,788,681,17,28,5,49,2,107
34007077203,1317,1017,778,89,56,10,82,2,239
34007077202,1313,1017,831,77,38,32,40,1,186
34007005002,839,663,587,34,20,9,7,1,76
34007080012,1965,1497,1365,35,35,9,48,3,132
34007050002,1469,1159,831,102,181,33,31,3,328
34007090003,1328,988,928,15,12,7,17,1,60
34015050008,1077,782,714,14,27,16,13,1,68
34031040112,2917,2120,66,1262,580,30,324,6,2054
34031070106,1095,854,580,140,20,4,112,1,274
34031040203,2537,1819,118,787,163,23,800,2,1701
34041020004,1208,980,899,37,9,9,16,2,81
34031010208,2024,1605,850,491,81,15,190,2,755
34007075009,1752,1422,1100,99,148,19,48,1,322
34007075016,1382,1097,960,32,72,12,24,0,137
34007015005,623,509,438,21,25,3,21,2,71
34007085008,1330,941,859,29,9,5,30,1,82
34007085003,1252,858,754,26,42,19,29,0,104
34007075033,1906,1409,588,139,575,32,96,1,821
34007043004,1775,1393,910,153,168,22,142,2,483
34007135017,2076,1591,669,439,429,27,84,3,922
34007040204,1155,831,30,326,489,30,4,5,801
34007125003,1224,1001,859,64,50,8,21,2,142
34041110006,980,784,701,42,11,8,17,0,83
34041110005,1470,1240,1027,101,37,10,36,0,213
34041050002,1583,1296,1211,24,16,20,17,0,85
34041060001,1473,1215,1044,75,49,21,18,2,171
34015045003,1491,1151,887,73,130,27,40,2,264
34015040009,1523,1086,921,39,55,6,53,0,165
34015040001,1316,976,805,19,111,5,34,2,171
34031065002,1495,1212,968,128,46,1,57,1,244
34031065001,1375,1096,857,115,46,9,79,2,239
34031065007,1444,1171,815,205,50,17,91,4,356
34031065003,2396,2114,1792,202,56,17,57,3,322
34031065005,1368,1118,872,150,19,17,57,0,246
34031040309,1968,1491,66,666,798,18,40,4,1425
34015100013,1700,1332,1171,49,64,5,45,3,161
34015090025,884,741,644,24,44,4,26,2,97
34015100008,1269,1038,919,28,41,12,25,3,119
34015055415,1711,1237,964,58,151,20,45,0,273
34015055421,1425,1081,770,52,204,18,45,1,311
34015005002,1240,925,648,88,167,26,8,1,277
34015005006,1498,1204,872,86,168,21,54,8,332
34015050006,1434,1184,1095,25,25,10,26,0,89
34015050005,1481,1139,1006,40,53,14,19,0,133
34015025008,1091,866,727,46,71,12,13,0,139
34015005004,1552,1232,855,96,219,23,43,0,377
34015050001,1132,904,850,15,9,7,17,1,54
34015075007,1339,1038,945,20,29,18,18,2,93
34015010022,1598,1182,780,95,231,19,71,0,402
34015010016,726,631,561,21,23,10,20,2,70
34015055425,988,915,818,29,38,19,13,0,97
34041105001,1550,1221,978,125,80,34,36,5,243
34031010121,1582,1386,787,247,171,10,173,2,599
34031010112,1467,1259,742,196,57,14,247,5,517
34031035204,2541,1888,29,1688,246,94,46,10,1859
34041080003,938,751,640,47,28,12,14,2,111
34041080002,1125,903,688,66,78,20,39,2,215
34041050001,920,747,709,10,5,13,3,0,38
34041030002,1025,811,740,33,11,13,5,0,71
34031080003,2366,1858,1010,680,95,27,70,0,848
34031080005,1986,1672,1213,260,55,9,141,3,459
34031080007,1165,1114,928,83,38,6,65,0,186
34031080002,1806,1463,925,394,88,16,55,0,538
34031080004,2382,1829,1217,400,101,31,139,1,612
34031080006,2199,1792,1159,303,196,3,132,2,633
34031025003,2027,1679,1236,264,53,16,107,0,443
34031010113,1747,1431,837,309,58,20,214,1,594
34031010207,1376,1057,486,396,63,18,125,1,571
34011050104,1712,1341,1049,119,135,25,25,1,292
34011050503,2615,2091,1567,193,297,33,29,0,524
34011070103,1515,1212,727,363,97,32,11,4,485
34027160001,1332,1005,786,91,37,10,80,1,219
34027110016,1255,987,820,65,24,9,62,0,167
34033000704,2161,1662,882,239,501,46,21,1,780
34033004205,1606,1271,1135,47,33,45,14,0,136
3403360W002,1077,726,196,43,473,18,11,0,530
34033075002,1718,1344,934,93,283,28,23,3,410
34015010007,918,681,337,71,256,28,22,0,344
34015110102,706,557,378,49,89,12,20,1,179
34015110103,841,640,393,80,139,16,17,1,247
34015090033,1376,1070,858,44,105,2,61,0,212
34031070407,1174,956,762,73,27,7,94,0,194
34033050003,1311,1083,887,54,100,27,15,1,196
34033050004,1256,1007,589,143,224,38,13,6,418
34027170005,1408,1115,823,138,40,9,112,0,292
34027105009,1289,1021,786,23,11,10,196,2,235
34015015002,1441,1191,1050,36,52,11,38,0,141
34015015003,1005,827,734,28,38,24,4,0,93
34011070104,1286,992,305,548,151,18,1,2,687
34027120201,2181,1591,209,1040,328,116,23,2,1382
34031070202,1029,810,678,60,7,7,44,0,132
34031070204,1297,1148,952,105,18,4,69,0,196
34031070205,1246,977,820,68,15,4,72,0,157
34031035104,5222,3508,176,3214,221,195,21,11,3332
34031040101,1778,1266,6,771,547,13,2,0,1260
34031040109,2647,2022,100,1076,872,39,45,5,1922
34011070101,1705,1344,822,317,182,35,10,5,522
34023125516,1217,983,612,122,52,16,178,1,371
34023070501,2752,2571,996,353,240,29,936,9,1575
34023070404,2376,1710,98,1391,238,87,23,4,1612
34023105027,1888,1473,489,37,79,6,863,1,984
34023105002,1484,1158,535,65,90,5,477,1,623
34023085406,3514,3501,907,360,401,5,1757,10,2594
34023095028,2178,1649,646,339,464,23,188,2,1003
34023125207,1200,968,357,208,141,12,282,1,611
34023125212,1212,968,522,223,98,11,130,1,446
34023105023,2515,1770,375,118,390,15,895,1,1395
34023105026,2009,1628,636,69,61,4,844,1,992
34021050017,738,553,414,18,7,2,107,0,139
34021050019,601,473,290,27,12,5,144,1,183
34021050015,883,617,411,39,26,7,126,0,206
34023025001,2246,1563,416,39,58,2,1062,2,1147
34031015004,1708,1257,235,691,267,20,98,2,1022
34031015005,1302,996,345,443,117,1,93,1,651
34031020403,1288,1051,810,160,50,14,39,2,241
34041070002,1576,1263,1109,67,30,17,33,0,154
34027135014,1736,1346,784,241,100,18,206,2,562
34027135015,1148,986,646,120,107,5,107,1,340
34027120303,3296,2732,981,1328,255,191,147,1,1751
34027105014,1533,1211,815,32,10,6,346,0,396
34027190005,2152,1689,1439,134,44,15,45,0,250
34027190002,1734,1317,1201,68,13,12,22,0,116
34027090002,1113,891,755,70,11,2,45,0,136
34027090003,1158,853,772,34,10,6,31,0,81
34027005301,865,668,393,122,60,2,79,0,275
34027125002,994,688,507,40,8,3,123,1,181
34027020008,1084,801,586,91,10,6,103,1,215
34015090019,1040,847,714,25,49,6,46,0,133
34015030001,1756,1403,835,124,375,16,64,1,568
34015030013,828,789,703,25,38,12,18,0,86
34015025004,1768,1404,1186,125,61,22,12,2,218
34015065001,1774,1380,1129,157,65,25,13,0,251
34011070205,1919,1430,665,451,245,21,73,1,765
34011070203,1596,1206,321,560,313,30,16,1,885
34035050025,1110,810,610,22,43,7,122,0,200
34035050004,1189,937,644,73,19,4,195,0,293
34035080004,2013,1553,751,482,44,14,278,4,802
34035080005,1066,842,602,89,18,4,129,0,240
34035080002,1972,1543,889,190,66,19,380,1,654
34035080003,844,700,406,38,18,4,236,1,294
34021055E08,2896,2181,290,1315,560,101,17,14,1891
34035065013,1748,1321,530,124,86,6,577,6,791
34035065018,1796,1349,765,73,57,6,437,2,584
34035070005,1713,1316,371,562,274,33,112,1,945
34021055W14,1257,1034,104,143,768,21,17,3,930
34021055W08,1189,906,64,105,759,9,6,0,842
34021010010,1516,1133,201,165,732,15,30,1,932
34021055W05,897,704,79,46,583,5,8,1,625
34021055S09,1920,1357,209,757,411,27,9,5,1148
34021015043,1184,959,860,56,23,9,20,0,99
34021015036,793,670,585,38,19,15,14,2,85
34023025034,661,525,190,17,3,0,314,0,335
34023095020,1928,1543,497,255,327,5,463,0,1046
34023020001,1549,1211,695,49,47,5,410,0,516
34023085405,3039,2418,260,135,525,27,1516,0,2158
34023025031,1323,974,357,132,226,16,270,5,617
34023065212,603,594,533,14,16,0,36,0,61
34023035005,1212,980,566,153,147,7,97,1,414
34023125205,1184,922,462,296,72,15,104,5,460
34023065305,1501,1124,826,53,20,4,216,2,298
34027110004,884,765,592,60,28,11,77,2,173
34027110003,978,772,93,338,310,21,21,2,679
34025185011,1056,798,687,42,11,2,20,3,111
34025170020,1187,997,319,109,525,19,43,1,678
34025110003,1521,1226,805,279,94,28,49,1,421
34011070601,1515,1172,768,265,123,21,32,0,404
34011070610,2181,1774,1233,273,161,31,86,5,541
34025155037,1420,1133,979,82,11,6,52,2,154
34025185006,1359,1071,865,100,27,4,62,0,206
34001005201,1311,1080,786,106,117,36,43,3,294
34001095101,2745,2252,626,688,924,45,100,5,1626
34025090007,1348,1006,687,27,1,1,288,0,319
34025185015,1482,1155,441,167,459,15,96,2,714
34025130007,1492,1158,976,84,15,2,83,3,182
34025220001,944,850,809,27,4,5,3,0,41
34027155005,1188,940,812,84,10,4,28,0,128
34027075007,1246,991,867,53,4,9,47,2,124
34027075002,1297,1010,865,65,10,11,56,1,145
34027075006,1066,825,701,42,20,3,62,0,124
34027180104,972,757,572,106,32,5,38,0,185
34027060006,1747,1487,1148,57,31,4,249,0,339
34027060008,1476,1181,936,84,30,15,112,6,245
34001040015,2418,1963,806,478,279,35,396,6,1157
34027070010,930,759,651,69,9,18,20,1,108
34027070014,1794,1400,1202,96,35,12,37,4,198
34027195002,1448,1152,466,581,42,28,62,1,686
34027060007,1487,1168,947,79,23,2,105,1,221
34027115005,1004,776,645,65,24,7,40,0,131
34027115001,1130,908,700,109,30,6,60,0,208
34027040202,1633,1302,1085,96,19,19,68,1,217
34027040203,601,520,419,18,15,9,61,0,101
34027005202,1658,1394,738,329,89,19,223,1,656
34027005201,817,633,445,81,33,13,69,0,188
34027195004,1402,1083,485,459,70,33,68,4,598
34027195003,1377,1058,403,555,70,20,39,0,655
34027110013,863,659,507,83,21,3,32,0,152
34027080201,1761,1428,937,256,69,21,141,0,491
34031070103,1031,798,508,193,32,8,72,5,290
34027105003,1249,956,775,74,15,4,90,0,181
34033000501,1966,1530,1376,23,66,38,10,0,154
34033045003,1386,1084,807,57,177,9,29,1,277
34027050003,1279,1020,837,52,10,1,114,0,183
34027050007,1873,1557,1178,116,26,1,216,2,379
34027190001,1337,1067,947,37,28,7,36,0,120
34027115003,854,661,542,71,12,1,32,0,119
34027115004,1013,749,611,35,34,5,61,0,138
34027120404,908,840,629,103,61,9,41,0,211
34027110008,912,767,645,40,19,0,61,0,122
34027125004,721,485,414,19,4,3,42,0,71
34035100008,1004,770,545,62,22,3,133,2,225
34035100013,1279,978,613,55,26,3,270,1,365
34021050007,6524,6427,2994,646,593,53,2162,57,3433
34027180402,853,672,571,58,13,3,26,0,101
34027055005,727,546,453,31,3,3,51,0,93
34027105001,897,715,523,45,14,9,128,0,192
34001010401,2726,1873,175,900,159,53,693,51,1698
34001010303,1033,730,41,154,556,35,8,6,689
34001010404,1676,1397,373,434,192,15,398,13,1024
34001010201,2132,1813,468,300,758,30,303,7,1345
34023077307,623,493,317,73,27,7,76,1,176
34001030101,471,387,365,12,2,6,1,0,22
34023025023,1548,1249,508,287,99,9,353,3,741
34023025022,975,694,280,153,65,4,208,0,414
34023065202,2067,1564,950,147,113,10,333,2,614
34023065306,1019,787,575,40,18,8,135,1,212
34023065213,1678,1209,558,93,100,8,456,1,651
34023065201,2501,1883,1238,127,58,9,444,1,645
34023040003,2006,1490,680,604,148,31,42,1,810
34023065308,1236,967,611,53,57,4,241,0,356
34023070207,3305,2462,257,1456,665,75,150,4,2205
34023125509,1404,1092,537,155,228,9,184,0,555
34023055010,1924,1484,692,448,180,13,167,3,792
34023085210,3063,2331,395,189,577,26,1174,0,1936
34023025056,926,723,289,128,23,3,273,3,434
34023115001,1037,852,437,241,87,14,44,2,415
34023095015,1006,813,526,115,77,17,80,3,287
34023077401,1497,1296,777,196,159,18,173,1,519
34023020018,1235,969,418,192,101,2,255,0,551
34023055004,1427,1166,793,209,77,8,82,1,373
34023025077,3517,2426,249,74,137,16,1965,4,2177
34023050011,2610,2106,1046,180,216,21,648,1,1060
34023085202,926,728,285,67,110,1,265,0,443
34023077501,887,703,548,82,38,12,34,1,155
34023095025,1009,808,532,125,47,13,91,1,276
34023095017,656,511,367,70,44,5,29,2,144
34023060007,1031,788,669,61,25,16,22,0,119
34023005012,1209,951,388,260,104,9,207,1,563
34023020037,1836,1474,828,98,48,2,494,0,646
34023075019,2596,1988,444,190,419,28,925,11,1544
34023005019,779,640,230,165,55,6,188,0,410
34023125304,862,687,403,138,89,14,70,1,284
34039095031,1083,831,411,152,146,11,104,2,420
34039095001,931,753,395,175,117,14,74,2,358
34039100103,1296,907,599,98,61,10,149,0,308
34039020309,2175,1668,263,1081,279,34,61,0,1405
34039070102,1040,828,120,306,396,24,27,5,708
34039070104,1510,1184,154,399,636,28,20,0,1030
34001065004,1949,1407,887,329,143,34,43,2,520
34001020002,2317,1761,1045,555,145,50,27,6,716
34033004206,1401,1111,926,50,74,18,30,4,185
34035050010,1283,1044,793,88,46,35,96,5,251
34035050031,1566,1123,527,59,31,2,484,0,596
34035045003,1458,1180,895,116,40,12,118,2,285
34033005002,1317,1060,961,23,35,18,12,0,99
34027120101,807,637,475,106,34,6,17,0,162
34027060004,1873,1584,1139,64,43,11,316,0,445
34027060009,1514,1246,1019,42,17,3,154,5,227
34027175601,1188,930,787,67,16,11,48,0,143
34027175302,917,681,554,84,18,7,22,0,127
34023020007,1192,919,605,103,35,10,166,0,314
34023020031,1700,1322,762,107,59,16,374,7,560
34001055009,1809,1614,1341,79,114,11,67,2,273
34001055014,1645,1449,1220,74,79,12,64,1,229
34001095203,2375,1798,160,901,766,26,28,4,1638
34001042203,807,587,253,175,148,11,14,0,334
34011030001,771,632,538,32,36,15,5,0,94
34001040006,1624,1305,1054,69,60,30,77,0,251
34015090022,1331,1033,909,45,25,18,36,0,124
34025095010,1527,1182,971,106,36,17,44,0,211
34025185022,1554,1372,1175,43,40,6,99,0,197
34025140025,1784,1323,762,79,27,7,443,2,561
34025015009,792,701,368,88,225,11,15,2,333
34025080007,1755,1329,817,268,122,25,95,1,512
34025155028,1299,989,870,61,20,11,31,0,119
34025075004,1750,1348,465,645,173,65,60,3,883
34025095029,1322,1040,798,92,56,16,80,0,242
34025085002,1186,1005,859,98,24,4,11,1,146
34025155015,1967,1573,1302,154,28,4,68,3,271
34025155014,1723,1402,1182,73,31,7,99,0,220
34033004204,1708,1381,1197,69,49,27,34,6,184
34021035012,1763,1452,833,157,281,23,175,1,619
34021035010,1145,903,521,209,119,14,56,0,382
34025095022,1598,1185,942,137,51,9,44,2,243
34025130012,1167,901,757,53,12,5,74,0,144
34025225002,1068,825,741,33,25,6,11,0,84
34025080025,903,709,618,43,12,6,28,0,91
34033050002,1367,1080,990,32,22,21,5,0,90
34021015004,1635,1247,236,431,529,40,62,1,1011
34021015028,1079,909,693,71,40,16,90,0,216
34035010011,1169,871,620,57,30,7,153,0,251
34021050020,1457,1100,597,92,87,15,312,4,503
34021050022,1440,1097,481,57,102,12,444,1,616
34021020003,1420,1059,497,346,142,32,65,1,562
34021015012,2506,1899,649,863,351,55,35,3,1250
34021010020,633,525,358,34,107,9,15,0,167
34035040218,1190,1059,571,50,113,12,328,0,488
34021035011,908,705,501,57,38,9,99,2,204
34021015023,2719,2027,565,735,658,34,85,1,1462
34021015029,1116,889,549,200,96,18,33,0,340
34021015051,1046,887,671,83,92,5,41,1,216
34035020004,3629,2635,494,1828,220,68,82,5,2141
34035070002,1444,1119,352,397,340,11,40,2,767
34001050001,1811,1464,1247,116,57,37,7,2,217
34029025330,1306,1304,1209,59,17,9,8,0,95
34029085003,690,627,590,15,1,4,9,0,37
34029020002,2310,1749,1410,178,77,29,57,4,339
34029025415,611,603,540,14,23,8,15,0,63
34029030033,881,859,803,27,18,5,7,0,56
34029020001,1440,1110,892,145,38,24,19,1,218
34029030018,1234,1037,964,37,21,5,7,0,73
34021015055,1908,1643,1392,68,78,5,96,0,251
34021055N08,1906,1394,87,501,831,49,20,3,1307
34035025008,1352,1092,801,93,54,19,122,3,291
34035065004,810,612,425,26,7,7,134,0,187
34035065003,828,653,520,16,16,4,90,0,133
34035065002,1368,1002,437,30,33,3,510,0,565
34021030008,1671,1193,959,52,51,5,113,0,234
34021010027,1964,1757,732,267,669,14,84,0,1025
34021055W03,1536,1406,563,161,636,8,52,0,843
34035015002,1201,850,713,95,5,19,29,0,137
34035010005,1189,942,758,50,5,6,118,0,184
34035030032,1438,1127,684,63,37,2,341,1,443
34035025013,1129,884,743,43,22,16,58,1,141
34021015011,1813,1351,616,429,263,43,38,2,735
34029055016,2115,1717,1313,218,122,20,41,0,404
34029080006,1377,1112,1004,52,21,25,4,0,108
34029080014,1010,881,775,53,14,10,29,0,106
34021030002,1327,1087,984,40,20,12,22,0,103
34035040547,1460,1210,346,194,406,20,256,1,864
34023085305,838,644,251,52,130,7,212,1,393
34035005005,1265,1134,880,96,38,9,113,0,254
34035040437,880,698,285,58,259,10,98,1,413
34035040436,951,778,191,72,368,6,147,0,587
34029070001,3854,2152,1602,424,52,9,17,2,550
34029035054,1289,1033,874,95,11,5,50,0,159
34021050021,716,564,383,56,11,10,99,0,181
34021055W09,1108,827,42,68,729,17,6,0,785
34021065010,1666,1272,514,73,42,6,635,3,758
34021035016,5200,4146,1246,275,549,54,2031,1,2900
34021015052,2355,1963,1031,248,220,46,443,5,932
34025095023,1587,1212,967,87,74,9,71,0,245
34025095016,1526,1191,968,107,54,14,46,1,223
34025095002,1948,1523,1249,100,54,10,104,1,274
34025125014,2564,1970,500,679,519,55,48,8,1470
34025260013,1331,1057,912,85,13,18,16,1,145
34039080021,1535,1273,727,169,248,7,131,0,546
34039095034,1665,1380,466,345,331,12,198,4,914
34039095022,1233,1034,292,207,397,7,119,0,742
34039045301,1320,1024,232,361,396,41,26,4,792
34039045101,1832,1448,585,433,369,31,67,7,863
34039065401,2009,1618,174,275,1084,27,119,1,1444
34039100203,874,732,588,33,16,2,92,0,144
34025155012,1083,830,746,55,6,5,15,1,84
34025155008,1057,858,734,53,25,12,23,1,124
34025082012,744,602,498,61,21,10,8,2,104
34017030B33,2117,1647,286,381,488,19,526,10,1361
34025200007,1051,934,784,96,29,20,17,0,150
34025110001,1078,880,697,110,34,10,25,1,183
34019085003,1012,865,712,97,29,8,23,0,153
34019085004,887,772,665,51,17,6,23,1,107
34019130001,1528,1183,1012,74,42,14,33,0,171
34019035003,899,739,684,30,4,2,14,0,55
34019105012,1496,1194,884,162,58,26,67,2,310
34019105020,939,710,640,29,12,0,22,0,70
34019105016,1111,903,721,89,17,14,62,0,182
34013040003,899,653,506,28,27,11,67,0,147
34013040001,1126,800,585,63,68,6,75,1,215
34013110410,761,580,261,81,172,8,68,0,319
34013090103,967,735,576,44,22,8,77,1,159
34013090106,905,769,622,28,34,2,87,1,147
34039020401,2084,1586,197,987,357,24,20,0,1389
34013030407,1896,1445,68,151,1224,19,30,5,1377
34013030410,2585,1985,41,333,1635,46,31,1,1944
34013045W09,1969,1472,20,164,1300,14,16,2,1452
34013070W38,1203,943,30,34,841,21,20,0,913
34013050025,1131,877,653,16,28,1,181,0,224
34013050012,1230,877,678,28,9,4,154,2,199
34013110102,1074,841,436,84,289,5,33,2,405
34013110108,1175,848,406,112,312,13,36,3,442
34013065208,1084,739,597,30,53,3,51,0,142
34013065206,1137,794,549,62,112,2,62,2,245
34013010314,1368,1158,370,348,369,19,74,3,788
34013010103,2220,1942,668,428,736,40,173,2,1274
34013055020,820,573,450,29,59,8,27,3,123
34013110403,1846,1412,783,192,289,8,158,1,629
34025155035,1257,927,831,43,8,2,35,2,96
34025200009,1895,1342,351,637,326,63,35,0,991
34025160004,1100,874,703,62,29,12,67,0,171
34025047005,963,740,643,56,3,2,24,2,97
34025140021,970,721,587,29,11,2,80,0,134
34025250005,1220,987,777,105,34,11,42,1,210
34025082010,859,672,581,55,11,4,24,0,91
34025082007,1617,1369,1134,139,29,13,59,0,235
34025082008,729,579,500,49,15,11,10,0,79
34031040209,2363,1780,263,1049,206,24,327,1,1517
34031035403,3170,2214,39,2069,191,161,45,4,2175
34039100404,1359,928,728,53,19,8,117,0,200
34039025005,1219,890,687,77,42,9,80,1,203
34031040407,3286,2338,50,1304,1088,37,10,4,2288
34031015002,1458,1167,449,559,135,17,46,0,718
34031015003,1331,1055,457,395,156,42,89,0,598
34005030008,1660,1363,644,109,460,10,132,0,719
34005030009,1205,1087,776,45,200,10,64,3,311
34005192027,676,561,60,45,454,14,7,0,501
34039046001,891,738,429,153,88,6,60,1,309
34039015027,944,773,563,80,79,9,36,1,210
34039085004,1068,871,590,100,62,6,108,1,281
34025245004,1136,939,892,20,2,8,13,2,47
34025215002,859,784,709,34,9,3,23,0,75
34029055028,743,721,661,35,20,8,5,0,60
34029055033,618,568,514,28,10,11,15,0,54
34029090003,1903,1463,1109,172,97,11,62,2,354
34027110005,790,570,462,45,12,3,46,0,108
34039015020,658,487,435,29,3,5,20,0,52
34027110007,1462,1275,1092,58,25,10,92,4,183
34027110009,698,584,473,46,31,1,35,1,111
34005030010,1585,1215,631,69,333,15,178,1,584
34005030017,812,597,363,42,139,4,57,0,234
34005125027,853,629,417,32,48,2,123,2,212
34005055002,1774,1407,859,124,289,36,117,3,548
34005125014,2080,1630,1093,105,204,19,212,10,537
34005105007,2340,1785,1635,48,20,10,74,3,150
34005065011,1043,827,706,41,27,12,44,6,121
34005065004,1245,1022,805,44,97,4,76,1,217
34005065015,957,757,674,19,23,6,41,1,83
34029030045,1874,1477,1218,157,50,23,25,1,259
34029090019,1001,997,896,38,39,14,8,0,101
34029025417,702,696,652,22,11,2,3,0,44
34029030032,1242,1049,832,124,21,18,47,1,217
34029030050,1251,1060,744,215,60,32,28,1,316
34029025235,2216,1634,1380,126,49,24,56,1,254
34029035041,2222,1704,1294,233,81,40,76,2,410
34031070303,1013,749,656,46,7,6,28,1,93
34031040406,1982,1410,36,875,542,38,16,6,1374
34031040405,1662,1275,16,675,600,22,7,6,1259
34031070604,1457,1145,823,120,21,9,179,1,322
34031070502,1787,1443,989,117,47,8,273,1,454
34031025004,1370,1096,727,236,31,10,90,1,369
34031025005,1428,1102,729,244,57,10,78,0,373
34039050001,848,636,492,76,20,5,42,2,144
34039060201,3592,2461,128,1819,561,58,20,8,2333
34039050002,666,500,395,34,3,1,63,0,105
34039090204,681,474,371,28,24,0,46,0,103
34039090207,1272,952,534,200,93,17,109,1,418
34039045402,1102,866,46,199,621,17,16,0,820
34005045002,848,633,506,53,53,15,14,2,127
34005065013,1661,1434,1257,41,47,17,65,9,177
34039060401,4697,3154,41,2184,947,119,26,3,3113
34039035402,1081,773,264,200,276,11,31,3,509
34039095019,914,782,419,102,124,2,135,1,363
34025095005,1596,1246,965,124,45,24,88,4,281
34025120001,224,190,177,5,0,0,7,0,13
34025130005,1504,1130,993,66,15,4,60,0,137
34025130015,732,722,628,44,25,0,22,0,94
34025130004,1819,1425,1175,127,39,15,59,4,250
34025140014,915,681,550,40,12,3,73,0,131
34025140015,878,813,757,16,1,0,39,0,56
34025095008,2016,1655,1227,235,98,22,88,5,428
34025095017,1813,1395,1111,136,56,7,88,1,284
34025260001,1882,1416,1269,60,34,21,22,2,147
34025160002,1595,1221,977,73,67,14,83,0,244
34025095012,947,939,821,61,29,11,19,2,118
34025170013,772,664,600,28,14,3,8,0,64
34025190002,929,740,657,30,14,1,16,0,83
34025255004,1880,1528,1373,53,23,6,68,0,155
34025255002,2014,1471,1168,68,48,11,161,2,303
34021060002,1349,1008,764,39,35,10,162,1,244
34025205001,808,677,546,68,34,10,17,0,131
34029025308,869,865,794,40,14,5,11,0,71
34029070021,1933,1337,834,302,127,9,55,2,503
34029030007,1984,1564,1235,208,41,21,47,3,329
34029060004,1459,1120,959,95,22,25,16,1,161
34029035009,1537,1228,1028,115,35,32,21,0,200
34029030051,770,628,560,24,20,7,7,1,68
34005192013,1117,900,86,97,688,19,42,0,814
34005065028,1674,1374,1125,94,79,29,50,3,249
34005065029,1378,1024,907,37,52,10,19,2,117
34005192033,707,584,70,40,480,14,7,0,514
34005115013,965,743,611,28,36,12,39,0,132
34005150012,2750,2111,1282,262,425,56,99,4,829
34005105014,777,591,548,20,11,3,13,0,43
34005180005,1325,1074,998,36,14,17,4,1,76
34005950010,1338,1110,801,83,191,39,37,0,309
34005060001,718,547,352,48,106,20,19,0,195
34005170004,2127,1730,1552,65,75,10,33,0,178
34005025301,819,639,387,67,163,9,13,2,252
34039055004,1260,904,673,52,14,3,147,1,231
34039040002,1339,1084,703,266,43,24,63,0,381
34005125015,2945,2281,1423,114,243,21,489,5,858
34005020008,2146,1741,1293,132,177,21,123,1,448
34005192010,842,631,73,83,475,11,18,1,558
34005105016,1135,825,723,30,29,3,35,1,102
34039100306,1244,968,655,99,39,3,161,1,313
34039060102,5329,3670,106,2654,943,159,18,6,3564
34039060301,1301,936,87,515,328,73,6,2,849
34009040205,275,209,183,20,2,2,1,0,26
34009055002,816,651,609,16,5,9,9,0,42
34009025101,895,746,640,60,39,15,5,0,106
34009035202,425,367,342,9,8,2,5,0,25
34009035104,321,288,275,8,1,1,0,0,13
34009035204,468,409,363,27,12,4,1,1,46
34009025201,609,519,453,29,13,15,4,1,66
34009045001,477,437,418,7,2,1,7,0,19
34009030011,1189,924,788,59,49,12,5,1,136
34009040201,504,431,377,42,3,7,8,1,54
34009040301,668,597,576,5,8,3,4,2,21
34013070W46,1549,1093,27,898,188,43,12,1,1066
34013010211,1063,792,496,126,70,16,100,0,296
34013110101,1069,810,477,71,203,17,51,1,333
34013070C42,1273,903,6,204,697,12,18,2,897
34013070W25,1487,1080,3,88,1002,10,15,0,1077
34013045W06,1393,1065,20,297,749,26,7,0,1045
34013045N02,2161,1622,48,292,1273,22,13,3,1574
34013045W01,1970,1519,25,136,1368,9,23,0,1494
34013110413,1178,895,379,105,222,9,181,0,516
34013110407,1746,1460,692,150,436,10,188,7,768
34013110412,2146,1717,913,118,464,14,213,5,804
34013070W47,1978,1469,28,366,1066,32,26,5,1441
34013070W13,1649,1076,12,206,892,3,2,1,1064
34013070C45,1583,1174,65,596,534,48,20,2,1109
34039020504,1205,870,21,499,337,9,29,0,849
34005100008,910,749,604,53,41,19,34,4,145
34005115001,861,702,560,55,41,6,35,0,142
34019020001,1005,797,726,27,5,15,15,0,71
34005125002,2568,1923,1158,128,273,33,348,0,765
34025125007,1953,1505,702,455,125,18,30,8,803
34013005101,1930,1516,295,808,211,38,221,5,1221
34013110107,1033,774,110,314,327,26,21,1,664
34013110103,1100,830,209,198,381,16,49,2,621
34009010002,347,306,251,42,7,1,0,0,55
34029135001,584,538,519,7,1,0,5,1,19
34029150017,877,635,580,34,2,0,13,0,55
34029150016,689,650,601,35,4,7,7,2,49
34029025206,2204,1632,1400,88,86,15,48,0,232
34029030038,1501,1191,1044,91,12,5,25,0,147
34029030031,1341,1193,1057,57,34,5,39,0,136
34029030023,817,810,773,23,9,3,3,0,37
34029030030,1127,1005,900,55,19,14,13,1,105
34029035051,1194,901,641,161,49,4,60,0,260
34025140004,1761,1396,920,61,46,6,360,0,476
34025125004,1119,819,714,63,16,6,12,0,105
34025080014,1053,757,642,50,17,14,29,0,115
34025125015,1281,1095,810,108,75,15,18,2,285
34005035001,7788,6247,2309,810,2174,42,981,2,3938
34005050206,1193,916,621,65,152,18,55,0,295
34005050204,1227,909,706,25,44,20,76,0,203
34005050202,1150,848,570,22,118,5,134,1,278
34005115002,996,772,637,30,52,8,45,3,135
34005155003,984,751,570,90,43,14,9,0,181
34005045001,688,552,431,44,51,11,6,0,121
34037075001,1212,1003,764,115,77,20,35,1,239
34013050006,1144,850,509,45,28,6,264,2,341
34013100008,1322,1005,844,76,24,4,56,1,161
34013080307,1171,936,580,193,54,5,113,0,356
34013075003,1457,1116,932,90,20,12,61,1,184
34013105002,1061,820,729,40,10,9,26,0,91
34013015002,817,607,459,116,9,3,22,0,148
34013030106,1142,858,21,100,737,6,7,0,837
34013055008,976,661,573,25,12,8,31,2,88
34013105003,1704,1347,1040,172,44,7,86,2,307
34037010003,1117,885,744,76,29,13,19,0,141
34037110003,1175,938,776,105,26,6,14,0,162
34009020004,897,748,662,27,18,27,9,2,86
34009020006,651,542,471,26,11,10,5,3,71
34009025210,688,588,510,33,27,13,6,0,78
34039095021,1069,885,428,207,160,7,92,1,457
34003190007,1894,1574,656,339,183,19,408,0,918
34003190008,1578,1282,651,240,80,12,305,1,631
34003190006,1915,1596,684,343,202,10,404,2,912
34003035004,1490,1075,617,40,12,1,404,0,458
34003015010,1896,1263,792,203,82,7,188,2,471
34003350009,988,726,634,37,7,10,41,2,92
34003350007,1746,1353,1166,78,11,13,73,1,187
34003005003,1397,1056,861,76,14,6,108,0,195
34003125001,1160,978,718,146,32,9,73,1,260
34003325006,1370,1155,763,213,118,5,62,0,392
34003020003,1727,1362,422,701,160,28,139,2,940
34003225002,1886,1593,161,275,29,37,1124,2,1432
34013060015,1091,768,551,27,8,6,172,0,217
34013030508,867,701,10,74,627,11,12,0,691
34013060010,1167,844,514,46,42,2,237,2,330
34013080202,1500,1170,942,126,20,16,73,2,228
34013080106,1054,840,662,94,7,8,67,0,178
34013055011,2321,1784,396,162,1179,15,74,2,1388
34013070S25,1696,1121,13,201,930,19,11,0,1108
34029060005,1492,1225,1104,68,24,7,8,3,121
34003280007,1639,1375,811,274,61,8,220,1,564
34029070043,1710,1261,584,345,263,18,76,1,677
34029070029,4288,2387,1393,757,173,36,50,2,994
34029070023,857,848,720,63,55,8,13,0,128
34029025107,1542,1225,1018,121,30,17,28,2,207
34029070016,3781,2020,1807,115,27,14,7,3,213
34029055015,1966,1325,978,174,93,14,54,4,347
34029055024,1723,1358,1123,89,55,28,45,0,235
34029080009,1594,1214,1045,71,45,38,9,0,169
34023050002,1219,950,711,60,40,6,135,4,239
34003240003,2455,1857,1454,178,31,14,163,0,403
34003240002,2149,1597,1384,102,23,11,78,0,213
34003240008,955,734,645,55,1,2,27,0,89
34037110009,1130,905,795,59,20,13,5,0,110
34037040003,706,552,475,28,12,6,12,0,77
34017030F31,2687,2183,661,747,589,63,213,2,1522
34017030F29,2425,1810,196,729,814,40,172,7,1614
34017030B26,1044,774,193,193,376,14,32,3,581
34017030E14,1566,1397,708,222,155,18,328,5,689
34025080015,1690,1400,825,172,272,22,116,3,575
34025047006,1437,1089,935,41,10,3,94,2,154
34025135004,1211,1043,987,29,9,9,12,2,56
34025125012,2418,1762,354,970,179,67,20,2,1408
34025260018,593,561,536,4,1,2,13,1,25
34005090003,1403,1128,449,135,485,32,68,2,679
34005040006,606,458,399,13,20,1,13,0,59
34005040004,590,463,397,16,14,13,20,0,66
34005095004,751,735,678,13,32,5,9,2,57
34013030505,1374,1025,34,256,746,16,15,0,991
34013080303,1009,807,594,106,20,6,81,0,213
34013045E04,2641,1974,22,175,1801,15,11,4,1952
34013045E08,2058,1585,16,203,1363,25,20,0,1569
34013050016,953,642,466,29,24,4,110,0,176
34013040008,961,659,555,31,6,1,57,0,104
34013040002,1630,1160,904,60,68,12,115,0,256
34013070W21,1135,732,10,50,680,13,2,3,722
34013080204,1444,1139,855,145,14,2,116,4,284
34025155031,1401,1087,976,54,14,9,28,0,111
34019075004,1075,838,764,44,1,10,13,0,74
34003240001,1954,1581,1159,200,37,17,171,1,422
34003255014,1726,1257,775,86,12,7,374,1,482
34013105008,1131,851,681,81,22,3,59,4,170
34013095004,1852,1498,784,148,416,36,119,4,714
34013070S45,1335,1060,8,97,982,8,6,0,1052
34013065405,1399,1208,456,159,519,29,88,1,752
34013050022,1015,767,485,55,41,2,180,0,282
34013110301,1009,757,110,276,366,17,19,3,647
34037055007,1504,1202,980,110,65,16,39,0,222
34037090009,1034,776,675,44,5,4,21,0,101
34003015006,1764,1428,393,462,153,19,461,2,1035
34003160009,1279,1026,624,267,42,20,93,1,402
34003350002,1941,1404,1286,62,9,9,43,0,118
34003230014,1245,1003,685,80,9,4,225,2,318
34003230018,850,635,420,69,10,8,130,0,215
34003230020,1125,947,597,83,5,3,248,0,350
34003160001,2492,2095,1167,456,212,17,275,2,928
34003067008,3387,2768,1813,577,137,34,240,5,955
34003115505,965,841,368,222,174,13,78,1,473
34003050011,1536,1207,798,160,75,6,177,1,409
34003210008,1235,958,833,68,7,13,37,1,125
34003210001,2502,1987,1564,159,40,17,213,2,423
34003290001,1684,1378,1064,79,36,15,173,1,314
34019070002,1307,1034,860,88,47,12,35,1,174
34019030003,1127,849,611,43,29,10,149,0,238
34017005215,2679,2030,865,689,275,31,226,6,1165
34017005105,2153,1691,855,472,219,17,174,4,836
34005050101,588,445,344,31,26,15,10,3,101
34005100019,3242,2377,585,617,904,87,263,9,1792
34005190004,1495,1171,694,135,263,29,65,1,477
34005120001,2037,1708,680,364,582,27,92,5,1028
34005150010,1789,1469,811,169,398,51,81,5,658
34005065024,3213,2496,1842,115,137,29,385,4,654
34017030E07,2544,2180,722,606,149,35,711,9,1458
34017030E09,9634,8511,3303,492,262,44,4358,8,5208
34017030E15,3065,2641,939,121,78,13,1467,5,1702
34005025302,1323,1096,539,90,445,12,35,1,557
34005192018,1020,796,141,65,580,22,15,0,655
34017055104,1101,908,369,392,44,31,109,2,539
34017005102,1367,1084,483,262,271,7,78,3,601
34017005103,1246,969,454,290,205,17,45,0,515
34017005106,1236,981,612,242,94,3,57,5,369
34005170001,1336,1086,949,53,31,29,22,3,137
34005060006,1665,1346,539,251,457,41,65,0,807
34005090005,1714,1329,1001,48,173,7,106,5,328
34013055015,937,634,460,44,105,10,24,0,174
34013050009,621,472,277,36,2,0,148,0,195
34013050005,1579,1179,739,57,43,7,320,2,440
34013070C01,2119,1809,168,340,1288,37,73,1,1641
34013060008,1151,786,534,33,14,4,201,0,252
34013110401,1611,1276,821,107,190,8,146,0,455
34013110415,1378,1145,747,94,194,9,102,4,398
34013070W19,2136,1494,18,258,1237,20,10,4,1476
34039065101,1023,833,145,265,377,25,42,1,688
34005120006,1124,803,360,143,289,22,28,3,443
34005095001,1052,830,637,51,56,14,62,2,193
34017060202,2895,2269,227,1794,178,89,140,0,2042
34017040504,1921,1495,140,1245,57,67,66,2,1355
34017030D06,963,750,246,348,60,10,112,4,504
34017030D04,1653,1402,583,506,113,34,213,3,819
34017045101,1507,1209,677,260,42,9,237,1,532
34017045302,2950,2440,1042,337,170,17,898,1,1398
34017060102,2952,2665,758,1240,170,33,526,5,1907
34017005108,966,794,514,162,44,9,69,1,280
34017005311,1740,1387,644,367,167,35,208,3,743
34017050503,2371,1822,112,1549,113,91,82,3,1710
34039040005,1460,1162,876,190,17,8,57,1,286
34007110004,4098,3151,952,904,1219,99,105,7,2199
34007135013,1372,1071,613,245,158,31,59,2,458
34007040104,1546,1091,74,509,539,31,3,3,1017
34007125004,1144,924,829,35,22,10,9,1,95
34007020006,1720,1372,1129,134,59,18,32,1,243
34007020005,1744,1391,979,182,109,19,97,3,412
34007040301,1897,1304,31,970,240,51,102,10,1273
34007135004,2341,1812,287,761,555,29,259,7,1525
34007040206,2361,1733,55,580,1137,31,17,1,1678
34007015001,1569,1213,1097,56,28,23,15,2,116
34007020007,1235,1003,815,76,48,17,49,1,188
34007075032,1546,1251,876,71,254,14,32,0,375
34007075030,2099,1636,1216,123,214,47,45,5,420
34007075020,1808,1431,918,62,347,21,84,4,513
34007075039,807,630,408,59,127,3,42,0,222
34007025005,847,681,564,27,55,5,24,0,117
34007075001,1044,841,715,54,42,17,16,1,126
34007040302,2106,1534,66,976,372,30,181,11,1468
34007135012,1359,1027,210,467,263,17,112,5,817
34015110203,984,871,621,54,167,20,10,0,250
34007090001,941,723,672,18,10,7,6,1,51
34007085005,911,609,550,17,9,2,24,0,59
34007040307,2119,1478,39,1004,441,18,71,7,1439
34007077102,1171,848,689,87,45,18,14,1,159
34015090021,843,719,662,38,13,3,5,0,57
34015030008,1608,1367,949,74,208,11,131,3,418
34015115003,467,374,318,22,20,7,8,3,56
34015110204,796,566,147,145,278,14,7,2,419
34041060004,1220,962,854,64,18,13,17,0,108
34041095301,1340,982,609,150,192,19,20,1,373
34015110201,824,655,451,70,112,25,10,6,204
34015010005,1484,1239,906,122,171,26,31,3,333
34031040303,1815,1440,53,661,762,22,11,7,1387
34007075015,2118,1666,1182,134,244,33,100,1,484
34007065001,1145,898,795,35,24,10,26,3,103
34007065002,1044,802,656,48,39,10,35,6,146
34041080001,969,835,742,53,19,6,11,1,93
34041110001,826,669,577,27,36,7,12,1,92
34031035102,2943,1919,29,1791,174,119,14,0,1890
34031035103,4755,3133,149,2808,289,254,20,9,2984
34031075003,1714,1351,1163,93,36,23,21,1,188
34031065008,1113,936,609,180,83,25,51,0,327
34031045002,2371,1936,1318,378,62,34,145,3,618
34007080008,1737,1507,1238,98,68,18,93,0,269
34007055003,884,730,515,72,78,25,41,2,215
34007075012,1508,1222,1049,42,94,9,34,1,173
34007040203,1213,891,14,144,754,17,2,3,877
34007043012,2434,1996,1164,190,274,38,354,0,832
34007043025,1423,1134,765,115,69,19,177,4,369
34015040007,1269,976,871,35,41,7,27,1,105
34041035004,1755,1277,720,149,200,5,192,1,557
34041095502,1365,1016,688,138,130,35,26,1,328
34015030003,1683,1344,508,260,522,27,53,0,836
34031040201,3082,2172,99,1100,230,49,801,6,2073
34041085002,645,518,451,29,10,10,12,1,67
34041085001,1799,1404,1212,89,42,22,30,0,192
34015100017,1240,1078,812,63,128,13,64,0,266
34013105004,1683,1391,1177,86,35,9,79,1,214
34013010311,1302,975,249,505,175,22,63,8,726
34013010205,1362,1077,637,156,75,5,216,1,440
34013045W07,1869,1427,28,195,1197,7,26,3,1399
34027155011,1300,1113,1005,63,7,4,28,0,108
34027105015,1643,1380,943,55,10,2,356,0,437
34023065111,723,534,335,32,23,3,138,1,199
34023105001,2854,2127,662,108,126,20,1215,1,1465
34023085109,1185,958,380,168,166,19,264,5,578
34023085401,821,657,216,127,82,11,228,2,441
34023095003,2378,1890,871,232,186,18,575,8,1019
34023085309,1277,1050,349,147,236,12,324,0,701
34023025014,1115,921,482,75,78,12,283,4,439
34023025013,2234,1696,336,174,268,7,920,0,1360
34023050009,743,612,428,57,50,4,75,0,184
34023077409,714,628,399,70,32,7,127,0,229
34023077403,1231,1004,758,88,39,5,119,0,246
34023077305,1476,1317,833,182,126,11,181,0,484
34023025033,800,651,250,27,19,7,356,0,401
34003305012,1414,961,714,43,20,0,175,0,247
34003160010,1696,1399,882,389,55,18,69,2,517
34005135003,1319,1062,958,36,26,28,11,1,104
34005080002,1248,1091,917,64,55,20,36,1,174
34031040106,1840,1397,129,897,342,61,98,1,1268
34027035002,2140,1680,1417,114,24,18,98,1,263
34027145028,1055,847,493,37,34,8,290,1,354
34027045401,2234,1726,131,1476,121,88,56,0,1595
34027160011,2251,1747,1058,173,97,12,404,3,689
34027145001,2742,2153,986,156,173,13,840,4,1167
34011070605,1372,1115,743,238,119,31,18,3,372
34011005303,1506,1040,224,491,310,73,10,6,816
34031065006,992,825,589,114,28,13,71,1,236
34031030002,738,632,557,44,10,4,16,0,75
34031030007,540,452,388,43,8,6,11,0,64
34031030003,1456,1207,1031,115,20,12,40,0,176
34031060001,1637,1334,752,460,47,21,77,1,582
34031020203,1992,1635,1160,332,70,9,71,2,475
34031040305,2603,1883,84,1614,234,165,15,5,1799
34027085009,1247,875,694,89,8,7,73,1,181
34027180203,1110,858,573,166,19,19,81,0,285
34027180205,792,644,465,119,14,7,38,3,179
34027065004,910,738,663,18,9,5,41,0,75
34035010001,746,553,432,24,10,3,77,0,121
34001010203,1882,1256,53,515,714,14,10,12,1203
34001060013,2720,1984,959,321,375,36,320,2,1025
34023020034,1517,1150,672,41,47,5,376,0,478
34023095001,831,665,428,97,89,3,45,1,237
34023080201,2205,1708,189,1372,302,55,24,8,1519
34023080402,1918,1430,47,1303,147,29,10,0,1383
34023070604,683,637,426,54,55,6,83,0,211
34023035011,1373,1056,540,197,116,13,188,0,516
34023030001,2455,2023,1575,191,106,39,115,6,448
34023125108,918,723,241,145,140,3,197,0,482
34023125518,742,585,353,62,29,5,139,0,232
34023085204,1030,875,342,127,132,26,274,5,533
34027145012,1666,1407,666,109,48,8,581,4,741
34027020005,1090,740,644,24,3,4,60,0,96
34001110002,1789,1554,1158,207,62,16,116,2,396
34001065007,2254,1745,1218,425,39,32,41,0,527
34023085107,3861,3041,388,458,747,29,1442,6,2653
34023115014,779,615,440,101,39,0,21,0,175
34023020004,1206,957,661,50,15,1,218,0,296
34001010102,1750,1493,283,308,862,20,54,0,1210
34027145013,1089,913,432,120,40,6,329,0,481
34027145017,1087,866,360,86,16,14,405,5,506
34027160010,1059,823,598,109,51,6,69,1,225
34023077108,2006,1664,1126,174,140,13,218,1,538
34023075022,1495,1194,405,195,333,8,258,0,789
34023100103,983,802,576,139,56,5,36,1,226
34023125403,1289,1055,250,86,41,11,680,1,805
34023070203,2207,1593,145,1183,228,66,90,3,1448
34023105019,1078,830,290,70,158,7,321,0,540
34023105010,1130,815,418,59,69,11,258,0,397
34023077606,2046,1736,1188,204,143,22,187,4,548
34023025002,1740,1416,132,32,139,2,1112,0,1284
34023020030,1471,1268,749,68,67,9,387,6,519
34023025016,1228,1014,476,139,80,2,315,1,538
34023065207,756,751,658,27,32,0,32,0,93
34023065208,515,507,443,14,13,0,34,1,64
34023110002,1452,1199,724,256,119,23,105,1,475
34023077510,2317,1876,984,211,227,25,464,2,892
34023085102,1210,912,219,350,255,9,85,0,693
34023080103,1881,1365,36,1276,124,35,7,6,1329
34023105021,1132,920,383,24,40,4,469,0,537
34023065206,540,539,464,19,24,1,28,0,75
34023095007,676,528,343,102,48,2,46,2,185
34023025066,1549,1175,211,24,23,3,909,1,964
34023025064,1635,1366,267,61,162,10,876,1,1099
34023055006,702,575,441,68,25,8,36,1,134
34023055002,1887,1459,821,346,123,34,162,0,638
34023065309,1788,1361,973,111,33,17,216,3,388
34023065101,625,619,542,17,22,1,30,0,77
34023077102,959,827,631,112,37,15,35,0,196
34023070103,3950,2784,270,1866,497,93,199,12,2514
34007075024,1419,1249,1074,41,98,5,29,0,175
34007075040,1654,1352,1001,69,190,20,80,2,351
34007043021,1986,1572,938,114,148,9,354,0,634
34007043029,1779,1373,1011,96,77,16,171,1,362
34007055008,1143,944,795,63,40,16,32,1,149
34007005008,1092,856,787,29,18,11,5,2,69
34001005202,1892,1489,478,227,444,17,362,1,1011
34035065014,732,574,385,25,13,3,141,0,189
34021015039,1399,1094,514,379,191,22,19,0,580
34021065011,2001,1494,559,41,23,2,875,0,935
34021030007,1226,933,748,40,17,3,119,0,185
34035090005,738,606,389,124,37,0,57,0,217
34035030018,1309,1063,637,77,85,5,264,0,426
34035030027,821,707,548,48,14,6,103,0,159
34035080001,1940,1600,869,376,87,14,243,1,731
34021055W16,1223,928,25,113,802,9,3,1,903
34021060009,2654,1849,1029,68,80,7,657,1,820
34021060007,1915,1434,894,71,91,10,362,0,540
34021060004,1791,1329,828,64,67,8,356,2,501
34021055E02,2010,1404,31,614,772,24,16,16,1373
34021055E01,2300,1555,20,472,1093,94,13,9,1535
34025160001,1319,1027,845,75,33,6,55,0,182
34025155029,2482,2102,1843,111,52,11,62,1,259
34025085003,926,775,645,49,34,11,18,1,130
34025085004,1030,932,825,39,21,7,25,0,107
34025125010,2037,1509,590,513,128,54,32,4,919
34035070009,1754,1318,379,559,321,46,58,0,939
34025200001,689,564,452,76,20,20,11,0,112
34025260010,1025,886,855,16,3,4,8,4,31
34025172003,1039,927,755,79,70,21,12,0,172
34025170008,1421,1161,453,237,443,27,35,3,708
34025140005,1578,1288,1028,79,16,0,161,1,260
34025095024,1817,1334,792,247,94,24,194,2,542
34021005008,2318,1819,1078,174,142,24,428,2,741
34035090002,1641,1270,583,313,127,15,238,2,687
34021015020,968,787,681,52,18,8,22,1,106
34021055E06,1606,1176,43,617,518,35,16,13,1133
34035025009,1507,1220,820,73,81,11,237,0,400
34025082001,1366,1098,922,113,23,20,27,1,176
34025155032,2347,1864,1531,161,49,10,108,1,333
34025210005,1027,717,647,28,2,2,31,0,70
34025095026,2240,1661,1444,116,42,6,48,1,217
34025247013,1177,972,711,94,93,5,72,0,261
34025185020,862,738,580,53,27,7,73,2,158
34025185003,810,644,596,22,11,2,8,0,48
34025200006,2363,1747,685,768,257,61,54,4,1062
34025260017,1364,1056,999,18,4,4,23,0,57
34025155042,1056,844,757,31,5,3,35,2,87
34025155019,2089,1579,1386,70,14,6,96,2,193
34025200002,1284,1080,799,174,68,14,24,4,281
34025260014,1251,973,882,42,10,6,35,0,91
34025260007,1423,1187,1027,89,16,11,35,4,160
34025110004,1088,891,619,181,37,14,35,1,272
34025080021,872,788,685,37,24,4,31,0,103
34025080002,1302,1153,957,101,29,12,49,1,196
34025082002,2172,1710,1349,149,48,19,147,5,361
34025095004,1835,1363,1079,88,39,24,125,4,284
34025130008,1190,956,812,78,8,1,50,1,144
34025260016,1132,930,862,23,0,2,34,0,68
34025125001,781,554,448,52,7,1,3,0,106
34017035309,1087,858,405,351,30,19,37,3,453
34025055002,1573,1296,564,275,333,47,112,0,732
34025135001,1600,1260,1069,152,6,13,24,1,191
34021010028,934,767,218,103,404,9,51,2,549
34021015041,1588,1321,775,241,202,27,99,0,546
34021050001,1749,1365,834,69,61,1,389,2,531
34035030021,798,639,463,29,30,0,122,0,176
34013070N19,1875,1375,60,985,319,23,55,1,1315
34025082005,1006,794,677,71,14,11,23,0,117
34039095045,1175,946,470,193,147,4,117,2,476
34039085003,849,700,390,183,68,6,51,0,310
34039085002,848,639,463,99,19,9,48,1,176
34039002037,2058,1660,213,990,470,23,35,1,1447
34039020103,2624,1857,168,1560,138,43,37,4,1689
34039002010,1658,1214,198,965,63,36,12,3,1016
34039020501,3206,2366,571,1487,149,40,61,7,1795
34039015024,729,539,464,26,13,3,27,0,75
34037050003,810,667,581,51,13,5,15,1,86
34019035005,874,748,684,33,12,11,5,1,64
34019115001,495,430,400,9,2,9,9,0,30
34019040005,849,739,684,23,13,8,11,0,55
34019040002,751,623,562,31,10,4,12,0,61
34039015001,1565,1278,972,160,52,11,74,2,306
34039015014,758,565,449,65,13,3,36,0,116
34039095035,1266,1019,410,211,230,19,153,3,609
34039045702,1993,1470,264,611,561,37,41,5,1206
34039045603,1959,1596,656,491,360,27,73,0,940
34039010202,1493,1258,993,133,73,9,44,3,265
34039015025,603,456,392,32,9,4,21,0,64
34039090213,850,582,439,36,12,10,79,1,143
34039015019,647,487,422,36,2,5,21,0,65
34005150003,1990,1518,869,176,348,40,81,9,649
34005105008,1355,1038,972,32,7,9,20,1,66
34005180001,974,797,742,24,11,3,2,1,55
34005165001,825,629,583,25,3,6,8,0,46
34005155005,833,671,435,117,41,18,15,0,236
34039095024,1314,1120,642,173,135,6,155,3,478
34029030025,951,855,814,14,8,0,6,0,41
34029030055,681,610,573,19,6,5,1,0,37
34029025313,787,782,730,26,16,0,1,1,52
34029070007,5783,2810,1793,725,271,44,20,0,1017
34029003009,1004,970,909,39,7,6,11,0,61
34029003014,553,553,517,27,5,0,4,0,36
34029055030,1052,787,617,82,51,12,28,1,170
34029055012,1925,1550,1168,191,100,28,66,2,382
34029055010,2265,1714,1269,220,140,14,74,1,445
34029030028,697,637,561,38,27,11,7,1,76
34005140006,989,855,684,50,99,20,15,2,171
34005140005,781,606,405,73,90,19,30,4,201
34005150002,1997,1558,1104,126,203,40,61,9,454
34005155004,667,529,414,36,34,19,9,0,115
34005140007,922,696,517,58,99,17,8,0,179
34005160003,1095,879,779,23,33,12,12,0,100
34009045002,439,407,395,7,2,1,0,1,12
34009055004,944,806,754,24,2,6,16,1,52
34009010004,499,441,401,22,7,6,2,0,40
34009010005,829,645,538,55,29,9,14,0,107
34009045004,619,587,566,10,1,2,6,1,21
34003130001,1768,1390,1048,65,46,17,221,1,342
34003280011,1695,1462,896,248,64,11,250,0,566
34003350010,1418,1099,938,72,15,8,70,1,161
34003215001,1570,1187,888,76,9,4,202,0,299
34003015004,1366,1125,407,336,123,10,289,1,718
34003220005,1471,1146,882,82,19,3,154,0,264
34003155011,2263,1776,744,678,199,20,193,0,1032
34003105503,1135,897,526,288,61,11,27,0,371
34003190002,1689,1332,882,199,52,13,212,0,450
34003085002,1923,1496,1097,183,39,2,180,5,399
34003230015,1509,1236,664,81,39,5,454,3,572
34003300023,1652,1296,69,368,816,12,101,4,1227
34003300016,1089,863,30,194,615,9,60,1,833
34003260008,1710,1312,422,166,71,6,647,1,890
34003115506,2190,1880,603,465,496,24,348,1,1277
34005045003,711,572,414,31,94,18,12,2,158
34005030019,2069,1649,500,99,737,19,316,1,1149
34005030006,1262,1002,364,61,432,6,138,1,638
34005040007,1152,859,690,54,69,17,25,1,169
34005192015,782,631,67,57,496,8,29,0,564
34009025106,1107,861,725,75,29,14,9,3,136
34009030003,987,825,686,49,41,14,40,0,139
34005025203,641,520,318,68,121,19,8,0,202
34005030001,670,537,420,47,60,6,10,0,117
34005060004,805,658,394,72,157,8,29,0,264
34005035002,1634,1276,1140,38,36,11,28,4,136
34005030005,820,610,354,42,158,11,68,0,256
34003030003,2756,2087,529,1215,133,117,178,1,1558
34003335004,1664,1358,847,201,101,17,197,0,511
34003085003,1452,1086,893,65,19,4,104,3,193
34003270001,1683,1439,780,382,86,14,177,8,659
34003330004,1645,1371,1143,108,10,3,96,0,228
34003285010,1262,986,731,166,19,5,67,0,255
34003285008,1218,978,710,195,33,8,46,1,268
34003305008,1352,964,645,55,16,0,235,2,319
34003235006,1488,1239,1049,55,4,2,122,0,190
34005125022,836,711,596,24,31,10,43,3,115
34005015102,784,657,463,47,119,7,28,0,194
34005125025,1096,908,605,53,140,7,100,1,303
34005192029,584,489,103,28,359,14,8,2,386
34013070W06,1461,1033,15,403,638,28,9,1,1018
34013010111,2266,1905,1005,460,326,28,128,4,900
34013010104,1265,1040,545,223,151,19,114,1,495
34013005102,2141,1730,383,857,244,19,261,2,1347
34013030110,748,589,9,44,530,11,6,1,580
34013070C23,3505,2440,26,442,2042,34,16,18,2414
34013070N14,2516,1991,133,1541,338,34,37,0,1858
34013110502,1428,1127,130,468,511,30,28,0,997
34009ZZZZZZ,0,0,0,0,0,0,0,0,0
34009075001,657,572,514,38,12,2,4,1,58
34009140003,1005,759,347,245,141,17,11,1,412
34009025307,773,656,633,13,2,0,5,0,23
34009030012,896,692,512,75,80,8,15,3,180
34009025109,602,508,468,26,10,2,2,0,40
34003100004,3007,2326,1827,172,38,11,257,3,499
34003180004,2733,2174,1612,121,53,3,390,5,562
34003300011,1683,1167,994,48,79,6,29,0,173
34003230001,1879,1533,767,235,62,6,470,0,766
34003115502,1438,1209,302,486,280,29,169,2,907
34003260003,1315,958,643,113,29,10,191,0,315
34003260005,1259,927,624,78,32,10,192,0,303
34003260004,1281,969,717,84,14,2,148,1,252
34003140002,1484,1063,890,61,10,2,94,3,173
34003140003,1311,952,811,63,8,1,66,0,141
34003285002,1114,931,612,160,28,4,113,1,319
34003300001,1637,1330,297,457,304,15,313,2,1033
34003255006,1367,928,669,84,23,6,152,0,259
34003085020,1476,1127,697,206,51,11,177,0,430
34003085015,2286,1883,1328,209,81,3,262,0,555
34003130002,1575,1163,865,57,19,8,221,0,298
34003255002,1557,1043,831,63,10,3,124,3,212
34003005001,2088,1584,1262,77,24,7,207,1,322
34013045S11,1403,1047,5,140,915,15,13,5,1042
34003115501,2136,1694,416,658,482,25,195,3,1278
34003255013,1536,1143,792,53,13,5,264,0,351
34003200001,1335,1034,701,78,18,3,223,0,333
34003200003,1861,1422,872,116,22,3,404,0,550
34029035031,1358,1154,925,138,54,14,27,2,229
34013055006,1091,754,572,42,99,6,35,0,182
34013070N17,1561,1265,211,730,332,24,39,1,1054
34013055017,1183,808,643,60,43,1,55,2,165
34013095003,1357,927,606,37,185,3,80,0,321
34003095008,1544,1207,387,166,35,7,620,0,820
34003280005,1454,1144,627,195,78,15,250,0,517
34003060003,1687,1390,732,419,103,17,154,4,658
34029090021,645,637,589,13,30,2,2,1,48
34019105015,1305,1010,766,67,41,8,112,1,244
34019105004,823,635,547,49,17,6,19,0,88
34019110010,1170,964,873,39,5,3,33,0,91
34019105003,1287,1023,858,61,17,8,74,4,165
34019105005,1364,1036,693,66,43,7,222,0,343
34003300022,1746,1444,323,288,294,16,559,3,1121
34013050002,1291,967,613,51,24,1,278,1,354
34013050001,1104,818,506,33,36,2,235,0,312
34013050003,1447,1067,648,87,36,7,267,0,419
34013030401,2003,1486,18,219,1278,25,9,7,1468
34013015005,1398,1032,831,82,45,14,60,1,201
34013105007,811,624,559,34,3,3,16,0,65
34003325001,1453,1159,831,263,49,6,26,3,328
34003305011,1239,856,618,30,24,1,174,6,238
34003305002,1250,881,397,53,16,9,412,2,484
34003090002,3049,2436,673,1421,140,69,208,0,1763
34003065001,3052,2407,999,366,229,21,833,9,1408
34003065004,5822,4845,1946,502,290,14,2074,7,2899
34003065002,2771,2258,1121,314,152,9,685,6,1137
34003195003,1973,1640,792,368,96,24,383,2,848
34003110004,1336,961,764,55,11,8,120,2,197
34013070S32,1137,803,4,57,754,21,0,0,799
34013005306,1675,1299,313,616,273,27,132,4,986
34013005207,1425,1138,455,413,94,18,180,0,683
34013005304,1396,1125,286,609,100,15,138,1,839
34013070N37,1805,1308,32,1001,307,46,4,2,1276
34013080306,2827,2316,1213,517,225,28,349,2,1103
34025003002,2525,1925,719,277,671,22,248,2,1206
34029070030,602,596,558,15,6,0,19,0,38
34029150011,1613,1217,1037,121,27,17,18,0,180
34029003001,2017,1644,1420,132,52,25,22,0,224
34029040001,1722,1384,1250,81,9,36,18,1,134
34029070017,2039,1349,1112,90,103,4,7,1,237
34029070005,2676,1402,1232,107,11,9,7,2,170
34029030048,691,648,589,30,1,4,18,0,59
34029055019,1832,1226,883,233,67,15,24,0,343
34029055004,2766,1842,1279,437,74,28,28,3,563
34009010001,464,416,366,32,7,1,6,0,50
34009035203,426,381,353,12,10,1,1,0,28
34037055004,1148,929,826,33,11,14,18,0,103
34039015011,633,487,419,41,2,1,26,0,68
34039080015,1100,811,694,51,13,7,50,1,117
34017045204,1153,890,506,170,39,20,178,0,384
34017030C27,1877,1329,204,306,267,12,564,5,1125
34039020603,3598,2632,423,2016,172,39,26,3,2209
34039065203,1302,1041,361,344,305,13,49,1,680
34039065303,1070,856,452,217,150,7,55,0,404
34017030C02,1202,983,174,179,52,15,595,2,809
34017030B12,2261,1762,213,521,586,33,459,8,1549
34017030B13,2244,1671,201,509,624,42,344,7,1470
34019105010,795,663,514,45,56,5,48,0,149
34019035004,945,788,692,45,1,4,24,0,96
34019105014,1192,1005,849,63,20,2,63,0,156
34005010002,887,633,221,110,258,24,17,1,412
34017030E02,2603,2131,1286,166,90,18,568,2,845
34017030E21,3110,2526,1390,172,107,16,828,3,1136
34017030E08,3130,2695,1364,182,118,9,1000,3,1331
34037025003,1158,969,884,36,7,17,15,0,85
34003030012,1602,1327,648,269,102,22,258,4,679
34003250006,1713,1444,635,576,108,11,155,2,809
34003250004,2024,1636,642,691,153,23,207,3,994
34003250002,2082,1682,528,752,177,29,251,1,1154
34003145004,1667,1291,356,272,69,13,604,0,935
34003165006,1485,1268,1106,36,17,10,93,0,162
34003165007,1928,1602,1398,94,21,9,74,2,204
34003190001,1967,1546,912,266,115,28,270,0,634
34003345004,2114,1772,1031,400,76,10,264,4,741
34003175002,1055,823,688,106,5,5,21,0,135
34017060204,1782,1398,90,1247,58,81,33,4,1308
34017030A34,1654,1310,704,101,80,12,390,1,606
34017030A09,906,700,46,204,413,7,33,2,654
34017035406,1586,1275,493,569,71,26,80,5,782
34017040602,2370,1929,276,1376,114,67,183,4,1653
34003335006,2024,1640,1029,180,239,17,188,5,611
34003075102,1409,1000,661,132,82,15,128,1,339
34003270004,1505,1249,814,269,64,13,108,2,435
34003285006,1732,1357,895,280,65,13,128,0,462
34003115104,1585,1284,264,666,330,34,55,0,1020
34003230007,1415,1093,673,117,15,6,285,0,420
34003115204,1376,1132,327,419,214,25,191,2,805
34003085006,1473,1174,892,106,54,3,116,3,282
34003035001,961,735,455,58,7,6,202,2,280
34017030A08,1285,947,103,264,426,25,142,7,844
34017030A10,1513,1144,85,353,458,25,217,4,1059
34017005318,1182,914,369,321,120,19,101,2,545
34017005211,1180,950,488,276,106,18,83,2,462
34017005307,1004,783,339,243,107,16,93,0,444
34037110004,1135,890,757,84,14,5,22,1,133
34009015001,305,292,280,6,3,0,2,2,12
34009060002,401,365,335,15,9,9,0,2,30
34009040302,415,348,294,41,4,7,5,0,54
34017005213,1518,1143,525,394,114,28,135,1,618
34029150010,1852,1395,1184,127,30,29,33,2,211
34029055006,1882,1509,1122,218,98,28,65,0,387
34029055018,2494,1643,1204,265,99,29,41,1,439
34029115006,944,725,665,26,12,4,7,0,60
34029115003,1056,919,827,42,21,15,16,0,92
34029115004,1310,1036,908,53,20,25,15,0,128
34029150013,1006,923,856,44,3,6,13,0,67
34029150002,1002,775,695,47,4,13,16,0,80
34029080004,2387,1828,1466,210,72,46,27,11,362
34029030043,1216,956,775,113,28,12,19,3,181
34003095014,1136,996,502,117,42,7,320,4,494
34003225004,2659,2140,241,802,60,113,1046,0,1899
34003125004,1551,1222,814,231,36,8,125,2,408
34003125003,1208,955,673,160,25,0,99,0,282
34003160015,1264,1064,722,251,19,8,59,0,342
34003020006,1496,1191,365,561,182,21,102,2,826
34003230017,1164,918,569,86,12,1,252,1,349
34029035005,834,652,550,76,9,12,7,1,102
34029035061,1416,1181,1058,65,10,9,27,0,123
34029020005,1627,1254,1076,104,37,15,18,1,178
34029055021,2258,1757,1331,149,151,22,98,2,426
34029055011,1757,1305,953,191,74,29,55,2,352
34029055001,2184,1661,1310,167,80,30,59,2,351
34029090033,1640,1244,857,170,115,32,74,0,387
34029060011,851,765,736,22,3,0,1,0,29
34007080010,937,746,626,38,48,10,32,0,120
34007040403,1376,1053,43,726,301,13,4,1,1010
34007005006,1415,1144,1009,59,25,22,22,0,135
34007040405,1889,1175,20,763,441,32,3,1,1155
34007043034,1339,1028,725,49,38,7,207,0,303
34007040201,1129,794,28,180,604,17,0,1,766
34007085001,1494,1079,942,51,17,9,40,0,137
34015080003,997,795,690,43,30,12,12,1,105
34007180302,1814,1303,155,125,994,26,40,2,1148
34015025006,1981,1535,1200,63,224,32,19,1,335
34015035004,822,646,571,17,33,15,4,0,75
34015055117,1751,1446,1089,169,113,41,24,4,357
34007140004,2011,1563,496,185,795,26,68,3,1067
34007140006,1387,1089,373,115,586,16,27,0,716
34007160006,1125,866,749,44,37,10,27,2,117
34007160001,813,634,519,31,43,17,37,1,115
34007043045,2497,1982,1271,95,187,15,413,4,711
34007043007,1399,1066,679,57,101,2,221,0,387
34007055009,1893,1493,944,253,220,38,66,0,549
34031010206,1352,1084,540,418,78,9,67,1,544
34031040410,3413,2401,85,1876,472,107,34,8,2316
34031040306,2195,1667,57,1368,282,150,14,2,1610
34015110303,1104,827,501,94,221,9,14,0,326
34015115002,808,617,561,19,24,5,8,1,56
34007075021,1014,828,732,44,16,12,29,1,96
34007035001,1815,1426,1145,127,90,25,62,2,281
34007040410,2107,1950,680,373,794,40,139,5,1270
34041115005,930,783,705,36,23,9,9,0,78
34027155002,1365,1078,848,128,26,11,52,0,230
34015090028,1108,904,791,29,26,10,48,1,113
34031045006,1499,1206,911,169,14,22,100,0,295
34041115004,697,574,504,44,12,5,4,0,70
34015090026,1773,1319,861,98,249,17,90,1,458
34015075002,1093,908,859,17,12,11,7,1,49
34041035001,1186,948,779,69,44,19,34,0,169
34031010306,1505,1187,362,683,110,16,79,2,825
34031040208,1368,1087,223,587,197,21,109,0,864
34041020005,1122,926,836,42,16,10,15,2,90
34031055001,1322,1041,911,76,15,12,18,2,130
34031055006,1160,910,807,47,8,10,23,0,103
34011070201,1209,864,144,497,219,40,32,4,720
34027010001,1162,943,764,71,33,3,71,1,179
34033070001,1381,1134,979,76,46,28,9,1,155
34015090003,1027,857,789,32,22,3,14,1,68
34015090038,1601,1340,1152,59,75,7,52,0,188
34027045403,1330,984,149,791,35,32,23,2,835
34027010003,831,671,550,50,11,4,52,0,121
34015085001,1256,929,687,111,95,19,26,2,242
34015060002,831,638,522,40,30,27,15,0,116
34015055302,1897,1423,833,76,420,21,73,1,590
34015055312,1115,820,603,34,160,11,18,1,217
34027050002,1202,992,713,74,20,1,183,1,279
34031060004,1839,1483,1006,189,77,7,216,1,477
34031010119,1345,1097,663,218,40,6,179,0,434
34031035404,4038,2858,56,2665,263,222,16,5,2802
34031010115,2106,1826,909,371,204,16,378,2,917
34031040404,2105,1579,87,770,789,12,4,7,1492
34031040401,2401,1770,28,1092,725,43,17,2,1742
34023075001,1563,1226,351,556,136,23,184,2,875
34023065301,1079,863,690,81,22,18,48,0,173
34023077203,1563,1255,837,109,68,6,231,0,418
34023090011,815,650,184,42,89,4,337,1,466
34023090002,3542,2855,889,272,346,12,1348,0,1966
34023090007,1130,982,684,30,112,3,144,5,298
34023090013,1335,1069,562,28,28,1,444,1,507
34025140009,2454,1889,1013,101,76,8,676,1,876
34025145004,1989,1615,1180,165,104,13,144,1,435
34023025075,2839,2071,220,101,221,18,1531,3,1851
34031010120,905,759,540,73,9,4,126,0,219
34031040604,1971,1501,54,1351,155,21,11,5,1447
34031040506,1676,1204,28,799,429,15,16,8,1176
34031020202,1092,901,651,184,29,21,45,0,250
34031070405,1397,1102,848,100,3,1,138,2,254
34023095018,1071,838,629,123,51,2,40,0,209
34011025004,894,717,43,72,564,51,0,0,674
34027140001,1408,1126,806,225,36,14,38,1,320
34027145029,997,765,414,74,42,10,226,4,351
34015100014,1527,1324,882,94,290,14,52,2,442
34023100302,2161,1836,1230,263,139,17,192,5,606
34023125208,1658,1291,510,267,246,19,258,4,781
34035065006,842,642,419,15,14,0,192,2,223
34035040441,1533,1139,100,367,626,14,67,1,1039
34035040442,1155,922,165,165,509,28,93,4,757
34021010021,1523,1309,863,72,200,13,155,0,446
34023110015,2838,2281,607,253,334,19,1093,6,1674
34023075015,991,793,134,256,316,17,106,0,659
34023075018,796,626,318,103,101,13,103,1,308
34023070402,2133,1505,60,734,714,30,32,3,1445
34023005004,1367,1006,74,391,428,23,128,3,932
34023125515,964,763,247,36,27,4,448,3,516
34023065113,941,935,806,39,39,0,50,0,129
34023025032,821,655,152,16,12,5,472,1,503
34023025069,877,693,183,20,33,12,459,2,510
34023050003,1072,818,631,52,24,4,105,0,187
34023125505,1290,1014,657,104,42,6,210,0,357
34025160003,1735,1353,1045,76,78,8,142,0,308
34011050201,1494,1073,399,238,443,34,6,3,674
34025125016,1577,1320,758,223,227,23,26,3,562
34025165001,1578,1323,1223,45,13,5,24,0,100
34027165002,1755,1458,1157,150,57,21,67,0,301
34027165003,1449,1277,1078,64,15,7,117,2,199
34025155027,2037,1601,1318,130,68,17,56,0,283
34025170006,878,717,485,71,123,11,21,0,232
34027090001,867,658,590,27,7,3,27,0,68
34027095001,1285,995,834,40,14,6,83,1,161
34027082002,1236,946,800,57,16,5,62,1,146
34001070202,1085,821,715,51,12,3,37,0,106
34027120104,1765,1622,1129,243,74,37,167,2,493
34027120103,955,873,667,90,36,8,61,1,206
34027120402,1125,951,726,99,47,38,53,0,225
34027120403,1102,951,707,110,44,7,66,0,244
34027040201,1247,1001,833,58,18,12,79,0,168
34027105002,2390,1825,829,194,111,13,674,0,996
34027060002,1350,1029,814,46,16,7,135,1,215
34027155008,1119,844,787,22,2,1,26,0,57
34027050001,1825,1455,1093,106,46,2,203,2,362
34027110002,1033,913,657,126,45,10,69,0,256
34027145002,1573,1238,541,61,85,13,546,6,697
34021025001,919,718,603,39,30,8,30,4,115
34027005102,1262,1027,848,63,16,17,84,0,179
34027095004,1013,738,603,47,15,3,55,0,135
34035015007,1043,765,614,83,7,10,47,1,151
34023075027,2914,2240,403,324,842,15,681,10,1837
34023005009,1288,1021,243,259,151,8,371,1,778
34023075020,2793,2230,562,229,367,23,1079,8,1668
34023020016,1266,1001,592,93,60,13,258,4,409
34023020021,957,753,492,50,31,9,170,1,261
34023065310,1370,1356,1228,28,17,2,85,3,128
34023065311,770,724,647,16,4,3,53,2,77
34023025024,799,676,269,100,57,4,258,0,407
34023060002,1053,809,650,79,45,6,28,0,159
34023105018,1445,1121,312,52,90,4,667,0,809
34023025068,1618,1235,418,31,28,1,743,1,817
34023025037,1281,1046,524,212,97,10,209,1,522
34023110003,944,751,424,144,113,19,64,0,327
34023105028,1959,1519,377,58,82,15,1005,0,1142
34001065001,2168,1724,1429,242,28,33,9,1,295
34001085301,2159,1707,1475,124,58,17,27,2,232
34039020606,2099,1575,65,1266,249,20,14,5,1510
34039095033,991,801,381,154,136,3,111,2,420
34039020404,2578,2016,149,1566,320,65,46,3,1867
34023025038,1303,1069,383,206,202,18,264,0,686
34023105020,1305,1002,456,77,126,3,349,2,546
34001010501,2949,2154,335,1028,260,40,545,10,1819
34023065112,1853,1399,455,28,40,2,872,0,944
34023020020,1510,1135,680,79,35,3,339,2,455
34021050018,761,611,504,29,11,8,63,1,107
34033004002,998,747,344,167,224,29,5,0,403
34033050001,1303,1065,920,58,36,37,6,0,145
34011070401,2365,1794,761,708,315,41,29,3,1033
34011050501,2058,1654,1205,167,228,43,29,0,449
34027045402,1226,973,139,767,71,23,23,3,834
34023020033,2153,1770,802,176,193,3,599,0,968
34023020019,754,604,292,65,47,1,198,0,312
34001005203,1021,802,681,36,56,14,16,0,121
34001070201,1408,1104,953,48,20,8,71,0,151
34015090020,1091,871,779,33,23,6,27,1,92
34025210004,1047,694,643,22,5,8,9,0,51
34025155023,1254,981,876,67,7,9,18,1,105
34025255001,1460,1102,944,79,14,11,35,0,158
34025085001,1479,1364,1222,77,24,18,18,1,142
34025040003,992,850,661,156,6,15,9,0,189
34025145005,1410,1171,866,113,85,8,82,0,305
34025155003,1591,1251,1028,127,29,20,51,1,223
3403360W001,1144,820,291,86,468,11,6,2,529
34033007001,1092,827,597,120,69,23,19,0,230
34015090030,1522,1146,995,52,52,7,43,0,151
34021040001,1142,894,817,13,17,8,30,0,77
34021015061,1242,1144,1014,48,56,3,30,1,130
34035050021,1651,1281,646,176,131,26,321,3,635
34025015008,1377,1188,670,249,203,23,41,6,518
34035000005,1113,864,410,46,23,8,373,0,454
34035045004,1350,1065,557,91,101,3,309,0,508
34021050014,1140,914,394,140,194,10,190,0,520
34021065012,1341,1114,423,20,12,7,651,0,691
34021010007,1025,828,455,115,206,13,58,4,373
34021015007,4408,3247,457,940,1783,50,98,9,2790
34021005010,1729,1291,385,636,116,13,152,7,906
34021005011,2011,1562,634,481,265,27,196,3,928
34021015005,2733,1964,514,945,500,41,33,2,1450
34035055001,1431,1166,794,275,30,17,43,2,372
34035050006,903,686,510,96,34,13,50,0,176
34035100007,1529,1217,951,88,15,8,145,7,266
34035015001,1093,810,704,58,6,12,34,0,106
34035015006,985,759,679,24,7,4,43,0,80
34021055N10,973,686,11,70,618,6,3,3,675
34021055W06,856,630,17,83,540,9,5,2,613
34021015013,2588,1941,297,608,970,41,72,10,1644
34035020001,2875,2221,640,1202,281,78,103,4,1581
34001055010,2497,1762,492,364,754,33,176,9,1270
34001010101,1649,1464,374,209,778,19,118,5,1090
34001010103,1606,1220,312,231,563,51,126,9,908
34029030036,762,693,636,35,8,7,9,0,57
34029005001,640,596,563,21,4,7,1,2,33
34029025000,0,0,0,0,0,0,0,0,0
34029025116,1327,1035,912,76,21,11,9,2,123
34029060013,1181,1019,958,20,11,18,2,1,61
34035055006,1167,949,706,190,13,11,25,0,243
34035040438,1238,965,278,210,383,33,94,0,687
34021035019,2413,1964,743,93,266,16,863,0,1221
34021055S01,3004,2092,165,1608,347,63,12,3,1927
34021020002,1090,868,497,229,66,27,66,2,371
34021015030,1065,850,745,35,27,10,36,1,105
34035050013,1481,1202,688,140,117,6,246,0,514
34035050014,1500,1153,659,127,144,5,215,0,494
34035050009,1999,1412,674,79,34,3,616,2,738
34035050027,1899,1336,719,30,43,4,529,3,617
34009055003,851,717,663,14,11,8,16,2,54
34029055014,1226,1039,888,86,32,17,11,0,151
34021065009,1627,1245,445,65,47,3,684,1,800
34035065011,1267,957,543,31,20,9,356,2,414
34035050028,1356,1070,622,58,53,6,320,0,448
34021060005,1514,1051,496,47,54,9,448,0,555
34021035020,976,880,665,54,60,3,103,1,215
34021035015,1425,1124,850,67,65,9,119,0,274
34021005013,2341,1851,526,582,224,18,508,2,1325
34035040443,1696,1229,94,622,500,32,57,2,1135
34035025012,933,815,587,63,47,11,114,0,228
34025045001,2055,1576,1399,66,71,10,13,5,177
34025080017,1497,1175,919,82,31,5,132,0,256
34025035005,841,784,735,24,6,4,11,1,49
34039065502,1503,1165,324,427,371,25,61,1,841
34039100302,903,625,520,46,24,11,31,1,105
34039015026,832,681,588,49,16,4,24,0,93
34039055002,1394,1037,829,98,7,5,98,1,208
34039045401,1426,1077,58,201,784,13,21,5,1019
34039045102,1402,1066,422,281,316,21,59,2,644
34025080010,1678,1277,1014,86,36,6,123,0,263
34025220002,922,773,741,18,5,4,2,1,32
34025140018,1970,1420,888,107,53,13,368,1,532
34039020306,2115,1634,384,984,198,46,83,7,1250
34019105006,954,753,584,30,38,4,98,3,169
34013030301,1187,929,10,78,830,20,19,0,919
34013070W40,1984,1652,22,78,1572,12,6,3,1630
34013075002,1836,1394,1144,81,27,4,138,0,250
34013055019,844,581,444,13,70,6,36,3,137
34013055001,1157,849,640,67,72,19,49,0,209
34013110202,1650,1321,653,121,397,28,161,3,668
34013110205,929,840,599,26,115,7,95,0,241
34013110416,913,723,291,91,253,7,72,1,432
34013030101,1191,909,24,109,790,8,12,3,885
34013065201,1102,819,596,56,91,6,65,3,223
34013065209,1244,893,666,73,71,12,68,0,227
34013065105,1162,789,634,57,47,6,50,0,155
34039055003,1076,771,576,56,5,4,126,1,195
34025130003,1555,1195,1062,77,20,11,27,1,133
34039010103,1024,874,666,112,41,3,39,0,208
34039020107,2061,1482,139,1106,272,77,8,4,1343
34039020104,2612,1813,162,1100,580,61,17,2,1651
34039015015,1081,846,607,100,85,14,41,0,239
34039100307,1279,917,671,50,32,3,142,0,246
34039025006,1165,867,660,73,22,9,98,2,207
34039080012,1068,773,580,62,32,8,92,1,193
34031040402,3755,2644,27,1270,1434,63,19,6,2617
34031045005,2106,1630,1204,313,44,24,68,0,426
34005125006,1693,1406,1121,64,133,25,69,2,285
34005100018,554,442,372,23,21,14,15,1,70
34025090001,1776,1454,1135,79,28,13,180,2,319
34025165002,1596,1366,1261,50,16,6,24,0,105
34029070026,2537,1153,1058,41,21,5,1,1,95
34029070042,3339,1523,1364,90,16,5,13,3,159
34027085011,1210,994,700,174,38,6,69,3,294
34019075002,1152,951,890,21,10,14,14,0,61
34039002028,2105,1539,273,1015,196,49,64,4,1266
34005055001,1204,960,742,90,93,22,19,3,218
34029090036,848,797,716,27,23,2,18,1,81
34029123001,711,570,505,46,7,8,7,0,65
34039095020,884,707,309,170,153,10,64,1,398
34039060308,938,693,38,204,442,13,16,1,655
34025160007,1369,1061,815,97,59,6,60,1,246
34037110010,1136,895,791,65,13,12,10,0,104
34039075302,1488,1164,594,369,105,12,105,1,570
34039075401,1247,971,388,395,85,16,99,2,583
34039040003,1397,1096,749,225,21,17,70,0,347
34039095003,1369,1062,415,215,286,14,125,2,647
34039045103,1120,887,382,340,150,13,44,1,505
34041060003,1313,1024,860,71,44,18,24,1,164
34041100002,790,654,577,37,6,10,5,1,77
34019075001,1135,944,875,28,15,16,13,1,69
34025055007,1948,1591,1181,162,84,12,125,0,410
34025095015,1751,1346,1145,113,35,5,38,0,201
34029025233,736,614,535,46,13,6,20,0,79
34029102001,2632,2166,1973,94,27,37,22,0,193
34039095050,922,746,223,145,263,10,109,0,523
34039005002,1393,1145,836,121,32,8,149,0,309
34005115016,1102,883,790,28,37,11,22,2,93
34005125020,3201,2547,1618,186,449,35,289,0,929
34005192003,1105,861,139,108,587,16,20,2,722
34005125004,1185,997,856,42,33,26,31,0,141
34039060211,1397,1088,97,328,640,26,24,5,991
34009055015,903,698,651,18,8,12,9,1,47
34009055005,968,777,738,20,5,4,9,2,39
34009045003,569,515,490,12,2,1,6,0,25
34013055007,1273,870,706,72,41,6,40,1,164
34013045W08,2663,2152,63,235,1814,24,53,2,2089
34013030104,930,738,30,145,556,12,21,1,708
34013070S02,1399,930,11,66,868,1,2,2,919
34013005106,1648,1346,393,502,206,41,263,6,953
34013005105,1571,1227,217,679,242,15,105,1,1010
34019040001,840,652,585,26,4,4,22,0,67
34019030006,983,759,669,35,7,11,30,0,90
34019120005,1340,1092,965,51,17,1,58,1,127
34025145006,1281,994,812,91,49,20,33,1,182
34025125009,2080,1570,505,671,120,38,44,1,1065
34025210006,1179,807,740,26,2,2,23,0,67
34013080101,1984,1608,1095,250,51,17,209,2,513
34029030027,1243,978,793,90,56,12,27,3,185
34029102004,1326,1105,1004,46,15,10,20,1,101
34029030056,935,734,628,66,15,10,24,1,106
34029030017,852,705,617,49,18,3,15,0,88
34025075007,1503,1192,536,451,114,24,85,5,656
34025265004,2789,2496,1872,279,218,23,69,2,624
34025095013,1651,1228,1022,88,40,9,54,0,206
34005040018,1009,831,723,25,50,7,17,0,108
34037060009,877,734,556,116,25,23,19,0,178
34005010003,735,578,322,49,190,14,15,0,256
34013105005,1209,935,773,61,14,6,72,3,162
34013070N03,2671,1912,79,1573,258,60,30,5,1833
34013010102,2354,1911,970,469,323,30,162,4,941
34037095003,931,796,656,78,18,5,27,1,140
34037095001,1185,952,742,125,30,24,34,2,210
34037090013,1621,1181,1044,65,22,11,39,0,137
34037075006,999,805,615,79,45,25,45,3,190
34037070003,1681,1383,1121,175,35,14,28,0,262
34009055011,137,128,123,2,1,0,2,0,5
34009025208,905,749,690,35,14,9,1,0,59
34009005003,328,314,307,2,1,0,5,0,7
34009025205,640,484,436,22,9,13,5,1,48
34003065003,2691,2107,1076,319,152,25,551,2,1031
34003150004,1810,1507,631,394,122,21,401,1,876
34003345002,1087,871,645,135,17,4,60,0,226
34003150005,2859,2397,570,557,183,44,1099,4,1827
34003160013,1700,1383,846,392,46,8,91,0,537
34003350001,1889,1437,1187,85,13,11,136,0,250
34013100010,1889,1431,1059,140,96,19,140,3,372
34013045S05,1112,833,5,114,730,5,4,0,828
34013100007,1139,861,736,57,12,4,48,0,125
34013070S35,987,736,1,52,690,20,5,2,735
34013065109,2352,2035,667,280,1033,19,90,0,1368
34013070S39,1199,964,14,66,882,11,4,1,950
34023080404,1341,1043,58,933,92,28,17,1,985
34023080607,1524,1173,100,1017,90,38,22,0,1073
34003200002,1565,1305,667,217,31,6,378,0,638
34003285005,1656,1371,918,200,57,7,193,0,453
34003285007,926,750,622,82,8,6,40,0,128
34003050006,1778,1395,805,223,56,13,316,0,590
34003350004,2193,1729,1305,330,23,2,73,6,424
34029030001,1086,959,866,33,13,11,29,1,93
34029025438,532,529,496,19,5,6,5,0,33
34029035037,1520,1185,644,203,215,42,98,1,541
34029030020,1260,995,746,176,22,18,34,0,249
34029035016,1856,1453,1176,152,40,30,48,1,277
34029120013,911,710,650,43,3,7,6,1,60
34029025410,847,844,773,28,23,4,14,0,71
34023085201,1871,1546,322,205,238,22,789,1,1224
34023080405,2268,1669,100,1331,276,34,53,5,1569
34023115003,869,695,433,166,25,12,38,1,262
34023005006,1584,1157,194,578,135,26,277,3,963
34037040004,496,384,329,31,10,1,5,0,55
34017030F14,929,697,42,246,429,29,31,7,655
34017005304,1001,778,414,208,99,15,64,1,364
34025115002,802,566,515,21,0,2,12,0,51
34025115004,1004,800,723,25,12,7,27,0,77
34025055008,841,705,404,94,54,10,131,1,301
34005040005,1059,807,677,29,27,8,55,1,130
34005100012,545,449,388,31,10,10,10,0,61
34007135006,1581,1310,796,235,208,19,83,4,514
34005100016,1698,1450,705,114,233,29,398,1,745
34005065002,1143,889,768,36,36,12,34,4,121
34013060011,1254,815,577,23,21,4,181,1,238
34013065308,1473,1188,701,159,226,26,90,3,487
34013005206,1189,978,424,277,60,41,207,1,554
34013060013,1649,1108,698,34,13,5,352,2,410
34013060003,1610,1086,539,32,19,0,487,0,547
34013065210,1394,1093,653,92,258,8,83,2,440
34013070N29,2147,1588,141,1145,307,53,43,4,1447
34013050015,1161,876,480,55,20,6,302,0,396
34013070C28,1588,1104,13,115,975,22,4,0,1091
34013025003,1492,1175,823,238,70,10,72,7,352
34019100001,1232,996,901,55,15,23,7,0,95
34013005208,1616,1344,500,381,133,16,346,3,844
34013070W29,1398,1007,2,67,945,4,8,1,1005
34013070S10,2171,1458,20,168,1273,21,10,0,1438
34013055012,1100,846,243,89,493,15,24,12,603
34037110002,939,740,635,68,20,1,5,1,105
34037105001,2024,1637,1315,212,53,45,35,1,322
34003315005,1204,896,721,42,15,1,112,0,175
34003320005,1560,1130,866,134,15,4,106,1,264
34003030013,1138,941,459,258,21,16,197,6,482
34003300002,2236,1859,543,651,403,35,310,2,1316
34003115405,1236,1022,392,324,210,12,116,0,630
34017050302,1791,1373,139,1157,103,95,39,3,1234
34017060206,1982,1491,114,1323,58,70,43,2,1377
34037020003,1296,1045,913,74,16,8,25,1,132
34037090014,1090,896,773,52,16,17,28,0,123
34017050502,2523,1918,119,1643,129,123,88,1,1799
34017025403,1259,924,149,535,276,13,21,0,775
34017025404,1318,973,314,417,238,12,55,1,659
34017030B30,1128,877,87,199,198,18,410,6,790
34005065003,1583,1281,944,65,86,8,174,1,337
34013070S04,2818,1902,43,190,1708,25,13,6,1859
34005175002,1144,928,806,42,35,15,24,2,122
34005030016,1258,952,590,58,189,21,100,0,362
34005125017,670,635,562,10,22,6,34,0,73
34005020006,1580,1301,815,121,168,24,200,0,486
34013090105,918,773,629,41,19,3,83,0,144
34013090104,1121,875,746,56,14,3,45,1,129
34013050023,844,618,270,22,34,1,291,1,348
34005040014,540,412,382,6,4,4,9,0,30
34005065007,1977,1483,1191,39,52,8,181,0,292
34017035205,1467,1161,340,621,73,17,51,5,821
34017060304,1474,1151,135,895,78,13,69,1,1016
34017045301,583,502,296,120,9,2,79,0,206
34017030F19,1831,1341,50,355,887,17,78,9,1291
34017035308,1022,845,464,251,22,9,82,2,381
34017035106,1177,922,334,464,57,27,35,4,588
34017030D24,1190,883,230,225,55,17,380,2,653
34017030D23,1567,1256,249,211,94,16,685,2,1007
34017050601,2406,1877,169,1527,173,55,86,15,1708
34017030C20,1627,1388,324,265,114,14,681,2,1064
34017030C09,2003,1696,405,309,257,16,697,9,1291
34017030C07,1733,1591,354,199,110,43,926,6,1237
34017040605,1931,1558,142,1214,112,40,142,2,1416
34017040701,2437,2070,404,1491,159,29,107,11,1666
34017030D10,1489,1174,371,556,76,27,170,8,803
34007050003,2116,1642,796,280,510,33,60,3,846
34007135015,1791,1355,182,602,397,18,218,2,1173
34007170005,2279,1782,792,121,292,29,564,0,990
34007135008,1393,1110,383,275,215,20,262,5,727
34007080006,950,730,598,52,41,5,38,0,132
34007020004,1281,1081,1015,28,6,19,7,2,66
34007135023,1066,858,406,177,191,7,81,2,452
34007135003,1299,1089,611,204,192,14,100,1,478
34015055214,1404,1102,764,101,196,22,26,3,338
34007185001,1640,1174,177,482,463,34,75,4,997
34007185002,1262,920,136,373,271,29,151,3,784
34007075008,1562,1257,692,55,446,35,45,0,565
34007075026,1218,994,816,40,93,8,36,0,178
34007075035,2341,1824,933,156,529,26,202,0,891
34007135011,1444,1150,630,231,194,27,103,3,520
34007135007,2056,1574,351,646,374,28,258,2,1223
34015010017,1209,962,496,213,241,39,12,0,466
34041075006,1604,1409,1030,80,181,9,105,0,379
34041075004,1154,861,597,91,101,7,61,4,264
34015010012,1492,1202,1082,39,27,19,19,1,120
34031040313,1791,1410,81,523,820,27,19,10,1329
34031040501,1208,922,5,597,357,11,3,11,917
34031075007,2706,2335,2097,110,34,18,53,4,238
34041115003,934,776,683,54,23,4,10,0,93
34031070606,1230,969,855,51,15,2,53,0,114
34031010116,974,786,470,133,10,7,175,0,316
34007043041,1604,1264,772,146,138,18,192,2,492
34007135002,2457,1831,151,785,799,33,165,9,1680
34007150006,1412,1114,1012,42,10,17,29,0,102
34007105002,1601,1275,66,137,1046,32,37,3,1209
34007150004,1297,1019,828,80,53,12,47,0,191
34007043037,1266,967,681,33,65,2,180,1,286
34031035207,2829,1886,21,1659,278,110,9,8,1865
34031035405,2137,1482,32,1312,192,90,6,2,1450
34031035406,2105,1516,36,1325,202,90,12,0,1480
34007135021,1059,842,251,263,175,11,162,8,591
34007040205,1316,891,20,338,561,12,2,0,871
34007140001,1544,1185,561,94,470,32,59,1,624
34031070406,2043,1719,1310,160,66,3,174,2,409
34031070306,1136,871,699,76,20,8,72,0,172
34041095401,1787,1353,898,214,209,43,23,3,455
34041105003,1889,1459,1033,194,126,25,83,0,426
34015055209,1186,1131,1011,34,57,13,13,0,120
34015005005,1253,922,416,86,396,20,12,2,506
34015055408,1075,859,606,49,165,23,19,4,253
34013030406,1275,908,4,191,744,9,7,0,904
34013010305,1892,1426,249,540,547,24,108,2,1177
34013010301,2139,1898,812,341,514,27,249,0,1086
34013070S41,1242,934,7,62,872,7,5,0,927
34013045W03,1919,1414,31,548,817,30,33,3,1383
34013010307,1115,895,356,225,259,17,59,7,539
34027080202,937,805,602,106,34,11,59,1,203
34027135005,1394,1074,825,86,48,19,107,1,249
34027125003,886,577,485,13,3,3,64,0,92
34027025002,1180,815,682,37,8,1,84,1,133
34023125114,1063,844,362,143,197,10,143,0,482
34023125109,1231,991,502,265,117,15,113,3,489
34023050013,820,659,411,71,45,12,121,1,248
34023025061,1251,939,316,144,93,23,409,1,623
34023125405,1590,1236,270,101,54,7,806,0,966
34023025040,1106,851,210,39,18,9,583,0,641
34005065010,726,577,528,16,15,7,12,0,49
34001095204,2799,2102,239,1017,863,34,45,6,1863
34001095103,2319,1798,222,806,767,40,60,4,1576
34001065005,2142,1703,1350,280,24,37,24,1,353
34041040007,1361,1019,640,324,14,13,25,1,379
34027105012,1080,830,625,69,18,5,110,0,205
34027105004,989,756,664,25,7,9,46,0,92
34031040302,2325,1778,44,867,936,28,10,1,1734
34031035305,1954,1492,278,926,178,53,143,0,1214
34031035309,1813,1070,823,168,44,16,19,1,247
34031035301,1365,999,174,627,111,17,131,2,825
34031030004,1128,957,769,104,22,3,57,0,188
34031030005,1598,1357,892,222,189,17,48,0,465
34031040311,1592,1391,358,424,615,12,26,0,1033
34031040508,4311,3253,356,2286,609,82,87,6,2897
34041015001,816,639,560,31,12,12,11,0,79
34031040312,2310,1785,105,849,891,32,30,2,1680
34027175504,1182,950,745,111,35,5,60,0,205
34001040011,2644,2029,881,305,240,16,607,1,1148
34001105102,1647,1376,1025,146,168,23,15,3,351
34001015401,1936,1696,1229,164,80,20,217,0,467
34023125213,2080,1741,548,347,304,18,547,1,1193
34023070202,2197,1487,152,1142,151,49,63,0,1335
34027160007,2289,1824,912,681,90,21,156,4,912
34027160008,1582,1292,532,281,56,7,418,3,760
34001040022,1502,1137,832,80,90,17,111,1,305
34001055007,3326,3115,2161,407,406,48,162,12,954
34011050402,1826,1278,633,263,362,50,26,7,645
34023077109,703,551,422,45,21,4,53,2,129
34023077110,690,517,318,58,28,7,114,0,199
34013010310,1412,1116,146,644,271,35,73,3,970
34033004003,1915,1216,176,473,578,27,6,1,1040
34001090201,826,639,527,37,18,3,32,2,112
34023025042,2497,1856,255,130,209,12,1237,4,1601
34023020017,1015,798,544,59,46,3,141,1,254
34035040101,886,718,471,129,61,17,56,5,247
34023055001,1695,1247,465,584,117,6,86,2,782
34023125301,972,768,392,191,83,16,99,2,376
34023015005,1672,1240,607,419,101,15,99,3,633
34023015002,1727,1339,531,517,203,38,80,1,808
34023065105,669,666,506,32,58,4,65,2,160
34023065104,1090,1079,843,74,68,5,83,0,236
34023065102,753,749,597,44,39,7,70,0,152
34023065103,494,490,390,24,40,3,32,0,100
34023095033,3962,2884,585,626,1098,27,519,4,2299
34023077506,1322,1035,742,144,45,10,99,0,293
34007115003,1136,891,675,56,139,15,14,4,216
34023095009,720,586,415,93,42,9,34,0,171
34023077202,1970,1568,852,127,80,7,484,1,716
34023090003,2061,1570,366,93,96,6,1012,1,1204
34023085306,2430,2386,554,224,186,6,1354,3,1832
34023080606,1737,1291,76,1150,165,58,12,7,1215
34023115006,1028,811,522,164,44,13,47,1,289
34007075038,1342,1027,481,78,358,10,119,2,546
34007005003,1229,1041,956,40,16,16,7,1,85
34007125001,1102,896,764,59,40,12,20,0,132
34007075022,1448,1224,1015,111,61,20,36,3,209
34007043032,375,360,260,27,42,1,30,1,100
34007005004,880,699,653,14,6,10,15,1,46
34001090203,1389,1030,876,51,19,5,79,0,154
34001040013,788,635,248,129,85,9,176,2,387
34001065003,2335,1908,1553,248,74,21,19,6,355
34021050009,2063,1568,673,457,262,35,171,1,895
34035030015,1287,1024,729,114,52,11,114,1,295
34035030026,1149,878,609,47,34,5,173,1,269
34021055W11,1920,1282,31,121,1148,26,3,0,1251
34021055W02,929,699,14,75,615,10,1,1,685
34021035018,1711,1418,961,86,139,11,212,3,457
34035025002,1102,868,662,46,31,11,117,0,206
34035025011,1061,843,646,60,30,3,107,0,197
34021010014,669,560,419,45,86,5,18,0,141
34021050016,881,637,455,21,8,2,154,0,182
34025160005,1530,1215,978,87,53,9,76,0,237
34025185009,1081,822,685,58,31,6,21,0,137
34025090006,1623,1195,830,62,21,4,276,1,365
34035010023,1167,856,377,18,13,2,436,0,479
34021035004,1324,1140,792,41,90,2,204,0,348
34021050003,1119,876,493,31,33,2,307,0,383
34021010017,1251,1058,470,147,408,15,47,3,588
34035025014,740,586,451,44,22,7,62,0,135
34025247010,1278,1116,823,74,141,16,61,1,293
34025247011,961,956,880,26,27,1,18,0,76
34025040001,1547,1344,1005,238,76,22,25,0,339
34025040002,909,804,641,112,21,26,17,0,163
34025185019,1249,1010,834,55,16,7,84,0,176
34025155006,796,637,556,48,18,8,18,0,81
34025155010,1334,1036,932,59,14,1,13,1,104
34025155041,679,658,620,24,2,0,10,0,38
34025155043,1407,1134,1049,47,8,3,23,0,85
34025260008,1070,867,801,33,8,1,20,0,66
34025155002,1388,1098,1011,32,14,7,26,0,87
34025082013,1198,913,724,104,30,14,58,3,189
34025015006,1275,1209,895,127,148,11,23,2,314
34025185007,982,790,646,75,22,5,26,1,144
34025185008,1238,989,779,98,35,11,54,4,210
34021010016,739,613,474,43,55,3,31,1,139
34021015035,1441,1210,932,98,56,7,123,2,278
34021015024,1049,827,535,202,82,12,18,0,292
34021065014,1446,1078,343,43,40,10,633,2,735
34035030023,1110,880,623,40,12,5,204,0,257
34025125005,2011,1738,1037,328,84,39,60,2,701
34039095023,1331,1055,522,233,166,11,117,0,533
34039070503,1287,1124,261,254,559,17,60,2,863
34039070402,1405,1151,155,398,559,32,60,2,996
34037040002,1168,893,766,68,20,12,29,0,127
34019110007,1026,799,664,49,23,4,56,0,135
34019030012,922,780,612,34,20,1,101,0,168
34019110012,773,603,560,19,3,2,16,0,43
34039090201,933,753,444,196,34,7,78,1,309
34039090102,908,681,459,89,60,9,74,1,222
34039090110,1103,825,457,213,37,8,117,0,368
34039090112,1050,748,562,36,9,3,128,0,186
34039060107,1655,1217,40,609,577,66,14,8,1177
34039035301,1557,1234,31,172,1022,17,20,1,1203
34039060402,3376,2368,102,1435,778,104,53,2,2266
34039100205,1671,1097,948,39,13,4,73,0,149
34039045201,1584,1283,637,392,202,22,49,1,646
34039065504,1026,835,381,204,227,35,41,2,454
34039009541,1226,939,29,128,767,14,29,2,910
34039095038,1182,924,138,126,600,7,43,3,786
34039020310,2143,1616,162,1200,228,48,65,3,1454
34039010304,1094,877,708,120,5,8,40,2,169
34039070502,1388,1132,221,334,538,17,60,3,911
34005020005,821,667,561,49,31,13,28,1,106
34005125016,1938,1577,1305,48,81,22,115,0,272
34005170006,1507,1487,1381,28,52,6,18,5,106
34005090008,2049,1512,433,194,736,54,166,4,1079
34039085008,935,685,503,84,41,5,51,1,182
34039100202,1394,971,834,39,15,7,70,0,137
34039100206,1071,759,664,49,18,1,21,1,95
34039046002,645,501,283,136,72,9,20,1,218
34029090025,795,786,720,28,17,13,14,2,66
34029055005,921,852,747,65,30,8,10,2,105
34005050203,1126,866,738,30,36,16,32,6,128
34005192025,721,572,42,34,483,8,25,3,530
34003115402,1366,1188,410,260,384,19,150,2,778
34003230010,1074,836,549,65,17,0,199,0,287
34003015003,1781,1462,370,459,159,23,490,5,1092
34003145006,1435,1117,372,194,38,9,519,1,745
34003095019,2260,1973,1006,206,39,2,719,2,967
34003255001,1327,813,664,36,7,8,94,0,149
34039005003,1103,826,632,90,21,4,90,0,194
34003320004,1441,1151,1004,58,12,4,74,0,147
34003305005,1115,774,507,42,10,7,207,0,267
34003015009,1988,1579,173,815,297,28,320,1,1406
34003010001,1762,1403,782,89,50,6,486,0,621
34005060008,959,815,577,57,152,12,18,1,238
34005045006,791,738,488,31,196,12,22,1,250
34005045004,825,650,515,21,75,15,18,1,135
34005155008,1124,891,664,65,83,16,24,0,227
34005065020,2172,1643,1392,38,70,23,106,6,251
34005055004,1172,942,621,113,154,21,43,4,321
34005125008,1153,886,726,47,51,11,54,2,160
34005090004,819,658,526,46,64,10,17,0,132
34005175003,521,433,399,11,8,7,5,1,34
34005200002,720,532,250,84,151,24,45,1,282
34005030004,1946,1517,310,136,808,34,247,2,1207
34003160011,1214,1027,638,242,18,18,121,0,389
34003160012,1033,834,610,153,20,2,47,0,224
34003110002,1635,1182,901,88,76,4,112,0,281
34003305001,1349,956,525,64,29,8,334,5,431
34005105001,1487,1109,886,95,79,29,41,2,223
34013065302,1468,1235,817,80,235,22,92,3,418
34013065207,937,757,345,117,272,20,25,0,412
34013015006,1277,1101,819,141,35,6,96,1,282
34013010109,1304,1120,534,294,221,12,90,1,586
34013070N04,913,679,15,237,456,15,6,9,664
34013045S10,1598,1188,21,154,1035,10,4,0,1167
34013050020,1194,900,514,29,29,0,323,0,386
34013045S01,1892,1499,44,228,1226,26,9,1,1455
34013065107,872,629,425,46,103,6,57,0,204
34013065108,992,684,551,39,36,3,49,1,133
34003105203,1610,1293,826,338,94,29,50,2,467
34003210007,1721,1258,1104,78,9,7,51,0,154
34003235002,1354,1070,831,123,21,10,80,0,239
34003075303,985,829,168,219,382,14,61,5,661
34003335001,1684,1362,1028,179,37,9,120,4,334
34003285009,1247,1032,806,114,33,3,74,0,226
34003320001,1997,1528,1213,187,21,9,83,0,315
34013070S38,1172,936,10,48,888,5,2,0,926
34003110001,1538,1086,873,39,11,7,143,0,213
34003140001,1463,1084,905,60,15,2,89,0,179
34029102003,1692,1385,1252,85,17,15,10,0,133
34013070W37,1298,991,13,97,909,27,11,0,978
34013010110,996,818,352,215,158,23,80,3,466
34013070W09,1629,1154,36,563,620,21,9,7,1118
34019110006,989,773,664,61,6,10,29,0,109
34019105002,997,771,604,64,24,5,68,0,167
34019110004,932,741,663,31,11,10,25,1,78
34003230009,1221,1020,660,105,20,1,232,0,360
34003190009,2066,1586,939,213,84,10,355,1,647
34019010003,943,743,687,19,8,4,17,1,56
34003095001,2169,1688,703,297,58,5,640,1,985
34013015001,905,708,562,78,32,7,38,0,146
34013070E16,3099,2298,535,1311,131,44,18,5,1763
34003290002,1688,1423,1082,77,38,9,207,1,341
34003020005,954,765,235,360,100,13,96,0,530
34003220003,1370,1034,683,95,19,8,232,1,351
34003220004,1304,977,716,62,12,6,179,0,261
34003280003,1559,1231,830,193,41,23,137,0,401
34013060001,1932,1473,747,154,85,18,463,1,726
34013060009,1514,1091,559,52,55,8,413,1,532
34025185002,1065,771,645,38,15,8,32,1,126
34025140010,923,704,583,34,5,4,67,1,121
34025155020,1251,963,892,36,4,5,18,2,71
34013010304,1325,1012,137,422,357,17,81,8,875
34013030507,814,631,16,127,476,10,29,0,615
34029150008,1877,1403,1182,136,25,16,36,0,221
34029120010,1433,1206,1095,58,8,13,18,0,111
34029120001,1213,954,845,69,12,11,16,0,109
34029070032,775,762,675,49,12,6,19,0,87
34029ZZZZZZ,0,0,0,0,0,0,0,0,0
34037120001,951,739,657,38,14,6,6,0,82
34037110015,1143,935,794,73,23,20,10,0,141
34039075102,1590,1233,422,584,135,21,98,0,811
34039100106,951,675,575,42,11,3,46,0,100
34017030B05,1512,1266,454,290,259,15,291,2,812
34017030A07,1789,1380,233,308,237,19,615,1,1147
34017030A06,888,718,222,153,80,11,261,2,496
34017030A05,1082,859,250,173,134,27,314,5,609
34017030B14,1447,1052,166,270,530,28,91,4,886
34039020511,2882,2041,61,1033,955,35,51,3,1980
34017060301,1384,1145,255,681,106,41,112,1,890
34017030F30,1484,1180,422,470,176,14,117,1,758
34017030E06,5868,5196,2692,418,215,5,1836,11,2504
34005115004,983,745,550,39,105,9,57,1,195
34005192023,754,600,114,52,426,7,5,0,486
34005125010,1028,809,546,38,141,3,85,1,263
34017030F02,1284,845,114,234,501,9,34,1,731
34017030F28,2356,1995,934,519,207,48,373,4,1061
34017030C11,816,638,46,25,12,1,552,0,592
34003250001,1140,951,305,464,64,21,130,0,646
34003100005,1920,1501,1235,69,21,3,162,2,266
34003067002,2733,2151,1232,603,143,28,177,3,919
34003085022,1533,1197,719,279,55,16,143,3,478
34003230019,1271,1097,784,86,10,6,204,0,313
34017035102,1183,937,254,558,39,47,53,0,683
34017035103,1257,1033,347,483,56,39,71,0,686
34017035104,1349,1041,278,606,57,18,42,0,763
34017040206,1607,1253,134,1057,23,30,35,2,1119
34017030D11,1749,1396,167,877,131,32,254,5,1229
34017030D02,1040,839,170,387,53,16,254,2,669
34017005317,1527,1163,503,323,198,22,149,3,660
34017005308,2325,1883,673,407,261,37,539,6,1210
34017035108,1639,1245,261,804,57,24,61,4,984
34017035107,1484,1130,267,683,36,12,49,1,863
34017035204,1611,1204,330,734,46,22,47,2,874
34003160004,1946,1593,1023,341,97,15,130,1,570
34003160006,1277,1066,698,252,24,16,73,1,368
34003210006,1753,1344,1168,100,14,9,55,1,176
34003100002,1426,1144,914,86,19,0,120,0,230
34003230006,1428,1121,606,133,35,5,349,1,515
34003115305,3042,2413,438,1019,718,71,299,6,1975
34003250003,1507,1186,380,508,156,30,164,6,806
34005125005,2601,2031,979,208,635,36,185,7,1052
34017030B29,1660,1261,143,299,330,20,495,4,1118
34017030B10,993,775,171,201,333,16,89,8,604
34017025106,2128,1837,1349,142,39,20,287,1,488
34017030B08,1919,1340,279,300,392,15,375,4,1061
34017060205,1173,914,93,760,55,25,47,2,821
34003070005,1004,770,591,68,17,6,96,0,179
34037010001,1635,1418,1121,100,109,16,67,0,297
34017050203,1740,1271,89,1121,101,35,25,10,1182
34009025304,1193,957,867,37,26,16,12,2,90
34009025202,620,554,515,19,13,5,5,1,39
34037020006,1809,1394,1184,123,36,9,31,0,210
34017040705,1880,1514,235,813,102,52,384,5,1279
34017030F03,1673,1241,48,304,853,37,70,8,1193
34017030C19,927,750,281,258,65,9,146,4,469
34017030C23,779,693,285,204,108,6,102,0,408
34017030C24,1637,1352,217,244,75,13,823,2,1135
34017050201,1803,1441,223,931,181,68,204,0,1218
34029035006,3168,2281,1512,323,336,32,123,1,769
34029035062,1392,1052,853,69,37,17,81,1,199
34029070039,5405,2124,1848,120,68,15,8,0,276
34029055027,941,585,483,61,32,5,8,0,102
34029110001,979,818,754,24,7,15,13,0,64
34029150004,1467,1294,1205,61,1,6,17,1,89
34029025301,777,544,160,118,259,6,6,2,384
34029025327,1095,1075,977,55,23,5,14,3,98
34029025409,1011,1000,921,48,16,3,9,1,79
34003155006,1667,1335,669,462,116,16,108,1,666
34017050104,2330,1720,139,1451,156,41,73,3,1581
34003170003,1357,1070,676,204,68,10,137,1,394
34003015005,1504,1184,320,434,81,21,371,2,864
34003350003,1722,1315,1103,97,8,9,100,0,212
34003195004,1658,1322,797,400,37,12,61,5,525
34003280004,1120,888,599,124,40,11,126,0,289
34029090016,1800,1793,1582,85,61,32,25,0,211
34029030003,1500,1245,952,178,60,22,41,1,293
34029025421,584,578,524,31,12,3,3,0,54
34029090026,816,815,727,39,19,4,17,0,88
34007020003,1710,1412,1059,132,158,23,54,2,353
34015055201,1087,882,682,60,89,11,27,0,200
34007090005,1184,911,874,14,6,4,9,4,37
34015055122,2030,1592,1186,77,235,29,79,1,406
34007055010,1048,886,699,86,72,20,16,3,187
34007075023,2016,1529,585,145,557,20,233,6,944
34015115004,945,731,654,23,36,3,11,3,77
34031040608,2013,1523,374,972,203,32,42,8,1149
34015040005,1765,1275,1027,76,121,13,50,1,248
34015090036,686,602,485,28,62,6,23,0,117
34031035310,1323,879,272,513,55,12,59,0,607
34031010108,1618,1085,714,228,38,10,108,3,371
34027190004,1067,852,740,63,12,6,28,0,112
34015090005,1809,1331,967,76,162,16,109,2,364
34027130002,1525,1331,1108,124,34,5,56,0,223
34027020009,716,547,365,75,19,0,69,0,182
34027180101,1262,969,639,198,93,8,36,3,330
34031060002,2344,1924,1438,277,35,8,162,1,486
34031060005,1748,1415,985,302,42,5,99,1,430
34031010202,1719,1350,530,650,85,39,95,4,820
34031040606,2036,1541,215,1159,213,33,36,2,1326
34031070307,1105,846,675,81,17,9,67,0,171
34031070404,1797,1424,1099,142,35,6,146,0,325
34023125501,865,679,551,61,14,1,54,0,128
34023125506,1313,1046,663,144,59,21,173,0,383
34023025026,1004,802,401,161,44,8,197,2,401
34023010002,1431,1115,798,39,26,3,253,2,317
34023085106,1090,868,348,115,198,17,204,0,520
34023077302,1391,1095,701,161,59,16,169,0,394
34023070605,1159,1041,620,209,85,10,112,4,421
34023080601,1188,863,38,803,95,17,5,2,825
34031070402,1096,861,700,72,4,15,71,2,161
34031070403,1055,820,632,85,22,11,78,0,188
34027180103,1039,829,621,113,31,16,44,1,208
34027082004,1421,1088,864,81,30,14,95,5,224
34027140002,1967,1610,1057,351,104,39,66,0,553
34027082006,1296,1004,809,92,10,10,78,0,195
34027020003,1149,801,647,40,13,6,88,0,154
34015080002,1252,926,791,33,64,11,26,1,135
34015050011,859,683,632,21,18,1,10,0,51
34021050004,1149,853,565,39,35,4,202,0,288
34021050005,774,586,459,30,8,3,71,2,127
34023025018,743,593,271,74,46,5,201,0,322
34023025047,687,566,241,84,51,6,193,3,325
34023025074,1495,1220,447,182,83,8,500,2,773
34023025045,1126,831,223,67,27,20,520,2,608
34023025065,1372,1077,307,36,39,4,686,1,770
34023065307,1690,1282,766,67,64,3,384,1,516
34011005304,1641,1092,217,641,225,78,15,3,875
34011025001,1859,1697,751,350,528,79,18,1,946
34011070609,1249,975,708,153,73,24,34,2,267
34025172004,910,723,296,37,364,9,18,0,427
34025170005,1067,907,705,33,125,11,29,0,202
34025130006,1984,1533,1194,140,46,8,149,3,339
34027155007,1029,799,736,40,2,2,17,0,63
34027025006,964,711,558,24,9,3,114,0,153
34001105101,1357,1205,1076,65,33,5,19,2,129
34027135016,821,630,444,123,33,16,36,0,186
34027180301,1411,1089,752,128,68,7,136,0,337
34027105007,873,770,629,42,6,0,92,0,141
34027160016,1121,829,717,48,17,1,47,0,112
34027045302,1418,1106,122,900,99,35,16,1,984
34027082005,1660,1334,1047,122,7,4,135,1,287
34027155004,1389,1098,915,87,20,11,56,0,183
34021015031,2441,1901,1428,144,209,17,92,1,473
34021030012,1188,912,762,58,23,12,41,5,150
34021065016,967,932,672,19,14,0,222,0,260
34027020007,1096,736,637,38,5,2,51,1,99
34027035005,1342,1023,870,58,12,1,60,0,153
34023070401,3458,2329,201,1787,280,72,110,5,2128
34023095014,983,813,553,119,83,2,60,0,260
34023020036,1179,962,605,44,29,14,279,2,357
34023025051,784,613,267,161,78,7,112,1,346
34023077104,918,752,565,89,39,5,54,0,187
34039010401,748,592,440,61,11,2,77,1,152
34039095008,942,751,59,91,586,5,18,1,692
34039095007,1080,836,87,49,645,16,48,0,749
34039060202,1068,797,123,306,370,23,13,0,674
34039090105,909,610,456,40,21,7,86,3,154
34035030007,993,780,548,51,14,1,160,0,232
34035010009,1254,932,732,53,12,4,125,2,200
34011070606,1338,1116,749,253,108,38,16,0,367
34023020039,1133,882,423,51,37,6,369,2,459
34001090101,869,699,606,35,17,4,28,2,93
34025155045,1337,985,910,45,3,1,25,0,75
34025265001,1250,920,795,59,25,7,5,0,125
34025210002,1467,1097,1034,44,8,5,9,1,63
34021015032,859,694,585,52,15,12,34,0,109
34035035001,924,768,625,85,14,3,37,0,143
34035075002,1268,951,733,131,43,1,36,1,218
34025095020,1498,1162,878,113,84,4,84,0,284
34025155022,1907,1496,1318,73,25,7,54,1,178
34021005009,2344,1694,268,784,202,19,452,1,1426
34035020007,833,682,390,205,46,21,33,2,292
34035010016,675,505,355,23,11,4,106,0,150
34035065009,1240,909,470,35,24,6,373,1,439
34015100010,863,672,609,24,18,12,8,1,63
34035030030,1237,962,689,65,37,7,167,1,273
34035075001,1290,1016,909,81,5,2,20,1,107
34029030011,1258,1067,932,73,18,20,29,0,135
34029090023,773,768,684,42,20,2,14,1,84
34029120012,1265,1009,902,64,14,18,23,0,107
34029055023,1615,1198,940,102,80,10,59,1,258
34021005014,2217,1782,542,546,271,38,424,9,1240
34021005007,1151,899,674,69,51,5,108,3,225
34035050019,1242,970,560,82,68,3,249,0,410
34035050033,1455,1098,604,118,84,7,281,3,494
34029030009,1219,1036,911,69,16,9,24,3,125
34029030005,1418,1269,1160,64,8,14,17,0,109
34029030004,1491,1205,1075,73,15,25,22,0,130
34029030014,1967,1586,1331,149,42,11,42,0,255
34035030035,1679,1323,407,45,15,14,832,1,916
34035030036,1671,1253,445,64,41,7,684,1,808
34035015005,912,702,585,39,9,6,64,0,117
34025065005,814,563,499,16,10,7,25,0,64
34039100402,1620,1187,889,89,70,9,130,1,298
34025155034,1516,1236,955,68,37,7,168,0,281
34025015002,2253,1628,273,524,813,31,21,7,1355
34019095002,887,713,656,22,4,13,21,1,57
34013070C22,2454,1616,15,233,1398,30,14,0,1601
34013065103,1198,825,625,52,61,6,72,0,200
34013070C09,2004,1479,5,186,1328,18,3,1,1474
34039070504,949,771,143,222,396,15,26,2,628
34025170017,1871,1679,1065,144,326,23,148,1,614
34025110006,1383,1208,839,181,100,17,79,4,369
34025140008,1517,1153,934,70,29,5,121,0,219
34025170010,1750,1433,438,167,756,36,72,1,995
34025155024,1472,1125,981,65,27,19,27,0,144
34039100405,1613,1188,914,64,27,11,162,0,274
34039055001,993,741,450,55,48,6,183,3,291
34005110001,1063,800,748,15,5,2,19,0,52
34005105012,1745,1311,1210,39,11,16,31,0,101
34005050301,785,582,518,13,9,6,17,1,64
34005040009,664,520,456,27,19,6,8,0,64
34039065104,1228,971,304,360,302,27,22,9,667
34039065202,1131,916,379,235,280,13,30,3,537
34029070006,10463,4402,3213,918,145,89,27,1,1189
34029045001,391,351,341,6,1,2,2,0,10
34027145032,3162,2494,687,253,110,10,1429,1,1807
34005125019,1111,862,648,42,64,8,109,0,214
34031070607,1610,1214,913,135,37,3,123,1,301
34039020406,1346,1011,181,508,289,18,56,2,830
34041035003,1305,994,702,108,118,6,76,0,292
34025125013,2681,2068,454,722,528,76,63,6,1614
34029070010,5584,2636,2429,104,10,9,2,0,207
34029070040,4855,2177,1875,198,28,8,4,1,302
34029035040,1169,954,631,142,86,11,88,0,323
34005015103,387,316,266,19,13,4,12,0,50
34039002064,2414,1855,115,1432,332,39,19,5,1740
34039005009,1075,811,595,42,19,2,136,0,216
34039055009,2141,1772,1351,139,40,10,229,1,421
34005040002,800,657,580,13,42,5,4,0,77
34005100015,1670,1366,746,161,377,14,96,1,620
34005040003,785,639,581,19,27,7,20,0,58
34005155001,803,624,455,59,63,17,14,2,169
34005105003,1257,1003,922,20,16,7,24,0,81
34005020004,797,624,506,51,35,15,25,0,118
34039045303,2326,1878,636,463,671,22,113,5,1242
34039060101,1267,938,38,326,576,31,7,9,900
34013070W30,1371,1026,14,74,945,20,12,0,1012
34013070W32,760,630,21,27,583,5,12,1,609
34013070W34,2067,1576,78,83,1414,16,21,2,1498
34013030310,1073,777,35,85,658,7,7,4,742
34013030313,1531,1143,14,75,1073,9,7,5,1129
34013005104,1140,897,297,398,90,19,102,1,600
34013010107,1340,1103,409,369,249,15,98,1,694
34039065304,1084,864,453,185,160,8,63,4,411
34019005004,1166,945,831,47,20,7,34,1,114
34025003006,1032,814,671,60,32,4,53,2,143
34025185017,1283,1003,804,86,17,7,64,1,199
34009055006,897,703,652,17,18,13,5,1,51
34025247014,1068,873,626,73,105,15,55,0,247
34029055022,1210,1192,1131,28,12,0,14,0,61
34029070025,4188,2156,1444,571,99,30,12,0,712
34029115002,2145,1745,1492,147,32,63,15,2,253
34029035036,1348,1065,780,142,47,11,92,0,285
34029035038,1239,962,814,102,25,5,17,0,148
34029035008,1277,1220,1176,23,7,8,13,0,44
34005040016,876,637,565,11,25,6,29,1,72
34037060010,1248,1029,842,128,28,15,23,1,187
34005192032,736,581,84,59,426,12,8,1,497
34013050007,954,710,448,22,26,2,202,4,262
34013065406,1390,1058,196,94,758,13,32,1,862
34013045N04,1198,949,21,83,837,22,14,1,928
34013095010,1037,764,426,54,220,11,66,2,338
34037110019,976,784,699,52,14,7,7,0,85
34037110006,1012,795,672,67,11,10,21,0,123
34037120007,1437,1167,1026,80,33,18,18,0,141
34039045801,1240,939,254,517,128,10,28,1,685
34039045802,1151,935,225,493,171,11,30,3,710
34039025001,1122,843,556,74,87,7,122,0,287
34003155005,1874,1549,757,521,131,10,151,1,792
34003030007,1501,1199,567,425,38,20,155,2,632
34013070S20,1607,1159,13,97,1061,10,4,2,1146
34013070S23,1719,1165,6,122,1083,7,8,3,1159
34013080104,1258,996,719,140,18,11,98,1,277
34013005305,1125,901,242,517,83,26,65,2,659
34013100011,824,643,486,62,21,6,65,1,157
34003085021,1947,1551,956,350,90,24,177,2,595
34029035053,1077,892,784,65,12,6,27,0,108
34023125103,960,777,400,213,81,12,71,3,377
34023085205,1553,1311,324,238,405,13,342,0,987
34023120001,1801,1492,1100,137,68,13,168,1,392
34017045304,1089,885,433,226,41,10,184,5,452
34017045105,868,693,230,153,51,12,261,1,463
34017040601,1228,955,152,707,60,48,60,4,803
34025130018,2586,1941,1383,120,121,17,284,2,558
34025095025,1741,1343,1058,121,97,24,46,2,285
34005090007,1239,968,724,29,118,24,72,0,244
34005165003,2203,1653,1561,39,21,20,9,0,92
34005100006,1034,820,710,41,31,13,24,0,110
34005065009,1445,1145,921,54,61,13,93,0,224
34013010204,1198,939,540,147,73,4,172,1,399
34013110408,1204,966,564,85,182,5,123,0,402
34013070S11,1312,874,4,195,684,16,2,3,870
34019065001,1438,1169,976,99,29,18,31,0,193
34037120003,1562,1262,1152,48,19,18,19,0,110
34037055002,990,847,724,63,22,4,26,0,123
34003145003,1428,1118,418,237,48,12,427,3,700
34003015011,1817,1104,698,128,74,3,198,0,406
34003115503,1242,1002,480,254,193,9,96,2,522
34017030A24,1402,1139,145,274,416,16,333,7,994
34017050702,1510,1187,118,978,63,63,50,1,1069
34017050704,1842,1473,266,964,127,51,137,4,1207
34017055202,1029,805,275,407,37,23,89,2,530
34017055102,1784,1531,713,532,108,18,187,1,818
34005120005,1076,806,507,106,156,22,26,2,299
34005192021,768,629,116,71,438,7,18,2,513
34005192020,910,713,82,66,571,13,17,0,631
34017030F21,1517,1147,68,268,824,20,38,4,1079
34013050014,1591,1247,838,58,55,2,296,0,409
34005155002,1313,963,539,215,92,18,11,3,424
34005080005,1479,1115,782,73,131,12,104,1,333
34005140002,719,603,483,40,59,3,13,3,120
34017060106,1700,1400,385,647,90,21,309,0,1015
34017030C06,1151,1005,279,210,171,10,362,9,726
34017030F18,1325,980,50,231,696,10,43,3,930
34017060309,1534,1203,119,1026,83,55,31,3,1084
34017030C26,1414,1114,319,232,131,21,451,4,795
34017050701,2261,1894,371,1250,152,57,191,1,1523
34007080005,731,564,403,86,47,8,26,1,161
34007040107,1539,976,18,407,574,35,18,3,958
34007043008,1631,1227,610,222,224,11,176,3,617
34007180103,1033,868,715,74,42,19,24,0,153
34007120002,1039,823,622,82,69,21,39,3,201
34007040409,1900,1352,53,1063,294,28,12,10,1299
34007075027,1341,1069,734,80,98,17,148,2,335
34007030001,2267,1907,1427,150,132,20,171,4,480
34015030011,1337,1153,945,63,95,23,42,4,208
34007043044,1844,1430,766,55,174,6,438,2,664
34007155002,1358,1119,667,120,253,17,64,3,452
34007055011,1130,906,724,70,59,8,39,1,182
34015100002,859,676,580,45,29,13,12,0,96
34015075005,1231,978,885,39,20,11,22,0,93
34015025007,1398,1104,974,49,24,16,19,3,130
34015055405,1293,1016,903,39,41,13,13,2,113
34031010104,2585,2073,1117,660,108,40,179,3,956
34031010103,1620,1401,758,299,105,23,243,2,643
34031040105,2781,2017,118,1299,614,54,56,12,1899
34007043016,995,731,569,31,40,6,84,2,162
34007130002,1273,1046,763,108,138,15,29,1,283
34007040408,1916,1394,40,1064,276,47,41,5,1354
34031050004,1876,1431,398,757,238,11,81,1,1033
34031040107,2948,2096,63,1204,596,61,324,8,2033
34041040005,1113,903,709,134,21,18,28,2,194
34015040008,2204,1487,1246,51,60,11,117,0,241
34015090031,1154,893,806,33,30,6,22,0,87
34013050008,1129,818,582,31,16,11,180,0,236
34013050004,1167,865,465,42,30,8,321,0,400
34013070S47,2456,1723,92,613,913,19,24,5,1631
34027065001,1031,835,740,34,11,2,38,0,95
34027175603,778,623,535,59,15,5,19,0,88
34023125511,1159,906,598,116,64,6,131,0,308
34023025078,3758,2801,23,60,27,19,2663,0,2778
34003030005,1718,1402,495,568,60,39,241,2,907
34027040402,930,716,557,42,24,4,82,0,159
34011070406,1629,1242,661,350,207,23,35,2,581
34011070503,1706,1195,215,601,392,22,28,6,980
34031010201,1646,1299,574,556,103,19,115,1,725
34011070407,1585,1227,565,450,205,34,22,1,662
34023125507,1255,1002,761,79,50,2,110,1,241
34023075009,1376,1098,421,120,168,6,383,2,677
34023070603,2114,2048,1092,262,144,2,491,0,956
34023095023,693,543,386,83,42,0,35,2,157
34001040012,1787,1260,361,290,263,23,343,1,899
34001005102,1913,1639,1173,161,222,30,73,4,466
34001090202,1005,802,689,57,16,7,39,0,113
34011070102,2072,1654,928,535,158,35,13,2,726
34023075017,1333,1094,417,141,259,23,289,2,677
34027035004,1428,1053,908,61,8,6,48,0,145
34027085012,872,674,478,120,15,2,53,0,196
34023125504,843,672,438,52,16,2,165,0,234
34023125414,1054,857,267,104,57,6,426,2,590
34023095011,1351,1094,754,180,60,9,96,0,340
34023100203,1186,914,560,205,67,7,75,5,354
34023020005,856,625,350,38,23,5,207,0,275
34023020013,1289,1010,500,91,74,17,343,2,510
34023105003,1471,1211,719,93,106,12,278,0,492
34023070602,1151,919,431,236,60,11,176,3,488
34023125113,1720,1350,706,359,185,29,89,7,644
34023125115,1165,937,534,273,108,20,36,1,403
34007043017,1601,1263,842,94,131,18,184,1,421
34007170014,1307,999,655,68,81,8,196,0,344
34001090204,1154,914,524,198,69,13,112,3,390
34021030005,1753,1332,1094,69,50,6,115,4,238
34021030010,2809,2185,1409,135,139,9,508,1,776
34025055005,1821,1530,765,246,309,49,194,6,765
34035005009,674,558,398,47,15,1,84,1,160
34025135003,1507,1285,1228,24,8,5,13,5,57
34025090009,1456,1076,800,53,10,8,192,0,276
34025140007,1356,1039,812,66,25,2,130,0,227
34035040106,1182,941,208,69,233,9,430,0,733
34035040107,1423,1171,353,85,246,11,489,3,818
34035040105,1215,993,323,59,179,14,428,1,670
34035010015,1144,945,711,49,18,2,161,1,234
34035045002,996,735,443,63,29,2,195,0,292
34035000006,1046,851,425,112,41,4,264,0,426
34035030019,1056,773,624,37,12,7,90,0,149
34025185016,842,653,572,28,12,2,38,0,81
34025185010,967,747,619,50,25,6,41,4,128
34025155021,1805,1382,1187,98,33,12,47,0,195
34025215001,590,542,472,27,11,5,25,0,70
34025082009,1538,1259,1016,119,45,13,68,6,243
34025130017,1950,1503,1222,94,20,7,158,0,281
34035030024,1151,932,696,55,26,7,148,2,236
34035020002,698,557,409,77,25,5,38,1,148
34035040220,950,805,388,120,135,18,166,1,417
34035040219,1188,1019,491,72,185,4,268,1,528
34021030003,1258,1094,745,109,180,11,24,1,349
34025080024,805,661,551,41,23,1,41,0,110
34039085005,797,640,491,69,31,5,44,2,149
34039075502,1711,1383,642,381,150,39,204,2,741
34039020312,2563,2053,204,1442,405,62,42,3,1849
34039002048,2941,2087,246,891,856,69,142,10,1841
34039095025,958,807,421,131,135,8,99,0,386
34039080004,1190,887,644,84,62,5,93,1,243
34039080008,1097,807,505,89,83,1,124,1,302
34019050002,1047,867,736,64,16,26,25,0,131
34029035039,2014,1539,1329,109,14,3,77,3,210
34039020301,850,648,339,254,41,9,13,0,309
34039090108,839,593,461,45,10,5,72,1,132
34039090209,876,613,541,22,7,2,37,0,72
34039002068,3657,2702,273,2179,242,73,53,1,2429
34039015012,819,636,535,31,38,3,22,1,101
34039070101,1244,958,90,506,331,37,57,2,868
34005030002,1750,1324,599,92,521,14,120,1,725
34005105004,733,597,537,21,10,5,23,1,60
34039095030,1057,849,437,144,116,2,122,3,412
34029070014,4233,2032,1054,779,163,20,3,2,978
34005025201,711,556,233,56,250,10,16,1,323
34005192009,955,702,95,77,524,14,18,3,607
34009025303,1087,921,841,22,15,10,27,1,80
34003075104,1822,1511,133,903,454,43,95,1,1378
34003050004,1818,1472,779,334,90,12,282,1,693
34003315004,1943,1499,1058,96,57,9,276,0,441
34003145005,1900,1498,602,147,57,12,689,2,896
34005140004,586,507,408,34,42,9,12,0,99
34009025104,1018,786,647,82,36,17,7,0,139
34005010001,877,685,474,73,123,15,16,1,211
34005125023,1520,1474,1313,34,58,6,65,0,161
34003115203,2534,2035,319,1012,536,54,243,1,1716
34003110008,1139,784,654,40,18,0,69,0,130
34003015015,2109,1680,474,592,130,31,532,2,1206
34003015013,2070,1518,477,413,174,11,477,0,1041
34003255005,1419,984,762,61,12,8,153,0,222
34003115205,1207,1022,284,318,270,23,154,0,738
34005140001,741,599,524,28,20,14,13,1,75
34013100009,2009,1670,1382,147,52,1,73,0,288
34013005301,1539,1236,226,756,151,17,104,2,1010
34013030304,1369,1002,9,68,903,13,13,3,993
34013030207,2940,2363,58,198,2118,26,13,2,2305
34013005204,1073,859,327,297,100,13,150,0,532
34003095010,6042,5246,2534,424,234,12,2070,1,2712
34003210002,1687,1362,1083,122,57,27,76,1,279
34003340001,1231,956,770,52,11,8,117,0,186
34013065102,987,709,522,56,66,10,61,0,187
34029003006,2068,1569,1196,186,137,21,50,0,373
34029003010,505,464,395,25,34,10,7,0,69
34029030015,1380,1113,982,77,18,28,12,0,131
34029120007,1069,824,758,43,4,10,3,1,66
34013110404,1017,794,392,89,227,6,79,1,402
34013110409,1312,990,589,94,207,4,99,1,401
34013045N05,2178,1665,46,161,1476,40,13,1,1619
34013027N03,2562,1967,50,672,1248,48,20,5,1917
34013027E01,2787,2189,37,600,1566,57,14,8,2152
34013005401,1315,1038,263,592,85,35,124,4,775
34019005002,1249,955,830,50,18,7,37,1,125
34003230008,1859,1565,884,124,113,2,441,159,681
34003230011,1118,923,540,65,18,1,289,0,383
34003230016,1585,1287,785,126,31,10,348,0,502
34003330003,1057,788,693,46,8,8,40,1,95
34013015007,2499,2311,1514,323,278,5,189,7,797
34003235004,1187,959,816,77,15,11,46,0,143
34003085018,1213,932,690,126,27,9,94,1,242
34003067005,1406,1114,529,360,96,15,153,5,585
34003135006,1795,1374,1164,87,12,11,96,0,210
34013005303,1895,1536,278,881,264,39,125,7,1258
34017035303,1098,905,627,201,15,8,51,0,278
34025140023,1321,1048,710,38,17,2,278,0,338
34029090038,615,608,583,10,5,5,3,0,25
34029090031,763,761,707,18,22,6,6,0,54
34029150007,1614,1263,1087,96,22,23,33,2,176
34013045N10,1200,895,23,88,783,16,6,1,872
34029055026,1010,995,949,23,4,0,20,0,46
34029070036,1972,969,911,6,0,2,4,3,58
34009035103,350,333,324,5,0,0,3,0,9
34039070301,887,703,98,307,288,11,22,2,605
34039070201,1122,864,86,384,377,34,31,0,778
34017020203,1398,1195,393,315,120,18,325,0,802
34017020401,1067,851,175,409,17,21,191,1,676
34017020301,1181,964,261,424,28,25,194,0,703
34005105005,879,655,588,30,4,3,22,0,67
34005150008,1876,1542,469,260,753,59,84,2,1073
34017025407,1494,1359,826,324,102,4,107,9,533
34017025303,1199,1006,751,154,42,9,68,1,255
34017025302,1333,1152,853,121,41,12,126,3,299
34037120006,956,799,705,40,21,3,16,0,94
34003135001,1230,936,824,61,4,8,40,1,112
34003210004,1304,1075,879,103,28,4,59,3,196
34005050303,1131,857,759,30,38,2,17,0,98
34003340004,1974,1527,1287,83,22,9,118,0,240
34003145002,1338,1068,517,210,30,12,326,3,551
34003075103,1506,1208,188,570,391,19,97,3,1020
34003085016,1532,1161,766,213,31,13,158,2,395
34003085001,1681,1286,808,211,49,15,215,0,478
34017030A04,1396,1133,208,318,233,27,384,2,925
34017030D15,1524,1193,282,549,99,18,277,1,911
34017035105,1225,943,273,519,36,13,50,0,670
34017035101,1839,1490,425,664,101,22,240,4,1065
34017060303,1633,1328,312,742,108,25,188,5,1016
34017030E03,3304,2803,956,210,128,7,1457,9,1847
34017025104,970,886,594,147,30,12,127,0,292
34017005319,2227,1716,626,445,262,27,375,7,1090
34017005310,657,549,322,127,52,16,57,1,227
34017035304,1092,892,497,319,14,22,50,2,395
34017040201,989,825,176,579,35,7,44,3,649
34017030A15,1275,1041,100,349,378,28,207,4,941
34017005113,2118,1598,807,491,194,14,129,3,791
34009025102,878,681,579,50,26,14,9,0,102
34037075003,1597,1362,1065,186,55,22,42,0,297
34009025206,770,674,615,32,13,10,4,1,59
34009030008,1452,1017,338,150,492,31,24,6,679
34017030D03,1208,1000,324,413,106,14,177,3,676
34017030E10,1419,1202,745,144,95,19,221,2,457
34017035403,1081,866,412,350,32,12,34,6,454
34029035049,622,603,555,19,10,1,10,0,48
34029035052,3320,2232,1739,157,65,9,239,2,493
34029070004,3380,1855,1437,340,31,19,11,4,418
34017030B27,1251,920,133,268,218,15,318,4,787
34003090003,3301,2576,627,1672,93,125,158,0,1949
34029030008,1467,1183,997,83,45,22,37,0,186
34029035035,1994,1518,1331,102,34,6,24,1,187
34029030012,1379,1142,1008,74,6,14,30,2,134
34007175007,1419,1145,1046,29,47,5,18,3,99
34007115002,976,749,519,76,133,20,20,0,230
34015090035,1107,839,693,47,45,7,43,0,146
34015090032,1155,924,795,56,52,10,17,2,129
34015055203,1258,967,600,101,228,27,25,3,367
34007043028,1697,1319,780,34,50,10,443,0,539
34031010305,1870,1442,480,810,129,40,46,1,962
34015100012,618,499,450,13,24,1,8,0,49
34015010011,1887,1505,1259,87,95,25,29,4,246
34015090012,863,681,584,29,31,9,28,0,97
34015025009,1180,986,859,28,68,20,12,0,127
34015035005,631,534,426,32,62,11,9,1,108
34027145038,725,580,348,44,20,8,162,2,232
34015055306,1877,1304,660,76,456,28,104,0,644
34011065003,1520,1253,875,189,118,62,37,4,378
34031040111,2231,1692,110,1145,455,39,32,3,1582
34031040607,2184,1707,444,1036,247,27,50,5,1263
34031070308,995,767,643,46,18,5,59,0,124
34023010001,1362,1011,752,56,43,6,152,2,259
34023015006,892,690,368,194,68,18,45,5,322
34023080401,1357,1044,77,838,142,39,69,1,967
34031035206,2281,1632,148,1311,224,67,28,3,1484
34031040307,1040,743,27,490,244,80,1,1,716
34023035004,761,595,425,54,51,7,68,0,170
34027055002,720,535,498,11,3,4,18,0,37
34027160005,1028,765,513,107,32,7,104,1,252
34035060001,448,334,295,18,9,3,9,0,39
34035010017,1658,1340,849,79,122,3,285,4,491
34035050023,1060,828,571,79,39,6,109,2,257
34035030017,783,600,494,39,9,4,51,0,106
34035010010,1254,926,767,33,13,13,98,0,159
34023090001,2853,2309,928,149,110,16,1123,2,1381
34023125307,896,716,331,203,75,7,118,0,385
34023100202,838,666,435,160,44,7,29,1,231
34023060008,1003,774,610,106,26,18,25,3,164
34011070301,1356,986,80,767,129,25,8,2,906
34011070302,1320,956,49,773,148,27,18,2,907
34011065004,1888,1497,1155,137,96,49,84,0,342
34027070009,1635,1315,1115,105,40,22,24,1,200
34027045201,1298,1070,306,642,113,43,26,0,764
34027195005,1206,960,367,486,34,20,52,1,593
34027080102,1453,1148,901,129,23,13,77,2,247
34027080101,1804,1413,1154,122,16,11,104,3,259
34027005402,948,761,611,54,28,10,59,3,150
34035095003,1332,1045,551,320,102,18,70,0,494
34027135006,809,656,524,64,24,6,41,1,132
34027070007,1257,1022,904,70,19,3,11,1,118
34027020006,863,639,543,14,11,4,57,1,96
34027025004,929,632,516,31,5,3,61,1,116
34001070102,1323,989,891,34,20,7,33,0,98
34023005001,1677,1265,191,523,304,19,278,2,1074
34023005008,1620,1222,228,460,225,27,302,0,994
34001065002,1811,1409,1038,311,37,24,13,6,371
34023095012,1516,1220,779,176,114,9,134,0,441
34023095016,1081,829,616,89,36,10,76,7,213
34023055005,1316,1053,815,134,19,13,63,4,238
34023075005,1483,1180,484,200,154,17,350,4,696
34023095002,1743,1346,614,204,149,20,371,2,732
34023020028,646,507,338,57,24,2,82,0,169
34023070503,1472,1278,433,346,228,39,269,3,845
34023070601,2324,2253,902,295,198,3,804,0,1351
34023025041,1434,1124,376,181,136,14,413,0,748
34023075025,4048,3123,1004,357,836,18,915,9,2119
34023110008,1442,1155,605,140,112,5,273,7,550
34033075001,1960,1475,1294,62,65,35,27,0,181
34025247003,1660,1398,636,305,424,38,24,2,762
34025080026,1047,839,621,65,36,5,122,0,218
34025185001,1114,872,681,89,26,10,38,0,191
34025082017,692,572,484,56,17,2,12,1,88
34025045002,1539,1310,1203,58,9,11,18,0,107
34035050002,897,720,534,90,29,7,69,1,186
34035040425,934,772,389,114,186,10,95,1,383
34021065015,4382,3063,788,158,267,16,1842,2,2275
34021040002,812,579,528,19,7,5,20,0,51
34021020001,1707,1360,714,427,101,37,95,5,646
34035005006,1128,981,775,60,29,2,109,1,206
34029090032,1470,1130,883,107,93,4,34,6,247
34021060006,1639,1247,941,78,28,9,186,0,306
34035100012,1556,1298,791,68,25,1,394,0,507
34021010026,1172,1002,507,95,362,8,39,1,495
34021055N04,2324,1788,270,430,1089,32,22,5,1518
34035040549,1551,1379,484,150,307,9,438,0,895
34035030025,1104,858,697,37,16,6,102,1,161
34035050015,1246,939,478,67,98,5,288,0,461
34039060208,718,587,150,142,271,10,23,4,437
34039070304,1326,1016,82,296,624,19,32,0,934
34039065103,1413,1119,175,367,548,25,55,2,944
34025155026,1192,936,844,55,18,1,15,2,92
34019080004,722,594,533,15,22,14,16,0,61
34019105001,1020,741,624,41,9,12,47,1,117
34013070C12,1383,996,12,140,871,13,2,4,984
34013070C07,1169,898,11,117,793,4,5,2,887
34013027S01,1582,1277,47,160,1058,15,50,3,1230
34013045S09,1301,942,11,141,799,18,0,3,931
34013070S42,1612,1193,16,94,1101,16,5,2,1177
34013055004,1101,788,365,58,331,7,54,1,423
34013027S06,1465,1101,92,323,675,20,22,5,1009
34013065106,864,639,508,45,40,5,33,0,131
34013055022,1210,929,378,87,412,4,46,0,551
34025130010,691,675,574,33,15,1,47,0,101
34029025139,1213,1009,769,209,6,15,12,0,240
34029025102,1538,1194,933,105,58,44,50,3,261
34031040205,1624,1200,147,656,244,51,189,0,1053
34031040206,1502,1194,163,665,247,24,156,3,1031
34039100301,682,542,428,54,24,6,36,0,114
34031070102,1943,1667,1189,264,61,24,137,1,478
34039065503,742,607,268,159,123,9,58,0,339
34027045301,1631,1302,207,954,133,37,35,2,1095
34019095003,1093,877,788,41,14,13,14,1,89
34019095006,867,693,620,34,8,11,9,0,73
34019095005,809,647,583,32,8,5,15,0,64
34005190005,2226,1774,865,100,545,18,284,2,909
34029070041,2305,1311,1229,58,8,6,0,0,82
34029070012,7078,2773,2562,87,40,6,3,5,211
34029090006,1408,1391,1274,64,11,17,26,3,117
34029025137,1496,1122,865,133,61,20,45,0,257
34029025205,2261,1745,1409,230,51,44,37,0,336
34029030046,1221,980,855,78,22,7,20,0,125
34039095047,944,757,375,196,84,11,97,0,382
34039060105,1608,1062,18,647,393,54,19,6,1044
34039090107,818,616,526,28,18,5,36,0,90
34029035030,2376,1921,1252,383,180,23,82,1,669
34029030047,1745,1362,1106,135,71,19,44,0,256
34029102006,1372,1364,1318,15,12,0,15,1,46
34029102005,980,971,941,18,5,0,4,0,30
34005050302,1008,761,634,35,36,5,26,0,127
34005192002,1119,867,106,111,636,30,33,0,761
34039020403,2087,1568,259,989,218,48,53,2,1309
34019120004,1135,920,773,68,13,4,39,1,147
34009025105,829,705,647,39,12,6,2,0,58
34013095007,2000,1503,949,104,312,11,135,2,554
34013100002,1319,1055,875,70,32,5,65,2,180
34013110109,745,572,330,62,149,3,37,1,242
34005030012,833,653,167,87,362,6,64,1,486
34005192012,923,744,91,88,560,17,18,2,653
34029030041,1246,1038,944,49,6,11,16,0,94
34025140013,2041,1647,1220,94,31,4,287,0,427
34009020002,449,348,318,12,2,11,0,0,30
34029020003,1544,1217,1043,105,25,17,26,1,174
34025130023,1032,785,651,56,16,6,53,0,134
34013070W44,1888,1370,38,978,359,26,28,4,1332
34013105006,1152,913,801,56,9,5,31,0,112
34013070W22,1467,1048,9,79,974,25,5,4,1039
34013065101,925,750,571,57,55,3,57,0,179
34037110020,1280,1015,869,55,54,14,18,0,146
34039050004,657,517,416,55,9,7,29,2,101
34009020005,931,784,737,16,20,4,4,0,47
34003280001,1522,1178,794,224,33,8,112,1,384
34003260006,1561,1207,646,137,64,7,365,0,561
34003300015,2457,1913,793,453,552,35,137,4,1120
34003300019,1669,1252,541,257,306,17,172,1,711
34003230004,1329,1008,593,76,24,5,300,0,415
34003210005,1458,1137,954,94,30,2,56,0,183
34029055003,1529,1190,924,113,97,19,34,3,266
34029070035,2821,1458,1278,110,39,20,2,2,180
34029080002,1499,1178,1068,64,15,19,12,2,110
34029025134,1140,991,906,37,21,2,18,1,85
34023020010,1386,1070,490,70,51,4,461,1,580
34023050008,946,685,468,63,20,12,118,1,217
34037110012,1684,1328,1173,107,19,19,12,1,155
34037030003,1765,1418,1121,179,53,33,36,0,297
34017045303,1016,893,497,164,33,9,195,2,396
34017010001,1156,918,187,599,25,52,71,4,731
34017030E04,1403,1261,701,227,106,16,236,2,560
34025260005,1446,1202,1082,74,8,19,30,0,120
34025082006,1236,1004,846,99,14,10,32,1,158
34013045N03,1914,1460,24,289,1136,19,27,0,1436
34013070C03,2576,2351,600,560,1002,31,294,7,1751
34023005014,872,684,224,146,82,8,238,0,460
34025060001,2346,1809,1319,237,81,12,168,1,490
34019070003,1205,931,782,74,12,12,54,0,149
34003240006,2393,2036,1563,142,44,9,278,2,473
34003067009,2091,1691,1046,414,98,12,137,4,645
34013010308,1649,1341,272,476,473,25,106,4,1069
34003155010,2633,2162,898,848,260,27,189,0,1264
34003230005,1173,938,538,112,22,6,268,0,400
34003110003,1597,1154,950,55,7,5,121,0,204
34017005114,1301,991,548,259,126,12,64,1,443
34005065031,1423,1130,981,36,44,5,63,2,149
34005065016,1141,972,828,34,51,1,51,0,144
34005125007,1762,1453,1020,97,176,14,181,1,433
34005125003,1398,1108,865,83,79,14,68,1,243
34005150011,1308,1045,682,111,178,27,64,0,363
34017030F12,1504,1144,121,275,734,46,39,8,1023
34005192017,573,442,32,50,360,9,15,1,410
34037060007,1045,867,675,127,32,15,22,1,192
34013070S48,2470,2175,194,461,1550,22,27,2,1981
34013070S46,1356,1099,4,51,1040,13,4,1,1095
34039035404,1634,1274,27,154,1096,15,8,0,1247
34013070W49,1800,1261,17,229,1025,26,10,1,1244
34017005116,1756,1346,537,482,227,35,115,2,809
34017030E16,1750,1572,522,327,111,12,622,2,1050
34017025307,1360,1164,912,137,28,7,94,1,252
34017035401,1380,1172,494,486,47,14,83,3,678
34017030C25,1422,1184,416,244,147,23,372,1,768
34017025103,969,830,599,76,23,9,131,1,231
34017005101,1587,1183,658,267,192,21,57,1,525
34017060109,2191,1760,172,1420,172,44,91,3,1588
34017060207,1480,1185,55,1098,54,56,23,1,1130
34017030E12,1482,1304,641,248,111,18,303,10,663
34017050304,1222,981,230,631,59,38,77,5,751
34007075011,1329,1045,932,26,57,0,34,0,113
34007075031,1452,1153,810,75,184,16,75,2,343
34007075036,1047,802,540,29,201,17,26,1,262
34007075018,2248,1610,740,142,614,10,119,3,870
34007043031,2100,1761,1071,119,261,24,301,1,690
34007055006,949,720,629,37,26,6,23,1,91
34007085010,1030,741,663,13,5,3,46,0,78
34007040304,2088,1461,36,895,542,52,11,6,1425
34007055007,1261,978,855,51,30,13,22,2,123
34007080009,785,623,547,28,9,6,28,0,76
34007043002,2239,1706,937,386,177,39,203,0,769
34015020002,940,708,607,37,47,15,5,0,101
34007170008,2444,1987,1122,75,362,9,430,2,865
34007075004,1444,1151,926,57,84,16,77,0,225
34031070504,2675,2449,1040,371,756,4,292,0,1409
34007085002,1502,1187,1049,32,22,13,52,1,138
34007170010,1255,971,644,46,120,10,151,0,327
34007080013,757,623,570,24,5,4,17,0,53
34015030004,1155,914,611,69,153,22,58,0,303
34015090024,1755,1419,1129,79,141,11,57,0,290
34031020101,2413,1830,860,769,148,15,50,6,970
34031070201,1225,961,796,76,13,4,60,0,165
34013070S19,1552,1104,0,116,1019,21,1,2,1104
34013045W04,1799,1285,21,340,929,14,4,0,1264
34027045303,1618,1270,257,900,68,35,57,1,1013
34027060003,1545,1262,947,109,48,6,143,0,315
34027070004,1524,1254,1088,105,15,15,26,0,166
34023025030,1426,1114,383,48,22,5,655,0,731
34023115008,853,684,514,76,32,5,35,0,170
34023125510,1562,1228,672,165,54,2,338,1,556
34027145023,1620,1374,519,102,37,25,698,5,855
34027175303,919,738,547,76,20,6,93,0,191
34027120401,1281,1087,614,312,98,44,55,1,473
34031035402,1315,895,12,649,328,23,6,3,883
34031040310,2213,1664,43,888,791,34,8,0,1621
34011ZZZZZZ,0,0,0,0,0,0,0,0,0
34023077105,2648,2153,1373,257,226,23,263,0,780
34023070606,1626,1572,730,177,105,5,519,6,842
34023050012,984,733,447,101,51,12,132,0,286
34023077107,601,567,452,51,24,1,40,3,115
34027035003,1807,1354,1164,53,29,1,85,1,190
34027050005,938,789,677,27,3,1,77,0,112
34015010013,1256,988,872,51,27,13,27,0,116
34023075024,1530,1171,299,104,183,13,586,0,872
34023020015,588,467,255,30,32,3,146,0,212
34023020032,697,541,287,72,42,0,141,1,254
34023025072,1917,1487,241,43,61,5,1142,2,1246
34023065302,839,674,571,46,14,3,40,0,103
34023065304,1402,1020,636,91,55,9,218,2,384
34023085307,1609,1335,325,82,218,12,719,3,1010
34023080502,2785,1937,77,1780,118,75,11,6,1860
34023110001,1461,1156,501,321,260,16,66,2,655
34023085407,1626,1291,176,66,192,12,858,2,1115
34023070405,3057,2029,73,1696,284,120,25,0,1956
34023005003,1476,1082,94,559,381,10,78,2,988
34023005002,2422,1871,402,561,574,25,364,2,1469
34023080406,1744,1289,109,1075,153,35,21,6,1180
34007043011,1696,1328,922,85,101,9,205,0,406
34021010015,1250,1049,387,82,500,11,68,2,662
34035090006,785,659,441,82,26,5,90,1,218
34021055W04,869,674,88,46,533,12,5,0,586
34021055W12,933,685,25,82,584,9,9,0,660
34021015050,1234,1026,838,46,52,11,75,0,188
34025055009,742,620,461,56,24,4,55,0,159
34025145003,1269,989,795,83,57,17,41,6,194
34025010001,583,473,386,38,26,7,12,2,87
34035005001,646,507,417,54,5,2,29,0,90
34035010021,1297,933,358,24,13,2,524,0,575
34021010003,939,811,322,105,362,15,29,1,489
34025040004,834,733,599,103,11,18,13,0,134
34025080004,946,695,591,53,26,11,11,3,104
34025245005,558,527,507,13,1,0,5,0,20
34025095028,1538,1170,842,88,83,12,138,2,328
34025095032,1378,1043,818,56,23,7,134,1,225
34025140011,741,590,492,41,19,1,37,0,98
34021015034,1067,882,640,97,60,13,60,0,242
34035030029,1225,981,651,82,50,3,194,1,330
34039015030,699,597,443,69,51,4,24,4,154
34039070204,1205,940,45,254,645,11,11,0,895
34039050007,1065,837,728,48,17,1,41,2,109
34039070302,1112,857,73,251,536,8,17,0,784
34037015001,791,631,566,31,12,7,18,1,65
34029035056,1247,967,825,66,24,16,29,0,142
34029030052,914,748,648,43,14,10,24,1,100
34037030002,1632,1333,1077,144,43,28,14,6,256
34039060307,882,661,46,178,449,35,20,1,615
34039065404,2125,1790,469,479,654,37,224,4,1321
34039060310,3173,2105,68,1453,594,65,17,2,2037
34039035102,1548,1186,25,139,989,6,18,2,1161
34039040006,1414,1138,798,245,27,6,57,0,340
34005065019,1355,1046,901,40,56,5,36,2,145
34039005011,744,535,383,56,8,5,75,0,152
34029035033,1791,1364,1197,106,18,15,25,0,167
34029060018,1178,919,794,70,13,12,15,1,125
34029060003,1045,828,749,41,13,8,19,1,79
34003115404,1702,1417,510,440,335,15,161,2,907
34003085007,1203,889,623,99,31,4,133,1,266
34003285001,1345,1098,698,246,59,7,94,0,400
34003095002,1453,1117,544,220,30,7,329,1,573
34005095005,863,847,776,25,32,6,10,1,71
34005125018,2383,1985,1189,131,373,24,276,1,796
34005025403,1121,922,669,57,163,25,24,2,253
34003030010,2056,1757,995,322,77,13,367,3,762
34003030014,1168,1044,618,77,30,8,314,0,426
34003030015,1243,1119,707,95,41,9,289,0,412
34003030002,2293,1752,587,900,75,37,181,1,1165
34003075202,1322,947,644,124,97,14,71,1,303
34003335008,1288,992,802,101,12,13,71,2,190
34005105002,1272,968,843,56,24,16,19,2,125
34005105015,1575,1252,1104,54,21,8,67,1,148
34013027S04,1701,1245,62,326,845,33,26,4,1183
34009025107,968,778,699,39,11,16,7,0,79
34003265005,1735,1328,1072,78,25,6,144,0,256
34003005002,1269,950,675,84,19,3,167,0,275
34003155002,3151,2484,1013,1043,276,30,173,5,1471
34013010302,1125,924,339,243,324,14,53,0,585
34019085001,998,869,752,87,15,13,14,0,117
34003160003,1918,1522,841,428,82,32,157,3,681
34003090004,3454,2567,537,1845,117,214,85,0,2030
34013095006,1291,885,662,53,127,8,47,3,223
34025140006,1197,920,739,65,23,11,90,0,181
34013070C38,2501,2021,159,460,1377,26,82,2,1862
34029030002,884,791,706,38,13,20,17,0,85
34029035059,711,697,647,31,3,7,5,0,50
34029025240,775,618,533,32,17,13,15,1,85
34029025320,932,660,584,51,19,3,5,0,76
34029055031,831,659,513,41,51,11,40,1,146
34029055013,1739,1441,1138,138,120,12,48,0,303
34017025507,2803,2312,1636,268,46,11,322,4,676
34017060306,2183,1681,142,1406,113,61,51,4,1539
34039100305,1322,917,727,51,15,5,112,1,190
34039100304,1248,899,656,49,60,5,130,1,243
34039080013,894,661,488,45,78,1,49,1,173
34017030C21,1635,1403,198,102,61,11,1034,1,1205
34005115003,1108,856,586,55,117,6,97,0,270
34005192028,1016,830,93,107,638,11,16,1,737
34003085012,1368,1011,699,108,35,3,176,0,312
34003330006,2050,1608,1343,110,21,7,124,1,265
34017040305,1138,915,159,683,28,14,44,0,756
34003215003,2208,1752,1076,98,33,8,537,1,676
34003195006,1591,1277,704,442,50,16,66,5,573
34017005206,1708,1328,680,351,154,20,161,2,648
34017040303,1305,1042,156,828,44,58,39,0,886
34017030B15,90,69,5,40,6,2,13,0,64
34017005313,825,668,311,181,106,11,101,0,357
34017050602,2514,1858,108,1668,108,94,37,2,1750
34017005115,1190,928,458,276,113,12,89,3,470
34017005107,1537,1227,657,337,136,8,115,0,570
34017005303,1407,1174,681,260,119,16,117,1,493
34017030D05,1391,1147,359,571,97,32,133,2,788
34017025601,936,808,606,71,9,4,126,2,202
34029035046,1471,1186,1012,105,20,28,19,2,174
34029120003,1313,1063,960,76,7,4,14,0,103
34029120004,1186,907,825,51,4,11,10,0,82
34029025331,1089,1086,1033,25,9,0,14,0,53
34017030D27,1777,1419,301,470,134,28,544,2,1118
34003095015,1886,1515,422,253,70,11,765,5,1093
34003145001,1536,1185,490,147,28,8,521,3,695
34003105202,2196,1708,961,603,100,42,58,0,747
34003155007,1192,962,487,359,67,13,64,0,475
34003205002,2815,2180,1289,127,47,3,710,0,891
34029070038,620,559,516,17,10,5,11,0,43
34007040404,1757,1290,70,775,496,44,13,1,1220
34007075034,1380,1155,766,42,257,15,70,4,389
34007090004,752,629,573,25,14,3,7,0,56
34015055107,1612,1234,926,60,156,8,68,2,308
34007095001,927,731,413,106,159,23,39,1,318
34031010114,1111,895,533,195,25,10,146,1,362
34015075003,1007,811,757,29,11,3,9,1,54
34007043015,1468,1165,838,93,91,11,132,0,327
34031035303,1635,1166,581,376,98,5,96,0,585
34015010018,764,731,653,20,38,10,12,0,78
34015040002,1449,1061,881,52,55,6,70,2,180
34031035203,1879,1437,218,892,99,39,236,1,1219
34011005203,5855,5346,465,2966,1990,52,10,2,4881
34027110015,384,339,286,23,6,0,17,0,53
34015055318,1589,1157,863,69,157,18,54,3,294
34015100003,978,780,679,28,40,10,20,2,101
34031070401,1016,786,647,58,8,4,73,0,139
34023025020,949,745,230,93,100,3,319,0,515
34023115013,996,794,539,148,70,6,27,2,255
34031020301,1419,1201,1002,124,37,11,39,0,199
34027180405,1005,777,643,57,21,2,49,0,134
34027135001,682,541,425,61,35,14,10,0,116
34027135002,822,600,449,73,25,7,53,0,151
34015110302,958,753,544,69,101,20,23,0,209
34035040546,1520,1229,300,338,461,66,164,2,929
34035050024,1047,813,540,29,32,2,202,1,273
34021030001,1331,1025,725,58,54,5,180,0,300
34023025021,996,819,392,149,102,8,161,1,427
34023125106,923,747,367,235,96,22,54,0,380
34027135009,1296,961,782,81,66,11,28,3,179
34025015003,2577,1671,70,427,1189,34,9,3,1601
34025190003,1356,1026,923,55,15,7,22,0,103
34025190005,1093,872,831,15,6,3,9,1,41
34025155030,976,727,670,34,3,3,16,3,57
34027025008,1368,953,695,55,17,3,176,0,258
34027005302,1120,907,630,110,70,5,91,1,277
34027160014,1306,996,745,107,30,6,100,1,251
34027080401,856,661,484,113,27,4,27,0,177
34027095005,907,663,578,31,7,7,27,0,85
34027025010,1270,1142,980,30,13,3,108,0,162
34021025002,999,793,735,28,11,7,8,2,58
34021050002,814,613,475,24,8,0,99,1,138
34027160009,1265,966,728,82,37,5,112,1,238
34023120006,834,655,445,78,52,7,83,0,210
34039090210,887,596,498,39,8,2,43,0,98
34039095046,1065,860,394,211,151,5,118,0,466
34023105006,1527,1158,571,279,55,19,240,0,587
34021015044,1108,935,721,64,37,10,96,0,214
34025115006,817,580,512,32,7,4,24,0,68
34025247004,1206,974,840,50,45,17,32,1,134
34021050006,1016,828,602,46,45,20,122,6,226
34035020005,624,521,337,108,45,14,22,0,184
34021055S04,2110,1402,184,1004,232,34,10,4,1218
34021035017,2169,1938,1164,220,369,22,181,2,774
34035070014,831,675,272,135,239,6,30,2,403
34029120006,966,786,690,74,4,26,5,0,96
34021015001,1278,1024,829,107,37,11,42,1,195
34021035007,1249,959,809,23,26,2,96,0,150
34021015062,777,644,540,55,20,3,29,2,104
34035055002,1748,1379,743,485,88,25,52,0,636
34035105003,1000,800,563,50,15,0,159,4,237
34035090011,848,692,468,60,38,3,120,0,224
34035100003,1417,1086,623,89,8,1,347,4,463
34035010019,1368,1123,821,49,37,0,210,0,302
34035105005,1512,1232,705,107,189,6,211,2,527
34025065002,1041,726,664,26,17,6,7,0,62
34039015002,563,415,362,27,3,3,25,1,53
34039015005,797,586,476,58,19,7,34,0,110
34039046004,1079,901,500,276,97,9,29,1,401
34013027W06,1395,1083,26,232,840,16,11,1,1057
34013010206,1953,1528,573,381,404,17,177,7,955
34013095012,3373,3052,1614,381,653,14,313,2,1438
34013025006,896,702,586,47,10,2,56,0,116
34013030509,895,704,12,66,631,8,2,0,692
34013027N04,1526,1144,45,535,579,36,37,3,1099
34013070E14,2188,1650,455,854,40,21,10,6,1195
34025260006,1465,1213,1082,72,12,16,33,0,131
34025200004,1196,971,756,151,28,9,25,4,215
34025155046,1340,1062,914,100,11,6,33,0,148
34039065301,1223,948,409,247,217,8,79,3,539
34031010301,1610,1235,482,605,118,17,63,1,753
34039030002,1210,975,834,76,19,11,31,1,141
34025247009,1872,1552,1079,126,196,15,131,0,473
34029025418,768,760,696,25,18,12,10,0,64
34019045002,1267,1011,662,234,38,29,70,1,349
34039055006,972,774,482,92,47,2,144,1,292
34029035042,1234,1006,907,66,10,4,17,0,99
34005050305,861,680,578,19,46,3,21,1,102
34039090208,696,547,353,68,40,9,70,0,194
34039095009,1852,1529,570,328,373,10,226,1,959
34039035403,1490,1145,356,326,367,7,82,5,789
34039095006,903,719,201,111,322,12,85,2,518
34025130022,1985,1524,1218,96,50,7,149,0,306
34025003010,1090,859,687,73,33,9,58,1,172
34025125008,1535,1233,522,468,97,13,37,0,711
34029090010,2220,1825,1235,280,214,31,71,8,590
34005135001,1461,1210,917,182,66,32,17,0,293
34039065501,1878,1536,440,462,453,30,203,1,1096
34005145001,1371,1109,672,140,240,44,52,6,437
34005060005,1245,951,284,119,489,20,63,0,667
34039035302,2424,1919,483,624,686,21,43,1,1436
34039100105,1068,710,600,24,16,3,64,0,110
34013070W24,1337,988,13,124,881,17,5,1,975
34013030306,929,736,1,44,707,13,3,3,735
34013065403,953,720,238,54,407,14,37,1,482
34013070E18,3005,2369,571,1144,115,52,29,4,1798
34025170011,2056,1635,252,299,1074,34,55,0,1383
34029120005,1473,1140,1046,55,3,15,10,0,94
34005040015,454,349,303,8,6,4,22,0,46
34013070S36,1595,1282,28,96,1157,19,9,2,1254
34013070N27,2013,1477,163,1043,150,32,80,18,1314
34013110104,1148,884,485,62,268,18,49,0,399
34013070N07,3417,2571,197,1970,433,53,70,6,2374
34013070N06,1130,929,78,451,394,11,22,1,851
34039045203,1163,911,399,328,152,23,24,0,512
34003170007,1762,1340,455,382,135,24,348,0,885
34013070W23,1495,1059,6,81,992,15,3,1,1053
34013070E01,2428,1907,628,861,57,23,25,0,1279
34013005402,1735,1384,385,782,132,26,91,0,999
34003155009,2131,1688,760,643,129,26,182,0,928
34003260002,1470,1121,718,96,26,3,296,3,403
34029120011,1574,1222,1085,89,4,11,17,0,137
34023095013,1171,939,620,132,62,12,120,2,319
34023065205,654,652,574,25,16,2,31,0,78
34025075001,2566,1850,419,1268,102,85,38,3,1431
34025047004,746,562,524,22,3,1,9,0,38
34025240004,752,628,602,10,0,2,11,0,26
34005105010,1156,841,791,17,8,7,14,0,50
34013110402,1704,1345,745,122,300,12,157,3,600
34037055006,914,728,563,79,44,10,26,2,165
34037035004,678,540,497,24,3,9,9,0,43
34003050010,1013,799,488,155,45,7,103,0,311
34003270003,1303,1048,614,273,26,7,127,0,434
34003015017,1432,1180,283,442,107,15,368,3,897
34003255019,1311,940,557,59,7,1,308,2,383
34003030009,1231,1030,521,319,38,12,138,4,509
34017005110,1644,1316,816,228,112,11,151,2,500
34005105017,1205,916,813,33,11,15,43,0,103
34017015005,1894,1435,234,1112,50,44,50,3,1201
34005192014,912,704,127,103,476,22,15,0,577
34017050801,1579,1209,144,1001,71,65,27,1,1065
34013030405,954,751,15,179,579,3,1,0,736
34017030E13,1318,1090,607,197,57,10,222,6,483
34017030D13,2123,1684,360,801,187,46,385,11,1324
34017030B11,2230,1646,134,454,864,22,231,2,1512
34017020403,1140,846,205,430,26,18,146,0,641
34017030F15,2189,1615,85,528,1067,10,28,4,1530
34017030C16,1328,1062,214,445,116,31,299,3,848
34017060209,1630,1225,79,1087,62,59,24,2,1146
34017005216,1571,1313,606,361,230,14,132,0,707
34007075014,2262,1914,947,201,579,31,137,3,967
34007040305,1923,1330,9,922,403,42,34,13,1321
34007135022,1438,1255,543,248,300,28,171,4,712
34007055004,1195,1017,819,61,74,27,39,0,198
34015110304,650,525,305,86,107,15,14,0,220
34015060001,684,530,467,20,25,16,4,0,63
34015090034,953,732,614,30,35,16,29,2,118
34031015001,1403,1036,215,579,171,36,79,1,821
34007140003,1855,1457,1047,89,261,28,38,2,410
34041115002,737,725,704,11,3,0,6,0,21
34007150001,1212,937,702,117,77,22,30,2,235
34007043023,2246,1771,912,186,207,34,447,1,859
34013027W04,2292,1776,47,271,1459,22,14,4,1729
34013045W02,1849,1341,32,278,1044,11,13,1,1309
34027175401,1040,790,619,95,22,9,37,0,171
34011070206,1617,1181,249,698,260,35,15,4,932
34031035205,2697,1984,99,1563,279,98,141,5,1885
34031050003,1604,1185,215,687,244,47,68,3,970
34031035308,1868,1257,349,594,222,35,170,2,908
34041015003,1071,831,744,54,6,9,7,0,87
34023040002,700,517,264,180,52,15,13,2,253
34023035003,776,614,457,49,54,4,55,0,157
34023025060,619,499,196,96,38,8,169,0,303
34027175103,1333,1081,676,228,56,1,120,0,405
34001090102,996,759,633,62,14,15,33,1,126
34023077607,1315,1068,738,144,66,16,106,0,330
34023077505,1071,881,636,118,59,7,66,2,245
34023080102,1688,1198,47,1103,116,28,3,9,1151
34023015004,1349,1027,419,406,134,2,60,0,608
34023077407,851,679,436,112,26,7,104,0,243
34007085007,1236,893,813,36,18,4,19,3,80
34007115004,1077,882,679,57,100,10,36,0,203
34021010008,902,772,592,49,79,16,29,2,180
34025245001,1055,911,822,45,5,10,14,0,89
34021015019,756,629,515,33,42,6,39,1,114
34025265005,1052,839,727,53,21,1,19,0,112
34035025010,812,619,513,32,24,1,46,0,106
34035005007,1151,1034,752,95,34,8,143,0,282
34025185004,1166,919,749,72,19,8,54,0,170
34025135002,1620,1277,1165,82,6,20,16,0,112
34035010003,1021,823,653,59,10,4,98,1,170
34035010007,978,706,605,39,6,3,51,0,101
34035030006,1018,816,589,43,18,2,158,0,227
34039045703,1282,1034,306,448,261,12,43,1,728
34039055005,1225,852,670,50,7,3,126,0,182
34029060016,2546,2173,1996,79,23,16,60,1,177
34039095011,1122,907,387,216,218,17,93,2,520
34039095036,1235,984,392,222,240,3,93,0,592
34039080005,1091,776,621,54,36,6,52,0,155
34039005006,1092,856,586,65,31,3,173,0,270
34039090106,771,602,424,80,27,13,49,1,178
34039015003,756,588,484,56,11,4,33,2,104
34039080010,956,715,398,58,185,7,63,1,317
34009025203,784,661,600,28,18,7,12,1,61
34003255017,1176,826,603,50,16,3,148,0,223
34003085011,1439,1097,747,170,40,10,146,1,350
34039020502,1813,1295,67,870,339,40,12,6,1228
34003115403,2301,2062,940,365,502,17,297,3,1122
34009025103,644,538,496,29,12,4,0,1,42
34003085008,1593,1264,797,220,51,7,205,3,467
34003305004,1262,909,569,68,10,1,264,0,340
34005030003,1062,802,479,45,197,15,65,1,323
34013070N05,1705,1466,212,841,431,25,44,2,1254
34013030210,1563,1175,14,141,1018,34,5,1,1161
34009055012,1102,832,797,18,6,3,5,0,35
34029035028,1352,1016,917,53,15,5,24,0,99
34013027N02,2678,1962,45,622,1313,37,23,3,1917
34019120002,1199,932,817,37,12,2,46,0,115
34013070E11,2520,1868,523,876,99,30,14,8,1345
34003095004,1060,989,789,50,14,3,129,0,200
34013070C29,1471,1007,23,720,348,35,1,5,984
34025130009,1376,1050,900,62,16,3,68,1,150
34029150014,422,414,381,16,4,2,9,0,33
34029075002,777,701,651,26,6,6,8,0,50
34037090004,1013,784,718,32,11,7,8,0,66
34039020607,1996,1416,44,1190,195,27,22,1,1372
34029035044,1247,971,782,58,16,2,109,0,189
34005050205,512,400,321,15,38,4,12,0,79
34005192022,415,336,31,25,287,4,3,0,305
34005192031,598,477,82,47,336,12,19,1,395
34003255007,1595,1207,885,78,30,8,203,1,322
34017040604,1729,1330,201,995,63,45,77,4,1129
34017040603,2333,1839,279,1391,104,58,107,7,1560
34017050105,1418,1117,133,893,89,55,54,6,984
34017040401,1775,1388,282,998,89,39,59,0,1106
34003115304,1997,1667,343,542,633,39,163,1,1324
34017005312,1264,969,502,294,103,11,75,8,467
34017005306,975,785,372,249,86,12,85,0,413
34017040102,3347,2917,1015,1023,276,40,621,7,1902
34009030001,1179,929,775,41,58,14,21,3,154
34009030017,1152,928,738,61,116,5,9,1,190
34017055301,2314,1900,642,941,177,53,199,3,1258
34029090014,1029,1020,952,32,12,6,12,0,68
34029090015,786,781,710,26,25,13,13,0,71
34029025425,979,970,926,30,6,2,4,0,44
34017030C17,976,841,237,322,68,17,195,3,604
34017030D08,1515,1266,481,539,83,35,164,4,785
34003105401,3086,2362,1362,689,167,23,169,1,1000
34003225003,1985,1633,242,333,28,30,1034,0,1391
34003050002,1908,1573,859,319,64,18,339,8,714
34003075401,1180,914,18,363,529,20,42,2,896
34003195009,1633,1360,836,389,33,24,89,0,524
34029035003,975,792,688,39,21,11,22,0,104
34007043030,919,725,558,43,32,4,86,0,167
34007170016,1101,755,522,20,51,3,157,0,233
34007110008,2441,1999,701,267,945,68,102,0,1298
34031010122,1240,1007,593,260,60,6,98,1,414
34041015002,633,513,446,34,10,15,7,0,67
34041100004,730,594,519,26,20,4,15,0,75
34015010009,1363,1055,352,67,590,25,47,1,703
34031040207,1514,1179,157,667,222,12,179,0,1022
34015100011,794,613,553,10,14,14,13,1,60
34027085003,2736,2419,1557,264,244,26,364,7,862
34031070203,1382,1113,787,147,30,5,144,2,326
34031040301,578,367,27,204,150,3,2,0,340
34023015003,857,639,445,109,39,7,39,2,194
34011005305,1965,1305,242,575,474,69,5,2,1063
34027145015,1435,1145,498,135,28,4,484,0,647
34035070004,1569,1362,426,429,378,19,132,1,936
34035040332,1249,990,307,119,258,16,316,0,683
34035040333,1305,995,192,64,227,14,509,0,803
34035040334,1613,1199,120,238,567,16,288,1,1079
34035030031,1448,1193,733,137,59,16,254,3,460
34023020027,1189,930,678,71,17,4,159,1,252
34025260019,1107,972,878,63,10,3,8,2,94
34025145002,1500,1117,608,226,170,8,97,1,509
34027130001,949,744,567,94,34,20,27,3,177
34027095002,1802,1343,1113,54,33,4,117,1,230
34027060001,2327,1918,1368,173,94,7,263,2,550
34027090005,976,807,726,39,9,1,28,0,81
34023125411,1968,1534,417,139,143,12,834,0,1117
34023025009,676,520,266,122,32,14,107,0,254
34023110013,1670,1311,683,277,236,21,106,1,628
34039090206,918,634,425,113,31,7,45,0,209
34035010014,1141,836,635,60,54,10,74,1,201
34035050032,1317,1031,630,87,94,4,222,7,401
34035045001,1318,1021,722,138,35,18,103,1,299
34021010018,1620,1449,964,108,279,10,94,0,485
34035050018,929,683,538,30,11,1,102,0,145
34021065006,1130,809,486,30,26,4,264,1,323
34001105201,1333,1035,804,88,117,10,21,4,231
34021015015,2753,2362,1648,245,258,17,208,8,714
34021010012,995,830,408,110,276,24,38,0,422
34035090001,889,737,495,155,28,19,46,0,242
34035040324,932,835,426,71,152,9,192,0,409
34039060206,760,640,259,79,272,14,50,2,381
34039080020,1635,1163,787,59,56,7,255,0,376
34039010303,794,614,513,48,6,3,33,2,101
34017030A03,2222,1768,234,337,297,23,902,11,1534
34025ZZZZZZ,0,0,0,0,0,0,0,0,0
34013027S02,1843,1515,102,117,1282,25,36,8,1413
34013070C40,3001,2367,67,389,1922,23,20,2,2300
34013027N05,1858,1337,43,274,1020,23,17,5,1294
34039015022,721,535,465,31,5,2,27,0,70
34025075003,1469,1061,401,559,62,48,25,3,660
34025080003,1012,817,697,26,32,11,49,0,120
34039045903,753,526,290,118,76,4,21,2,236
34039046905,571,482,226,74,76,0,97,1,256
34031040611,2813,2037,791,1036,180,19,55,4,1246
34025045003,1388,1108,1045,27,5,5,21,0,63
34005100010,1006,831,724,60,17,7,15,1,107
34029055025,2210,1612,1138,160,136,14,150,2,474
34029090020,779,769,697,23,33,3,8,0,72
34005192036,748,619,77,59,470,5,18,1,542
34039090109,793,583,408,35,11,3,118,1,175
34039050003,748,599,456,61,4,4,67,0,143
34039020601,2463,2023,240,1304,481,46,51,0,1783
34039040001,1519,1151,691,267,87,20,69,0,460
34041020001,1252,1045,910,67,19,16,26,4,135
34029030019,1199,1015,939,58,5,8,3,0,76
34005040020,711,556,480,31,21,1,22,0,76
34005100017,529,480,398,21,28,9,24,0,82
34005192016,952,774,109,79,568,13,22,0,665
34013070E21,2150,1768,402,999,272,47,35,7,1366
34013070C17,2336,1846,231,309,989,16,320,1,1615
34013025009,1028,810,650,58,23,6,71,3,160
34019050001,1179,974,867,48,2,5,24,1,107
34019040003,716,622,540,37,18,9,18,0,82
34005025202,806,641,365,57,198,10,20,0,276
34025115005,749,587,538,23,7,5,16,0,49
34009055009,882,665,618,7,5,16,9,0,47
34029090011,786,783,699,40,23,4,15,0,84
34013010309,1211,927,101,403,341,31,83,3,826
34037110013,823,635,564,42,15,9,0,1,71
34009030005,1130,900,746,42,88,12,11,0,154
34039080002,1199,950,426,147,230,9,138,1,524
34003160005,1187,971,630,226,18,13,77,1,341
34003015007,1552,1298,304,414,139,18,461,2,994
34013095001,1404,1044,537,96,299,16,107,0,507
34013030402,245,178,0,16,167,1,1,0,178
34013070E15,1677,1314,411,661,53,30,10,6,903
34013070E10,2212,1709,625,676,69,19,9,2,1084
34013045N07,1726,1276,18,62,1197,16,5,1,1258
34013060014,1039,723,443,17,12,5,243,0,280
34029090018,625,620,531,34,35,9,15,0,89
34029070002,3411,1453,1344,66,17,4,5,1,109
34017040506,1100,956,113,808,55,22,23,9,843
34017040501,1173,1038,228,761,26,15,27,1,810
34005105011,1559,1155,1077,29,14,7,15,1,78
34005100013,537,426,389,16,1,10,10,1,37
34013030412,993,782,26,64,692,17,17,8,756
34013065404,1614,1258,238,319,664,20,57,3,1020
34025155017,1085,859,754,66,7,8,9,0,105
34003320002,1987,1556,1170,212,47,12,123,0,386
34017005104,1402,1056,591,296,126,16,54,1,465
34005100007,902,699,561,53,36,14,28,4,138
34005100004,960,750,638,40,25,17,24,3,112
34005155007,1376,1076,689,114,101,16,39,1,387
34037110014,1027,837,684,76,23,26,23,1,153
34017030B22,839,707,236,172,102,10,198,1,471
34013030314,1628,1310,41,118,1168,14,25,0,1269
34017030C18,1648,1415,579,473,155,28,216,13,836
34017045203,1109,909,480,196,38,4,203,0,429
34017030F13,1437,1093,120,253,714,26,31,1,973
34017025501,980,850,637,72,43,21,91,4,213
34017060104,1697,1289,73,1148,60,72,41,4,1216
34017040702,1436,1189,158,863,82,29,105,6,1031
34017030C31,1089,864,230,268,54,14,313,0,634
34017051002,2003,1531,79,1387,84,70,28,0,1452
34007135019,1096,823,209,361,189,19,87,2,614
34007043042,871,697,565,35,34,11,58,0,132
34007040207,1516,1072,25,318,745,39,7,4,1047
34015050003,1176,920,836,28,29,13,10,0,84
34015040006,1328,1024,885,42,40,14,42,0,139
34015010015,1154,907,636,75,174,25,15,0,271
34031035201,2162,1616,215,873,179,32,419,2,1401
34007075029,1766,1321,891,57,239,28,108,3,430
34007090006,1230,990,891,36,24,12,25,1,99
34015090027,1332,1006,659,100,179,9,63,4,347
34015050007,727,553,507,18,19,6,4,0,46
34023025063,2572,2031,531,412,461,24,665,4,1500
34013010313,1560,1211,259,471,381,31,139,3,952
34013010312,1232,1024,312,347,302,28,80,2,712
34013105009,1257,962,820,74,19,7,45,4,142
34013005302,1525,1164,263,747,141,14,43,9,901
34023005018,1136,871,284,213,97,16,288,2,587
34005100014,1341,1117,511,110,338,21,145,0,606
34031080001,1580,1231,510,618,69,23,45,0,721
34027175204,820,612,435,54,22,2,91,0,177
34011070105,1780,1445,573,686,206,34,7,2,872
34031035307,1582,1077,286,616,95,25,109,0,791
34023105005,1176,891,555,71,62,14,193,0,336
34023035012,1080,879,370,204,133,36,167,3,509
34027160018,1725,1312,950,146,67,7,135,1,362
34027175402,1104,841,645,96,34,9,42,4,196
34023005010,1060,832,282,238,61,17,269,2,550
34023080604,2252,1651,203,1341,129,35,15,1,1448
34023095029,643,498,336,80,20,3,48,1,162
34023080202,2117,1596,204,1147,336,36,50,5,1392
34023070204,1627,1092,148,740,166,22,39,2,944
34023090012,1726,1208,212,62,98,8,840,2,996
34023085105,1608,1289,493,341,230,18,198,1,796
34035050022,941,734,577,23,14,4,114,1,157
34035100006,1015,789,561,41,24,3,156,1,228
34035030016,1246,996,743,53,31,16,156,1,253
34035030033,1328,1023,571,75,32,9,322,0,452
34035005004,831,689,510,31,15,12,125,0,179
34025125006,1522,1134,472,242,196,18,67,1,662
34039105002,733,637,553,48,10,13,15,3,84
34039105001,690,573,496,51,14,2,6,1,77
34039095004,1405,1138,341,221,363,13,200,1,797
34039060309,1632,1233,71,566,560,31,28,1,1162
34039060207,1242,889,70,323,498,35,14,0,819
34039100204,1241,881,753,41,20,2,61,3,128
34039060403,2594,1780,34,1076,683,56,25,2,1746
34039090111,1036,752,422,144,99,1,84,0,330
34039085013,928,709,542,65,20,2,70,1,167
34039060209,622,544,313,64,143,9,21,1,231
34039060106,1164,914,37,246,612,28,12,1,877
34039046003,1513,1270,654,279,271,7,71,3,616
34029035025,1106,1012,774,127,44,20,62,0,238
34029120008,935,756,702,43,3,5,4,2,54
34029120016,1011,779,737,23,1,3,5,2,42
34003025005,1385,1163,743,247,21,16,140,0,420
34003025004,1228,988,644,206,50,16,95,0,344
34003105303,1757,1386,813,418,107,12,69,0,573
34005115007,833,641,547,39,33,8,16,0,94
34003300013,1605,1251,60,303,843,26,97,3,1191
34013005103,1516,1254,451,506,214,17,99,4,803
34013070E08,2199,1714,610,739,59,28,2,2,1104
34003115302,1101,1022,453,261,216,18,103,1,569
34013080201,817,653,493,92,22,7,42,0,160
34005192026,664,546,62,71,410,1,11,4,484
34003020004,1470,1178,459,546,96,25,104,2,719
34003105502,2169,1693,1091,465,86,19,61,3,602
34025210001,1300,960,861,43,12,3,22,3,99
34013040007,1179,828,602,66,88,16,72,1,226
34039002047,2325,1807,133,868,784,65,67,0,1674
34017030F09,1687,1333,217,532,471,25,164,3,1116
34017040703,1516,1178,142,913,97,42,91,2,1036
34017035301,999,808,480,239,24,16,52,1,328
34017040302,1092,912,103,763,68,34,17,5,809
34003225007,1805,1528,226,226,20,16,1054,2,1302
34017060107,1409,1159,374,230,54,6,505,0,785
34017030A11,1114,829,72,320,400,13,34,2,757
34017050102,1018,802,152,554,67,29,67,0,650
34017030A13,1174,899,104,354,385,7,79,0,795
34009025207,511,458,429,8,13,5,5,1,29
34017040704,1644,1292,174,745,84,51,332,5,1118
34029070018,575,573,464,48,61,0,3,0,109
34029090013,877,874,786,28,39,6,14,0,88
34029030037,1485,1194,1043,89,17,19,23,2,151
34029003008,970,946,874,44,14,4,7,0,72
34003195001,1089,892,479,302,43,11,60,3,413
34029003003,1559,1238,1031,105,44,15,41,1,207
34031010303,911,690,296,286,49,9,72,0,394
34031010304,1103,881,300,456,102,20,58,6,581
34041040003,1276,1005,642,277,32,16,32,0,363
34015025001,1039,835,703,55,53,14,10,1,132
34023005013,1207,911,272,383,121,9,140,0,639
34035065001,1127,890,436,53,32,5,364,7,454
34023115004,772,607,443,77,39,8,24,3,164
34023075004,1954,1517,395,382,311,31,424,7,1122
34025065001,1069,683,642,19,5,3,6,0,41
34027110001,824,627,469,112,18,7,17,0,158
34027005401,1164,879,548,125,64,11,132,1,331
34027145037,629,493,310,56,22,1,104,1,183
34027070012,1444,1163,1027,81,15,6,37,0,136
34027085008,1210,899,748,66,10,3,69,0,151
34027135003,634,482,383,50,18,10,28,1,99
34027135004,1388,1138,913,106,47,13,70,1,225
34023085108,1141,930,293,117,244,17,292,3,637
34023025029,1371,1116,443,160,102,10,401,2,673
34023025048,728,595,275,76,27,4,218,2,320
34023080608,1381,1017,51,917,103,28,6,2,966
34023100101,633,529,354,127,28,6,15,1,175
34023077504,829,651,482,84,38,4,39,2,169
34023035006,1272,995,393,201,226,22,175,2,602
34039080001,1312,999,239,165,511,18,100,9,760
34039070103,589,472,75,170,210,11,21,0,397
34039015018,712,482,387,60,14,1,24,0,95
34025130024,1134,877,759,66,21,8,26,5,118
34025185021,1180,913,742,58,40,9,61,1,171
34035040217,802,796,621,18,46,0,104,0,175
34021030006,1237,973,851,46,19,10,35,4,122
34035095001,1605,1313,732,354,143,38,95,0,581
34021065007,959,748,431,41,25,6,234,0,317
340210055E7,2219,1561,136,890,560,51,5,6,1425
34021015059,1554,1324,1140,76,33,8,74,0,184
34035025007,1181,918,715,57,18,7,125,2,203
34021065005,1157,863,425,37,24,8,366,0,438
34035025006,1275,1017,843,60,28,11,73,2,174
34025035004,1482,1269,937,239,40,44,35,5,332
34039010402,887,677,605,48,5,0,15,1,72
34025003012,1740,1541,1274,119,45,6,81,2,267
34019110008,1120,945,790,60,22,1,64,0,155
34013070S34,1489,1079,27,80,983,8,4,1,1052
34013045S02,1748,1227,17,210,1010,25,15,3,1210
34025075002,1375,1075,700,285,55,17,35,1,375
34039020602,1221,958,78,724,168,23,4,0,880
34025185018,1594,1381,744,162,329,24,137,1,637
34031070305,1150,894,772,65,9,2,39,1,122
34039095037,953,811,275,187,240,10,112,1,536
34039100107,758,584,507,16,13,0,44,0,77
34029035057,1139,934,784,74,13,13,43,0,150
34029035010,2250,1701,654,677,222,75,160,0,1047
34039080014,812,585,474,34,22,7,41,1,111
34013110303,1301,1048,306,344,347,13,56,0,742
34005100002,705,577,487,47,17,10,24,0,90
34029090004,737,687,588,38,31,17,26,1,99
34013090102,1378,1211,975,59,56,4,103,0,236
34013070N21,1376,1071,95,655,339,32,15,2,976
34013110504,1261,956,221,252,450,17,37,1,735
34039060203,746,608,100,107,395,6,7,2,508
34003155004,2143,1716,537,600,354,16,271,0,1179
34013080302,1242,971,600,213,75,9,84,0,371
34013080107,1380,1130,708,203,68,11,152,1,422
34003085019,1224,940,642,142,29,4,139,0,298
34023055009,1290,1025,782,112,43,10,80,0,243
34023055003,1517,1191,510,428,130,34,111,1,681
34003330002,1178,970,807,94,16,5,55,3,163
34017030F26,345,247,5,131,103,8,13,0,242
34013055016,993,678,485,45,96,8,41,1,193
34013070S16,1529,1134,10,140,1006,14,11,3,1124
34013010105,1732,1432,322,294,589,15,221,1,1110
34019105019,1194,967,747,76,27,9,109,1,220
34013030105,2105,1713,64,125,1523,24,20,0,1649
34013065204,831,561,422,42,54,5,37,0,139
34013110106,1837,1350,208,543,562,31,44,1,1142
34037090002,998,795,709,39,11,1,18,2,86
34003315001,2060,1485,1158,94,37,7,199,4,327
34019070001,1034,820,738,55,5,4,23,0,82
34017030F24,1632,1191,20,258,923,16,27,7,1171
34005100009,665,523,422,54,11,10,24,1,101
34013010209,1787,1353,903,185,83,9,170,0,450
34013110503,1252,987,472,139,336,16,50,0,515
34017040105,1255,1046,342,516,106,24,128,3,704
34017015002,2398,1828,214,1520,114,71,57,7,1614
34017025606,1949,1733,1261,223,72,12,167,4,472
34017060307,2063,1527,98,1335,103,85,28,3,1429
34017030C12,1426,1178,380,240,142,36,421,7,798
34007015004,2194,1862,1326,132,308,21,70,1,536
34007043038,1115,841,632,30,63,4,123,2,209
34007043040,1030,782,641,25,22,6,82,1,141
34015100005,950,723,565,50,70,15,16,0,158
34007055012,784,642,545,26,38,11,18,0,97
34007175002,1658,1293,1040,66,111,31,40,1,253
34041105004,1434,1211,910,157,90,30,35,2,301
34015090015,900,707,612,24,39,6,21,0,95
34031010107,1634,1300,705,300,58,7,217,4,595
34015090023,1155,899,779,60,29,5,24,0,120
34013025002,1667,1378,1126,100,44,4,108,1,252
34027180403,935,736,612,56,11,3,44,0,124
34023077408,1431,1119,567,247,174,10,150,3,552
34005105013,2140,1542,1358,52,44,9,64,3,184
34023077404,808,683,446,120,50,4,68,0,237
34027110020,1155,901,660,135,40,9,57,1,241
34025130002,1869,1399,960,91,120,11,218,0,439
34027145022,3098,2501,802,299,150,26,1247,0,1699
34001080004,946,887,819,46,1,8,16,4,68
34023125210,1042,818,369,359,63,16,28,0,449
34023105009,1169,977,507,84,74,16,316,0,470
34023077509,839,674,483,92,29,7,69,0,191
34023080105,864,649,72,526,97,22,5,3,577
34023080101,720,576,148,383,64,12,14,0,428
34007085006,1244,850,791,19,9,5,27,0,59
34035070003,2424,1791,254,1284,220,55,40,4,1537
34035020006,1327,1048,402,506,75,55,53,2,646
34025080006,1036,790,539,157,60,10,37,0,251
34025080008,1273,1015,808,67,30,5,65,1,207
34021015026,1352,1148,733,154,207,26,49,2,415
34039095049,1247,1002,79,115,756,11,60,2,923
34039080007,1478,1097,816,101,98,3,78,5,281
34039015009,823,593,529,46,9,2,6,0,64
34039045202,1286,996,470,352,121,9,41,0,526
34039020308,1122,823,398,363,40,21,13,1,425
34039080003,1158,901,666,103,55,11,69,0,235
34039095048,585,516,238,114,93,0,68,0,278
34003030006,1434,1166,642,359,29,24,126,2,524
34005075303,1193,947,763,50,88,24,28,1,184
34013065306,1468,1235,600,121,452,6,54,1,635
34013070S44,1504,1149,3,100,1059,13,7,1,1146
34003170006,1371,1098,595,294,77,4,136,1,503
34003300003,1910,1449,752,282,253,13,159,3,697
34029030040,882,825,783,11,4,2,16,0,42
34013010210,1939,1515,669,499,207,22,154,0,846
34017030B16,862,711,215,140,204,3,154,5,496
34005125013,1074,801,709,41,25,2,18,0,92
34003095009,1463,1169,367,166,67,9,577,2,802
34003265003,1868,1440,1214,81,14,5,124,2,226
34017015003,2163,1701,220,1362,136,52,82,1,1481
34003070002,1256,1013,746,140,34,9,92,1,267
34003070006,882,694,533,82,11,3,63,0,161
34003255004,1143,776,599,60,11,2,99,1,177
34003225006,1792,1494,163,286,34,24,1024,1,1331
34017005112,1491,1146,604,329,132,10,96,2,542
34017005111,1231,959,576,264,96,0,49,1,383
34017030A20,1360,1016,35,279,715,24,41,6,981
34003260007,1641,1201,665,121,31,2,397,0,536
34017040203,1346,1046,126,841,42,47,56,6,920
34017040103,1426,1248,479,603,75,21,105,0,769
34017005214,1082,804,287,233,134,7,164,2,517
34017005305,907,726,478,117,60,12,67,0,248
34029035027,1795,1406,1150,183,39,16,28,1,256
34003195002,1457,1184,636,448,47,17,57,3,548
34031035302,1942,1311,715,405,83,29,79,0,596
34041075005,980,740,574,57,47,11,47,4,166
34015115001,878,697,637,26,15,8,7,6,60
34031035209,2139,1533,38,1233,329,101,11,3,1495
34031035407,1620,1165,50,1026,147,84,12,1,1115
34031035208,2223,1500,32,1200,338,70,24,10,1468
34027145004,1257,1017,594,87,59,2,278,1,423
34015095001,930,734,664,26,18,12,24,0,70
34011070505,1157,913,412,323,188,24,5,3,501
34031010501,1514,1114,220,763,130,20,48,5,894
34023080403,1885,1372,61,1280,125,53,9,1,1311
34035050011,735,590,467,33,13,6,69,2,123
34035095002,1926,1557,622,470,250,51,209,1,935
34023077502,973,736,587,61,33,6,51,0,149
34023100303,1039,816,574,135,61,14,47,3,242
34023080614,1462,1186,261,788,157,21,21,2,925
34027180304,1226,1048,794,121,48,0,75,0,254
34011070502,958,740,309,316,121,24,19,1,431
34025095021,677,648,552,57,17,7,19,1,96
34025155005,1142,867,778,48,10,9,11,1,89
34027135019,747,582,466,59,34,0,29,0,116
34027170004,1598,1292,780,261,31,8,208,1,512
34027135018,1376,1090,764,171,62,12,81,2,326
34027165001,903,746,628,88,8,6,20,0,118
34023025008,692,558,304,114,53,7,68,3,254
34023035013,2401,1982,653,245,216,15,851,2,1329
34039090203,869,649,399,154,34,9,59,0,250
34027170003,1050,889,587,212,17,3,67,0,302
34025200003,1166,969,661,220,48,12,35,0,308
34029090035,627,614,541,36,10,2,24,0,73
34021065002,719,562,395,43,28,4,106,1,167
34021035008,1106,894,641,98,65,8,74,0,253
34021010022,4299,4183,2250,630,1000,25,289,2,1933
34021065008,1131,822,395,48,23,5,369,0,427
34029035060,1362,1039,629,234,44,52,115,0,410
34021005001,2110,1654,974,165,127,26,353,2,680
34039020304,1096,860,360,413,48,7,52,0,500
34039020402,2552,1908,148,1188,543,49,54,6,1760
34039095039,695,590,120,91,318,16,73,3,470
34039095018,1173,901,62,107,711,7,36,0,839
34039095028,979,808,182,114,334,6,155,1,626
34025080022,927,720,573,26,29,2,82,0,147
34025090002,1741,1338,860,62,12,8,384,2,478
34013070N23,1850,1358,30,1156,271,51,3,3,1328
34013070E30,1877,1491,117,775,575,15,21,1,1374
34013010108,1138,920,407,283,168,29,65,1,513
34039005010,1013,738,562,45,8,1,111,0,176
34025155038,1186,867,773,35,3,10,37,1,94
34029115005,1520,1215,1005,126,22,29,22,0,210
34029115001,1097,872,727,78,23,24,21,0,145
34005125001,1858,1579,1137,69,241,18,120,1,442
34037035002,1079,886,812,26,9,9,18,0,74
34005025101,774,635,302,43,278,7,16,1,333
34039005005,1027,786,601,57,19,6,100,0,185
34005055007,1544,1172,370,116,387,11,314,1,802
34005192008,944,750,107,70,566,17,26,0,643
34005192001,1672,1338,178,173,920,30,63,1,1160
34005025303,1478,1078,361,105,587,21,37,1,717
34039060305,711,567,61,81,419,4,7,0,506
34039002049,1981,1549,133,793,585,44,62,10,1416
34013110411,829,668,340,91,181,7,61,0,328
34037010004,536,453,388,28,9,8,13,0,65
34013070N01,2514,1814,228,1305,214,40,83,10,1586
34029055008,3624,2533,1815,309,295,47,65,1,718
34023125309,1362,1059,417,254,159,9,230,4,642
34017040402,1757,1377,272,974,62,38,90,0,1105
34005125009,1240,946,798,34,49,10,46,0,148
34017050803,1907,1510,127,1290,84,90,65,4,1383
34017030B17,1405,1048,223,375,390,31,94,2,825
34017045202,1738,1368,614,207,65,1,480,2,754
34013010207,1214,991,576,203,104,20,110,0,415
34017040204,1626,1266,194,1009,39,38,42,1,1072
34017030F20,1535,1147,59,283,795,12,31,7,1088
34017060101,2162,1681,88,1451,107,91,69,1,1593
34017060105,2312,1735,111,1517,86,131,59,14,1624
34007080007,828,642,568,35,14,4,15,0,74
34015035003,691,571,539,7,4,9,11,0,32
34031050002,1831,1318,227,810,276,30,64,0,1091
34031060003,1883,1519,979,365,71,16,104,0,540
34031010402,3682,2711,474,2076,210,109,56,1,2237
34041005003,960,783,652,41,54,8,24,3,131
34031040308,1534,1214,18,655,600,50,8,2,1196
34041040002,1418,1180,789,192,134,20,53,0,391
34031020102,1376,1084,722,299,52,27,12,0,362
34027085007,980,736,560,65,26,5,82,1,176
34011070202,1145,910,224,507,156,30,28,2,686
34023025007,552,422,219,33,40,9,122,3,203
34023077106,556,532,436,44,19,1,29,1,96
34023060006,590,446,373,53,6,3,11,0,73
34035025005,967,764,638,43,21,4,51,2,126
34035030010,1336,1065,808,63,27,7,145,0,257
34035030012,1214,911,731,38,10,8,120,0,180
34035040108,1254,1025,299,104,295,18,322,0,726
34035015004,1111,846,653,141,13,7,25,1,193
34019110015,619,471,409,23,11,5,17,0,62
34039055010,1131,829,576,44,23,7,178,0,253
34039020205,1799,1427,250,1024,134,35,37,1,1177
34039095029,1091,895,378,148,268,6,101,0,517
34005115014,1035,711,629,17,15,10,41,1,82
34039090212,970,653,521,27,18,1,73,0,132
34003255016,975,673,555,32,2,6,72,1,118
34003067006,1389,1099,338,357,142,4,242,3,761
34013030303,904,665,8,36,622,8,8,1,657
34029035047,770,735,651,46,17,3,16,1,84
34029025428,643,639,611,16,2,4,6,0,28
34029003011,3600,2686,2131,282,168,56,68,4,555
34013070N08,1966,1504,142,1122,300,43,20,6,1362
34013070S12,1118,824,16,65,749,12,1,3,808
34013015003,900,699,517,121,28,7,28,1,182
34025140024,1648,1262,751,50,52,5,398,1,511
34009025301,674,542,492,24,9,4,8,0,50
34017025206,2728,2158,1638,118,29,11,340,3,520
34017025203,1320,1084,782,196,36,7,76,4,302
34017020302,1915,1514,402,653,66,28,353,3,1112
34017040106,1319,1120,332,660,71,40,90,1,788
34003035002,1450,1102,607,109,22,3,364,0,495
34017030B03,1302,1104,356,306,249,23,200,1,748
34017050903,1873,1432,86,1270,85,74,44,0,1346
34017050904,1166,871,48,763,75,59,45,2,823
34017030B06,1656,1267,296,255,133,13,595,0,971
34017005315,1068,833,403,234,127,15,78,0,430
34017030B07,1525,1246,308,315,76,20,552,4,938
34017020102,2290,1793,322,1083,82,54,279,1,1471
34015030007,1650,1364,1011,64,172,18,96,0,353
34027030001,1681,1302,1033,188,16,25,54,2,269
34027180302,784,647,541,50,21,1,39,0,106
34015090018,1365,1078,891,57,77,12,43,5,187
34027115002,1249,1022,730,71,45,2,169,0,292
34023077306,977,807,576,114,60,7,67,0,231
34027160015,1163,849,557,92,20,1,169,1,292
34027175102,1199,942,603,190,63,4,92,0,339
34027175404,525,419,344,42,13,9,11,1,75
34027175104,660,529,347,91,33,5,51,2,182
34023025025,1019,788,271,116,71,11,326,0,517
34023105011,1041,795,420,42,34,10,291,2,375
34039050009,805,618,523,47,19,3,29,1,95
34023035009,938,692,493,82,33,11,61,4,199
34021015060,1621,1314,1116,102,53,19,43,1,198
34035065016,1079,760,486,47,7,4,214,0,274
34035065019,959,753,542,18,11,0,179,0,211
34021015048,661,632,552,30,24,2,27,0,80
34021010013,757,560,80,92,379,6,10,0,480
34035105002,1334,1057,752,93,31,6,148,1,305
34039020509,3090,2459,503,1569,225,43,64,6,1956
34013030201,1689,1330,41,142,1154,27,41,4,1289
34013070W31,1520,1203,27,72,1116,9,7,1,1176
34025065003,974,705,642,30,6,2,26,0,63
34025140017,1198,870,715,36,11,6,94,2,155
34025247012,588,583,552,1,4,0,25,0,31
34025065004,1013,715,677,15,4,2,15,1,38
34029030054,2514,1817,1040,340,375,14,50,0,777
34005192030,857,691,87,35,551,15,21,0,604
34029025423,634,632,570,29,10,3,15,0,62
34025095006,1935,1502,1022,201,137,21,141,1,480
34005040017,1120,890,798,22,24,10,30,0,92
34013030202,1732,1369,15,194,1158,18,11,0,1354
34013027E02,2230,1656,14,542,1100,45,18,3,1642
34013070S15,2204,1690,33,157,1539,24,7,0,1657
34013045E09,2022,1428,24,117,1312,18,18,1,1404
34013070E17,1969,1522,438,763,85,30,23,4,1084
34013030311,1483,1164,14,76,1074,12,1,0,1150
34013070S08,1516,1068,21,169,877,24,5,3,1047
34017055103,839,688,448,175,24,10,52,4,240
34017005309,1114,836,479,179,80,16,97,3,357
34017030D18,1502,1134,221,455,88,28,405,1,913
34017030B24,1620,1216,168,415,284,22,310,8,1048
34017025605,1068,904,701,77,25,9,97,0,203
34007115001,1163,953,504,126,283,21,38,1,449
34031070301,873,634,558,45,11,6,18,0,76
34007075003,1081,886,726,55,71,15,28,1,160
34007075025,1513,1186,987,57,65,24,67,0,199
34023077602,1231,1009,723,134,72,12,87,2,286
34031070302,849,653,569,31,5,3,40,0,84
34031010203,1989,1559,791,431,101,17,250,3,768
34023035007,1174,991,610,68,53,8,245,0,381
34023020024,949,759,539,58,30,5,127,1,220
34027025003,1256,817,687,21,8,0,94,0,130
34023035008,895,711,508,45,41,8,94,1,203
34023065115,756,694,572,23,24,4,72,1,122
34023050007,844,597,383,45,42,10,125,0,214
34035100001,990,774,527,28,26,3,172,0,247
34025105001,1684,1286,871,240,117,25,52,7,415
34025090008,1801,1398,898,69,15,5,414,3,500
34039020203,2816,2133,262,1519,275,52,61,0,1871
34039085012,1062,827,631,79,45,3,71,1,196
34009055010,878,666,641,8,0,1,5,0,25
34003030008,1582,1378,576,416,51,32,306,0,802
34003155003,2156,1648,636,799,151,40,67,4,1012
34003315002,1485,1104,816,59,14,4,200,1,288
34003095020,938,756,217,162,36,4,350,3,539
34029060012,1676,1246,1130,72,6,5,18,1,116
34013070N22,1942,1459,66,1152,245,62,34,3,1393
34009025308,1096,957,865,41,37,6,6,1,92
34017055204,723,610,265,225,53,7,81,1,345
34017050901,2171,1633,84,1482,75,74,41,2,1549
34017050906,1150,979,202,587,83,24,130,0,777
34005065006,1298,1132,789,94,101,26,138,1,343
34037075002,1960,1513,1031,280,123,25,59,1,482
34037075005,928,719,563,98,28,7,23,0,156
34017035202,1065,847,321,419,20,7,45,0,526
34003225001,1713,1463,183,176,33,15,1072,2,1280
34017040304,1254,1036,102,885,34,54,31,0,934
34017005302,860,690,377,136,82,10,100,0,313
34017040101,1465,1190,206,910,66,52,38,2,984
34017030D28,977,789,157,284,49,27,304,0,632
34017030C29,240,170,10,58,27,9,79,0,160
34017005203,1672,1265,367,462,329,23,169,3,898
34029090017,725,720,650,39,12,4,16,0,70
34029035018,958,717,571,64,31,19,39,0,146
34017030D20,1604,1305,349,586,155,15,251,1,956
34015090004,1313,1006,887,11,40,7,53,1,119
34031010209,1315,1013,576,221,44,8,164,1,437
34027085013,1016,702,608,30,23,1,36,0,94
34023115002,1112,851,416,275,56,18,26,1,435
34035025016,826,667,531,33,24,11,66,1,136
34027010002,690,524,443,16,14,9,38,0,81
34023075023,1151,950,384,112,168,9,303,2,566
34039080018,912,663,482,64,33,5,82,1,181
34039035401,1419,1095,407,256,328,9,66,2,688
34039095044,798,640,224,151,170,10,84,0,416
34039015017,604,467,418,24,1,0,21,1,49
34023105008,1167,922,559,57,59,7,250,0,363
34021035014,820,642,492,54,41,6,37,3,150
34021030009,1140,873,704,30,23,7,97,1,169
34035090012,967,762,498,125,47,4,97,1,264
34021030004,1335,1084,954,33,6,13,44,1,130
34035070008,2100,1637,444,649,379,35,165,3,1193
34021020004,1683,1265,625,460,94,41,85,4,640
34035050012,1316,1023,420,178,121,10,303,3,603
34013070N15,2205,1637,35,1179,447,33,22,5,1602
34013070N38,1725,1206,61,963,240,41,3,2,1145
34013070N18,2067,1670,98,961,607,26,76,3,1572
34013095013,1787,1381,931,72,263,12,102,0,450
34039010301,834,655,521,66,11,6,45,4,134
34031040304,2997,2195,96,1861,326,85,9,5,2099
34025003011,762,562,459,50,21,2,24,0,103
34029035045,2464,1927,1621,151,32,15,105,0,306
34041080006,2831,2299,1419,496,214,34,117,0,880
34025155039,1546,1095,980,50,4,3,43,2,115
34005040012,626,500,435,14,25,8,15,0,65
34013027E05,1350,1156,17,84,1052,8,6,0,1139
34025047008,1130,889,794,39,2,10,45,1,95
34025055006,2364,1885,738,247,502,22,250,6,1147
34009055013,653,525,504,8,4,0,3,0,21
34029030035,546,518,466,34,12,4,3,0,52
34029070003,815,809,722,43,22,0,21,0,87
34013070S28,1182,806,7,66,733,13,0,1,799
34037065002,953,776,721,35,10,4,11,1,55
34003075301,1941,1523,152,947,357,50,109,1,1371
34003060004,3487,2849,1695,470,129,40,556,0,1154
34025095009,1571,1212,924,138,70,18,61,1,288
34037090007,1670,1351,1061,141,42,13,95,0,290
34005065023,579,440,338,26,37,1,41,1,102
34017030B02,1150,931,259,269,175,11,247,2,672
34013110406,1362,1053,549,72,358,8,77,1,504
34007135018,1928,1515,832,344,270,33,72,2,683
34007040108,1265,850,13,236,619,4,9,2,837
34007055005,1717,1375,434,332,554,40,45,3,941
34013030107,1911,1568,33,135,1413,36,9,0,1535
34013010201,1250,953,705,102,44,13,85,0,248
34027135011,1747,1405,780,302,182,9,138,3,625
34023077402,1260,1070,615,191,130,15,124,0,455
34023065107,643,635,538,38,24,5,19,0,97
34027175304,1405,1383,1263,56,20,5,31,0,120
34023075012,1218,922,138,464,182,18,133,3,784
34023070403,1765,1222,59,1005,151,61,19,4,1163
34033060E01,1677,1114,356,125,622,17,5,1,758
34035100011,1265,1003,548,75,32,0,339,1,455
34021035009,862,715,433,121,118,5,47,0,282
34025140016,1018,866,743,33,14,3,79,0,123
34035030020,1239,963,771,51,7,6,114,3,192
34039060405,1325,940,11,521,419,22,8,7,929
34039075101,1183,905,408,316,106,13,86,0,497
34039015029,672,557,458,59,16,3,20,0,99
34039020302,971,766,362,335,38,12,40,0,404
34005155006,903,674,348,165,64,7,10,0,326
34003225005,1501,1231,88,412,32,54,718,1,1143
34003085013,1462,1120,986,68,13,2,56,0,134
34003115201,1609,1249,221,329,293,16,424,0,1028
34017030D25,1578,1252,234,337,68,26,609,1,1018
34003245005,2779,2206,817,613,91,16,669,3,1389
34003067007,2090,1665,873,427,124,39,230,3,792
34037090008,1230,949,842,58,12,2,28,1,107
34017040404,1899,1505,290,1059,86,36,97,4,1215
34037010002,762,599,480,55,15,9,37,0,119
34029080003,1155,1024,941,38,25,17,6,1,83
34017025202,1948,1575,1101,106,58,13,272,11,474
34017025201,1561,1371,1063,148,30,15,117,9,308
34017030D19,1261,985,208,373,111,12,339,2,777
34031035202,1612,1167,463,369,128,30,206,1,704
34023115005,865,665,494,108,51,4,10,0,171
34023025003,1237,938,309,29,11,3,578,0,629
34011070204,1657,1104,69,814,205,33,32,2,1035
34027135022,1597,1153,663,112,69,8,307,3,490
34025170018,1297,1073,246,112,663,24,56,3,827
34035100009,1178,900,615,86,16,8,147,1,285
34021060008,1602,1194,791,30,26,7,323,0,403
34023080301,1790,1229,27,1166,95,23,3,7,1202
34023020040,1573,1194,644,102,105,13,345,3,550
34023025015,1177,967,422,125,56,10,353,1,545
34023050004,922,676,505,45,26,9,91,1,171
34035070006,1389,1130,225,404,390,14,101,0,905
34039010403,819,642,537,68,7,3,23,0,105
34039060103,1293,981,43,614,328,32,8,1,938
34039045502,1348,1067,207,523,324,19,18,3,860
34025190004,935,714,650,19,5,5,9,0,64
34005192024,668,549,76,75,406,9,4,1,473
34013070C41,1357,1091,61,318,712,10,3,0,1030
34025160006,1728,1372,1110,95,66,9,73,1,262
34005100011,1103,954,821,63,37,9,37,0,133
34005060003,870,671,354,62,232,14,14,1,317
34005040008,733,594,518,16,8,5,30,0,76
34013110201,1663,1396,528,174,565,12,140,0,868
34013030512,862,639,8,98,529,16,10,0,631
34003195010,1173,939,590,235,34,19,85,0,349
34017005202,1707,1271,432,571,205,32,82,0,839
34017030A32,1477,1016,11,238,778,33,23,1,1005
34017060103,2155,1642,128,1407,126,108,65,3,1514
34031055009,1068,856,769,54,19,8,13,0,87
34023020009,966,735,519,50,34,3,119,0,216
34023077405,1209,957,633,178,78,1,68,0,324
34023115010,1908,1637,821,187,182,20,418,0,816
34023075010,732,584,267,147,69,16,91,0,317
34027155006,1593,1282,1147,72,9,12,39,0,135
34023090009,2442,1964,742,159,260,4,802,0,1222
34023070205,1707,1211,54,966,208,65,26,2,1157
34023095019,621,489,369,48,33,2,37,0,120
34023025043,2150,1613,182,83,486,18,867,0,1431
34035030028,968,759,576,58,26,4,101,2,183
34035030022,1112,948,771,50,12,3,104,0,177
34021065001,1322,965,341,35,28,3,556,0,624
34035065015,1405,980,535,27,24,2,387,0,445
34025145007,1182,978,616,155,135,20,55,0,362
34039020410,2578,2052,196,1181,603,47,78,4,1856
34039060302,1289,937,43,451,459,13,1,1,894
34039085009,1670,1311,760,166,247,15,115,3,551
34013065301,1116,894,623,54,158,7,51,1,271
34013070E20,1782,1447,404,771,72,28,32,0,1043
34013070S17,1367,963,21,78,875,6,2,0,942
34025075006,1815,1432,734,422,222,27,54,2,698
34017030E11,1325,1137,643,193,75,19,236,2,494
34005090002,1151,895,606,69,178,21,32,0,289
34005192019,835,673,94,60,514,7,13,1,579
34003345003,1801,1482,1109,242,30,7,103,1,373
34017050107,1033,868,481,184,41,9,155,0,387
34017035201,1350,1043,272,594,52,27,67,1,771
34017030A19,1492,1121,63,342,664,26,76,5,1058
34017030B23,799,712,170,201,115,21,210,1,542
34017030A21,1323,1006,24,286,695,8,10,2,982
34017030D17,1395,1124,231,463,83,27,336,4,893
34017030C30,973,824,242,296,75,30,207,1,582
34017030D22,1961,1499,258,620,106,43,558,0,1241
34023105029,1909,1416,352,80,141,7,851,0,1064
34023095024,1020,815,555,120,36,4,99,2,260
34023025070,2243,1640,232,43,48,11,1317,2,1408
34021035001,1350,1062,843,50,71,3,82,2,219
34039100303,1021,757,437,104,139,11,77,0,320
34031070309,1192,951,735,87,18,8,96,0,216
34039010203,994,853,597,155,52,2,62,0,256
34025247006,1022,769,599,42,56,19,58,0,170
34039010102,1158,910,737,86,26,1,61,0,173
34013070N09,1880,1405,52,1199,205,38,24,6,1353
34039060404,1591,1131,18,725,419,35,6,6,1113
34017040205,1998,1551,245,1191,53,44,83,5,1306
34013070W15,1726,1155,5,213,960,15,1,1,1150
34005025103,278,199,31,18,143,10,8,0,168
34005140009,1354,1216,859,66,226,5,61,0,357
34005025102,306,200,37,27,133,4,7,1,163
34039065102,1192,937,113,298,499,22,48,0,824
34017055302,3662,3140,1258,965,194,55,717,3,1882
34001ZZZZZZ,0,0,0,0,0,0,0,0,0
34023085208,935,768,69,33,266,8,408,0,699
34023075016,1061,953,444,212,176,23,129,0,509
34023077603,671,557,349,107,27,4,64,0,208
34021040003,848,636,566,11,30,4,23,0,70
34039020201,1950,1457,162,1012,261,35,57,0,1295
34005050105,548,436,369,31,21,10,3,1,67
34013055010,1258,969,265,53,578,15,67,0,704
34013030212,1300,984,12,78,900,13,15,1,972
34013030204,1896,1361,33,125,1212,8,15,8,1328
34003285003,1157,976,531,179,134,3,128,1,445
34009025209,348,311,280,15,5,4,6,1,31
34017035404,1194,933,422,398,35,23,46,1,511
34003115301,1548,1238,104,735,396,44,53,3,1134
34017030A31,1701,1267,61,313,857,20,66,7,1206
34003210003,1088,830,733,67,14,2,13,0,97
34017015001,1601,1322,276,835,113,28,130,3,1046
34029070033,1030,995,883,41,39,3,22,0,112
34031070503,1588,1362,1084,72,24,1,179,0,278
34021015008,852,709,516,114,36,2,33,0,193
34021015058,895,779,598,59,69,6,52,0,181
34029030049,515,502,458,29,8,3,2,0,44
34021015054,1572,1461,925,150,279,18,114,2,536
34039020305,1520,1204,226,654,273,31,61,7,978
34013055014,990,805,114,73,608,11,28,2,691
34019110016,750,612,540,26,8,6,25,1,72
34029080015,698,622,533,48,21,8,18,0,89
34019045001,2035,1396,501,705,66,41,104,6,895
34039095014,1246,1039,311,200,349,12,165,3,728
34005095006,704,689,612,17,32,9,21,0,77
34005050306,1092,812,409,52,100,2,35,1,403
34013100001,749,739,659,25,23,0,28,0,80
34013070W20,1358,963,2,160,820,36,4,4,961
34013070S03,3414,2388,55,489,1755,23,7,3,2333
34017025205,2523,2059,1583,140,107,7,185,6,476
34013065205,744,541,417,34,46,5,34,1,124
34005192006,1035,797,98,80,604,23,20,1,699
34017051001,2222,1719,129,1543,98,66,18,0,1590
34017025502,908,760,587,69,12,5,78,2,173
34017030C03,1269,1055,304,283,72,11,403,5,751
34015020001,812,631,211,92,309,30,10,0,420
34023020023,1309,984,687,39,24,8,227,0,297
34031070505,1725,1426,845,150,51,5,365,4,581
34023120007,900,794,746,34,2,4,8,0,48
34023025005,1423,1049,270,24,26,9,729,1,779
34021005012,1465,1132,474,399,146,10,124,4,658
34021005015,1396,1084,489,338,154,24,100,0,595
34025155040,566,555,505,29,4,0,13,2,50
34005125024,1812,1478,999,81,210,19,173,3,479
34005065027,935,783,628,41,65,12,45,7,155
34017025503,1036,830,653,87,24,9,52,2,177
34003115303,2954,2428,704,771,722,40,227,1,1724
34017050103,1086,840,95,700,89,18,12,0,745
34017030A17,1264,974,64,315,466,18,119,3,910
34015100018,1372,1172,926,54,112,11,63,4,246
34023025039,2192,1610,168,73,180,8,1193,2,1442
34027145016,1365,1115,253,75,50,5,727,0,862
34023125308,934,753,358,174,96,13,122,3,395
34039090202,833,633,314,174,80,11,64,1,319
34025265006,1118,877,751,48,41,2,21,2,126
34035050016,1272,1004,544,145,101,11,217,0,460
34019010001,919,740,669,33,10,7,21,1,71
34013070W41,1506,1107,18,69,1031,19,9,1,1089
34039015016,618,475,416,42,4,1,7,0,59
34029025422,623,620,573,32,3,3,4,0,47
34013005205,1176,987,467,287,110,14,143,0,520
34013070W48,2281,1451,16,245,1226,29,19,7,1435
34029150018,1227,909,810,38,20,2,38,0,99
34013070W36,1253,951,34,61,855,8,14,3,917
34013070C08,121,99,0,0,99,0,0,0,99
34013045E03,2071,1680,43,111,1523,19,38,5,1637
34017030B31,1133,885,114,179,203,11,389,1,771
34017060203,2006,1566,107,1421,81,84,25,5,1459
34017030E01,1785,1499,690,275,222,9,312,8,809
34017030B04,1212,956,292,167,179,17,313,0,664
34023065303,859,701,572,68,18,4,41,0,129
34023065108,451,445,361,19,30,0,29,0,84
34023060005,776,614,483,32,19,5,69,0,131
34039055008,1268,963,692,121,27,11,119,0,271
34039015006,796,583,490,46,8,10,31,0,93
34005040019,385,292,260,18,5,3,2,0,32
34005050103,2256,1812,713,187,661,25,103,2,1099
34003305006,1113,788,437,66,29,4,253,1,351
34003110005,1697,1258,970,95,22,6,167,0,288
34013070W39,1061,813,14,38,759,21,2,2,799
34029070020,536,505,378,87,30,4,3,0,127
34017030A18,1237,1020,79,372,473,31,104,2,941
34017005209,1303,1030,509,343,118,23,81,4,521
34017030C04,902,729,148,249,82,11,274,5,581
34017050905,1322,1024,55,910,68,44,23,4,969
34029025329,1054,1027,921,61,25,9,5,1,106
34027080301,768,633,462,66,8,1,87,1,171
34023075026,1173,960,274,108,177,6,402,0,686
34027120102,1657,1447,674,323,263,36,183,7,773
34035050020,881,664,499,21,17,1,119,0,165
34039095013,1184,933,386,221,159,19,164,0,547
34005125012,665,517,438,23,36,1,15,0,79
34013070C06,1473,1029,16,242,792,19,2,0,1013
34013070S01,1351,956,8,99,888,4,3,1,948
34017030D01,997,773,157,398,75,33,164,3,616
34017030D09,1217,1028,362,432,71,17,179,1,666
34013070S18,1510,1032,8,76,958,22,6,1,1024
34017030D21,1275,1031,267,374,102,17,300,5,764
34017030C05,706,571,89,188,221,6,75,1,482
34017025301,1151,1036,787,155,25,5,69,0,249
34017050902,1182,982,29,915,47,50,22,2,953
34007170015,1432,1099,707,18,67,2,301,1,392
34031010210,1003,903,505,274,67,11,68,6,398
34039045302,898,682,209,254,210,6,20,1,473
34005065001,1486,1219,953,58,85,2,111,2,266
34003095017,413,377,255,33,7,0,83,0,122
34013080301,1203,953,548,225,47,5,133,3,405
34013070C47,1654,1295,80,757,483,11,10,2,1215
34017005207,1218,939,485,271,82,9,114,2,454
34017030A14,1126,830,51,318,389,22,74,7,779
34017025504,887,767,602,92,24,0,44,1,165
34003275001,407,350,291,15,14,1,28,0,59
34023105012,923,717,380,82,36,4,214,1,337
34025115003,788,588,547,7,2,3,22,1,41
34005060007,1986,1572,632,202,594,24,59,0,940
34039095002,982,759,464,129,89,5,75,1,295
34017030F25,1292,945,45,229,689,15,36,6,900
34041060002,1463,1310,1075,121,48,8,62,1,235
34001105202,713,612,523,50,25,3,12,0,89
34003285011,1238,997,733,116,21,10,120,1,264
34003115401,1519,1316,579,270,363,9,118,7,737
34017025204,1549,1376,855,355,41,8,121,3,521
34017060305,1500,1166,103,964,65,55,48,3,1063
34017060201,2314,1811,121,1555,80,89,72,1,1690
34017050401,1837,1371,123,1147,114,55,53,3,1248
34017050101,1533,1180,120,953,99,40,67,1,1060
34017030C15,1011,826,221,347,101,17,183,1,605
34015100009,1070,839,524,96,184,20,38,2,315
34023110005,1006,796,528,127,43,9,73,1,268
34023020035,693,515,333,28,27,7,127,0,182
34013065104,1361,948,697,75,77,1,101,2,251
34027085005,1181,832,721,29,15,6,53,0,111
34013070N02,1630,1177,104,945,105,34,14,4,1073
34013065402,1252,959,170,121,635,20,24,1,789
34013110505,1157,828,98,339,330,24,60,2,730
34013045N06,2018,1615,48,159,1403,18,34,0,1567
34017030F27,1404,1112,105,634,388,56,28,0,1007
34017030A23,1126,949,104,230,226,16,408,5,845
34005100003,589,491,442,32,7,3,6,1,49
34017030A27,984,764,87,176,271,5,212,1,677
34017025105,1446,1285,1012,88,13,9,162,1,273
34013030203,1880,1425,13,277,1184,13,9,0,1412
34027155012,1889,1886,1814,5,30,1,29,3,72
34025140028,1473,1153,728,21,16,4,380,2,425
34039020405,1597,1266,233,623,364,22,26,0,1033
34023035001,1325,1118,699,180,88,18,140,4,419
34035025003,948,778,636,63,23,2,51,1,142
34021005016,1119,881,336,310,124,13,123,3,545
34013070N16,2243,1780,145,1258,420,43,39,7,1635
34029070022,907,902,779,47,56,7,11,1,123
34013070N48,978,835,61,527,242,15,19,3,774
34039050008,713,565,413,51,46,9,56,3,152
34013055021,1720,1276,152,121,973,10,32,7,1124
34017030F10,1404,1117,138,309,608,22,115,2,979
34017030C28,2080,1683,442,261,95,29,878,2,1241
34027180404,713,573,499,42,9,1,18,3,74
34029090022,692,681,585,26,43,10,11,2,96
34013065303,1135,874,535,82,191,7,66,2,339
34013070W33,1595,1160,18,70,1096,7,15,1,1142
34017030D07,1199,990,423,352,76,13,144,0,567
34015090017,1383,1094,991,43,24,3,33,0,103
34015090014,925,679,592,23,23,5,30,0,87
34023025053,967,752,304,92,38,10,317,2,448
34013030504,1184,799,7,102,705,19,9,8,792
34029090007,1124,1120,1042,31,22,6,15,1,78
34017030F11,1220,975,206,251,495,19,46,4,769
34017030B18,927,761,193,267,191,17,125,2,568
34041040001,1493,1243,950,196,49,11,40,0,293
34039060108,1134,889,45,269,581,11,13,5,844
34017030B01,1102,943,291,285,194,17,171,2,652
34017060108,1673,1350,157,1090,128,41,50,2,1193
34017030B25,1125,814,114,313,189,17,186,5,700
34027160019,931,756,555,65,24,5,103,0,201
34019110009,662,518,471,28,2,1,11,0,47
34013030102,855,705,18,47,639,9,7,0,687
34039080006,772,546,435,22,23,8,56,0,111
34013070W45,1952,1466,147,471,731,50,144,6,1319
34013070W35,3912,2827,269,657,1266,57,649,8,2558
34027025005,755,508,423,21,4,0,53,0,85
34023075003,1648,1205,248,813,144,64,47,2,957
34039015010,783,556,435,68,20,7,29,1,121
34005040011,632,475,427,15,28,2,7,0,48
34029035050,1117,902,762,57,22,9,48,0,140
34017030F08,1068,836,205,296,239,17,111,11,631
34017015006,2611,2267,1055,430,145,11,622,5,1212
34017050301,1669,1279,79,1140,72,99,26,2,1200
34007180403,2521,1930,836,160,813,36,97,2,1094
34027145021,1384,1218,613,148,127,11,325,0,605
34021015002,1109,897,722,71,45,8,48,0,175
34039020508,2458,1849,388,1101,295,35,24,0,1461
34017030F17,1478,1015,56,204,744,18,19,2,959
34007080015,317,288,224,12,10,1,41,0,64
34035090010,695,581,237,125,115,5,106,4,344
34013030312,1335,1038,9,61,963,6,1,0,1029
34017030A26,1234,943,88,207,396,29,215,4,855
34017030D26,1440,1160,192,429,100,17,464,3,968
34029070019,686,666,517,61,56,11,25,0,149
34007165001,9,6,3,1,1,1,0,0,3
34031070304,1067,794,640,78,4,11,54,1,154
34035040550,1013,843,373,65,219,17,181,3,470
34023077301,1202,981,598,172,52,10,153,0,383
34035005008,942,840,610,94,34,1,91,0,230
34003030011,1907,1636,726,479,54,32,357,3,910
34017030A29,1286,1076,176,188,317,19,356,7,900
34017005204,1673,1226,527,424,220,24,72,9,699
34027090004,867,649,583,27,3,8,21,0,66
34013070N13,1473,1034,34,749,280,24,26,7,1000
34003305003,1071,745,346,65,21,10,304,0,399
34017030F23,1386,964,50,233,686,23,17,0,914
34007110006,2053,1568,401,161,957,17,59,2,1167
34017060311,557,498,229,97,36,1,136,0,269
34013070C37,947,727,34,514,220,31,12,6,693
34017030B20,922,702,207,221,206,17,97,0,495
34025080013,663,532,442,23,27,7,24,0,90
34017030A22,1218,859,31,234,584,10,36,7,828
34039002065,2552,2018,321,1259,366,56,110,3,1697
34025130020,1514,1211,986,68,50,11,83,4,225
34017005208,1210,948,477,290,113,16,87,4,471
34025003005,821,677,533,66,38,3,40,0,144
34017020303,931,747,250,392,40,13,49,3,497
34017005201,1205,921,618,165,64,13,76,5,303
34031070501,1365,1160,788,171,41,7,135,1,372
34027080302,1761,1631,1273,105,173,6,69,1,358
34039060104,1089,819,61,366,401,34,17,2,758
34017030B28,1414,1115,118,274,222,8,469,6,997
34017050403,1621,1253,128,1068,70,19,36,0,1125
34005040010,599,476,436,3,15,0,17,0,40
34017060208,1952,1496,63,1389,90,86,15,1,1433
34017050802,1535,1177,94,1002,108,33,40,0,1083
34017035402,1703,1342,594,539,57,10,80,5,748
34039015004,639,462,441,16,2,1,4,0,21
34013070W27,1467,1031,12,101,937,6,1,0,1019
34013030409,657,453,7,77,377,11,6,1,446
34017040301,1240,974,110,783,44,52,49,2,864
34013070S13,1465,1034,6,152,880,6,18,3,1028
34039035203,1154,894,23,110,757,7,8,0,871
34029070027,28,11,7,1,0,0,0,0,4
34005105009,686,633,572,10,23,1,12,1,61
34013065305,1136,1013,603,135,240,7,40,0,410
34023080104,1436,999,24,920,102,35,11,6,975
34031010111,1121,985,681,117,21,0,169,0,304
34015090013,817,614,559,2,43,3,7,1,55
34023070504,2057,1475,252,937,196,45,160,0,1223
34037090005,1261,989,902,53,8,13,10,0,87
34025130011,710,700,632,31,6,3,29,0,68
34017015004,1350,1040,111,808,57,42,77,3,929
34017030D29,1371,1082,204,463,152,12,297,9,878
34027175403,735,582,497,51,2,3,25,0,85
34017030A25,866,673,59,160,217,8,214,1,614
34023085402,1372,1120,184,154,254,16,521,1,936
34025247008,689,623,518,42,33,4,27,0,105
34017025505,896,808,604,134,18,2,53,0,204
34013070N49,554,513,39,261,213,14,10,3,474
34013030111,1694,1373,32,90,1254,23,7,2,1341
34017030A12,1254,952,135,315,412,31,83,0,817
34017030D12,1392,1110,225,501,152,12,271,2,885
34013070W28,1558,1173,8,75,1099,12,6,0,1165
34017025603,1001,840,676,69,13,13,74,2,164
34007145001,21,17,15,0,2,1,0,0,2
34017030A28,1080,877,108,154,191,9,376,2,769
34013070N11,2000,1441,33,1138,331,41,16,5,1408
34013030305,1295,941,9,72,872,12,6,0,932
34017025604,1005,854,688,103,12,9,44,2,166
34025230001,1076,893,497,146,144,20,88,0,396
34013070S37,1306,914,7,104,818,6,6,0,907
34017030B19,1254,969,281,244,319,16,146,3,688
34017030D14,1196,957,196,314,71,11,364,1,761
34017030B32,1362,1077,168,232,220,13,456,3,909
34005200001,0,0,0,0,0,0,0,0,0
