GEOID,TOTAL_POP,TOTAL_VAP,WHITE_VAP,HISPANIC_VAP,BLACK_VAP,NATIVE_VAP,ASIAN_VAP,PACIFIC_VAP,MINORITY_VAP
13091000LEE,8498,6581,3745,199,2524,56,61,12,2836
130910RAWLI,1707,1341,924,58,334,17,6,2,417
130910MITCH,505,400,340,5,55,0,0,0,60
130910EDDIN,1450,1153,827,13,298,16,1,0,326
130910MULLI,1975,1743,835,43,855,5,13,1,908
130910PLAIN,663,533,451,8,67,3,1,3,82
1315300ROZR,20842,15775,9919,464,4820,263,319,11,5856
1315300RECR,17798,12536,3240,1229,7696,273,246,19,9296
1315300HHPC,15391,11867,5590,1052,4807,272,297,35,6277
13153000VHS,9625,6852,4538,356,1587,165,235,18,2314
1315300CGTC,7249,5417,3452,314,1310,82,250,16,1965
13153000BMS,14098,10308,6922,508,2216,237,452,30,3386
1315300NSES,3448,2743,1844,118,671,64,46,12,899
1315300CENT,11884,9087,5378,589,2483,200,471,8,3709
1315300HEFS,1881,1455,887,39,488,39,12,2,568
1305900006A,4819,3935,2229,415,1029,78,202,6,1706
13269000005,3311,2644,2074,52,458,41,19,1,570
13319000010,2363,1859,958,19,858,18,1,0,901
13209000005,2676,2138,1024,112,981,17,15,3,1114
13209000001,755,648,420,38,166,8,13,0,228
13161000402,1044,801,701,37,49,17,1,2,100
13209000007,1360,1079,716,109,233,22,1,0,363
13185000001,8332,5993,4626,244,888,134,75,12,1367
13153000TMS,9118,6817,3097,433,2808,123,384,20,3720
13071000008,2293,1622,1156,383,57,16,7,1,466
13183000002,4674,3137,1883,221,853,110,92,22,1254
13183000006,498,360,266,32,54,7,4,0,94
13183000001,2651,1883,865,606,355,63,23,1,1018
13183000007,1733,1206,786,49,330,28,16,4,420
13183000004,3166,2151,1201,207,642,60,40,38,950
13015000003,11581,9129,5973,1120,1691,236,190,10,3156
13015000016,10158,7760,4927,816,1664,184,210,8,2833
13015000005,16605,12590,9357,1309,1360,327,228,11,3233
13015000011,5760,4416,3319,328,587,133,38,0,1097
1315300FMMS,13329,9745,5312,553,3144,196,583,25,4433
13015000014,3969,3058,2761,116,57,87,19,0,297
13185000009,5706,4293,3229,199,717,96,69,3,1064
13185000008,6035,4627,3721,225,548,92,37,4,906
13185000003,45590,35040,14552,1900,17293,605,871,100,20488
13185000002,21347,15467,8398,1188,4977,329,598,83,7069
13185000005,15154,11865,7273,616,3473,200,320,24,4592
13185000006,7091,5176,867,342,3960,40,15,10,4309
13185000007,7212,5203,3566,429,1057,94,72,7,1637
13275000115,1949,1502,1202,28,221,35,6,0,300
1305900007C,5106,4400,3316,219,311,68,475,3,1084
13173000001,9877,7326,5010,370,1683,149,91,29,2316
13263000008,1408,1172,536,11,620,9,0,0,636
13133000008,7728,6772,6034,175,358,66,94,4,738
13263000002,885,748,360,5,363,9,5,1,388
13133000004,2910,2221,946,123,1099,34,24,11,1275
13133000001,6440,4920,2007,455,2340,56,57,10,2913
13133000005,1343,1064,514,54,489,10,1,1,550
13133000006,494,381,174,19,184,4,3,1,207
1315300MCMS,13494,9711,5562,527,2391,163,1101,22,4149
1305900002A,7226,5428,1369,1518,2461,83,35,13,4059
1305900001A,5044,3813,1742,766,1219,97,35,2,2071
1305900005C,2648,2157,1743,110,179,36,83,7,414
1305900005D,5454,3972,1109,1240,1509,61,62,20,2863
1315300ANNX,6683,5270,3385,600,1037,109,170,6,1885
1315300HCTC,9846,7716,4339,470,2460,192,325,10,3377
1315300TWPK,6387,4848,3014,226,1383,74,158,14,1834
13273000001,4763,3630,666,45,2868,26,47,3,2964
13015000008,7437,5582,4485,297,537,219,40,3,1097
13015000004,11544,8614,5887,836,1608,190,127,7,2727
13015000018,2605,2004,1633,137,164,61,16,2,371
13015000009,2095,1609,1457,76,25,45,5,0,152
13015000015,3546,2752,2455,101,89,104,11,0,297
13071000016,671,537,456,38,35,6,4,1,81
13071000023,1958,1483,955,442,56,34,7,1,528
13015000007,4453,3590,2974,249,161,167,34,3,616
13071000001,6464,4648,1066,581,2944,82,28,6,3582
13071000015,2499,1787,1059,490,205,40,18,0,728
1314100003B,805,656,140,8,504,15,0,0,516
13151000028,11098,8172,1448,884,5783,120,95,11,6724
13161000202,1889,1410,1296,58,20,23,15,1,114
131870000DA,33488,27689,24419,1345,507,873,385,41,3270
13151000035,4121,3038,774,165,2040,43,50,5,2264
13151000052,6530,4938,3026,218,1511,87,119,10,1912
13275000110,2831,2141,1350,50,715,17,15,0,791
13275000108,3219,2466,1818,86,488,60,12,0,648
13275000109,2937,2236,548,37,1620,29,16,1,1688
13003000001,3121,2289,1652,454,142,59,8,3,637
13003000002,1322,973,796,133,18,25,13,2,177
13023000001,12583,9613,7032,311,2036,86,146,8,2581
130050DOUGL,11140,8310,6374,547,1245,106,38,5,1936
13175000022,3192,2516,1499,118,855,25,15,6,1017
13175000004,10008,7324,1518,114,5576,71,100,1,5806
13093000002,995,809,388,50,358,5,16,2,421
13093000007,4677,3612,1575,224,1742,49,19,0,2037
13027001402,1465,1170,579,51,514,24,3,1,591
13027001199,6123,4639,1704,221,2630,71,44,2,2935
13027000660,2888,2255,1553,148,497,38,15,1,702
13151000061,5969,4520,1719,317,2365,75,111,6,2801
13151000037,4457,3289,2274,168,606,64,186,3,1015
13161000301,2230,1518,810,540,139,44,4,0,708
13025000003,6646,5053,4564,90,182,171,28,6,489
13151000030,7943,5868,2705,400,2569,169,127,9,3163
13151000051,5578,4523,1987,246,2030,76,218,11,2536
13275000117,1074,849,678,26,125,13,3,0,171
13275000114,3358,2503,1885,113,422,55,31,3,618
13275000120,3632,2817,1924,71,722,54,42,3,893
13185000004,1784,1367,908,58,389,14,6,1,459
13029000003,4063,3117,2519,62,410,96,32,9,598
13029000002,3126,2351,1908,63,270,68,21,5,443
13237000101,5203,3979,1953,385,1561,92,16,6,2026
13237000105,4443,3926,3453,141,242,57,38,2,473
13237000104,5279,4067,1720,318,1953,58,40,5,2347
13161000100,2847,2065,893,197,943,27,12,2,1172
13027001230,476,396,250,32,97,10,4,0,146
130750000DB,4105,3065,2075,166,729,59,36,9,990
1307500000C,3212,2364,1196,159,936,54,36,5,1168
13021000GF1,10934,8865,1734,484,6494,84,141,15,7131
13021000GF3,4615,3314,425,95,2776,40,10,0,2889
13021000EM1,2963,2140,150,35,1931,42,18,5,1990
13021000VV2,2940,2293,860,57,1348,24,19,0,1433
13021000VV4,5795,4185,533,82,3545,39,44,3,3652
1304900005W,460,327,298,5,14,4,5,0,29
1304900003S,1116,873,800,19,26,27,6,4,73
1304900005F,1154,899,788,7,70,25,5,0,111
13049000002,5936,5094,1384,1878,1918,54,98,6,3710
1304900004H,1312,960,824,16,77,28,15,7,136
13071000002,8718,6656,3418,930,2199,119,58,2,3238
131210SS08B,867,695,517,40,57,17,44,6,178
1312100008B,4585,3438,2820,133,236,37,190,0,618
1312100012N,1090,862,67,23,768,17,1,0,795
1312100RW09,7721,5744,4793,240,339,58,271,4,951
1312100012J,4435,3122,65,158,2894,43,20,3,3057
1312100RW01,6053,4707,3860,233,297,66,220,2,847
1312100JC11,5786,4162,2194,254,489,30,1168,6,1968
1312100JC07,7199,5280,1940,248,639,50,2426,6,3340
1312100JC09,4805,3616,1751,321,574,34,927,5,1865
1322900003A,2464,1857,1713,38,53,35,5,2,144
1300100003C,2515,1920,1247,144,473,43,34,4,673
13001000002,3563,2633,954,261,1392,23,16,3,1679
13273000005,822,661,418,10,225,12,3,2,243
13003000003,2022,1551,916,249,357,33,11,2,635
1305900003B,9946,8933,6612,396,1451,122,338,5,2321
13263000005,1111,854,202,5,639,8,6,1,652
13015000010,3991,3180,2695,108,238,118,17,4,485
13273000003,950,777,350,24,396,11,3,3,427
13183000005,967,698,549,24,109,21,5,4,149
13183000003,2479,1799,872,88,764,56,30,8,927
13123000009,2381,1833,1467,282,17,39,34,1,366
13025000002,6332,4787,4343,72,208,133,24,3,444
13025000001,5043,3852,3615,50,80,73,29,9,237
13161000201,1109,834,685,57,80,8,4,3,149
13123000010,2941,2186,1675,437,13,122,9,0,511
13151000055,4305,3242,2009,123,983,69,58,8,1233
13151000039,9682,7334,1198,558,5228,110,369,11,6136
1322900004C,1475,1100,977,48,49,19,6,4,123
132250000C1,1262,1024,776,116,68,36,32,1,248
13303001488,3875,2916,1044,37,1797,30,11,1,1872
13029000008,9259,6186,4294,491,918,170,309,42,1892
13029000010,3009,2212,1809,83,240,48,31,8,403
13029000006,3633,2848,2422,144,165,50,65,6,426
13029FTSTEW,0,0,0,0,0,0,0,0,0
13029000004,2919,2113,1297,163,459,58,128,8,816
13263000004,552,485,232,10,242,4,3,0,253
13319000008,1190,956,201,40,708,9,0,0,755
13319000005,1175,933,433,31,442,23,4,0,500
13269000006,2794,2221,1408,34,761,27,2,7,813
13209000002,691,527,467,11,43,8,2,0,60
13177000004,4921,3476,2426,83,833,69,60,7,1050
13177000005,2106,1459,1175,23,175,25,62,3,284
131210EP04B,3706,2626,49,100,2492,37,28,0,2577
131210EP04A,9014,6955,197,219,6488,76,86,9,6758
131210SC19B,2306,1839,43,74,1731,32,5,4,1796
1312100002J,2754,2523,1777,150,389,46,162,6,746
1312100006G,620,531,354,34,115,6,23,0,177
1312100001T,4743,4144,1005,652,2468,58,35,3,3139
131210CP051,1797,1481,41,80,1332,12,22,0,1440
131210CP07F,513,363,14,4,348,3,0,0,349
131210CP052,5,3,0,1,0,2,1,0,3
131210CP07D,7,7,0,1,5,1,0,0,7
131210CP07C,283,227,0,2,222,0,0,0,227
1312100002G,4436,4068,2903,241,619,58,246,6,1165
13151000059,6090,4345,2475,225,1499,94,59,6,1870
13257000004,1582,1250,1143,31,41,22,7,5,107
13119000003,4149,3344,2994,94,169,60,24,3,350
13119000001,3528,2754,2415,63,168,51,56,0,339
13119000004,3913,2904,2147,213,466,46,22,2,757
13119000005,1823,1421,1268,33,74,19,17,2,153
1312500EDGH,156,129,121,4,4,4,0,0,8
132890000HV,991,821,558,6,244,18,2,1,263
13177000001,582,493,264,21,193,17,6,1,229
13177000003,1922,1592,915,28,549,22,80,3,677
1300100001B,1834,1415,1251,46,89,27,8,4,164
1300100004B,1321,990,904,32,42,8,7,3,86
132250000B1,3635,2903,2081,116,586,98,29,4,822
13303000088,733,579,329,6,233,6,1,1,250
13273000002,1730,1384,866,32,468,19,6,3,518
13071000019,4550,3331,2176,514,561,84,28,3,1155
13249000001,4547,3328,2520,103,644,45,31,7,808
13275000111,1440,1055,513,55,463,21,13,3,542
13275000105,4206,2981,526,67,2328,39,29,8,2455
13237000107,5388,4425,3738,138,440,91,17,1,687
1312500MILL,1047,815,740,13,39,17,10,3,75
1312500GIBS,1061,818,720,3,82,13,2,1,98
13197000955,1343,1059,889,30,96,26,15,4,170
13119000002,2590,2070,1838,41,76,62,30,0,232
13151000060,5788,4374,2254,302,1603,92,159,2,2120
13151000057,3610,2850,1382,225,1088,33,132,3,1468
13151000053,5686,4470,1080,263,2404,43,715,14,3390
13151000038,7152,5238,1526,326,2948,95,380,7,3712
13151000034,8928,6529,1326,472,4476,126,239,6,5203
13275000107,1919,1501,1151,51,247,28,28,1,350
13151000025,9788,7011,2248,512,4062,101,171,10,4763
13119000007,3503,2721,2456,61,98,65,40,2,265
13257000001,6423,5099,3874,130,892,147,67,10,1225
13137000002,10659,7868,5273,1695,354,215,397,12,2595
13137000004,1423,987,682,160,36,37,77,0,305
13137000005,2988,2055,1106,773,105,39,64,0,949
13137000001,12544,9971,8974,376,210,268,120,10,997
132250000F2,4633,3508,901,775,1798,47,22,5,2607
13151000046,5368,4089,520,303,3226,48,47,6,3569
13151000041,5193,3816,1581,376,1719,94,110,12,2235
13151000056,4780,3780,1437,199,2006,104,89,7,2343
13257000003,4661,3730,3134,135,294,113,52,2,596
13119000006,3918,3093,2348,173,472,43,35,8,745
13257000008,4503,3623,3136,88,281,76,27,3,487
13123000001,4712,3783,3110,558,15,95,28,2,673
13123000006,1135,1008,937,18,6,31,8,0,71
1311100SUGC,2931,2432,2301,53,9,52,7,0,131
132250000F3,5035,4116,362,72,3673,16,7,5,3754
13279000513,8780,6561,3969,364,2023,83,142,4,2592
13279000043,2314,1772,1494,199,46,38,4,1,278
13279015361,6999,5205,3122,858,1137,68,33,7,2083
13279000514,6693,4966,2859,327,1696,71,26,2,2107
13109000011,10774,8127,4826,731,2410,132,72,12,3301
13031000011,10706,8543,4345,322,3674,98,149,12,4198
13031000014,9633,7185,3650,201,3102,87,159,18,3535
13031000013,12679,10397,6247,657,3063,160,296,23,4150
13031000004,5079,3545,2770,134,488,46,100,7,775
1305900001D,3351,2803,2077,127,429,56,86,4,726
13175000015,1446,1110,1008,24,42,27,6,1,102
13175000016,3654,2749,2011,105,581,62,7,0,738
132250000F1,4220,3278,1087,378,1771,65,20,5,2191
13303000097,9027,6809,2684,93,3939,57,54,2,4125
1300100005B,1843,1415,1174,84,133,26,3,0,241
1300100004D,2455,1880,1496,227,108,15,44,1,384
1300100001C,1538,1216,1008,68,127,10,5,3,208
130010003A1,1146,865,817,12,19,20,4,0,48
132250000B2,7330,5763,3768,245,1539,105,114,4,1995
1314100002A,872,719,159,3,550,1,7,2,560
1314100004A,2203,2032,397,13,1609,7,11,0,1635
13175000003,5589,4408,2612,104,1493,43,159,1,1796
13175000021,5622,4055,2018,170,1817,36,26,5,2037
1314100002B,1144,954,200,4,719,13,19,1,754
1314100001B,784,576,52,0,523,2,0,0,524
13175000005,5305,4177,2960,84,956,55,109,7,1217
13175000014,521,412,213,5,192,4,1,0,199
13175000007,1452,1128,630,35,451,8,11,2,498
1312100010E,1160,910,19,43,846,24,4,1,891
1312100010P,1757,1287,19,54,1221,7,12,1,1268
131210ML072,2194,1490,1107,90,102,21,169,1,383
131210ML071,148,101,83,5,4,0,6,0,18
131210ML07A,1026,761,601,42,48,18,43,1,160
1312100SS06,2336,1680,1372,77,95,19,97,2,308
1312100012F,1224,902,87,70,736,18,12,1,815
130990000CS,1598,1317,968,10,300,31,3,0,349
1309900000U,883,703,523,8,159,13,2,0,180
1324300718B,641,466,16,10,433,5,8,0,450
130990000CU,1587,1275,787,39,434,17,3,0,488
13115000055,5920,4660,3826,226,376,106,90,3,834
13115000140,5082,4233,2772,488,809,76,92,6,1461
13115000076,7236,5194,2635,1446,938,134,116,6,2559
13115000001,5423,4065,2940,638,351,93,49,2,1125
13101001058,3697,2709,1856,667,121,93,20,11,853
1306500000D,550,398,286,17,86,10,6,3,112
13115000050,8841,6801,4223,1202,981,154,252,5,2578
13115000020,2323,1814,1617,27,120,42,10,0,197
13115000135,4660,3602,3036,150,258,96,44,1,566
13115000090,6778,5120,3137,337,1460,104,130,7,1983
13115000110,2571,1995,690,202,1066,37,10,0,1305
13039000014,4088,3356,2863,100,241,74,72,9,493
13039000002,1880,1531,1183,26,284,37,7,3,348
13115000065,5120,3914,3102,126,495,116,76,3,812
13115000025,1626,1342,1200,33,61,36,2,4,142
131210AP01D,1481,1229,693,121,230,15,163,4,536
131210AP01A,7302,5543,3116,352,591,40,1399,6,2427
131210AP01B,1952,1650,889,140,263,26,334,4,761
1312100AP14,4390,3225,2039,181,265,45,669,1,1186
131210AP01C,3292,2399,1495,280,266,16,315,1,904
1312100007M,3413,2978,1615,320,683,42,337,5,1363
131210EP03B,1815,1473,94,96,1279,16,18,1,1379
131210CP01B,527,416,164,29,202,4,13,0,252
13039000009,10472,7567,5063,477,1512,193,338,30,2504
13039000007,3806,2770,1546,120,950,84,52,2,1224
13039000001,1354,1099,885,15,168,27,7,0,214
1322300001C,26417,18496,13162,1210,3141,390,558,31,5334
1322300011B,13996,10641,8068,603,1617,261,92,9,2573
13115000040,2191,1801,1680,35,37,36,13,0,121
13295000871,10292,8008,7008,151,526,235,75,10,1000
132050000CT,627,485,419,29,36,5,1,0,66
13055001083,399,325,259,12,40,14,1,0,66
13053FTBEN1,2,2,0,2,2,2,0,0,2
13055001382,227,190,174,1,0,11,2,0,16
13055000925,9261,7115,5704,152,1064,153,39,6,1411
13053000001,2578,1957,1168,61,647,50,38,5,789
13053FTBEN3,3449,2770,1649,560,316,54,181,46,1121
13215000112,13776,10070,1560,950,7336,168,262,37,8510
13115000105,5256,4095,2116,275,1580,119,54,3,1979
13039000012,2918,2352,1891,99,304,48,26,7,461
1312100001R,1851,1022,26,60,937,24,5,0,996
1312100001G,2547,1918,655,109,1078,37,68,2,1263
1312100SC13,4034,3077,192,119,2765,52,28,2,2885
1312100CH02,495,425,272,16,130,6,3,0,153
131210UC02A,14083,10178,399,964,8736,117,115,4,9779
1312100011B,7190,5511,63,105,5322,74,19,2,5448
1312100PA01,4510,3415,883,355,2109,62,51,4,2532
131210CH04A,991,803,689,36,67,6,6,0,114
1312100012M,3593,2499,60,97,2348,27,5,10,2439
1312100009E,3693,2776,457,102,2111,45,88,10,2319
1312100012K,3745,2966,461,111,2352,40,53,4,2505
1312100004K,2741,2279,185,52,2018,24,32,7,2094
131210EP02B,2009,1737,711,187,784,39,50,4,1026
131210EP02E,1954,1495,238,68,1176,18,13,0,1257
13277000006,2107,1581,1199,140,203,26,26,0,382
13277000002,3015,2378,2015,81,184,38,40,0,363
13277000012,5803,4307,2514,608,1023,62,104,5,1793
13277000003,2686,2072,1696,191,134,23,15,0,376
13017000001,6850,5226,2446,332,2348,110,25,4,2780
13017000002,10344,7939,5013,321,2397,122,93,2,2926
13021000HO4,2466,1902,1011,61,737,30,72,5,891
13021000VV1,5777,4995,2336,511,1952,92,110,2,2659
13021000RU2,4781,3698,2441,209,941,60,45,5,1257
13021000GF5,7233,4809,599,212,3936,33,36,6,4210
13021000GF4,3658,2561,497,127,1908,28,15,2,2064
13021000HO5,2370,1735,789,61,790,26,70,2,946
13295000881,3376,2635,2451,32,51,63,18,2,184
13295001818,6289,4839,4468,58,114,122,46,1,371
13295001812,11811,9212,7931,328,608,268,64,4,1281
13189000136,3452,2316,317,90,1903,25,6,6,1999
13295000869,3064,2389,2163,37,99,70,5,0,226
13295000960,2598,1979,1840,28,35,52,3,0,139
13295001893,5154,4085,3621,77,229,122,23,4,464
1312100009C,3643,2808,85,40,2676,45,20,0,2723
1312100009B,582,399,2,16,376,5,2,1,397
1312100003M,3500,3252,637,121,2433,21,65,4,2615
1306500000H,4947,3673,2299,109,1200,47,20,13,1374
13245000112,1568,1476,696,33,687,14,53,1,780
13021000EM3,4879,3862,1329,136,2301,66,36,12,2533
13311000071,439,388,361,7,13,5,0,0,27
13253000001,1792,1459,1106,20,319,16,1,2,353
13311000081,3789,2893,2606,115,36,113,10,2,287
13253000004,1696,1344,947,30,324,25,1,1,397
13021000EM5,3443,2629,836,33,1716,43,25,1,1793
13021000EM4,3504,2586,309,45,2230,14,7,2,2277
13033000007,660,530,199,17,308,4,3,1,331
13021000HO3,12654,9932,5659,367,3022,122,790,10,4273
13033000014,4531,3297,820,77,2375,33,8,1,2477
13033000016,1056,694,256,10,418,9,4,1,438
13031000003,3494,2646,1703,91,778,56,22,1,943
13031000012,2607,2018,1401,75,465,53,9,2,617
13031000010,5564,4276,3264,165,633,101,92,3,1012
13277000004,1890,1438,1230,64,115,22,11,0,208
13277000001,5981,4546,2609,538,1201,81,134,1,1937
13277000007,2010,1427,723,549,141,17,0,0,704
13277000009,6096,4848,2983,581,1062,63,182,0,1865
13123000008,1533,1272,1140,58,15,45,14,0,132
1312100010A,3601,2764,27,136,2586,26,7,1,2737
131210006L1,1135,912,728,37,98,5,41,0,184
131210006L2,824,605,516,25,26,10,28,1,89
1312100006D,12885,10253,6788,968,1675,140,715,15,3465
13021000WA1,3469,2717,1848,72,697,49,51,1,869
13207000011,751,594,318,4,260,11,0,0,276
13021000RU1,7940,6343,3744,362,1925,104,213,13,2599
13021000EM2,5453,3994,349,60,3570,39,22,7,3645
13039000005,2673,2038,1707,67,151,64,34,8,331
13039000013,4305,3214,2350,204,485,101,97,6,864
131210SC212,6110,4475,216,248,3955,26,66,3,4259
131210SC211,2579,1937,62,72,1804,17,12,2,1875
131210FA01B,9579,7280,823,564,5729,77,158,6,6457
131210SC21A,0,0,0,0,0,0,0,0,0
131210UC035,24,20,0,7,13,6,0,1,20
131210FA01C,1063,795,37,72,659,7,32,1,758
131210FA01A,5841,4309,495,503,3306,65,35,6,3814
131210SC07A,8756,6662,568,233,5793,72,82,3,6094
13189000132,1866,1575,1394,35,92,40,21,1,181
13189000134,2653,2089,798,45,1217,21,16,3,1291
13189000131,1780,1307,304,17,973,12,6,0,1003
13031000008,693,543,461,15,61,9,2,0,82
13031000009,1515,1101,670,47,342,41,6,2,431
131210ML06A,6036,4707,1559,470,938,99,1667,12,3148
131210AP12C,3050,2684,1934,222,245,32,217,2,750
131210AP12A,1913,1507,681,315,265,23,228,6,826
131210AP12B,2787,1914,397,112,232,31,1117,2,1517
131210AP12D,0,0,0,0,0,0,0,0,0
131210AP07B,2554,1889,1172,134,143,33,400,2,717
131210AP09A,7259,5233,2562,360,539,47,1673,5,2671
1312100008L,6091,5679,3837,406,929,69,446,20,1842
1312100010B,4145,3453,69,51,3313,47,18,1,3384
131210AP07A,5728,4594,2824,405,536,59,757,6,1770
1312100004M,1050,766,42,28,697,7,0,1,724
1312100002D,6530,5753,3178,366,1707,78,453,3,2575
1312100005J,683,631,300,46,227,7,57,0,331
131210EP02A,3610,2645,184,430,2002,67,17,3,2461
131210EP02C,675,545,171,55,311,8,8,0,374
130810CORDE,14918,11251,4485,327,6236,95,157,6,6766
1324500804H,3830,2999,1731,62,1091,87,27,10,1268
13245000608,2013,1564,956,43,477,35,38,17,608
13277000011,4730,3406,460,239,2677,66,12,3,2946
13137000006,8429,6939,5183,702,772,133,139,8,1756
13137000007,1784,1544,1464,32,6,24,2,1,80
132050000CN,2922,2167,345,100,1740,7,4,0,1822
13021000HA2,6216,4632,2231,154,2042,68,159,8,2401
13033000011,1835,1492,967,39,465,27,9,4,525
13021000GF2,3197,2424,392,108,1885,39,7,4,2032
13245000106,1756,1241,354,35,812,39,18,3,887
1300900MONT,5158,4087,2479,33,1497,58,13,3,1608
13019001767,847,663,597,35,15,14,3,0,66
13009000319,2631,2208,1189,31,958,16,16,5,1019
13277000005,1336,1081,977,57,27,13,6,0,104
1322300007B,8793,6521,4359,438,1494,154,108,16,2162
13019001157,8673,6580,5389,194,835,120,39,5,1191
13137000003,8204,6514,5617,377,192,208,106,17,897
13079000002,2190,1788,997,19,731,39,14,6,791
1300700000E,485,388,165,21,194,4,7,2,223
13245000207,3864,2737,343,83,2299,41,15,3,2394
13079000005,2555,2023,1758,75,113,53,27,1,265
1323900000M,123,107,46,7,45,11,2,1,61
13279000039,2244,1757,1366,230,134,30,2,0,391
131210SS07C,1236,989,651,197,100,8,37,0,338
131210ML021,3243,2160,1780,112,103,58,105,0,380
131210ML022,381,244,210,10,9,5,11,0,34
13245000303,1774,1424,1223,37,115,27,20,4,201
13245000301,3256,2565,1841,82,532,42,84,1,724
13245000703,7312,6123,2933,333,2497,106,318,15,3190
13245000801,709,576,364,37,149,15,13,6,212
13245000803,2432,2045,1096,537,200,44,178,7,949
1324500801B,696,531,396,40,76,11,3,2,135
13245000210,2745,2251,438,122,1611,26,86,11,1813
13245000503,5795,4444,902,243,3253,51,63,12,3542
13011000007,1615,1236,1022,157,18,33,7,1,214
13009000322,2191,1682,1273,10,377,14,6,4,409
1300900321W,4369,3420,982,53,2347,39,9,1,2438
13189000135,4279,3330,2173,67,1037,52,27,7,1157
1318900133A,1947,1506,965,145,344,34,13,3,541
131210SS07A,1486,1288,1012,66,90,28,105,6,276
1312100011K,2049,1723,113,39,1562,34,12,0,1610
131210SC14B,372,324,17,6,298,6,3,0,307
131210SC14A,1399,1050,22,14,1012,11,4,0,1028
1312100011C,3758,2851,42,59,2763,24,12,2,2809
1312100010D,6067,4192,56,228,3946,52,11,8,4136
131210005A2,3736,3292,1902,253,885,52,216,5,1390
131210005A1,3321,3044,2006,347,627,34,123,4,1038
1312100002E,2285,1906,1522,117,123,26,107,1,384
1312100RW03,7358,5934,3243,1125,1126,123,326,8,2691
131210RW07A,3730,2710,530,1133,925,117,87,4,2180
13107000053,12023,9084,4911,347,3649,115,93,9,4173
13169000001,3669,2740,2179,45,464,34,20,0,561
13169000011,3211,2368,1610,45,641,45,26,0,758
13169000003,4382,3369,1458,43,1817,38,22,1,1911
13245000309,4472,3502,582,183,2499,62,263,12,2920
13245000310,8692,6973,2223,403,4082,117,222,17,4750
13073000076,2801,2165,1401,166,437,50,145,2,764
13245000402,9711,7621,2947,1427,2707,157,449,40,4674
13139000029,4420,3393,2625,404,154,78,150,4,768
13139000031,4086,2984,2415,192,156,58,142,1,569
13139000030,6083,4592,3293,761,317,121,112,3,1299
1310300001B,4395,3297,2872,89,218,92,24,1,425
1310300003D,4448,3220,2403,85,612,102,21,7,817
1310300004C,4260,3065,2577,139,201,117,17,3,488
13139000002,9232,6531,1993,3451,609,183,429,10,4538
13139000021,6787,5369,3399,1115,602,109,151,3,1970
13179000001,1270,1012,173,17,818,14,6,2,839
13179000007,6250,4490,2006,553,1713,108,148,52,2484
13179000003,5760,4558,2379,164,1879,89,62,11,2179
13179000006,4643,3646,2777,168,550,107,57,9,869
13179000011,7087,5241,1836,489,2595,119,285,65,3405
13085000003,11635,9312,8098,624,135,244,159,13,1214
13085000002,12754,9963,9024,388,106,317,105,19,939
13069000005,5779,4852,2591,289,1902,50,24,2,2261
13069000002,3264,2415,1746,213,422,29,10,5,669
13155001529,6184,4794,2634,445,1543,57,125,0,2160
13155001753,942,749,591,44,101,15,1,1,158
13215000101,7397,5804,1690,216,3820,85,67,12,4114
13215000103,8479,6539,636,191,5645,78,87,38,5903
13215000113,8330,6387,557,225,5522,77,92,27,5830
13179000004,5789,4124,1181,518,2252,125,143,61,2943
13179000009,4867,3512,1122,422,1794,81,170,40,2390
13295001809,1643,1286,1072,6,155,28,9,1,214
13245000604,2868,2134,811,119,1127,54,47,3,1323
13245000102,2559,2152,793,51,1210,45,65,3,1359
13245000502,5860,4354,544,192,3541,75,69,13,3810
13245000501,4931,3586,457,148,2917,46,62,13,3129
13207000008,2601,1970,1652,46,221,51,16,0,318
13245000807,2403,1821,578,81,1071,53,57,15,1243
13245000111,2017,1657,441,71,1080,31,60,0,1216
13013000003,4948,3725,2718,391,277,114,227,6,1007
13013000014,2258,1777,1280,198,132,44,131,2,497
13211000006,3434,2664,2198,47,348,63,15,1,466
13211000004,4058,3157,2362,112,603,51,46,6,795
13211000007,3567,2777,2274,64,375,58,12,3,503
13157002000,19247,14887,12037,880,1302,347,290,23,2850
13211000005,942,720,576,38,79,15,11,0,144
13155000901,2540,2004,1822,56,76,51,9,9,182
13013000005,7515,5647,4060,483,745,123,246,4,1587
130550P-870,1825,1648,774,69,788,21,6,0,874
13055000870,6604,4907,4175,435,123,146,25,5,732
13055000962,699,560,523,5,10,20,3,0,37
130810LISTO,1309,1052,925,52,54,21,5,0,127
1310300004A,5539,3996,3130,157,559,106,43,4,866
1310300003B,2130,1611,1111,19,445,31,8,0,500
1310300001D,2897,2210,1911,99,112,60,25,6,299
1310300001C,2105,1636,1307,76,144,88,20,1,329
1310300001A,2820,1971,1605,93,150,74,40,0,366
1310300005B,6240,4351,2759,281,1005,114,179,13,1592
1310300005C,2163,1684,1198,78,325,37,53,2,486
13139000022,6466,4427,580,1759,2045,54,41,4,3847
13139000012,6870,5352,3787,953,431,132,70,6,1565
13139000005,5891,4768,3885,416,230,109,111,1,883
13139000006,5315,4203,2967,514,498,87,132,6,1236
13139000024,6286,4582,2116,1767,569,152,75,7,2466
13215000118,8040,6251,4291,326,1371,152,130,13,1960
13215000109,3679,3113,2397,111,322,42,255,9,716
13215000125,5226,3955,1403,191,2257,77,46,10,2552
13215000119,9114,7036,4468,527,1584,126,321,34,2568
13215000124,7923,6144,3582,573,1742,171,102,20,2562
13107001502,733,564,423,50,81,10,2,1,141
13139000007,7819,5923,4346,736,387,166,289,7,1577
13139000004,5485,4352,3139,781,211,89,131,0,1213
13139000019,6051,4772,3799,666,85,150,61,1,973
13139000025,2799,2154,1354,308,431,40,33,4,800
13139000015,3926,3033,2773,112,33,88,22,2,260
13139000013,5309,4100,3371,339,214,137,57,3,729
13139000023,14853,10177,2954,5659,1111,381,363,19,7223
1310300005A,4045,3015,2442,137,295,107,43,3,573
131210SC01C,2683,2192,29,35,2112,37,14,0,2163
131210SC01D,499,399,3,0,396,0,0,0,396
131210SC16B,13,10,0,5,6,0,0,0,10
131210SC01B,2791,2027,42,44,1946,31,9,4,1985
131210SC01A,36,28,2,1,23,1,2,0,26
131210SC08B,5347,3956,137,105,3697,43,34,4,3819
131210CP084,411,218,3,6,213,2,1,0,215
131210SC08F,1007,717,31,7,674,3,5,1,686
131210SC08E,1062,760,16,12,727,15,10,1,744
131210SC29B,0,0,0,0,0,0,0,0,0
131210SC08H,0,0,0,0,0,0,0,0,0
131210UC033,3,2,0,0,2,0,0,0,2
131210SC08C,130,94,1,0,93,1,0,0,93
131210UC01A,6165,4442,112,194,4139,43,24,1,4330
131210SC17C,1298,1023,18,11,989,9,4,0,1005
131210SC09B,2346,1840,20,58,1760,23,17,0,1820
131210UC01D,25,16,3,6,9,4,2,0,13
131210SC08D,795,607,14,14,582,13,2,0,593
131210SC08G,43,13,1,0,12,1,0,0,12
131210SC17B,41,33,16,4,12,6,1,0,17
131210UC031,4391,3393,507,77,2786,20,23,13,2886
131210SC08A,0,0,0,0,0,0,0,0,0
1312100008G,3858,3561,2187,226,939,54,189,7,1374
1312100005C,49,43,0,3,36,1,2,0,43
1312100001I,25,18,0,2,16,0,0,0,18
1312100005K,8213,7970,2135,505,4466,98,892,20,5835
1312100002S,961,869,437,58,331,18,47,2,432
1312100003C,1925,1506,54,32,1414,28,10,1,1452
131210ML05C,6070,4592,2684,377,650,73,767,5,1908
131210ML05B,570,426,351,14,15,7,35,0,75
131210ML05A,64,53,34,4,9,1,8,1,19
1312100006R,1865,1687,1356,71,144,26,80,1,331
13121003P1A,7395,7021,2957,461,1652,102,1902,7,4064
1312100003N,3184,2709,453,116,1973,33,193,8,2256
13121003P1B,9,9,0,0,8,0,1,0,9
13013000016,9768,7063,4384,885,1412,138,271,11,2679
13013000008,4772,3576,2791,290,258,113,139,2,785
13013000015,4927,3707,2942,296,204,104,180,1,765
13033000002,3647,2809,1930,122,678,55,26,7,879
13033000006,788,597,301,44,223,15,9,5,296
13033000012,632,460,262,6,181,9,3,3,198
13193000002,3614,3233,913,88,2188,19,21,2,2320
13193000001,2073,1710,884,28,756,15,33,0,826
13193000004,1938,1574,407,51,1048,17,58,3,1167
13117000019,10552,7524,3350,277,385,41,3441,4,4174
1312100JC01,8604,6380,2046,238,616,39,3465,8,4334
13117000021,21951,14975,8160,656,708,117,5236,10,6815
13157004000,11410,8812,7129,665,660,222,135,5,1683
13157001000,24383,17191,13479,1406,1394,356,512,25,3712
13227000004,1725,1382,1286,31,9,37,10,4,96
13207000006,603,476,314,4,133,20,7,0,162
13245000706,4472,3843,2568,186,830,78,174,9,1275
13245000708,530,437,314,39,46,8,29,1,123
13245000104,4439,3024,164,42,2807,20,21,4,2860
13245000107,2414,1994,1120,76,732,24,34,5,874
13245000306,6643,5588,2265,328,2679,124,272,17,3323
13245000308,1114,949,501,53,342,19,36,0,448
13207000003,2820,2295,1966,37,222,22,51,1,329
13245000802,4853,3730,2630,130,825,110,39,14,1100
13245000202,7240,5254,1526,205,3433,55,57,7,3728
13245000114,1217,883,125,23,731,7,4,0,758
13071000010,1010,759,481,29,236,13,6,0,278
13071000012,1171,884,805,18,30,21,14,0,79
13071000013,556,448,408,12,11,9,2,0,40
13071000017,2717,2019,1564,178,239,28,17,2,455
131290849-A,9986,7555,5634,1316,309,244,80,11,1921
131290849-B,16943,12636,8166,2776,1032,402,377,12,4470
13129000980,2680,2078,1648,291,79,63,13,2,430
13129000874,2806,2213,2038,34,38,82,11,4,175
131450000WH,1815,1521,1154,27,274,51,13,1,367
13069000001,28571,20978,11682,2512,6266,371,247,29,9296
13139000028,10874,8296,6952,601,384,146,214,5,1344
13139000026,1826,1398,1121,177,53,33,15,1,277
13139000014,4807,3684,3391,94,47,110,21,3,293
13139000020,4573,3799,3417,177,74,73,55,4,382
13053FTBEN2,3536,2470,1395,537,322,71,165,53,1075
1310300003A,1953,1506,1192,25,244,27,9,0,314
13055001216,250,185,161,10,9,3,0,0,24
13085000001,2409,2166,2061,35,8,37,25,1,105
133130000ES,3958,2847,1375,1336,98,117,9,2,1472
1331300005A,6112,4206,747,3034,388,258,32,7,3459
1331300006A,6190,4130,684,3108,298,347,10,4,3446
13019001329,985,725,644,41,19,16,3,2,81
1322300010C,10893,7918,4942,478,2181,259,85,20,2976
130810ARABI,1303,1058,808,23,192,21,13,0,250
132410RABUN,16883,13767,12236,928,129,372,83,11,1531
13117000029,25858,18383,10700,1989,1000,267,4308,16,7683
13117000007,7076,5467,3358,1268,316,150,423,4,2109
13117000025,16838,11336,5762,591,408,110,4431,4,5574
13117000008,10161,7876,6569,552,268,117,348,6,1307
13117000016,18460,14109,10335,2136,631,358,631,17,3774
13117000027,15669,10977,9062,764,469,289,355,9,1915
13117000015,13000,9437,7765,798,302,252,269,14,1672
13117000001,25518,18111,11155,989,796,186,4856,32,6956
13071000011,1745,1318,913,243,156,13,2,0,405
13295001161,1439,1156,1090,15,7,22,3,2,66
13295000944,6858,5513,4958,129,277,90,44,4,555
13295001898,3605,2734,2431,40,145,88,12,3,303
13055000940,1294,1014,880,13,93,17,7,2,134
13055XC-968,1471,1194,1149,9,13,16,1,1,45
13147000003,3100,2354,1836,104,328,46,46,3,518
1311100TOCC,4147,3476,3198,125,24,76,32,0,278
13285000008,5618,4377,3480,67,694,70,55,0,897
13219000011,4114,3106,2198,307,362,42,186,2,908
13219000009,3429,2462,1948,152,177,46,129,4,514
13285000003,8030,5920,2242,374,2916,118,299,16,3678
13219000004,946,718,611,26,46,23,18,0,107
13219000013,2458,1765,1409,106,144,47,59,1,356
13285000004,4007,2927,244,102,2564,27,12,0,2683
13285000016,4347,3190,1654,118,1231,71,129,3,1536
13285000011,4636,3610,2769,80,647,72,37,3,841
13285000005,3222,2468,949,43,1430,27,27,2,1519
13233000006,9474,7180,5375,216,1336,161,89,3,1805
13285000002,7239,5234,1665,336,3091,49,97,5,3569
13213001013,4768,3518,2899,470,65,103,19,1,619
13163001460,990,783,493,12,262,14,8,0,290
13163000082,5721,4478,1745,91,2595,34,44,0,2733
13295001501,5565,4287,3890,90,123,124,23,3,397
13147000002,10172,8167,5830,207,1925,102,104,5,2337
13117000010,30426,21077,15188,1453,1073,303,2898,21,5889
1306300RD08,3820,3009,227,230,2464,58,106,3,2782
1300900CTY1,3706,3058,1511,110,1308,37,67,4,1547
13179000013,9453,6759,3203,1266,1966,169,286,72,3556
133130000DG,6422,4699,2638,1709,152,169,133,3,2061
1331300004A,4068,3037,1829,890,101,135,166,1,1208
13167001201,4427,3737,1774,30,1890,30,22,5,1963
13019001144,2099,1556,1180,101,208,54,20,3,376
1300900CTY3,1697,1325,555,53,674,17,26,4,770
1300700000M,340,286,193,2,87,2,4,0,93
13213001895,6753,4952,3771,983,38,189,20,2,1181
13213000824,10064,7723,6342,996,91,373,82,4,1381
13063000LJ3,13253,9824,1381,842,7476,119,190,11,8443
1306300JB06,3135,2696,1157,91,1136,55,273,0,1539
1306300JB11,5234,4008,699,493,2628,76,178,5,3309
13285000006,5261,3893,2507,153,1095,98,35,5,1386
13219000010,5721,4152,3331,145,153,32,471,1,821
13285000012,3808,3016,1799,73,905,34,192,1,1217
13233000007,3237,2517,2206,134,104,72,5,3,311
13233000003,14052,10086,5870,2375,1579,276,91,18,4216
13255000013,3575,2838,2389,115,241,59,43,2,449
13255000010,3070,2506,1495,95,817,45,56,4,1011
13255000005,6077,4487,1772,305,2206,86,148,4,2715
13255000006,4303,3098,731,134,2153,65,32,5,2367
13255000002,3080,2259,281,44,1904,33,1,2,1978
13167001746,451,364,257,9,89,7,5,2,107
13073000134,2870,2265,1590,141,334,34,155,3,675
13073000075,3247,2476,1589,149,514,60,182,15,887
13073000074,3166,2389,1432,192,590,61,132,6,957
13073000016,1693,1311,902,62,210,34,92,1,409
13073000085,1599,1198,933,78,105,28,45,5,265
1306300RD02,5449,3995,148,590,3216,46,58,2,3847
13113000014,4523,3296,2411,157,505,74,145,1,885
13113000033,2371,1870,1548,104,96,30,94,6,322
13113000008,3480,2814,1176,170,1353,66,82,4,1638
13113000027,3739,3026,2097,152,605,67,123,3,929
13045000642,9624,6999,3641,463,2648,143,155,4,3358
13097001258,8754,6480,2923,670,2550,134,247,3,3557
13045000649,6140,4552,3751,149,473,128,32,6,801
13045000641,7613,5684,4220,279,922,169,67,3,1464
132470000BT,5402,4331,2710,433,1001,103,81,0,1621
13211000002,3009,2311,1914,76,251,53,23,0,397
13219000003,1801,1371,1221,51,56,34,8,0,150
13285000010,5020,3950,3187,82,533,72,54,5,763
13293005610,12068,9316,5581,221,3338,143,42,2,3735
13293000589,400,354,55,0,292,0,3,1,299
13117000003,12917,10345,8476,1097,272,270,210,10,1869
13219000001,2630,1996,1771,53,72,28,57,1,225
130450714A3,5964,4432,2507,428,1308,96,125,4,1925
13045000640,4020,3056,2412,163,342,108,41,1,644
132470000OT,10967,8110,1404,596,6009,94,113,21,6706
13217000012,5230,4219,3079,143,858,92,66,0,1140
132470000FI,9217,6961,1071,303,5391,86,193,7,5890
132470000CO,6341,4458,924,508,2959,75,70,8,3534
13113000026,4167,3123,1725,310,807,70,211,7,1398
13113000029,4111,3261,1185,209,1631,52,236,4,2076
131450000HA,4080,3027,1993,117,797,61,47,8,1034
131450000CA,3704,2859,2260,132,322,72,64,4,599
13129000856,2637,2008,1779,79,82,38,16,1,229
13215000102,6145,4727,452,171,4059,42,55,13,4275
13215000116,11470,8301,1471,435,6243,103,135,40,6830
13215000107,9147,7054,3803,650,2354,167,110,35,3251
13215000104,4293,3343,2114,266,719,83,160,16,1229
13227000010,3142,2780,2594,44,23,75,28,1,186
13227000007,2355,1852,1696,34,20,88,14,1,156
13171001713,4552,3813,2562,80,1101,51,40,3,1251
130450714A1,8617,6571,2676,1381,2349,110,68,1,3895
13045001240,3715,2812,2414,115,171,52,45,1,398
13113000004,2800,2140,987,171,859,41,98,0,1153
13113000002,3217,2464,2218,70,61,79,39,1,246
13255000019,3721,2968,2102,148,608,82,35,6,866
13045001483,4772,3704,3064,147,379,68,30,2,640
13255000001,4059,2951,546,162,2209,28,14,0,2405
13113000003,3854,3114,377,158,2472,31,113,0,2737
13045001533,2452,1932,1636,49,174,45,16,0,296
13057000026,10018,7774,5853,718,659,110,395,12,1921
13057000042,4570,3511,2834,369,151,116,69,3,677
13057000002,6539,4968,4026,438,160,139,161,6,942
13057000004,5236,3958,3630,121,56,103,21,7,328
13057000039,7967,6225,5177,493,336,153,84,7,1048
131450000U9,2246,1831,1488,92,156,56,46,4,343
13073000031,4938,3546,1545,499,1318,113,170,26,2001
13045001006,1538,1215,1138,15,19,37,6,0,77
130450714BW,2926,2262,1867,88,241,49,26,2,395
132470000LA,4818,3369,661,1580,1078,79,30,8,2708
132470000MA,4418,3477,1602,252,1461,71,97,3,1875
13113000034,4957,3634,2876,198,232,63,236,4,758
13045001496,2000,1510,1125,46,277,43,21,1,385
13057000018,7091,5580,4903,277,133,127,102,12,677
13057000010,12914,10111,7011,1854,927,358,116,9,3100
13057000013,6499,4928,4167,285,279,109,72,2,761
13057000022,4828,3798,2939,373,309,113,104,6,859
13057000037,9203,6906,5356,610,547,153,186,11,1550
13171001714,5768,4469,3712,79,546,86,25,2,757
13019001148,379,289,251,10,22,10,1,0,38
1305103-10C,4357,3589,1240,252,1864,30,215,8,2349
1305107-08C,4854,3793,2903,239,461,113,51,15,890
1305107-12C,9737,7658,4219,527,2288,107,501,15,3439
1305107-11C,11988,9541,4367,783,3752,136,541,21,5174
1305104-08C,3094,2475,2287,60,43,17,51,3,188
1305104-06C,2675,2135,1854,59,78,42,85,4,281
1305102-11C,2505,1943,500,61,1330,33,36,5,1443
1305102-05C,2381,2006,848,69,990,33,63,9,1158
1305105-06C,5096,3496,1267,313,1808,78,70,31,2229
1305107-10C,6390,4934,2146,427,2092,116,193,32,2788
1305108-05C,2529,1604,152,19,1415,22,10,0,1452
1305108-06C,1507,1122,76,41,995,22,9,0,1046
1305108-12C,4030,3581,941,221,1897,41,512,5,2640
1305107-14C,10745,8229,3238,708,3708,146,472,34,4991
1305102-09C,4201,3391,1099,134,2064,44,62,3,2292
1305101-12C,2314,1780,1649,42,41,14,28,2,131
131310000SH,796,609,511,28,47,22,3,0,98
13087000513,10320,7742,3932,450,3152,103,104,1,3810
13087000694,2702,2133,703,181,1215,33,5,3,1430
13171001711,3487,2601,870,72,1597,39,47,2,1731
1317101712A,1983,1521,1268,50,150,33,14,0,253
131310000WL,3639,2871,2291,147,355,78,10,1,580
1313100000L,499,406,325,4,72,7,1,0,81
13215000110,10401,7369,644,706,5937,81,96,18,6725
13227000008,3198,2492,2182,118,80,81,20,1,310
13057000044,11192,8649,6246,1099,666,165,380,16,2403
1305107-09C,5550,4316,1868,676,1507,126,201,15,2448
1305106-11C,8354,6294,2403,696,2788,148,316,24,3891
1305102-07C,3822,2933,874,148,1830,46,54,7,2059
1305107-03C,2072,1622,1101,198,251,47,25,3,521
1305107-04C,7131,5000,1417,383,3046,118,124,6,3583
1305107-15C,1743,1336,724,133,433,28,37,5,612
1305108-13C,2858,2027,759,1010,234,72,11,7,1268
1305108-03C,1639,1253,663,337,208,35,17,3,590
1305101-16C,4443,3425,2439,543,289,104,48,4,986
1305108-01C,5355,4751,2694,536,832,51,652,2,2057
1305104-04C,2858,2333,2064,68,74,40,73,3,269
1305104-05C,2950,2345,2080,65,83,29,77,5,265
1305104-15C,2034,1816,1706,30,19,13,32,0,110
1305104-12C,2631,2137,1961,46,47,11,62,0,176
1305107-01C,2457,1891,964,221,633,46,34,1,927
1305103-01C,882,822,599,56,115,6,51,2,223
1305108-07C,826,611,37,33,549,3,0,0,574
13073000030,5628,3952,1996,404,1395,113,130,9,1956
13135000012,11845,8763,1354,2175,2633,197,2535,16,7409
13135000148,2741,2050,969,389,303,43,394,2,1081
13135000068,5403,3921,1712,353,909,68,884,8,2209
13135000047,4012,2925,1572,125,542,48,637,0,1353
13135000133,7369,5378,2893,788,1370,124,288,5,2485
13135000077,9401,7228,1994,1520,2063,157,1604,14,5234
13135000095,12394,9601,1626,1998,3272,149,2692,12,7975
13135000057,10275,8048,2243,2310,1422,185,2055,9,5805
13135000096,4815,3620,1494,322,471,53,1301,7,2126
13135000089,5627,4128,2000,601,698,80,785,6,2128
13135000024,9344,6658,2765,1969,1191,162,715,11,3893
13135000100,7364,5308,2257,349,733,62,1899,11,3051
13135000106,9256,7152,2901,608,1088,100,2495,15,4251
13135000028,8636,6184,3174,743,1827,108,361,9,3010
13135000038,6986,5104,720,2817,927,198,658,8,4384
130890000JB,6977,4895,728,184,2843,56,1126,5,4167
130890000MN,4773,3298,189,149,2789,42,187,4,3109
130890000CK,14754,9882,992,361,6712,110,1837,15,8890
130890000IA,3662,2889,623,164,1729,38,356,4,2266
130890000GD,6102,5021,2199,400,1207,55,1126,15,2822
130890000DF,7457,5727,2150,334,754,46,2413,6,3577
13057000024,12485,8908,6407,941,1039,253,254,14,2501
13073000060,3095,2351,1541,141,509,43,126,11,810
13073000070,2295,1823,1420,66,233,50,64,7,403
13073000080,1916,1478,1161,58,137,62,65,4,317
13073000107,2887,2086,1361,66,259,35,365,4,725
13073000109,3412,2628,1993,78,200,24,317,1,635
133130000TR,1850,1430,1295,74,19,34,9,0,135
1331300002A,4864,3847,2705,502,283,103,275,3,1142
133130000WS,3774,2969,2498,284,101,79,27,0,471
13135000035,5770,4122,1651,422,1111,106,895,3,2471
13135000053,6264,4518,1178,598,2512,93,215,7,3340
13135000044,6339,4634,1066,746,2528,92,311,11,3568
13135000153,4532,3344,1140,988,894,91,299,5,2204
13135000084,4973,3619,687,887,1234,109,815,6,2932
13135000078,5457,4147,1793,369,1580,45,400,11,2354
13135000055,8579,6042,2917,1449,1212,151,403,12,3125
130890000CW,3954,3043,2378,120,206,38,288,4,665
130890000DC,13089,9954,2643,4876,1496,314,899,3,7311
130890000CX,4347,3476,2423,257,367,66,390,11,1053
130890000CE,7314,5495,1450,3052,497,300,471,5,4045
130890000AB,3479,2411,1941,162,113,35,150,2,470
130890000WK,3955,3132,72,70,2968,53,30,6,3060
130890000WJ,4383,3869,1801,586,931,66,530,5,2068
130890000LC,5131,4361,2212,609,937,76,559,1,2149
130890000HI,2439,2161,1121,201,507,37,289,2,1040
130890000EA,4951,3709,1554,121,1897,47,116,5,2155
130890000MP,1958,1654,582,65,951,30,41,0,1072
130890000TA,2987,2425,570,93,1699,27,57,2,1855
130890000MD,2900,2495,614,84,1742,33,36,2,1881
130890000CQ,4062,3305,893,121,2195,53,61,2,2412
130890000BI,5254,4390,3466,252,346,56,265,2,924
130890000SE,6820,5954,3996,300,1145,64,432,6,1958
130890000SF,4045,2838,1546,910,174,117,185,1,1292
130890000SI,4616,3506,326,155,2965,76,94,4,3180
130890000SD,2963,2392,831,167,1336,47,65,1,1561
13251000007,1249,944,512,8,412,8,4,2,432
130890000FL,3696,2719,44,50,2597,27,27,0,2675
130890000CM,2579,1997,55,31,1901,30,18,2,1942
13135000059,8300,6102,1060,1941,2814,128,318,18,5042
13135000114,8306,6182,1825,2325,1137,172,875,19,4357
13083000974,2744,2220,1929,63,49,118,45,5,291
13083000960,4225,3250,2999,58,27,103,49,5,251
13135000052,3325,2512,1363,208,393,60,496,3,1149
13117000004,9232,6993,6005,615,78,203,96,11,988
13117000006,10112,7653,6415,698,205,185,149,7,1238
13113000007,3150,2450,968,245,1151,53,66,2,1482
13113000010,6708,4937,1896,646,2109,118,246,6,3041
13045000713,4186,3240,2910,64,178,63,19,0,330
13045001111,4539,3461,2720,77,578,70,18,4,741
132470000SP,6230,4786,1220,261,3168,83,88,8,3566
13113000016,4251,3363,2551,167,345,58,223,1,812
13211000001,3992,3069,1455,67,1479,43,19,3,1614
13135000101,3217,2459,1058,325,936,76,146,2,1401
13135000103,6986,5028,774,1880,1592,96,842,7,4254
13135000064,5081,3799,1025,606,2066,97,135,2,2774
13073000110,2021,1503,993,108,305,38,65,8,510
13073000090,2819,2197,1592,128,324,43,101,0,605
13077000014,6125,4559,3677,199,505,95,53,2,882
13077000028,14111,10918,5381,1141,3442,241,806,13,5537
13077000006,5722,4470,3758,220,268,109,86,4,712
13291000001,3613,3082,2800,112,68,64,19,3,282
13291000007,1802,1548,1473,34,3,30,8,0,75
13281000833,3445,2981,2776,91,19,63,18,11,205
13281000990,5047,4439,4201,111,13,74,34,5,238
1311100MORG,2585,2184,2031,42,15,81,8,2,153
13147000008,2330,1724,1227,74,356,21,54,2,497
13147000007,2413,1883,1667,54,78,55,27,0,216
1311100FLIN,4531,3571,3260,137,24,107,26,1,311
1311100HOTH,1507,1266,1188,23,2,39,2,1,78
1311100MOBI,1440,1219,1160,15,9,28,2,0,59
13105000315,1634,1287,990,84,160,31,23,0,297
13291000011,1381,1225,1141,31,9,27,5,2,84
13291000004,2629,2224,2069,54,16,64,14,1,155
13291000008,2752,2252,2115,57,14,40,20,3,137
13299000300,7878,6374,4116,257,1874,83,52,5,2258
13259000005,3463,3129,667,1184,1095,28,161,6,2462
13011000004,1220,908,767,66,46,17,8,0,141
13011000001,2159,1636,1503,42,36,35,16,1,133
13211000003,1095,876,673,30,145,17,7,1,203
130890000SA,3458,2660,2151,106,130,25,210,2,509
130890000CJ,4525,4062,2473,242,668,37,618,10,1589
130890000MG,2513,2155,1640,120,165,38,190,3,515
130890000SB,3916,3348,2087,194,478,50,552,1,1261
130890000CI,4403,3185,2355,133,379,50,252,4,830
130890000CV,4310,3240,2482,151,267,44,282,3,758
130890000YA,2222,1780,60,49,1675,21,14,1,1720
130890000MO,3508,2917,698,137,1996,52,50,8,2219
13135000072,13273,10153,1378,3079,4742,177,1102,15,8775
130890000OV,6314,4669,102,114,4458,40,35,6,4567
130890000HH,5021,3830,66,114,3672,59,17,5,3764
130890000AG,3909,2827,2161,153,289,22,186,5,666
130890000SL,3735,2834,178,207,2429,19,18,7,2656
130890000WD,4576,3312,132,59,3122,26,18,2,3180
130890000SW,5831,4634,145,122,4356,46,45,7,4489
130890000LD,2662,1866,117,138,1607,13,20,1,1749
130890000FE,4233,3368,85,56,3194,46,26,0,3283
130890000GB,2431,1885,175,127,1416,36,160,0,1710
130890000BL,2644,2009,62,65,1881,17,14,2,1947
13011000006,2685,2052,1782,69,82,68,46,0,270
13095000008,4241,3280,196,57,3014,43,7,3,3084
13095000014,1906,1431,66,14,1344,16,1,2,1365
13095000006,3343,2621,1367,66,1110,28,37,2,1254
13011000010,2136,1619,1464,53,62,33,9,3,155
13259000002,1851,1488,494,12,953,20,11,5,994
13297000425,6225,4546,2462,178,1776,100,37,5,2084
13165000005,1826,1395,833,37,509,12,3,1,562
13149000EPH,1978,1464,1352,12,44,36,16,7,112
1313100000R,866,699,496,20,163,12,3,0,203
13095000001,3910,3218,1523,57,1566,45,38,12,1695
13095000015,2707,2082,416,58,1568,32,33,6,1666
13105000190,878,708,531,11,158,10,4,1,177
13095000012,2121,1608,16,12,1587,8,0,0,1592
13095000013,1962,1484,61,16,1394,30,9,2,1423
13095000007,6483,4899,805,77,3970,45,42,11,4094
13095000016,1158,798,53,38,713,1,4,0,745
13095000003,3396,2659,1174,72,1362,29,30,2,1485
130890000NB,3890,3386,1306,173,1116,58,762,8,2080
130890000AE,3567,2861,2252,90,358,32,116,4,609
130890000ME,5881,4828,2064,350,1185,88,1202,7,2764
13077000017,8274,5861,1973,813,2924,105,138,17,3888
13077000005,5376,4087,1638,266,2112,90,28,6,2449
13077000002,3630,2823,2446,79,207,63,15,6,377
13199000007,3536,2875,1813,63,913,55,14,0,1062
13297000419,5941,4558,3197,216,1005,64,79,3,1361
13297000426,2712,2067,1714,36,239,46,22,0,353
13297000415,6385,4827,4000,108,533,105,63,1,827
13297000454,2285,1788,1524,60,151,38,16,4,264
13297000422,5502,4216,3319,251,446,77,72,5,897
13165000001,1189,914,319,18,565,13,4,0,595
1329900200A,4133,3046,1888,88,949,51,62,0,1158
13299000400,5032,3979,3441,95,242,86,94,3,538
1329900200B,3133,2230,748,116,1315,51,10,5,1482
13299000100,6364,4675,1117,131,3366,56,44,3,3558
13011000005,495,399,363,18,2,15,4,1,36
13095000011,912,730,17,13,702,7,0,0,713
13095000027,2075,1689,970,60,576,18,61,2,719
1305105-05C,2962,2290,40,35,2213,18,7,3,2250
132210000LX,5787,4602,3413,168,866,72,73,8,1189
132210000CR,4254,3297,2345,175,638,117,22,10,952
1330500003A,4814,3559,2674,178,590,72,36,5,885
1303500BCCC,25434,20360,13510,559,5660,400,136,18,6850
13087001342,975,769,554,17,182,7,8,2,215
13061000005,679,560,339,4,215,3,0,1,221
13095000028,2183,1909,100,37,1767,4,4,3,1809
13297000420,7027,5214,2287,201,2553,110,82,3,2927
13297000250,5300,4237,3381,183,363,91,205,2,856
13297000503,1473,1155,982,38,96,34,11,1,173
13165000003,1543,1247,910,45,270,16,2,2,337
13165000004,2666,2336,1397,71,850,16,6,0,939
13299000304,2107,1568,1249,125,173,22,4,0,319
1305104-14C,1960,1719,1608,29,24,18,33,0,111
13297000421,5303,3943,2651,263,850,89,95,7,1292
13297000427,5513,4029,2190,222,1384,92,136,3,1839
13297000418,6725,5010,3393,118,1341,121,34,3,1617
13087000514,5926,4394,1772,135,2397,42,38,2,2622
13087001277,792,628,485,29,89,22,3,0,143
13087001361,1546,1228,891,74,242,18,5,0,337
1313100000H,1335,1095,767,50,255,25,6,0,328
13087001613,1787,1500,1046,54,371,20,11,1,454
13297000424,4437,3329,2717,179,275,85,69,3,612
13297001663,6090,4598,3814,217,400,81,73,4,784
13299000407,786,624,566,35,8,8,8,0,58
13299000409,1499,1166,1053,53,35,16,5,0,113
1304700WEST,9197,7328,6253,337,334,216,186,15,1075
1304700GRAY,6661,5067,4552,117,132,143,90,5,515
1304700RING,10685,8267,7320,258,297,236,116,9,947
133130000VA,8101,6134,4806,911,209,154,89,6,1328
133130000TH,5990,4700,3964,462,120,115,46,2,736
13167001820,672,533,473,8,48,4,2,0,60
13095000018,3306,2422,203,45,2140,22,14,0,2219
13105000193,1449,1184,804,49,309,16,8,0,380
13063000MO6,4603,3461,580,495,2223,94,182,8,2881
13063000FP6,2620,1955,293,507,649,50,512,2,1662
13287000002,2540,2028,1626,60,306,32,7,0,402
13287000003,739,574,494,16,59,6,5,0,80
13163000081,4013,3069,1372,72,1590,17,12,0,1697
13151000032,7474,5466,876,280,3823,87,484,8,4590
13151000033,7846,5954,595,328,4146,90,903,8,5359
13151000054,7453,5535,1363,864,3034,122,272,12,4172
13213000872,3445,2687,2452,120,17,89,18,0,235
13233000004,4006,3149,2731,102,215,75,15,4,418
13233000001,5224,4008,3402,94,394,87,20,9,606
13095000009,1814,1517,876,22,598,32,1,4,641
13095000010,5217,3826,129,37,3662,29,6,3,3697
1305105-11C,4599,3659,1068,260,2085,43,239,5,2591
1305101-17C,3993,3314,2855,91,116,56,181,6,459
1305103-12C,3161,2724,1623,300,593,38,181,2,1101
1305108-02C,2807,2351,1421,154,549,22,204,3,930
1305107-05C,2259,1802,710,187,795,44,92,10,1092
13105000191,1282,1028,748,77,187,15,4,2,280
13095000025,2250,1854,1218,20,535,20,57,1,636
13095000021,1466,1139,345,78,686,17,19,8,794
1331500003A,1404,1057,848,64,105,14,19,2,209
13105000189,6690,5142,2518,251,2257,71,73,4,2624
13105000197,2346,1853,1167,74,587,18,18,1,686
1330500002A,2774,2131,1767,64,243,45,6,1,364
1330500005B,2712,2020,1532,106,322,36,32,0,488
1305108-10C,2173,1685,47,46,1616,12,10,5,1638
1305104-11C,1705,1588,1468,20,19,34,41,4,120
1305107-07C,10322,7959,4634,578,1884,176,682,18,3325
1305104-13C,2753,2338,2193,37,35,11,50,0,145
1305103-11C,1949,1505,389,49,1006,29,32,6,1116
1305103-02C,2279,2148,1677,107,223,28,117,2,471
1305102-02C,2760,2045,829,95,995,41,90,4,1216
13297000414,1455,1196,1062,20,62,23,24,2,134
1305101-01C,3792,3155,2713,131,136,67,94,6,442
1313100000W,1837,1444,1014,45,341,32,17,5,430
13037000005,791,607,140,6,458,7,1,0,467
1331500002A,732,585,327,15,237,10,2,1,258
1331500005A,3389,3037,1463,73,1474,17,11,2,1574
13037000004,811,630,270,8,348,4,3,0,360
13037000002,2182,2065,735,46,1269,10,14,0,1330
13301000001,2985,2306,650,26,1606,13,13,3,1656
13215000106,10451,7990,4822,620,1707,187,690,54,3168
13215000105,4816,3775,2492,245,715,95,253,12,1283
13227000002,2458,1925,1792,44,14,50,20,1,133
13069000004,3595,2698,1882,232,491,93,17,1,816
13299000408,841,641,582,37,6,7,7,0,59
13043001685,5599,4242,2624,270,1285,48,24,5,1618
13297000423,5996,4462,3693,198,369,113,76,7,769
13299000406,2928,2265,1925,56,219,37,6,1,340
13077000007,6186,4464,3431,297,446,112,164,10,1033
13077000004,1211,967,827,26,55,33,8,3,140
13191000271,2508,2042,1487,41,468,49,7,0,555
13191001771,2742,2303,1504,46,680,52,18,1,799
13191001480,670,522,387,5,115,9,3,0,135
13127005923,5022,3686,1615,366,1669,43,23,11,2071
13127005933,5881,4043,501,335,3160,55,19,14,3542
13127005943,2821,2145,628,315,1156,42,5,1,1517
13127001713,6452,4961,3699,388,620,137,112,11,1262
13127003713,5572,4308,2944,308,789,135,143,10,1364
13127003723,3022,2243,1503,113,503,48,81,5,740
13127001933,3778,2737,2088,82,426,63,75,2,649
13127001923,4373,3330,2528,122,549,95,32,9,802
13127001943,3325,2682,2200,169,209,58,38,4,482
13127002953,866,817,785,11,7,14,5,0,32
13199000012,994,783,522,8,228,19,3,1,261
13301000004,687,572,268,3,299,0,2,0,304
13215000117,9501,7688,4051,493,2730,184,307,21,3637
13227000012,4288,3359,3044,124,54,101,26,1,315
13217000005,4433,3401,1633,309,1359,75,63,7,1768
13087001805,4179,3111,1456,194,1427,33,11,1,1655
13077000018,16279,12401,8628,947,1871,216,816,8,3773
13077000003,2953,2342,1985,90,194,53,25,0,357
130890000BJ,4708,3684,105,116,3464,54,35,3,3579
13097000733,4359,3249,1096,353,1684,68,86,13,2153
13097001275,9165,7068,1350,558,5001,102,152,8,5718
13097000784,5533,4276,1353,279,2516,65,77,2,2923
13043001736,5382,3999,2605,565,724,86,31,2,1394
13297000416,3772,2841,2454,110,151,74,47,3,387
13297000502,2752,2061,1878,54,59,43,26,3,183
13299000404,606,466,432,3,13,12,3,1,34
13191001312,144,100,39,4,41,5,7,1,61
13217000002,6743,4944,1211,229,3394,89,49,6,3733
13217000024,7230,5232,606,394,4139,89,73,8,4626
13127004933,4406,3473,1632,331,1386,76,77,15,1841
13127004913,5036,4007,2572,302,943,73,137,11,1435
13127005913,4298,3668,1984,211,1426,36,26,5,1684
13127004923,4534,3452,1517,275,1541,65,68,21,1935
1305102-04C,3899,3262,848,134,2172,56,84,16,2414
13197000808,417,335,269,15,44,8,3,0,66
13029000001,3819,2844,1860,85,784,55,36,16,984
13149000FRA,3327,2559,1967,57,454,67,25,2,592
13149000SOU,950,712,575,9,105,21,4,0,137
13135000152,6942,4941,2503,625,1350,92,425,11,2438
13135000073,3138,2524,1237,393,705,44,175,8,1287
13135000105,6984,4976,2524,836,557,85,1017,6,2452
13135000010,3430,2701,1476,426,585,75,167,6,1225
13135000081,5708,4362,1691,527,1850,77,278,3,2671
13135000039,10195,7373,4674,714,1231,149,647,13,2699
132890000DB,2127,1747,1411,20,242,65,11,0,336
1328900JV/W,1747,1441,527,17,878,6,16,1,914
132890000GI,2170,1799,803,29,931,17,15,2,996
13087001325,1140,938,747,62,114,21,3,1,191
13149000COO,1103,840,743,14,57,24,2,1,97
13095000005,4857,3796,1542,87,2051,43,83,7,2254
1305101-10C,1293,1049,1002,20,12,4,2,3,47
1305108-15C,2562,1983,210,273,1471,41,20,3,1773
13131000C04,4082,3013,607,199,2174,40,12,1,2406
130890000CF,5200,3848,231,117,3501,48,43,5,3617
130890000BC,3981,3522,2376,298,420,61,383,2,1146
13135000058,9111,6610,859,3174,1867,195,754,33,5751
13199000001,626,506,434,7,56,6,3,1,72
13199000005,2702,2153,1121,30,959,31,5,0,1032
13217000004,6715,5019,2747,274,1883,79,92,1,2272
13217000001,3084,2277,845,137,1228,36,28,1,1432
13217000014,2971,2298,1711,56,468,53,10,1,587
13217000010,8621,6530,3060,382,2909,134,114,14,3470
13217000023,4299,3154,421,131,2518,36,36,25,2733
13217000018,5211,3701,2092,185,1319,70,41,6,1609
13073000064,4578,3262,1993,186,781,76,251,8,1269
13073000061,5076,3407,2671,182,319,56,177,15,736
130890000KA,3291,2684,270,57,2334,27,31,3,2414
130890000FC,3324,2542,102,64,2374,12,14,4,2440
1311100FAIR,1531,1296,1220,15,4,38,5,2,76
13217000025,3088,2406,2042,56,225,50,20,1,364
13135000003,7312,5268,2019,1023,1872,99,317,8,3249
13135000027,6314,4774,2504,568,1085,80,564,9,2270
13135000025,9283,6821,3546,1334,1130,187,713,18,3275
13135000054,7481,5353,3442,669,761,83,432,2,1911
13135000016,7989,5865,1670,1017,2279,96,878,5,4195
130890000TH,4029,3249,1421,384,1061,62,347,6,1828
13097001276,4554,3472,1400,588,1406,106,63,10,2072
13097000738,3153,2433,1275,221,852,55,54,1,1158
13097001270,6538,5058,836,454,3668,85,102,18,4222
1306700AU1A,7650,5689,1257,850,3454,125,116,9,4432
13097001273,6014,4511,1917,775,1677,118,65,9,2594
13097001271,6499,4984,3517,248,1014,111,84,6,1467
13077000025,3003,2377,1659,160,476,47,37,4,718
1305104-10C,1727,1536,1432,25,26,32,9,0,104
1305103-08C,1528,1235,601,48,531,26,25,8,634
13083001038,1303,1062,1005,9,10,24,3,0,57
13083001214,1529,1247,1172,11,8,40,6,0,75
13083001222,3219,2492,2307,35,13,113,11,0,185
13077000009,3973,2905,2091,97,625,59,28,1,814
13077000001,8157,6144,5080,290,541,109,106,9,1064
13127003733,3929,3091,2304,227,418,84,56,16,787
13127003743,4102,3159,2223,196,484,76,167,7,936
13127002713,4416,3743,3532,109,34,37,25,3,211
13197000807,2934,2224,745,215,1240,18,17,9,1479
13135000082,8147,6435,1991,879,2280,90,1319,17,4444
130890000EF,5368,4175,1865,904,849,81,507,2,2310
130890000MH,3140,2565,1890,190,199,36,248,1,675
130890000MW,2367,2049,614,126,1123,22,201,2,1435
130890000LV,1777,1347,922,140,111,22,157,3,425
132350ANNEX,9855,8012,5027,224,2564,97,85,9,2985
13291000010,3171,2659,2475,67,10,75,11,0,184
13291000002,2489,2047,1930,48,6,46,5,1,117
13291000006,1541,1316,1187,42,4,46,16,1,129
13281001468,3963,3468,3095,130,105,67,36,1,373
13291000003,1698,1485,1393,33,5,25,17,1,92
13217000009,6337,4694,1419,227,2959,72,42,9,3275
1305102-06C,1299,1073,404,77,502,15,74,1,669
1305105-03C,1765,1508,314,84,1048,15,74,2,1194
1305102-12C,2273,2115,1191,133,619,35,122,8,924
130890000BR,3608,2967,1581,121,1142,45,100,2,1386
130890000MB,4813,4121,1459,309,2225,78,101,6,2662
1330500004B,3292,2876,1072,294,1464,29,35,0,1804
1330500002D,1694,1269,1066,53,111,16,21,0,203
1330500001C,2565,1920,1645,94,148,29,9,0,275
13301000002,509,426,291,5,125,6,3,0,135
13215000126,4868,3702,1480,278,1801,80,92,25,2222
13215000115,12244,9741,2632,712,6292,138,192,48,7109
1305101-06C,2434,2017,1688,58,151,28,69,3,329
13063000FP3,5078,3786,571,973,2023,80,234,10,3215
1306300RD10,5388,3999,103,112,3771,43,39,5,3896
1306300JB16,3979,2731,315,439,1895,54,104,2,2416
1306300JB17,7013,4978,329,509,4117,70,97,4,4649
13097000731,4894,3832,1921,427,1360,79,73,3,1911
1309700736N,5407,3980,1149,283,2440,89,94,12,2831
13227000011,3034,2395,2173,110,23,71,5,1,222
13063000MO5,7654,5814,621,528,4358,86,324,8,5193
1306300JB08,6865,5015,427,750,3710,68,127,13,4588
130890000RL,5432,4144,342,171,3572,65,55,3,3802
13135000115,9056,6776,1459,2217,1620,125,1513,14,5317
13135000097,7674,6046,2266,847,1135,98,1740,16,3780
13135000045,4391,3445,1104,329,1640,46,383,1,2341
13135000088,7169,5231,1203,721,2982,114,328,17,4028
13135000136,6691,5088,2494,1026,910,89,643,0,2594
130890000CL,2265,1815,93,78,1653,12,21,8,1722
130890000CR,2520,1898,35,20,1806,36,21,1,1863
13135000029,2122,1645,1093,211,167,44,142,1,552
13135000048,5515,4524,1655,662,680,58,1506,6,2869
13135000138,7004,5531,1653,196,661,55,3014,11,3878
13135000150,6783,5055,642,1686,1703,136,1051,20,4413
13135000042,6172,5015,2263,828,1539,106,374,10,2752
13135000001,11112,7775,3327,1053,3014,169,344,15,4448
13135000154,5310,4068,2151,522,736,66,620,5,1917
130890000AF,2940,2335,280,62,1936,44,52,8,2055
130890000SQ,2468,1890,440,113,1293,34,40,2,1450
130890000HB,5799,4835,2015,742,1642,75,402,6,2820
130890000OA,3231,2306,1506,259,206,28,319,0,800
130890000LA,4544,3466,2320,501,408,54,222,3,1146
130890000WI,2982,2255,785,773,486,98,189,6,1470
130890000OB,5414,4049,566,2070,473,190,960,7,3483
1306700SN4A,8208,6052,3723,353,1505,91,383,1,2329
1306700SN3A,9792,7711,3869,1049,2318,146,379,7,3842
1306700BR02,5096,4107,1759,507,1593,70,243,3,2348
1306700NP01,7801,5856,2412,1584,1596,135,195,2,3444
1306700KE2A,5840,4487,2479,764,807,134,326,9,2008
1306700KE3A,9502,7674,3823,702,2579,173,444,9,3851
1306700MS02,3921,3071,1907,430,518,81,130,10,1164
1306700KE4A,5633,4546,2637,580,952,95,261,6,1909
13097000729,8174,5738,846,537,4289,105,58,7,4892
130890000SR,3158,2422,158,101,2141,37,19,4,2264
13135000075,7179,5361,1011,579,3428,85,373,16,4350
13135000040,6034,4959,2462,466,1048,67,940,5,2497
13135000032,4101,3104,1474,331,547,58,718,2,1630
13135000011,5703,4094,878,1584,801,140,821,13,3216
130890000PF,9096,6960,1215,2374,3089,270,354,13,5745
130890000DB,2598,2004,573,784,162,101,481,0,1431
130890000DA,7900,5797,958,3154,752,330,921,20,4839
13267000008,3970,2929,1830,163,890,33,27,3,1099
13267000007,4136,3090,2193,272,535,53,49,7,897
13267000009,1692,1219,1022,85,88,19,2,1,197
13267000010,5076,4376,1887,504,1952,31,15,0,2489
13267000003,2137,1652,1214,87,326,22,6,1,438
132610C1-27,5626,4064,786,218,2974,45,70,2,3278
1326100E-27,2681,2022,946,118,893,18,52,9,1076
132610C3-27,4467,3371,554,64,2736,9,28,1,2817
13195000HUL,6679,4981,3340,544,870,130,70,4,1641
130890000JA,2060,1463,1187,136,51,13,76,3,276
130890000EG,4111,3674,2778,234,365,34,270,7,896
13135000050,5301,4011,653,1400,1305,91,656,6,3358
13135000020,7212,5132,615,2728,1324,168,477,4,4517
13217000020,7282,5256,1344,515,3311,79,67,9,3912
13127002923,2951,2500,2272,66,103,25,34,1,228
13217000006,5038,3848,2859,125,782,96,13,6,989
13261000029,628,520,386,17,111,11,2,1,134
13261000017,1058,843,396,65,360,16,4,1,447
13261000015,2153,1810,1105,58,608,30,7,3,705
132710000MI,1203,929,792,31,101,8,1,0,137
132710000LU,1558,1217,694,22,485,15,7,2,523
13195000COM,2230,1705,1219,55,261,27,143,0,486
13195000DAN,4182,3314,2932,100,129,112,31,2,382
13195000PIT,2627,2090,1804,86,113,52,30,0,286
13143000010,2684,2102,1842,39,159,55,5,0,260
13143000002,9518,6974,6007,125,536,178,101,4,967
13159000363,905,678,438,72,155,16,3,1,240
132710000HE,2838,2490,940,93,1431,16,12,0,1550
13309000001,5082,4421,2167,141,2092,31,16,5,2254
1306700BG01,3597,3037,1881,340,632,59,141,3,1156
1306700CK01,11190,9936,4920,1004,3333,169,589,23,5016
1306700EL01,5870,4674,1827,466,1652,101,641,4,2847
1330500005A,3261,2509,1797,128,550,30,12,1,712
1330500004A,2113,1526,466,47,987,39,9,0,1060
1330500002C,1667,1262,1109,49,69,23,4,4,153
13143000003,3472,2690,2458,44,122,47,16,4,232
1331700003A,1459,1096,301,31,753,6,8,2,795
13317000001,2288,1777,581,82,1087,25,6,0,1196
1304700FT-O,6518,5141,4404,134,292,138,132,30,737
1304700POPS,5823,4428,4094,77,76,115,47,9,334
1306700DI01,13401,10605,3197,2541,4036,210,506,11,7408
1306700MR1A,9994,8168,2816,2842,2244,294,225,25,5352
1306700SN2A,7367,6580,2598,595,2569,119,713,11,3982
1306700SN5A,6989,5312,1883,1451,1627,135,302,17,3429
1306700OR03,12988,9841,2357,3662,3474,257,174,11,7484
1306700OR02,8360,6312,1803,1437,2758,185,273,7,4509
1306700OR01,1974,1489,1040,95,271,24,70,3,449
1306700SN6A,8091,6282,3588,348,1679,114,562,10,2694
1306700OK01,4611,3734,2228,236,971,50,244,6,1506
1306700LI01,6260,4789,1570,312,2611,78,279,6,3219
1306700SN7A,8595,6476,2746,366,2720,86,606,5,3730
1306700NJ01,6126,5108,1854,301,2566,86,373,5,3254
1306700MR6B,3741,3039,1803,247,572,40,317,4,1236
1306700MR5B,4761,3855,1263,576,1810,77,178,2,2592
1306700EL04,4418,3431,1563,653,745,66,358,13,1868
1306700EP01,3922,3180,1587,375,832,65,293,4,1593
1306700MR4B,3328,2672,1602,408,461,57,153,3,1070
1306700CH02,3844,2935,2126,157,423,46,167,4,809
1306700MR4A,2701,2155,1885,57,131,22,40,4,270
1306700HT01,5348,4012,3149,239,218,45,340,6,863
1306700PP01,4064,3034,2227,175,256,35,324,4,807
13199000013,663,513,402,12,76,17,3,0,111
13199000002,2583,1969,1301,31,600,22,19,0,668
13191001515,2497,1965,862,30,1036,31,17,0,1103
13217000013,7275,5367,1117,292,3885,69,51,8,4250
13217000017,4041,3427,2031,165,1176,68,33,9,1396
13159000297,2655,2067,1808,57,85,94,16,0,259
1306700MR7A,6911,5303,1257,1441,2056,237,189,8,4046
1306700MR6A,4554,3623,1177,797,1353,114,146,3,2446
1306700HY01,4962,3962,2813,319,568,76,197,2,1149
1306700VA01,4091,2944,2241,157,363,81,107,6,703
1306700NC01,3170,2402,1358,286,496,54,188,7,1044
1306700BK01,7222,5555,2804,588,1621,80,485,7,2751
1306700AC1C,7335,5415,2295,746,1997,98,327,8,3120
1306700MT01,5286,3888,3094,155,164,53,426,1,794
1306700GT01,5504,4281,2788,453,577,134,257,4,1493
1306700EL03,3634,2898,2091,195,257,54,248,4,807
1306700CL01,2806,2115,884,405,807,76,25,0,1231
1306700CL02,7156,5435,1770,529,2999,116,101,13,3665
1306700MA01,7102,5608,1916,943,2526,126,173,7,3692
1306700MA02,5683,4215,1123,1173,1809,82,89,2,3092
1305103-04C,1996,1455,227,40,1163,21,22,2,1228
1305103-03C,1865,1291,262,41,983,13,3,1,1029
1306700SF01,4262,3247,2569,135,237,51,239,5,678
1306700BF03,8681,6654,4178,1017,946,201,296,7,2476
1304700LAKE,5964,4676,4004,146,219,172,100,13,672
13297000417,7486,5655,3947,519,880,122,172,16,1708
13297000559,2753,2113,1839,47,176,39,13,1,274
1304700WOOD,4221,3130,2831,68,89,113,25,2,299
1306300JB04,3996,2925,398,236,2182,55,94,3,2527
1306300JB03,5962,4710,885,457,3147,88,240,4,3825
13267000005,4233,3111,1921,199,908,53,32,2,1190
13267000004,335,278,206,13,58,1,0,0,72
132710000JA,956,720,553,13,142,10,3,0,167
13309000002,2389,1796,1251,33,469,46,5,3,545
13159000295,5014,3744,2181,139,1361,52,8,2,1563
1305108-08C,2104,1611,21,74,1530,23,4,1,1590
1305104-07C,4799,3802,3218,141,161,90,181,8,584
13143000012,4677,3600,3274,38,153,74,29,2,326
13321000011,731,608,556,8,35,5,3,0,52
13201000001,6000,4749,3239,92,1358,48,34,3,1510
13293001577,544,415,351,12,31,18,1,1,64
1306700CH03,5146,3869,2500,235,874,53,191,5,1369
1306700OR04,6498,5057,1594,1047,2163,140,198,8,3463
1306700FO02,9715,7119,1655,2617,2444,195,353,3,5464
1306700KP02,5202,4060,2865,226,700,73,186,4,1195
1306700PE01,8275,6080,1184,1690,3108,158,76,10,4896
1306700LA01,4721,3457,2482,207,363,41,352,4,975
1306700RS01,3772,2716,181,679,1817,72,29,3,2535
1306700HL01,9547,7217,1597,1268,4172,151,197,7,5620
1306700VG03,5810,4839,2448,249,1897,54,283,4,2391
1306700SW02,5321,4065,1118,624,2195,60,94,17,2947
133130000PG,8332,6139,3954,1790,230,161,96,4,2185
1306700BT02,11423,7946,453,1578,5870,126,90,17,7493
1306700PF01,5427,4287,2548,595,516,126,266,13,1739
13143000004,1608,1280,1195,16,29,29,16,2,85
13267000001,1263,999,747,96,129,28,3,0,252
132610C2-27,6117,4817,2416,381,1775,31,240,15,2401
1306700HR01,3950,2993,2362,144,293,72,107,3,631
1306700EL02,3302,2606,1753,238,328,56,215,3,853
1306700MR3A,8899,7037,3456,808,2530,146,164,11,3581
1306700FO04,12700,8918,1687,4106,2861,263,244,12,7231
1306700SM01,4922,3572,2144,190,236,71,917,4,1428
1306700MD01,5308,3897,2864,289,226,60,431,3,1033
1306700MR4C,3191,2578,1962,91,367,27,121,0,616
1306700MR2A,2475,1963,1582,91,225,20,38,2,381
1306700KP01,2374,1793,1514,81,117,16,60,0,279
1306700DO01,2734,2025,1474,107,121,15,298,3,551
1306700PT01,3640,2840,2006,221,422,65,121,11,834
1306700BG02,4109,3301,2103,272,655,66,207,8,1198
131210SS07B,1280,1091,610,105,234,25,108,2,481
13321000001,4340,3243,1002,45,2167,35,18,5,2241
13195000HAR,897,671,611,31,8,10,12,0,60
1306700NS01,3316,2568,1784,283,302,65,91,0,784
1306700MS01,4961,3753,2900,352,314,103,97,4,853
1306700AC1A,7489,5866,3438,678,1297,140,349,7,2428
1306700AC1B,7464,5946,3663,754,1300,135,180,3,2283
1306700WL01,3629,2569,2111,110,135,44,154,2,458
1306700PO01,4662,3475,2677,233,262,66,246,3,798
13195000COB,4892,3660,2682,269,598,73,37,4,978
13039000004,1181,938,770,50,75,31,15,0,168
1322300008B,16110,12052,5628,1009,5007,284,254,24,6424
1322300004B,22154,16773,11593,1112,3431,386,299,31,5180
1322300012C,9748,7272,6051,234,691,206,77,6,1221
1322300003C,13487,9498,6299,643,2182,188,166,19,3199
13245000208,4153,3144,738,131,2215,43,36,5,2406
13245000804,2852,2148,860,84,1094,71,50,12,1288
13245000810,535,422,261,12,131,15,4,1,161
13169000008,290,228,187,1,36,1,2,1,41
13195000FOR,830,633,506,16,88,4,17,0,127
13195000COL,1024,791,702,8,38,18,29,0,89
13195000MIL,2349,1857,1754,19,18,36,21,0,103
13169000005,2476,1909,1408,15,444,29,9,0,501
13245000605,6460,4768,1732,159,2782,58,60,8,3036
13169000010,4270,3169,2362,36,690,68,9,1,807
1312100RW05,5635,4283,1606,1494,847,148,276,8,2677
13027001712,862,693,504,46,119,17,3,2,189
1307500000L,1838,1494,1150,60,245,29,11,0,344
13093000005,4085,3589,1382,177,2000,20,15,0,2207
13093000008,766,624,392,15,197,9,8,0,232
1306700MR5A,4334,3505,1308,582,1465,81,93,1,2197
1306700KP03,4871,3612,2837,168,377,58,136,9,775
1306700SM03,6937,5564,2941,603,1498,95,347,3,2623
1306700WG02,6409,4982,2763,566,1247,102,280,7,2219
13159000293,577,464,352,8,97,6,1,1,112
1306700CO01,8476,6482,1354,972,3964,108,168,11,5128
1306700CA01,10127,9086,3815,671,2755,114,1588,4,5271
1306700PM02,3976,3008,2371,147,257,27,212,0,637
1306700LM02,5237,3793,3067,167,347,66,138,8,726
1306700VG02,9643,8295,3713,553,2498,108,1459,10,4582
1305900008C,6693,5942,3644,534,1106,130,558,11,2298
1305900001C,2935,2530,2044,131,183,31,111,5,486
1305900004B,12671,11684,9053,684,662,107,1123,10,2631
1305900002B,8671,6968,3044,379,3014,72,331,6,3924
132830ANNEX,2791,2163,1947,43,145,31,3,4,216
1328300SOPE,3615,2771,1325,55,1369,26,10,8,1446
1328900SG/T,987,781,434,7,332,7,1,0,347
1304900004A,1046,829,766,16,25,23,5,1,63
13263000006,631,542,329,12,182,16,5,1,213
130910YONKE,486,373,319,7,39,10,2,1,54
1331500004A,1580,1216,1019,25,154,10,9,0,197
1331500002B,955,779,453,22,300,10,11,1,326
130750000EP,843,661,62,26,570,9,1,0,599
13263000001,596,522,246,5,267,3,4,1,276
13093000010,685,553,292,27,229,3,3,2,261
1300100005A,2229,1624,1197,244,157,24,17,1,427
13303000091,1340,1078,696,11,349,17,2,0,382
1322900004A,2152,1637,1318,89,189,35,6,1,319
13229000002,5131,3865,3384,140,217,71,27,2,481
13319000007,1038,858,546,15,283,19,2,3,312
13209000006,490,385,359,8,16,6,1,0,26
13071000020,1641,1302,943,189,131,27,15,3,359
13033000004,564,453,161,19,274,0,3,1,292
13115000085,1882,1465,1063,52,287,33,39,1,402
13115000030,6970,5477,4739,114,418,135,47,2,738
13115000045,1483,1230,1115,31,45,38,3,0,115
1322300005B,17530,12935,7902,986,3634,279,209,5,5033
1322300006C,7692,5618,4348,248,848,150,34,3,1270
1322300009C,13433,10110,5497,742,3513,202,174,8,4613
13115000015,3307,2693,2450,63,62,92,17,1,243
13115000125,2362,1969,1334,249,329,60,10,0,635
13275000118,3349,2669,1731,78,722,42,112,0,938
13275000103,5360,4052,2654,113,1122,85,71,2,1398
13303001350,867,718,439,9,268,7,0,0,279
13175000011,2653,2033,1554,43,395,25,10,5,479
13229000001,5291,4024,3108,152,668,73,32,4,916
1314100003C,457,422,241,4,171,3,3,0,181
1314100001A,1316,1156,767,8,340,28,6,3,389
1314100004B,583,493,180,3,307,6,1,0,313
13175000013,2684,2044,1703,24,273,43,10,1,341
13175000019,1341,1023,864,34,88,38,5,0,159
13275000104,1555,1193,905,40,225,23,6,0,288
13275000102,2397,1900,919,58,887,33,2,0,981
13303001253,772,648,397,14,229,11,1,0,251
13071000007,3367,2501,1567,508,321,62,66,2,934
13071000014,2910,2138,1537,399,132,32,25,3,601
13257000007,3184,2415,2114,67,149,82,10,2,301
13257000006,1705,1356,1131,24,126,42,20,3,225
13177000002,1383,1077,572,13,471,12,11,1,505
13015000001,10368,7759,6363,366,652,225,118,2,1396
13045001152,2383,1839,1655,55,55,64,7,4,184
13045001542,3189,2442,2042,88,215,54,17,0,400
13045001122,6319,4791,3508,264,812,161,40,6,1283
13255000016,6892,5086,1770,255,2939,78,86,2,3316
13255000012,3064,2433,1998,77,254,82,16,6,435
13113000032,2500,1918,1494,132,162,40,96,4,424
13161000401,1647,1204,862,123,186,23,9,1,342
1312100002A,7017,6738,4391,522,952,70,752,7,2347
131210004X1,2273,1858,223,44,1573,33,16,2,1635
131210CH04B,16,13,4,2,9,0,0,0,9
1312100001S,2526,1877,117,146,1612,26,17,1,1760
13021000VV3,4414,3293,319,59,2891,31,14,3,2974
13303000094,2676,2398,924,64,1395,18,3,0,1474
1312100012A,5731,4707,1052,170,3405,78,83,3,3655
13319000006,1533,1152,1000,24,90,31,13,1,152
13319000002,592,476,424,16,23,12,5,0,52
13209000004,634,504,469,7,21,9,0,0,35
1312100004J,2129,2071,25,13,2024,8,19,2,2046
13243000566,395,309,196,6,101,9,0,1,113
13243000954,390,325,116,8,201,2,0,0,209
13243000131,327,256,123,15,117,4,5,0,133
13011000012,1016,783,707,19,13,20,13,1,76
13105000201,2585,2033,1667,51,243,24,44,1,366
13105000202,673,533,425,17,80,10,3,0,108
1305900004A,4480,3879,2436,264,926,56,194,6,1443
1312100003D,1100,852,57,35,760,17,14,6,795
1312100011P,2415,2012,28,35,1951,12,6,1,1984
1312100SS16,2499,1837,1606,55,83,25,62,0,231
1312100RW02,5484,4001,3056,297,337,39,253,6,945
1312100RW04,2120,1709,1437,97,76,24,66,1,272
1312100HP01,6553,5057,1408,1296,2027,160,255,7,3649
131210EP03A,6508,5120,334,713,4070,53,48,5,4786
131210EP01B,4442,3358,485,356,2464,72,45,6,2873
131210EP01A,4004,3149,713,401,1943,52,49,0,2436
131210UC032,659,503,84,16,404,6,4,0,419
13015000002,6677,5228,4023,687,274,171,79,20,1205
1304900003B,1121,846,791,26,7,15,1,0,55
13029000005,5456,3660,2162,372,840,85,242,8,1498
13029000009,3736,2616,1662,248,567,75,111,10,954
1309900000A,1219,970,397,16,544,11,5,1,573
1324300718A,3010,2293,683,34,1547,29,16,2,1610
13243000334,975,781,323,2,447,11,1,0,458
13243000998,85,66,58,2,5,3,0,0,8
13031000015,16707,14780,8592,1081,4654,160,472,41,6188
1315300HAFS,2560,1971,1539,52,304,58,14,3,432
13151000031,10454,7573,3045,553,3805,146,123,7,4528
13033000009,1656,1262,689,15,530,21,7,0,573
13021000HA1,5303,3702,496,313,2834,31,49,2,3206
13021000HA3,10268,7711,2193,184,5156,88,142,8,5518
13021000VV6,4373,3398,2012,103,1179,65,69,10,1386
13275000106,1547,1204,1023,21,136,18,7,0,181
13257000002,4259,3301,2415,94,679,79,34,1,886
1312100SC04,1371,1126,358,79,685,20,5,1,768
131210SC30B,1397,1119,21,20,1072,18,4,1,1098
131210SC30A,193,165,0,5,163,5,5,0,165
13123000005,4236,3470,3153,170,28,98,15,3,317
13123000004,1736,1328,1173,107,6,26,9,0,155
13123000011,1740,1383,1198,102,9,62,10,0,185
13275000113,469,357,261,7,76,7,7,0,96
13303000099,698,563,431,1,123,7,1,0,132
13151000048,6851,5082,3482,267,1154,110,79,3,1600
131210SS08D,2873,2644,1244,189,530,14,650,7,1400
131210SS08A,2820,2569,1234,225,624,28,467,0,1335
131210SC05E,826,684,105,29,548,17,7,2,579
131210SC07C,14,11,3,2,5,0,1,0,8
131210SC05A,998,704,16,17,663,2,4,0,688
131210UC02B,32,23,4,0,19,0,1,0,19
1306500000F,372,282,245,2,30,6,2,1,37
13151000058,5153,3653,2625,152,774,73,39,5,1028
13151000062,2835,2105,1224,93,668,32,68,3,881
13151000029,13921,10208,2986,764,6082,185,385,26,7222
13151000044,4294,3348,1128,208,1904,49,65,1,2220
13151000045,4758,3785,2076,237,1337,85,84,3,1709
13193000005,2204,1634,433,54,1116,11,21,1,1201
13193000003,2253,1787,742,101,913,23,12,4,1045
13115000080,3026,2297,1947,115,140,62,22,1,350
13115000075,5589,3887,1638,1117,988,145,84,3,2249
13311000051,6797,5412,4670,194,277,190,51,0,742
13311000011,3095,2538,2318,64,26,90,26,0,220
13311000061,1588,1386,1252,29,33,45,15,0,134
13311000041,4433,3457,3188,85,28,111,19,0,269
1300700000N,1424,1088,602,35,438,10,16,4,486
13295001053,496,395,343,9,30,10,2,0,52
1312100002B,2778,2499,851,146,1243,41,235,5,1648
1312100005D,278,267,59,3,197,1,10,0,208
1312100004F,4748,4279,2102,259,1515,51,371,12,2177
1312100003I,8541,8400,5390,718,1216,95,992,30,3010
1312100SC27,2708,2183,59,64,2051,11,10,2,2124
1312100003L,713,566,16,6,536,16,6,5,550
1312100003B,867,661,36,18,600,9,11,2,625
131210SC05D,3893,2911,98,44,2747,20,15,0,2813
131210SC05B,4553,3391,100,63,3231,28,32,4,3291
131210SS13A,3260,2628,1546,529,371,30,152,2,1082
131210SS13B,1667,1387,822,212,268,27,81,0,565
1312100009A,5564,4290,1931,736,1355,106,255,15,2359
1312100SC10,2273,1633,22,42,1543,29,13,4,1611
131210SS09A,3643,2951,2377,133,251,32,159,6,574
1312100004L,1921,1593,252,61,1250,15,41,0,1341
1312100004T,1146,951,94,32,804,11,11,2,857
1312100003A,2092,1667,85,34,1550,24,10,3,1582
131210SS11A,6257,5249,2718,1008,1120,67,400,1,2531
1310300002C,6958,4709,3489,229,727,113,133,14,1220
1310300004B,2919,2181,1474,113,485,62,31,7,707
1310300002B,4401,3318,2459,215,485,63,82,6,859
13139000027,4979,3910,3555,152,56,94,40,6,355
1310300003C,3331,2551,1865,67,553,51,18,0,686
132050000BV,889,702,537,37,121,7,2,1,165
132050000PE,5699,4342,1946,130,2203,28,34,2,2396
132050000HF,459,370,296,17,54,3,3,0,74
13169000006,1854,1407,1001,21,361,18,4,3,406
13245000709,837,658,435,25,166,16,32,1,223
13245000707,3675,3019,1229,162,1398,42,217,10,1790
13207000005,904,698,534,16,118,12,14,0,164
13245000507,1683,1352,418,98,744,28,62,23,934
1312100JC08,4288,3157,1783,225,371,32,742,1,1374
1312100SS26,6194,5064,1644,726,2079,103,542,9,3420
1312100001C,1908,1424,205,78,1126,23,17,1,1219
1312100008J,4745,3593,2636,204,536,29,196,6,957
131210SC09C,2134,1655,43,48,1567,12,20,0,1612
131210SC09A,2526,1857,20,45,1757,7,39,1,1837
1312100012S,2575,1936,77,55,1778,29,14,6,1859
1312100001E,3750,2974,2094,159,557,54,124,5,880
13245000603,5079,3855,1665,115,1975,82,52,7,2190
13245000109,1840,1522,474,43,993,13,5,1,1048
131210RW22A,7197,5784,2772,965,1477,92,472,9,3012
1312100RW21,4302,3367,2335,299,485,30,219,3,1032
131210RW22B,16,11,1,3,2,6,1,0,10
1312100009K,7138,4938,281,239,4377,73,69,18,4657
131210ML06B,4915,3682,1655,413,682,63,880,4,2027
1312100JC06,4418,3379,1392,153,365,17,1415,6,1987
13311000021,1177,984,912,8,7,33,8,0,72
13311000111,2437,1922,1782,37,16,74,9,0,140
13311000091,1503,1232,1137,22,16,40,8,0,95
1312100006I,6712,6154,2073,703,2168,108,1238,8,4081
1312100007E,2766,2359,1409,178,490,34,268,6,950
131210EP02D,621,492,33,33,425,11,10,2,459
131210SC19A,259,208,20,12,173,4,7,0,188
131210CP053,0,0,0,0,0,0,0,0,0
1323900000G,2112,1763,991,11,720,31,13,4,772
1322300002B,8408,6164,5217,271,425,166,72,8,947
13039000010,6360,5094,3210,631,1037,111,155,34,1884
13039000006,4032,3084,2271,142,508,88,50,11,813
1307500000S,2003,1390,488,115,771,12,9,5,902
13107001560,2871,2246,1392,33,791,35,3,1,854
13207000009,7219,5711,2564,130,2901,79,63,6,3147
13207000007,1359,1026,868,22,109,7,13,0,158
13245000808,3082,2383,1266,82,931,59,60,11,1117
13013000001,5196,3784,2734,501,307,95,148,6,1050
13013000013,4384,3374,2479,292,448,69,106,5,895
13245000404,2638,1953,267,88,1546,31,50,6,1686
13245000405,5476,4259,382,156,3590,49,131,21,3877
13245000607,2270,1727,127,81,1503,17,30,11,1600
13245000401,2659,2058,115,84,1851,10,28,2,1943
13245000203,1303,1057,32,18,1000,7,2,1,1025
13169000004,2169,1699,1513,22,120,33,11,0,186
13245000103,2265,1657,110,20,1510,8,25,4,1547
13013000006,3656,2762,1904,230,404,72,135,0,858
13013000007,4524,3397,2369,253,585,78,104,7,1028
13013000010,5978,4356,2196,618,1317,105,148,5,2160
13107000050,982,735,655,40,29,10,0,2,80
13107000057,777,582,414,13,144,12,0,0,168
130650000AG,671,529,409,24,78,22,5,0,120
13107001333,940,730,598,6,123,1,1,0,132
1300900CTY6,3364,2567,1230,41,1203,18,80,1,1337
130810JAMES,1540,1325,1214,8,77,11,4,0,111
1300900CTY2,3520,3295,1286,58,1931,9,15,1,2009
13107001429,812,618,494,4,109,11,1,0,124
1300900MERI,3664,2926,1974,99,739,35,73,3,952
13009000318,4892,3929,2784,106,841,41,147,5,1145
13031000005,3177,2473,2130,49,185,84,6,8,343
13013000012,4206,3267,2492,377,193,99,103,8,775
1310300002A,4165,2974,2443,152,271,62,56,2,531
133070000P1,1218,950,396,23,510,16,9,8,554
13013000002,5083,3934,3005,294,307,86,253,2,929
13139000011,14349,9789,2790,5728,1014,454,161,10,6999
13277000008,1825,1403,975,103,290,26,14,1,428
132210000BV,4784,3740,3041,188,349,114,37,3,699
13253000005,2003,1712,1564,31,69,43,2,0,148
13253000002,1874,1473,863,59,499,25,44,0,610
1330500001A,1849,1393,1223,29,79,41,26,0,170
1330500003B,1700,1282,1142,51,50,19,4,0,140
13217000019,6670,5057,2305,397,2262,95,44,6,2752
13217000008,4893,3773,1800,192,1550,74,131,3,1973
13127002943,4786,4256,3943,86,115,50,35,0,313
13199000010,1761,1433,746,21,642,15,4,1,687
13295000943,1179,946,898,14,19,16,0,1,48
13147000006,2231,1715,1442,73,164,20,14,0,273
13233000005,4131,3196,2690,188,228,64,9,5,506
13219000012,5884,4286,3531,150,222,65,287,1,755
13285000001,5715,4437,3314,157,806,38,93,9,1123
1312100008M,2931,2429,2011,95,196,33,94,1,418
13233000002,2729,2102,1775,143,135,41,12,2,327
13117000002,13394,9707,4250,1659,1292,163,2366,9,5457
13219000005,2903,1998,1640,102,142,34,76,0,358
131450000SK,1232,992,612,15,311,6,43,0,380
13291000005,755,648,596,17,6,23,4,0,52
13231000003,1827,1386,1226,19,87,28,22,3,160
1306300RD11,2496,1933,82,102,1732,25,28,4,1851
1306300JB13,2818,2122,252,101,1720,17,58,0,1870
13057000035,3255,2563,2284,120,54,71,30,1,279
13129001064,888,696,609,18,47,16,7,0,87
13069000006,1456,1137,986,69,48,27,9,1,151
13057000006,8992,6538,3795,931,1100,202,472,5,2743
13057000040,3711,2930,2374,213,141,129,59,8,556
13057000036,13083,9173,6358,1909,478,316,183,24,2815
13057000034,3850,3015,2621,149,104,43,81,12,394
13215FTBEN1,16,15,2,1,1,1,8,2,13
13215FTBEN4,2585,1361,817,254,168,43,68,49,544
13227000001,4875,4287,4060,95,13,58,38,1,227
1331700004B,1181,997,591,18,358,31,7,4,406
1331700002B,859,700,485,15,186,15,3,0,215
13045000501,6586,4838,3004,523,1195,107,27,6,1834
130450714A4,5265,4607,1991,483,2133,42,54,5,2616
13057000019,10061,7100,5683,501,501,146,227,11,1417
13057000008,5504,4279,3611,224,219,89,115,6,668
13057000030,4972,3970,3524,161,151,94,41,1,446
13063000PH1,3542,2793,265,130,2342,33,75,4,2528
1306300JB07,4643,3598,438,361,2531,57,265,4,3160
1306300RD03,4703,3537,179,254,2960,47,160,5,3358
13231000002,2337,1758,1647,16,46,31,12,2,111
13063000MO2,3716,2876,507,439,994,73,942,0,2369
1306300JB10,5515,3773,408,498,2771,68,83,10,3365
1306300JB01,6753,5045,348,364,4251,77,97,9,4697
13057000014,1321,1046,955,43,10,28,5,0,91
131450000GM,2093,1691,1126,21,493,18,18,1,565
131450000WA,3808,2927,2048,85,661,72,60,7,879
13129001056,8097,6044,5184,452,169,161,57,3,860
13129000973,4292,3160,2648,291,98,104,33,0,512
13129001063,1708,1276,1154,60,15,41,7,6,122
1306300OAK1,4155,3026,58,155,2801,35,47,0,2968
13063000FP2,5384,3932,492,1150,2087,134,195,4,3440
131450000EL,5522,4197,3170,184,680,90,74,9,1027
13255000011,3537,2733,1851,77,742,39,27,4,882
13255000021,5393,4727,3370,197,1006,82,78,1,1357
130450714BN,2162,1698,1083,151,386,59,13,3,615
132470000MI,6444,4836,1110,472,3196,70,79,24,3726
132470000RO,6297,4967,1376,317,3180,72,87,7,3591
13255000007,2247,1723,1363,62,227,27,33,0,360
13255000008,2548,1952,1434,40,444,34,8,2,518
1306300RD01,3031,2397,163,165,2011,20,82,1,2234
13215FTBEN5,321,208,115,54,20,11,9,6,93
13215000108,8511,6515,4720,380,856,167,408,29,1795
13069000003,427,339,259,9,62,5,0,1,80
13301000003,492,417,143,3,270,0,4,0,274
13301000006,113,88,78,3,6,1,0,0,10
133130000AN,6167,4324,1502,2488,249,204,38,3,2822
133130000TI,1417,1077,855,172,10,31,3,0,222
133130000GL,5492,3876,1846,1814,121,142,56,5,2030
1305106-10C,5562,4493,2408,297,1388,101,301,14,2085
1305101-05C,2979,2530,1954,109,316,43,121,6,576
1305105-02C,1624,1474,564,103,691,30,105,1,910
13113000035,4226,3215,1619,203,1118,49,213,4,1596
13199000011,1696,1386,963,21,374,22,9,0,423
13097001260,6306,4765,3588,173,781,112,74,8,1177
133130000UT,1600,1247,1127,56,22,32,8,0,120
133130000CA,3659,2759,2123,463,41,113,33,3,636
1331300001A,6611,4983,2479,1956,442,233,65,9,2504
131810001-B,845,668,232,4,411,17,15,0,436
131810003-B,1173,959,573,4,366,10,4,2,386
131810001-A,731,636,452,5,148,29,7,4,184
13181000002,2067,1631,1153,14,428,36,8,12,478
13095000019,941,695,205,53,422,8,12,3,490
13011000002,1209,951,795,104,15,16,24,0,156
13095000020,3780,3072,1619,99,1274,59,13,3,1453
13095000024,3205,2419,194,23,2196,6,11,0,2225
13011000009,938,735,656,44,14,13,5,0,79
13011000003,545,425,378,9,10,12,16,1,47
13105000196,721,568,436,22,83,15,5,0,132
13095000023,3020,2360,834,171,1294,42,26,0,1526
13095000022,4902,3487,499,121,2832,35,18,5,2988
132470000FS,5136,3992,845,235,2701,62,174,15,3147
13045000715,2410,1792,1399,148,205,36,12,3,393
132470000LO,4781,3817,1702,125,1879,69,54,4,2115
13255000004,3712,2932,2425,95,341,46,18,3,507
13061000004,577,463,173,8,270,8,10,5,290
13135000139,9889,7159,1165,2112,2347,168,1547,20,5994
13135000013,4075,2875,2042,211,352,41,223,9,833
130890000SH,2347,2000,1088,110,679,16,103,3,912
130890000HG,1998,1701,973,58,513,30,148,1,728
130890000FK,2659,2062,52,62,1948,27,12,1,2010
130890000CG,3892,3113,91,71,2952,38,24,0,3022
130890000MI,6361,4757,96,114,4532,64,47,3,4661
130890000MF,3573,2859,78,37,2727,28,20,0,2781
130890000MV,2607,2029,61,36,1931,24,9,1,1968
130890000FJ,3041,2418,103,63,2244,16,24,7,2315
13135000085,5875,4554,2091,712,920,95,795,10,2463
13135000151,4204,2965,1622,303,946,47,97,6,1343
13135000018,5388,4011,944,1318,1094,133,664,8,3067
13135000108,5183,3859,1412,830,1442,107,139,6,2447
13135000156,6205,4588,1373,497,2599,100,134,3,3215
13135000145,9465,6433,1860,670,3527,109,396,18,4573
13135000134,6933,4908,1566,401,2557,99,364,8,3342
13135000015,6050,4509,1727,1211,1229,106,331,5,2782
130890000LH,4641,3463,65,96,3297,11,24,5,3398
130890000SC,3773,2825,727,169,1730,57,198,0,2098
1311100NOON,918,817,756,13,7,22,9,0,61
13147000004,1729,1365,863,38,421,30,15,3,502
13077000020,3165,2476,1880,156,361,44,19,4,596
13077000022,6111,4518,3264,274,746,83,144,3,1254
13157003000,20867,15561,12370,1310,912,315,629,15,3191
1306300JB09,3684,2567,423,770,1281,71,51,10,2144
13063000EW1,9009,6744,384,622,5565,119,178,4,6360
133130000CO,2311,1785,1571,90,50,50,9,0,214
13213001291,6097,4566,3934,336,53,230,18,3,632
1306300JB18,5079,3885,389,244,3068,64,206,2,3496
1306300RD04,6756,4995,358,672,3708,81,284,6,4637
13231000001,1883,1423,1121,12,251,24,6,6,302
1306300OAK3,7240,5407,177,200,4875,59,167,6,5230
13045000682,2854,2259,2008,45,106,66,7,0,251
13163000083,2290,1830,492,59,1260,10,11,1,1338
13063000FP5,8768,6080,598,1977,3116,164,432,5,5482
13213000874,3407,2687,2507,82,10,63,4,3,180
13231000008,3448,2610,2046,59,411,71,27,2,564
13231000006,1516,1193,1079,13,80,17,2,0,114
13113000030,3994,3051,1684,130,1049,44,142,2,1367
13097000730,8847,6812,2390,632,3570,160,137,20,4422
13097000737,5628,4215,1140,424,2501,99,135,9,3075
13097000740,3121,2419,1018,169,1122,63,66,6,1401
13135000049,3095,2296,912,251,699,35,402,2,1384
13135000122,8459,6080,1328,628,4061,118,113,18,4752
13135000086,5651,4372,668,1842,1236,100,673,4,3704
130890000PC,3064,2321,77,90,2142,31,12,4,2244
130890000CA,3150,2514,178,55,2274,26,18,0,2336
130890000OK,4124,2628,1750,85,600,41,135,7,878
130890000PG,3574,2554,1517,99,803,46,104,4,1037
130890000BB,5297,4270,2604,214,1199,63,202,5,1666
130890000LE,3697,3065,2477,145,197,35,189,6,588
13287000001,5727,4358,1771,180,2387,26,30,0,2587
130890000IB,6629,4417,575,134,1926,38,1766,11,3842
130890000DE,2974,2314,360,155,1542,42,242,7,1954
13061000001,503,403,234,4,160,10,3,0,169
1306700PS3A,5444,4098,1264,525,2195,83,85,2,2834
1306700PS1A,6426,4833,1549,372,2742,101,147,4,3284
1306700MR2B,6069,4572,1955,628,1754,97,178,16,2617
1306700KE5A,7730,5741,3197,486,1561,102,399,5,2544
1306700SI01,2468,1788,1324,79,94,8,258,3,464
1306700FP01,4842,3502,2223,138,242,30,841,2,1279
13227000005,1037,803,742,17,8,24,5,1,61
13227000009,3796,2964,2717,72,27,90,20,2,247
1306700SO03,4253,3213,2069,157,239,59,651,5,1144
1306700SO02,5892,4863,3028,303,905,77,516,1,1835
1306700KE1A,4443,3848,2393,458,817,90,157,7,1455
1306700ME01,4563,3518,1517,307,1561,77,98,10,2001
13073000040,2006,1601,1314,21,209,46,9,0,287
13073000051,1303,1100,954,35,71,19,10,2,146
13265000172,299,252,128,4,117,3,1,2,124
132710000SC,477,369,289,6,65,5,1,0,80
13159000290,1950,1490,1208,71,147,54,7,6,282
13321000004,1224,975,750,18,170,24,7,1,225
13163000076,773,578,397,25,150,4,2,0,181
13163001593,533,435,352,6,54,24,3,0,83
13297001675,1541,1253,1143,18,56,24,11,1,110
13215000114,6052,4469,513,228,3693,56,63,23,3956
13135000036,4232,3016,1580,242,607,97,545,2,1436
1313100000B,1492,1185,943,104,129,19,1,0,242
13217000015,2102,1572,1339,36,153,37,5,1,233
13217000016,1207,912,753,20,106,16,8,2,159
13199000008,1857,1511,957,35,477,31,6,0,554
1306700PS2A,5014,3804,939,611,2179,62,57,12,2865
1306700DL01,4359,3254,1841,433,799,98,128,5,1413
1306700MT03,4590,3432,2282,179,180,47,715,3,1150
13321000006,1640,1337,1083,11,223,14,5,0,254
132710000MC,5445,4465,1534,1592,1582,35,17,1,2931
13063000LC1,5760,4306,484,443,3081,65,296,14,3822
13135000155,5953,4547,2078,444,866,37,1113,19,2469
13135000140,5275,3744,2447,210,307,45,729,3,1297
13073000010,3590,2778,2262,112,254,109,45,11,516
1306700RM01,4543,3374,2359,232,355,80,359,2,1015
130890000FB,2658,2051,1706,88,84,19,137,4,345
130890000EE,5096,3774,3091,191,207,52,202,11,683
13135000146,9916,7075,3161,576,3023,110,269,1,3914
13135000023,5988,4252,519,2265,938,197,555,4,3733
13135000051,8393,5990,547,3473,1510,232,494,4,5443
13135000070,5375,4144,2169,529,654,64,753,4,1975
13135000091,6326,4635,2190,481,1647,107,282,3,2445
13135000060,10811,7394,1508,2022,3593,168,307,4,5886
13135000144,12001,8456,1733,2004,4021,170,683,11,6723
13135000019,4451,3264,1050,1106,769,92,341,1,2214
13083001885,1050,810,750,7,1,38,9,0,60
13293000470,557,462,280,5,172,3,1,0,182
13143000013,1651,1281,1167,12,46,45,4,3,114
13321000015,1830,1503,1317,32,111,30,10,2,186
13321000014,1253,995,889,14,83,6,3,0,106
13321000008,276,208,151,3,49,5,1,0,57
13135000031,4737,3450,1705,622,648,77,437,8,1745
130890000RE,5389,4092,399,217,3305,61,163,11,3693
130890000SP,4203,3093,312,243,2418,51,121,10,2781
130890000EC,2876,2254,1038,649,300,117,249,4,1216
130890000TF,4910,4001,2352,600,653,101,348,13,1649
130890000ML,4578,3808,699,157,2894,50,54,5,3109
130890000GC,4168,3465,913,147,2332,45,71,4,2552
130890000LB,3254,2731,2060,150,203,38,236,3,671
130890000ER,4305,4157,1716,210,1207,29,1014,9,2441
13135000041,8447,6147,1681,635,3678,82,148,12,4466
13321000002,2133,1625,1142,21,407,26,24,2,483
13131000C05,5685,4026,1703,910,1303,120,55,0,2323
13149000ENO,1644,1237,1094,36,66,31,3,0,143
13057000020,4441,3442,3097,128,72,84,40,4,345
13321000005,756,597,516,15,46,13,4,0,81
13135000127,3562,2662,685,686,1041,64,278,4,1977
130890000HF,5436,4350,1656,660,1395,103,630,6,2694
130890000KG,2751,2036,1644,102,111,14,160,3,392
130890000PB,5036,4273,1795,390,1345,46,684,7,2478
130890000WG,4616,3620,183,224,3047,45,161,2,3437
1306700LM03,6872,5086,3502,276,1078,100,151,3,1584
1306700SN1A,6633,5329,1604,1116,2183,96,411,5,3725
1306700LM01,4402,3385,2434,191,622,68,76,2,951
1306700MC01,5734,4219,1137,609,2270,107,156,2,3082
130890000WF,2884,1908,1402,94,232,48,156,1,506
130890000AI,3850,3172,2075,166,728,48,150,6,1097
130890000GA,3280,2723,1743,146,631,45,177,3,980
130890000RH,4954,3715,89,117,3523,44,22,2,3626
130890000HC,4400,3602,1893,415,847,39,433,4,1709
13135000080,9302,6672,2303,741,3228,83,384,5,4369
13143000007,527,428,409,3,4,14,4,0,19
1306700PR01,3685,2903,1920,306,434,54,176,9,983
1313100000M,2310,1789,1370,138,246,30,15,0,419
13293000555,7120,5548,3923,113,1341,97,75,3,1625
13293000588,1348,1088,928,14,110,25,10,2,160
13293001610,1918,1565,1384,16,129,32,4,0,181
13057000041,3516,3057,2786,96,78,66,21,2,271
13227000003,1251,980,914,20,9,24,4,2,66
13251000010,2064,1517,540,31,915,18,23,1,977
13251000001,2025,1624,845,35,703,13,26,1,779
13057000032,4525,3507,2942,258,172,57,63,3,565
13057000007,5583,4283,3352,252,395,80,186,6,931
13251000011,434,359,291,4,56,4,2,0,68
13251000002,1384,1084,828,9,238,14,0,1,256
13251000009,645,524,367,10,144,5,1,1,157
13251000004,1553,1186,580,22,572,12,6,0,606
13077000019,5068,3875,2396,399,939,79,113,5,1479
13077000010,3165,2348,1945,86,211,64,32,5,403
13077000026,6318,4897,4025,234,380,100,123,7,872
13251000003,1649,1258,776,31,439,19,0,4,482
130910JAYBI,358,275,193,5,76,1,1,0,82
130910CLARK,175,130,123,5,2,0,0,2,7
130910PONDT,952,760,602,15,136,5,3,1,158
130910CHAUN,638,473,365,7,97,2,3,0,108
130910VILUL,182,139,122,5,10,2,0,0,17
13209000003,2004,1511,1072,92,321,24,6,2,439
13319000003,251,190,140,0,46,4,0,0,50
13015000006,5177,4032,3382,182,259,112,68,13,650
1305900005A,4171,3458,2431,245,540,86,130,10,1027
1305900001B,5252,4132,2162,402,1405,71,74,2,1970
1305900008A,4928,3943,2245,419,1005,71,197,6,1698
1305900003A,4542,3517,1424,212,1758,56,87,3,2093
1305900007B,5194,4551,3360,276,603,43,233,11,1191
13015000012,2935,2267,2068,89,11,75,7,6,199
1314100003A,408,335,33,1,294,7,3,0,302
1314100004C,163,144,51,3,91,1,0,0,93
13161000502,587,466,353,34,69,2,0,0,113
130750000NL,1886,1447,1225,85,91,28,16,0,222
13021000HO2,5445,4427,3087,93,934,56,253,3,1340
1312100JC12,3501,2759,1735,94,250,22,665,1,1024
131210SS08C,1032,949,538,56,196,5,158,0,411
1312100011N,2706,2133,32,26,2052,33,5,1,2101
131210SC07B,0,0,0,0,0,0,0,0,0
131210CP012,1672,1377,406,47,894,25,26,3,971
131210CP011,1649,1285,370,76,809,25,19,2,915
1322900003B,2177,1674,1520,77,46,18,7,3,154
13003000004,1821,1316,423,446,420,23,12,7,893
13029000007,5718,3881,3100,208,372,87,107,8,781
13263000003,550,460,224,8,224,2,5,1,236
13151000049,5708,4156,1120,274,2650,55,85,15,3036
13273000006,345,272,126,0,141,1,2,0,146
13071000018,1482,1148,988,60,42,21,36,0,160
13275000112,1099,867,590,28,224,25,3,0,277
13257000005,467,389,363,9,5,6,4,0,26
1322900004B,631,465,388,33,38,7,4,0,77
13151000036,5051,3673,2479,152,877,95,66,7,1194
13123000013,2415,2074,1901,95,4,70,9,1,173
132250000P1,1866,1519,1096,86,285,28,26,2,423
13123000012,2152,1808,1642,68,13,60,14,1,166
1305900005B,4147,3193,1525,431,1087,82,117,2,1668
13031000016,1501,1084,938,25,85,28,9,2,146
13175000008,642,523,433,5,81,9,5,0,90
1312100JC16,3645,2708,1820,206,281,37,339,3,888
131210ML01B,345,246,165,23,30,7,28,0,81
131210AP04A,2124,1593,1230,70,113,24,160,2,363
1312100001J,3800,2697,225,70,2380,33,29,7,2472
1312100ML03,5014,3626,3019,167,199,40,190,2,607
13039000003,2587,2006,1257,36,622,58,17,11,749
1312100002K,1624,1539,1093,125,146,38,144,5,446
1312100010K,1604,1285,88,29,1177,7,6,1,1197
132050000CS,6740,5600,2384,180,2937,39,65,3,3216
13295001808,623,515,482,4,11,8,4,1,33
13055001484,1416,1124,1011,9,56,37,7,1,113
13039000008,3306,2512,1604,147,617,80,59,3,908
1312100007J,4036,3481,2418,258,596,48,185,3,1063
1312100009F,5154,4238,2931,254,755,69,245,10,1307
1312100003E,3050,2316,107,70,2112,15,31,13,2209
1312100009G,5124,4547,2625,320,1220,57,366,7,1922
1312100RW10,4661,3635,3097,154,201,63,102,2,538
13033000005,1537,1216,785,38,374,9,6,2,431
1312100004I,4117,4042,819,637,2467,29,112,3,3223
1312100001B,5191,4043,2625,294,929,75,162,9,1418
13021000HO1,5943,4812,2584,371,1658,60,284,3,2228
13311000031,650,562,510,11,8,13,20,0,52
13079000003,2462,1922,1598,69,191,52,12,1,324
13033000015,4977,3804,2058,57,1607,46,36,0,1746
13311000101,2095,1708,1582,33,24,56,8,1,126
13033000013,456,367,180,19,158,4,2,1,187
13031000006,2310,1795,1568,52,103,33,22,5,227
13277000010,3865,2737,630,144,1906,35,45,0,2107
1312100001A,4519,3783,2206,218,1134,57,204,11,1577
131210ML011,3818,2612,1847,143,122,29,465,3,765
131210ML012,624,471,389,32,23,10,13,0,82
1312100AP06,2488,1788,1432,106,82,9,154,1,356
131210AP021,4333,3352,2269,244,466,66,309,8,1083
131210AP022,3367,2661,1596,314,376,50,340,5,1065
131210AP02B,871,746,505,34,112,8,87,3,241
131210RW07B,1940,1335,165,999,139,31,31,2,1170
13021000HA4,2776,2254,1448,52,617,29,102,1,806
1318900133B,2882,2230,1715,101,364,43,11,7,515
13019000518,1599,1201,893,15,259,41,2,4,308
132050000LS,1899,1465,1125,52,234,36,9,0,340
1312100004G,955,719,53,23,640,6,5,2,666
13245000506,730,480,149,18,302,15,4,0,331
130650000AB,209,152,133,4,12,2,0,0,19
1307900001A,857,645,354,64,187,35,9,1,291
13079000004,2535,2014,1772,38,145,35,12,1,242
1312100SS05,2367,1734,1491,64,92,4,77,0,243
13245000702,2593,2193,1710,76,258,46,89,10,483
13245000805,1085,835,297,36,460,23,33,1,538
13245000115,1107,751,351,53,338,7,4,1,400
13189000139,1300,1047,670,26,324,13,5,1,377
1312100006J,3269,2626,2215,112,103,20,160,2,411
131210SS09B,4340,3272,2645,153,186,51,242,2,627
131210CP04A,0,0,0,0,0,0,0,0,0
131210CP04B,71,44,9,8,26,1,3,0,35
13207000012,1690,1291,1100,18,145,25,4,4,191
13021000VV5,3117,2418,1643,65,618,25,79,5,775
13215000122,3446,2920,1291,205,1320,49,74,11,1629
13179000014,4358,3124,854,270,1923,56,69,29,2270
13179000012,4146,2967,683,332,1846,44,100,25,2284
13179000002,3568,2715,1157,359,1085,69,104,37,1558
13179000010,7467,5379,1553,660,2959,147,214,67,3826
13245000204,2327,1998,1353,62,513,36,51,1,645
13107001748,1117,852,741,17,74,15,1,0,111
13107001208,1095,853,790,21,26,15,1,1,63
131210SC18C,2373,1876,61,47,1765,17,12,0,1815
131210SC18A,1181,985,33,17,929,10,8,2,952
1312100SC20,3243,2449,70,80,2312,31,21,2,2379
131210SC18B,1160,888,20,28,838,9,16,1,868
131210SC23C,3543,2573,39,108,2416,25,19,4,2534
131210SC23B,679,492,28,30,439,2,2,0,464
131210SC23A,5066,3642,76,102,3448,37,12,1,3566
1312100009D,2297,1763,61,45,1650,24,7,1,1702
13013000011,7348,5020,2869,899,989,140,198,14,2151
13245000809,1093,832,68,37,710,8,12,2,764
13245000406,4217,3128,245,132,2681,48,76,23,2883
13245000509,2946,2152,353,100,1663,34,28,2,1799
13207000001,2748,2216,1854,54,242,34,35,0,362
13227000006,2057,1580,1426,46,39,49,17,1,154
13139000003,5112,3860,2117,1074,540,85,117,0,1743
13107000058,1117,804,496,58,225,14,6,1,308
13115000130,5099,4048,3635,144,136,103,33,3,413
13147000005,3853,3228,2896,28,175,62,60,3,332
13285000009,2565,1955,1221,48,631,38,22,0,734
13219000006,2477,1784,1594,73,43,36,35,0,190
13285000015,2790,2069,919,71,895,13,181,1,1150
13219000008,5074,3436,2988,114,111,57,153,0,448
13163000077,778,634,438,12,173,11,0,0,196
1306300RD06,6532,4618,488,997,3001,74,167,9,4130
13073000017,6284,4268,2748,324,951,100,218,31,1520
13073000062,6948,4715,3174,280,856,79,343,17,1541
13073000018,7416,4818,2567,416,1535,118,236,12,2251
13073000015,5559,3877,2514,253,720,55,325,20,1363
13163000085,611,494,247,3,240,1,2,2,247
13167000055,1243,957,893,11,34,23,2,0,64
13255000009,2693,2124,1772,96,176,60,17,5,352
13167001405,618,474,255,8,212,2,2,0,219
13167001301,1031,830,580,9,234,7,2,1,250
13073000034,4885,3552,1576,417,1354,94,162,12,1976
13073000033,6380,4298,2121,467,1468,104,196,31,2177
13063000MO1,5626,4004,353,712,2802,114,116,2,3651
13117000005,10119,7223,5467,662,548,147,384,7,1756
1312100JC02,5057,3786,1331,216,462,19,1750,10,2455
13113000015,3141,2349,1949,85,191,55,64,1,400
13113000024,2059,1673,838,142,609,32,79,4,835
13113000005,3347,2805,1411,158,1047,43,153,0,1394
13045000650,5026,3625,2486,209,749,129,66,10,1139
13045001540,4339,3514,2795,150,414,83,49,6,719
13129001055,3167,2438,2162,121,34,78,23,5,276
13057000012,10797,8493,5801,1022,1172,141,376,8,2692
13057000011,6848,5346,3291,881,915,116,176,4,2055
13057000003,4432,3341,2911,210,100,67,44,1,430
131450000VP,1148,905,650,18,208,21,12,2,255
1305105-08C,2841,2191,762,231,1101,41,63,21,1429
1313100000S,1290,1023,829,65,89,37,4,1,194
13215000121,4828,3671,1809,291,1233,92,295,19,1862
1305103-14C,3070,2370,672,36,1606,18,42,6,1698
13135000098,4618,3605,1360,569,752,67,910,4,2245
130890000MS,4356,3044,1784,135,144,37,945,0,1260
130890000DI,3279,2407,2051,88,44,24,190,0,356
130890000AH,4891,4041,2536,264,525,61,658,17,1505
13073000020,6039,4465,3083,224,967,124,81,10,1382
13073000025,2945,2230,1837,112,190,46,42,11,393
13073000100,3149,2358,1618,112,402,54,158,18,740
13073000105,2012,1611,1242,32,67,20,240,1,369
133130000MC,2514,1884,1666,115,28,55,16,2,218
13135000131,6267,4562,2481,254,496,57,1284,6,2081
130890000CP,3365,2674,90,98,2425,50,70,2,2584
130890000RK,3510,2647,107,90,2457,36,25,6,2540
13251000006,1480,1148,975,15,143,18,3,1,173
13251000008,602,471,208,3,256,4,0,0,263
130890000BD,2177,1752,1308,80,141,17,198,0,444
1311100MINE,2209,1851,1752,16,18,39,11,2,99
1311100HEMP,1604,1393,1298,24,6,39,18,0,95
13113000018,7465,5511,3179,501,820,63,940,10,2332
13113000009,3712,2892,2230,157,383,50,69,8,662
13113000019,2375,1848,1417,146,115,10,148,4,431
13113000022,2251,1730,1513,55,43,27,78,4,217
13135000092,3743,2810,1533,246,514,42,513,4,1277
13073000136,3241,2369,1606,96,347,51,249,12,763
13073000063,1668,1220,940,58,175,17,31,0,280
13073000032,2376,1866,1145,198,408,74,81,2,721
13291000009,2801,2322,2172,68,6,57,19,1,150
1311100SKEN,418,381,351,10,6,12,3,0,30
130890000SJ,5932,4268,283,438,3436,74,137,6,3985
130890000SV,4509,3477,178,192,3017,53,79,14,3299
130890000HA,5955,4431,368,151,2964,56,952,3,4063
130890000AA,3689,2844,331,152,2108,31,245,2,2513
130890000PE,752,641,441,43,131,15,21,4,200
130890000WB,3238,2685,62,68,2576,17,24,0,2623
13149000CEN,2410,1886,1676,25,106,66,13,1,210
13165000002,1450,1113,415,23,649,12,10,3,698
1305102-03C,2219,1936,975,107,716,31,105,2,961
1305103-05C,2804,2227,1000,80,1004,40,76,10,1227
13095000026,1191,974,57,1,907,5,5,1,917
13095000017,3479,2468,28,32,2418,7,6,0,2440
1304700BLCK,3230,2500,2262,86,35,89,16,1,238
1304700BOYN,8274,6331,5720,126,127,173,149,7,611
13161000302,1147,840,737,50,25,23,2,3,103
1305106-09C,4923,4299,2396,293,1169,41,424,2,1903
1305101-09C,1147,870,383,88,317,16,60,6,487
1305107-06C,5207,4030,2030,508,1230,102,179,19,2000
13037000003,1078,804,204,22,573,2,3,0,600
13077000013,3488,2685,2199,118,260,75,33,1,486
13077000021,5935,4624,3453,381,567,125,115,7,1171
13077000027,2151,1715,1336,133,143,52,49,0,379
13097000785,5602,4098,602,209,3252,60,49,11,3496
13135000147,8833,6328,2056,1130,2738,156,447,13,4272
13135000102,4486,3307,1908,357,485,54,514,4,1399
1312500MITC,620,474,422,11,42,5,5,3,52
1305101-13C,1893,1477,1062,70,278,24,53,9,415
1305103-13C,2879,2296,1257,135,777,30,104,3,1039
13135000099,6644,4909,1230,1951,570,134,1124,3,3679
13135000087,6658,4917,1079,1807,941,140,1060,12,3838
13217000003,6555,4991,1154,215,3524,58,74,17,3837
13135000128,4230,3185,1308,619,611,43,636,4,1877
13135000112,4138,3175,1899,250,552,54,462,5,1276
130890000ST,4570,3528,183,194,3114,50,56,4,3345
13097000734,3762,2953,1621,292,919,68,55,2,1332
13097001274,3595,2691,1130,709,792,67,25,3,1561
13199000003,1332,1050,257,7,759,15,10,1,793
130890000PA,2848,2253,564,156,1509,31,30,2,1689
1305101-08C,2461,1930,1279,102,395,31,112,11,651
13083001889,2181,1906,1763,60,32,37,14,2,143
130890000MK,3928,3155,1223,304,1242,43,376,5,1932
130890000RD,2278,1808,1330,132,164,21,160,3,478
130890000RA,4581,3609,136,90,3355,56,48,3,3473
1305105-10C,4415,3349,261,124,2929,20,33,0,3088
130890000FG,4059,3048,46,59,2969,26,19,5,3002
130890000RF,3681,2744,95,63,2538,29,22,1,2649
130890000RI,4840,3846,187,142,3493,55,43,0,3659
1306300RD05,4328,3192,191,309,2591,57,97,3,3001
13063000PH2,4639,3494,682,211,2499,55,94,3,2812
13063000LJ5,5283,3712,372,602,2699,53,58,9,3340
13097000732,4582,3231,418,295,2483,41,25,9,2813
13097000735,5593,4308,2524,463,1182,130,54,0,1784
1309700736S,8399,6052,1778,514,3594,104,157,6,4274
13063000LJ2,5369,3864,436,397,2985,86,64,12,3428
130890000BH,3849,2980,1403,395,740,73,378,2,1577
130890000BF,4499,3459,1253,821,1089,62,275,3,2206
130890000MT,3754,3199,1758,149,1099,22,143,1,1441
130890000PN,3001,2327,626,81,1528,35,53,6,1701
130890000CS,5066,3790,104,76,3593,33,24,4,3686
130890000MC,5631,4126,53,108,3975,67,27,0,4073
130890000PR,3756,2987,32,76,2891,20,20,2,2955
13135000030,4292,3288,1084,358,1690,71,144,5,2204
13135000069,5210,3837,1431,339,1313,63,718,8,2406
13135000066,9726,6922,836,3610,1808,193,692,9,6086
130890000NC,3175,2476,325,86,1715,28,345,1,2151
1306700SA01,3937,2937,2026,209,273,60,351,2,911
130890000SG,1944,1655,161,42,1426,17,12,4,1494
130890000MA,4272,3244,147,207,2823,55,45,5,3097
130890000SS,2191,1784,73,39,1665,35,19,0,1711
1326100W-27,3518,2846,1570,120,1102,47,11,2,1276
13143000008,545,419,399,4,6,6,0,0,20
13195000ILA,2544,1948,1798,45,27,35,27,0,150
13159000296,2931,2230,2041,43,73,50,11,2,189
1304700CHAM,3452,2602,2422,43,30,57,33,2,180
13175000012,1515,1174,929,5,223,10,4,2,245
1304700CAKT,3847,2978,2716,100,53,88,22,4,262
13199000009,528,434,323,19,83,6,3,0,111
13265000601,1260,1037,378,42,605,13,18,5,659
1306700VG01,4398,4067,2168,288,1253,53,332,15,1899
1306700TM01,9811,7645,2639,818,2705,120,867,2,5006
13231000005,3455,2681,2394,51,156,39,31,2,287
1326100O-26,1618,1304,695,36,549,32,15,6,609
13143000006,1073,869,815,11,7,26,4,0,54
1331300003A,3342,2577,1671,689,135,72,50,4,906
13143000011,1462,1105,1074,6,7,14,1,0,31
13321000009,1521,1346,1070,10,260,6,1,1,276
13321000010,997,753,694,20,35,2,2,0,59
13321000012,1802,1439,1241,11,143,25,13,2,198
13261000028,1226,1012,587,51,340,21,21,2,425
13159000289,556,445,372,12,48,13,1,0,73
1306700RW02,4827,3427,2595,161,156,29,465,0,832
13321000007,610,497,431,6,41,20,0,1,66
1306700VG04,4202,3479,2270,160,913,37,125,7,1209
1306700OR05,4905,3602,1807,214,1421,80,134,0,1795
13207000010,2557,2021,1727,64,160,50,18,1,294
130750000RB,1943,1455,1231,68,124,23,14,3,224
13027001650,3401,2726,2161,113,394,41,15,1,565
1306700MA03,4069,3192,1677,489,864,88,89,3,1515
1306700MA04,1828,1549,998,112,353,27,58,1,551
1306700BF02,3977,3246,2049,282,457,67,362,8,1197
1306700SW01,4203,3255,1352,240,1559,67,64,6,1903
1304900005R,373,307,278,4,10,11,5,0,29
13037000001,711,581,218,8,350,6,2,0,363
130910EMPIR,729,573,488,13,59,12,2,1,85
13175000018,2694,2073,1418,38,583,22,15,3,655
13071000009,527,397,252,76,58,6,2,0,145
13175000010,1252,985,859,15,89,20,10,0,126
1331500001A,706,544,105,10,423,5,4,0,439
13177000010,6360,4873,3852,88,748,93,74,4,1021
13151000043,5268,4104,2172,173,1581,74,107,2,1932
13151000042,7211,5444,2235,445,2399,127,273,4,3209
13151000027,7076,4975,3734,214,838,121,70,2,1241
1312100007A,10099,8969,5918,545,1483,117,911,8,3051
13021000HO7,3239,2519,1864,61,491,39,61,1,655
13105000199,881,715,645,15,22,20,2,0,70
1312100010M,2655,2162,373,51,1715,39,26,3,1789
1312100007N,2825,2644,1050,287,888,40,396,8,1594
13197000539,322,258,161,21,63,11,4,2,97
1305900007A,4675,3942,2631,263,735,62,254,4,1311
1305900006C,5007,4325,2893,244,795,86,289,5,1432
13275000116,603,483,373,9,88,10,2,0,110
13123000002,1938,1637,1541,52,14,31,5,0,96
13275000101,928,735,510,7,198,9,8,0,225
1312100001D,1309,1043,245,49,718,17,40,2,798
131210011E3,4607,3425,80,96,3241,22,42,15,3345
1312100AP03,1510,1091,272,425,394,35,20,1,819
1312100008A,3846,3092,2170,110,558,23,224,1,922
13031000007,1910,1395,1113,48,184,33,14,2,282
13033000001,597,475,259,16,190,13,0,1,216
13115000010,2097,1639,1421,48,82,21,58,1,218
1300700000H,423,327,147,10,173,3,2,1,180
13295000953,1558,1230,1141,27,22,32,6,0,89
13295001851,1641,1197,1136,17,3,19,5,0,61
1312100008H,3131,2644,2282,79,192,22,73,0,362
1312100012D,1681,1282,69,39,1165,15,19,0,1213
131210004X2,894,733,72,11,642,6,15,0,661
1312100004D,1667,1318,115,39,1150,12,14,1,1203
1312100JC15,1457,1074,510,217,172,18,152,2,564
1312100MP01,571,470,400,21,12,13,13,1,70
132050000BA,1611,1198,652,29,492,18,7,2,546
132050000SC,496,386,282,31,67,6,1,0,104
132050000PC,229,196,166,2,24,4,0,0,30
1312100CH01,455,340,103,20,215,0,1,0,237
1312100CH03,463,410,303,13,69,21,1,0,107
131210003P2,11,6,2,1,3,1,2,0,4
1312100RW12,8232,6246,4729,350,430,88,596,3,1517
13295001800,463,388,369,4,0,9,1,3,19
131210008F1,2893,1962,1772,50,56,19,65,2,190
131210008F2,0,0,0,0,0,0,0,0,0
131210012H1,1533,1044,59,94,872,24,15,0,985
131210012H2,3499,2575,65,104,2393,26,8,0,2510
1312100SC15,9062,6720,194,145,6392,59,39,6,6526
1312100003F,2872,2675,1083,215,844,38,516,9,1592
1312100002W,1416,1371,667,128,316,18,237,2,704
131210SC11B,1959,1512,31,52,1425,9,4,2,1481
131210SC11A,1938,1479,32,23,1400,9,14,1,1447
1312100006F,3531,3030,2195,317,330,40,139,3,835
13115000035,554,451,398,15,10,17,7,0,53
1307500000M,1399,1062,883,25,129,16,8,0,179
13207000013,1675,1266,940,39,254,32,8,3,326
13207000004,1080,843,632,18,161,23,8,2,211
13245000806,1556,1243,802,52,332,33,32,7,441
13245000307,2307,1908,1323,52,452,25,53,5,585
1307900001B,1531,1214,600,22,571,23,5,0,614
13019001819,812,607,564,19,6,11,1,1,43
133070000P3,297,228,160,5,55,9,0,2,68
133070000G3,239,197,161,3,32,4,2,1,36
13031000001,1006,767,595,8,154,5,4,1,172
13191000022,2414,2108,1719,40,301,39,20,2,389
13139000016,8137,6446,5326,714,143,191,85,1,1120
13139000017,5231,4064,3313,507,82,89,55,2,751
13219000002,2501,1836,1632,54,84,32,29,0,204
13139000010,10189,7724,4122,2595,570,187,342,8,3602
131210011E2,1267,922,13,24,891,16,6,0,909
131210012E1,2347,1912,119,198,1567,34,25,0,1793
131210SS19B,2966,2438,1119,218,845,26,225,5,1319
131210SS19A,4453,3850,1698,346,1539,90,255,8,2152
1312100SS22,3807,3355,1754,341,997,61,209,3,1601
131210002L2,3493,3350,1969,303,371,13,678,0,1381
13285000007,4406,3429,2838,82,365,73,58,5,591
13129001235,2098,1649,1512,45,9,60,9,0,137
13215FTBEN3,1625,1107,665,161,180,33,74,17,442
13077000012,4636,3524,2766,157,497,75,22,4,758
13063000FP1,7376,5278,810,1261,3037,134,175,8,4468
1306300JB02,5993,4440,154,324,3823,62,174,2,4286
13063000FP4,3398,2462,496,675,731,65,563,6,1966
13255000020,3005,2360,2006,62,205,46,22,1,354
1305106-03C,3627,2896,1421,157,1025,64,221,3,1475
13113000001,3138,2524,748,127,1495,42,154,3,1776
130450714A5,3777,2951,1933,300,567,69,95,10,1018
133130000NI,4342,3303,2555,576,71,101,23,0,748
13095000002,5046,3953,1496,133,2134,46,164,7,2457
13177000007,2331,1816,1367,31,265,48,99,1,449
13095000004,4919,3876,1900,92,1809,28,56,0,1976
13177000006,5073,3803,2694,85,809,48,158,7,1109
13113000011,2570,1887,1242,335,136,62,114,6,645
13255000017,2972,2332,1606,111,545,75,1,2,726
13135000007,7637,5958,2381,563,1077,70,1915,4,3577
13231000004,2098,1559,1343,18,153,34,6,1,216
1306300RD09,3913,2944,217,287,2136,45,301,2,2727
13113000012,1508,1194,975,99,32,19,46,3,219
13113000006,2155,1677,676,104,803,26,79,1,1001
13063000MO3,7634,5605,533,506,3407,94,1167,13,5072
13135000135,6388,4857,2460,601,1224,85,503,11,2397
1305105-07C,3206,2562,893,204,1356,37,105,13,1669
13073000026,4388,2979,1806,258,737,56,147,15,1173
13073000065,3474,2702,1916,153,457,60,132,1,786
1331700002A,1636,1299,1006,34,220,24,11,0,293
133070000W2,594,472,214,5,247,7,7,0,258
13135000111,4473,3503,1408,459,557,29,1053,3,2095
130890000TG,2126,1580,1219,109,93,36,124,6,361
13073000132,2963,2332,1771,92,284,30,159,4,561
13073000135,2912,2031,1556,80,188,38,165,7,475
13073000131,1522,1198,999,43,67,35,46,1,199
13321000003,1211,955,714,9,197,30,6,0,241
1306300RD12,4275,3200,152,269,2645,59,142,3,3048
13127002933,4929,4167,3832,104,82,46,67,7,335
1313100000D,732,574,361,30,169,13,2,1,213
13135000061,3461,2774,1274,594,680,110,235,0,1500
13135000094,3368,2579,1536,280,502,38,232,1,1043
130890000RG,6024,5019,676,815,3448,44,132,1,4343
13135000014,4673,3580,2149,323,589,56,476,5,1431
13135000143,7250,5449,1722,822,1531,87,1356,4,3727
130890000KE,2605,2210,543,97,1527,37,40,1,1667
13135000005,3585,2786,1428,208,872,55,229,5,1358
131810004-B,1474,1265,1047,17,166,28,9,7,218
131810003-A,652,504,335,6,144,17,3,3,169
13195000POC,1518,1189,1052,20,71,26,16,0,137
13135000113,3589,2720,531,930,511,70,738,1,2189
13135000021,11176,7928,797,4493,1649,308,1035,13,7131
130890000CH,3620,2911,1148,488,885,26,379,7,1763
13135000083,6328,4865,2025,1036,905,77,879,7,2840
1306700BW01,3766,2918,1644,239,545,61,412,9,1274
1313100000P,1673,1228,751,117,335,30,4,0,477
13293001336,2856,2223,1976,23,129,65,17,1,247
13057000023,8637,6495,4229,1314,579,207,197,12,2266
13077000024,1296,981,406,67,483,22,2,0,575
130910MILAN,484,364,290,2,67,3,3,0,74
130910MCCRA,411,316,236,2,73,6,3,0,80
13269000001,1711,1255,204,21,1016,3,6,2,1051
13273000004,575,480,283,10,176,9,6,4,197
13071000021,347,283,236,13,26,5,7,0,47
13151000050,7269,5669,2025,402,2783,85,435,14,3644
13275000119,1926,1526,179,25,1303,15,3,1,1347
1312100SS01,5353,4441,3483,204,418,52,274,5,958
1312100RW20,3258,2627,1822,162,352,31,253,0,805
131210010H1,528,421,7,8,406,3,2,1,414
131210010H2,2921,2237,34,136,2066,32,12,4,2203
1312100RW13,5014,3910,2641,455,431,58,290,9,1269
131210AP01E,0,0,0,0,0,0,0,0,0
13161000501,2279,1718,1306,137,241,18,15,4,412
1322900004D,395,277,254,18,2,3,0,0,23
13039000011,5806,4247,2810,343,874,116,134,18,1437
1312100RW17,4271,3369,2045,557,544,81,140,9,1324
1312100JC19,5400,4216,2744,330,599,73,493,8,1472
13115000115,835,655,624,8,4,16,2,0,31
13055000968,1235,952,893,15,24,8,6,3,59
1312100008P,2612,2333,1074,202,826,39,221,4,1259
1312100009H,1713,1537,684,147,541,32,152,0,853
1312100006Q,692,644,222,38,315,11,56,1,422
131210SC16A,6019,4780,64,77,4613,49,40,8,4716
131210UC01E,785,561,18,28,510,5,6,0,543
131210UC01C,22,15,2,6,6,2,2,0,13
131210UC01B,638,512,5,12,505,5,1,0,507
131210012E2,0,0,0,0,0,0,0,0,0
131210CP083,243,171,6,4,159,3,1,0,165
13189000137,1473,1215,1023,10,171,9,3,0,192
13245000705,3054,2535,1527,89,789,26,125,7,1008
13253000003,1782,1289,201,20,1064,2,7,1,1088
1312100CH05,528,475,379,14,66,9,3,0,96
1312100009I,1408,1096,107,37,946,18,7,1,989
13033000003,1013,828,456,8,347,10,7,1,372
13019001427,782,620,539,35,21,11,5,1,81
13245000701,2943,2368,1677,58,539,30,59,3,691
13245000105,1518,1387,284,47,916,6,141,1,1103
131210SS02A,1635,1286,852,114,231,10,98,4,434
1312100SS17,4731,3872,2449,352,830,72,172,2,1423
1312100SS20,4093,3137,1110,500,1038,43,412,7,2027
13245000304,446,373,283,26,42,16,9,1,90
13245000101,1211,1043,683,41,275,15,38,1,360
13139000008,5413,4181,3230,545,243,111,48,1,951
13245000201,2240,1560,105,32,1411,18,10,4,1455
13139000018,4305,3582,2938,387,105,83,60,9,644
13139000001,8782,7050,4317,2162,262,157,205,9,2733
1312100003T,2025,1671,149,49,1452,41,45,4,1522
1300700000A,204,186,128,9,40,10,2,0,58
1306300RD07,5919,4166,268,989,2669,86,272,11,3898
13113000021,3158,2388,1572,188,321,47,287,1,816
13113000031,4606,3514,2515,214,357,60,344,5,999
130450714A6,2193,1790,1297,81,340,30,47,2,493
1317101712C,741,608,500,16,77,7,10,0,108
13057000009,6385,4750,4137,232,205,73,81,8,613
13009001714,1772,1354,911,30,388,17,12,3,443
13057000033,959,705,640,27,11,19,5,2,65
13057000028,4098,3229,2729,242,79,88,58,5,500
1305106-02C,2675,2224,1566,55,487,37,82,4,658
13073000125,3331,2606,1686,170,526,49,197,7,920
13135000022,2710,2234,1347,214,335,20,307,2,887
13135000009,8054,5876,3778,648,757,103,618,4,2098
130890000DH,5078,4657,2194,205,1633,20,624,8,2463
130890000RN,2260,1553,1006,92,341,30,101,1,547
1311100COLW,1498,1302,1206,32,9,41,5,1,96
13045001371,2044,1569,1351,48,117,38,14,0,218
132470000BA,6037,4725,1834,222,2502,92,112,2,2891
13135000046,2505,1909,1139,146,381,38,221,2,770
13135000117,8322,6105,843,2615,1961,196,707,5,5262
13077000011,4467,3524,2904,142,344,89,32,3,620
13077000008,6897,5196,4333,158,444,144,102,4,863
130890000PI,3012,2276,76,104,2087,36,27,2,2200
130890000SU,4691,3527,161,161,3198,52,54,2,3366
130890000RJ,2710,2080,237,80,1616,21,155,4,1843
130890000KD,5937,4688,43,98,4536,39,30,3,4645
130890000FM,4090,3110,321,194,2453,61,172,2,2789
13299000405,944,754,701,16,26,10,2,1,53
1305103-15C,1160,995,650,33,271,6,35,2,345
13231000007,2325,1727,1566,19,70,45,13,3,161
13199000006,1653,1339,750,29,534,14,11,1,589
13097000739,5503,4125,1562,242,2042,83,256,6,2563
13097001272,7491,5607,3194,476,1742,119,101,4,2413
13135000129,7903,5575,3628,497,914,87,461,7,1947
13135000008,6540,4894,3182,371,787,86,498,0,1712
1330500001B,1703,1358,1261,23,49,14,4,0,97
13073000120,2926,2465,1991,101,259,42,72,11,474
13073000108,2408,1841,1306,108,148,48,222,0,535
13073000130,3241,2568,1856,145,375,47,146,7,712
130890000MZ,5293,3776,64,93,3626,30,37,4,3712
130890000WC,4981,4123,2054,190,1660,37,188,7,2069
13135000142,6060,4354,1691,386,775,51,1494,1,2663
13135000120,3621,2581,514,1284,498,92,294,1,2067
13135000004,2772,2157,1075,206,474,44,366,3,1082
130890000FA,7575,5513,129,127,5261,68,24,11,5384
130890000WN,4151,3303,228,106,2906,41,70,1,3075
130890000WA,3344,2795,317,92,2371,21,23,3,2478
13135000124,4217,3270,859,787,1176,93,436,5,2411
130890000AD,3314,2358,2023,109,91,20,108,1,335
13195000PAO,348,273,243,5,4,11,10,0,30
1306700GM01,3628,2706,2040,188,255,36,169,6,666
1306700RW01,6832,4982,4000,265,270,58,351,7,982
1306300JB15,4580,3297,241,501,2518,90,108,1,3056
1306300OAK4,5973,4326,136,233,3888,38,98,2,4190
1305107-13C,2784,2343,1680,99,292,36,225,2,663
1305106-08C,3679,2814,951,513,1262,59,77,2,1863
1331700004A,1220,1021,712,23,257,15,14,1,309
1306700EL05,3958,3023,2078,232,320,63,292,6,945
1306700LM04,3379,2463,1803,104,364,41,132,1,660
131210SS15A,4219,3432,1009,585,1656,52,131,9,2423
1300900CTY4,3136,2953,2287,141,390,34,43,4,666
1305900006B,5677,4434,2360,590,1298,80,120,13,2074
1305900006D,2801,2360,1619,138,379,27,199,13,741
13021000WA2,5278,4437,2772,94,1484,39,57,4,1665
13197000339,1415,1118,983,36,53,27,16,5,135
13197000948,637,502,372,17,66,35,12,12,130
131210CP06A,818,658,12,48,610,5,3,0,646
131210CP08A,914,604,11,11,586,5,1,1,593
131210CP06B,9,8,0,0,5,0,1,0,8
1309900000B,5567,4050,1310,40,2638,64,26,2,2740
13151000047,5241,4258,721,178,3281,70,62,2,3537
13177000009,4506,3256,2064,119,900,59,107,3,1192
1312100JC14,3703,2648,1531,108,189,17,796,5,1117
13243000947,117,93,85,2,5,0,1,0,8
13031000002,2518,1946,1594,51,249,30,15,0,352
13123000003,2869,2264,1946,193,17,91,10,1,318
13021000HO6,2903,2315,1489,68,662,28,70,3,826
1312100004S,2460,1926,132,50,1726,38,14,1,1794
1312100010C,3313,2365,8,15,2325,15,4,0,2357
13243000934,485,388,322,3,57,5,1,0,66
13033000008,292,243,154,4,78,7,2,1,89
1312100012L,806,614,27,18,561,8,3,1,587
1312100011R,3372,2396,27,38,2343,28,5,6,2369
1312100007F,4879,4129,3070,325,429,42,260,4,1059
1312100007B,3837,2628,2261,97,100,20,134,4,367
13139000009,6881,5349,3415,1300,438,101,127,0,1934
13207000014,584,486,382,3,95,9,1,0,104
13207000002,1366,1020,920,9,47,18,10,1,100
13245000504,4294,3186,907,346,1831,77,76,9,2279
131210002F1,3765,3435,2558,208,351,58,239,5,877
1312100004V,4130,2956,124,52,2765,31,23,0,2832
1312100JC10,4079,3127,1546,390,478,43,661,6,1581
1312100008C,1859,1378,1227,38,29,12,58,6,151
13245000601,6728,4985,1570,287,2951,104,112,30,3415
131210JC13B,355,275,232,8,6,1,28,0,43
1312100AP05,6021,4595,2854,265,486,20,934,9,1741
131210AP09B,1416,1015,433,65,150,14,354,2,582
131210002L1,9442,9044,5449,701,1411,122,1375,12,3595
1312100008E,3283,2356,1973,105,118,29,141,1,383
13019001642,1984,1449,1124,172,114,24,10,1,325
13013000009,5165,4001,2937,437,412,104,135,10,1064
1312100RW06,3869,3067,2124,282,374,68,200,6,943
13129001054,2242,1747,1550,109,27,50,11,0,197
130810CONEY,1058,884,816,4,44,15,3,0,68
131210SS29A,6072,4994,1948,276,676,46,2041,9,3046
131210SS29B,19,7,0,3,6,1,0,0,7
13057000038,5374,4109,3627,174,129,73,75,10,482
13057000029,5057,3971,2964,327,375,121,158,5,1007
13215000127,10144,7616,4277,533,2356,148,396,28,3339
1317101712B,1969,1529,940,26,546,20,9,2,589
13097001259,2764,2071,868,221,940,41,28,6,1203
131810004-A,748,607,524,4,65,11,1,0,83
13011000013,808,645,603,17,13,6,8,1,42
13105000192,498,442,391,9,36,7,1,0,51
13011000008,779,598,524,45,5,24,3,0,74
132470000HC,3121,2485,1171,126,1071,49,64,3,1314
132470000HI,4936,3767,1380,254,2043,72,57,10,2387
13061000002,569,456,147,2,306,1,1,0,309
130890000ND,1875,1479,1074,100,100,24,181,2,405
13135000071,5997,4459,1000,953,2191,77,332,17,3459
130890000MJ,5367,4179,755,1783,1358,146,292,2,3424
130890000BG,4175,3380,2265,296,512,64,283,7,1115
13113000025,1932,1532,1080,58,328,31,39,0,452
13063000LJ1,5619,4256,549,411,3179,73,149,3,3707
13135000006,5788,4451,1612,1065,957,91,782,8,2839
13135000062,2897,2146,1724,67,90,37,229,0,422
13135000141,3971,3079,1943,279,333,65,466,4,1136
13135000125,2313,1721,1409,67,67,26,131,3,312
13057000043,5160,3798,2582,565,355,37,217,7,1216
13057000015,4053,3194,2442,191,356,67,128,6,752
13135000037,4844,3738,870,1248,1412,93,222,2,2868
130890000NF,5450,3723,897,1984,563,171,271,5,2826
130890000SN,2254,1749,1127,106,190,30,285,0,622
13215FTBEN2,2613,1510,960,283,146,63,76,20,550
13077000015,3693,2774,1513,183,985,89,27,2,1261
13077000023,4768,3700,3079,271,170,85,104,8,621
13319000011,504,405,304,4,67,22,3,4,101
13319000004,231,197,159,3,32,2,1,0,38
13071000022,1272,932,527,364,22,19,6,0,405
13197000034,430,358,224,3,125,5,2,0,134
13027000659,1086,868,732,24,106,9,2,1,136
13115000060,2353,1848,1750,26,31,27,11,3,98
131210SC17A,87,72,8,6,54,0,2,0,64
132050000HI,184,154,132,8,9,5,0,0,22
13123000007,1565,1371,1304,18,4,25,11,1,67
1312100004A,1756,1401,72,32,1282,33,9,0,1329
1312100008K,847,616,501,28,42,14,33,1,115
1300900CTY5,1643,1383,577,24,740,9,38,5,806
131210ML04A,2614,1837,1226,74,179,24,316,0,611
131210ML04B,1626,1214,1011,51,70,23,54,2,203
131210ML04C,157,100,74,7,12,1,7,1,26
13219000007,1861,1311,1068,72,48,24,105,0,243
13167001266,747,579,558,7,6,8,1,0,21
13073000137,2716,2168,1411,82,203,36,427,4,757
132470000ST,4239,3361,1370,207,1631,51,100,4,1991
13135000026,8042,6253,2456,1210,1716,92,860,11,3797
13135000118,2640,1952,973,200,359,40,379,3,979
13061000003,520,364,80,1,280,6,3,0,284
13151000026,4783,3559,2889,164,375,82,55,1,670
1305103-09C,847,686,569,11,80,12,9,2,117
1305106-01C,2771,2209,961,195,916,46,105,7,1248
13237000106,1734,1450,1345,49,33,16,12,0,105
13135000121,4840,3898,1949,330,634,72,947,4,1949
130890000CU,2485,2051,723,100,1087,42,129,3,1328
130890000CT,703,583,29,18,514,14,24,3,554
130890000SM,4188,3328,72,66,3184,26,14,3,3256
1305104-02C,3320,2640,1918,109,273,58,268,2,722
13063000MO9,2078,1587,216,234,1097,21,62,2,1371
130890000SK,5484,4383,103,105,4095,46,96,5,4280
13135000119,3698,2880,1540,292,532,68,472,2,1340
130890000CB,2314,1848,69,68,1702,29,14,2,1779
13135000063,3341,2483,1874,110,130,27,315,8,609
130890000RM,3052,2394,110,69,2203,25,40,0,2284
13135000090,5968,4795,1647,934,1955,94,294,4,3148
130890000RC,3539,2744,55,70,2603,36,21,2,2689
1306700PM01,4425,3235,2367,175,399,41,214,4,868
1306700CR01,3859,2889,2378,113,124,25,229,3,511
1306300OAK2,2713,2130,100,213,1590,24,240,3,2030
133130000FI,3949,2949,1777,938,174,98,10,2,1172
1306700DU01,5317,3877,3024,202,451,57,134,8,853
1306700EA02,5201,3990,3108,251,311,54,249,7,882
1306700EA01,3941,2918,2222,138,99,36,355,3,696
1306700MK01,2241,1764,1373,72,169,30,90,1,391
1306700BR01,4172,3211,1136,746,1192,99,109,11,2075
1306700MT04,3778,2808,2302,122,124,20,232,0,506
1312100011M,4667,3452,50,131,3262,35,26,4,3402
1312100010J,1329,994,32,24,944,11,12,2,962
1312100003S,987,720,19,20,680,11,1,0,701
1312100010G,1449,1141,16,25,1103,8,1,1,1125
1312100008D,1312,960,862,18,30,4,46,2,98
1312100010F,1223,1009,19,21,970,10,4,2,990
13033000010,355,251,89,3,156,4,0,1,162
131210RW11B,27,18,4,4,4,2,7,1,14
131210RW11A,3719,2961,2090,252,459,49,115,3,871
1312100007H,2397,2048,1706,104,136,20,73,2,342
13169000009,3161,2451,1995,45,336,29,46,1,456
13245000108,608,498,111,20,354,6,6,3,387
1312100SS12,3799,3098,2216,178,400,34,275,6,882
131210CP07E,57,34,1,2,31,0,0,0,33
131210CP07A,1530,1130,49,38,1048,9,2,1,1081
1312100SS31,2156,1902,1200,82,389,33,196,0,702
13013000004,3777,2805,2081,282,232,62,155,9,724
13285000013,2762,2106,1589,36,399,28,46,2,517
131210008N1,922,658,559,31,35,8,30,1,99
131210008N2,2143,1875,1263,64,411,3,115,1,612
131210SC29A,3711,2799,70,113,2602,38,5,3,2729
13057000027,6420,4685,3980,262,209,97,120,6,705
1306300JB14,5113,4146,1038,370,2517,60,212,0,3108
13113000023,1226,961,238,45,647,20,24,0,723
13255000014,3358,2614,1701,302,494,78,34,0,913
13113000028,2740,2247,930,138,1050,43,106,5,1317
13063000MO8,5039,3763,264,484,2898,56,110,11,3499
13135000126,3338,2520,1929,119,177,21,259,3,591
13213001039,5439,4077,3241,709,47,90,12,0,836
13135000067,8927,6661,2420,854,1665,99,1701,3,4241
130890000KC,1377,1161,49,13,1100,19,7,1,1112
1306700DC01,3788,2791,2072,137,139,51,364,3,719
13057000005,5371,4158,3423,271,234,107,102,1,735
130890000SO,4382,3243,66,117,3071,36,21,1,3177
1306700FY01,3272,2454,1729,173,361,38,162,4,725
13251000005,699,575,401,15,143,14,2,2,174
13251000012,283,203,64,5,123,7,1,1,139
130910JONES,712,555,500,19,33,4,3,1,55
131210AP04B,758,518,339,40,37,3,102,2,179
13301000005,429,350,286,6,54,2,1,0,64
1306300JB12,4238,3258,229,326,2642,58,71,6,3029
13063000MO7,3423,2463,243,302,1510,48,424,2,2220
13057000001,4298,3218,2461,349,178,88,116,1,757
13057000016,8540,6683,4494,1051,795,193,189,6,2189
130890000MU,3190,2339,1710,141,188,41,258,4,629
13135000033,2722,2131,1079,212,291,35,511,2,1052
130890000MR,2961,2474,124,23,2298,20,18,4,2350
13135000043,5114,3730,447,1393,1024,143,883,12,3283
13011000011,2430,1913,1714,78,49,44,22,2,199
13199000004,416,339,196,7,131,7,1,0,143
13073000050,902,701,325,18,327,14,12,5,376
13135000076,4853,3718,897,354,2284,63,169,11,2821
130890000GF,2762,2179,157,87,1907,20,24,3,2022
133130000LT,1799,1360,1214,96,7,31,8,0,146
13143000005,2283,1771,1664,24,34,30,8,2,107
1331700003B,922,761,478,40,210,16,17,1,283
1312100007D,6397,5796,3728,477,1086,87,450,8,2068
131210SS15B,2515,2149,1203,207,565,35,110,8,946
1312100007C,5979,5466,3956,299,768,36,420,2,1510
13169000002,2865,2235,1715,29,432,49,6,0,520
1312100006B,2120,1873,1513,114,108,19,116,3,360
1300900321E,2056,1545,339,46,1122,15,13,1,1206
131450000MG,3695,2852,2438,99,191,68,49,3,414
1305108-11C,1577,1204,5,1,1196,5,1,0,1199
13143000009,419,335,313,1,3,19,2,0,22
13057000021,3689,2849,2539,102,107,49,33,0,310
13321000016,460,363,191,21,141,13,1,0,172
13135000104,7998,5905,998,422,4261,87,224,6,4907
130890000VB,1552,1216,657,163,202,37,168,2,559
13293000561,889,740,70,7,660,4,1,0,670
13177000008,3979,2831,2027,112,560,55,86,10,804
1305900008B,3233,2531,1463,210,692,59,91,1,1068
1312100006N,2042,1656,1069,70,370,22,110,4,587
1312100011J,2408,1882,14,49,1825,22,12,0,1868
1312100011G,2813,2220,58,31,2131,24,4,0,2162
1312100012I,1204,928,15,19,904,0,1,0,913
131210JC04A,5777,4196,2418,243,425,49,1032,2,1778
1312100RW08,2951,2492,2046,171,133,34,95,2,446
13179000005,598,487,141,13,320,6,8,2,346
1312100002C,2534,2454,999,133,1077,31,214,1,1455
1312100005F,42,41,27,5,8,1,2,0,14
13113000013,4384,3287,2735,126,247,57,98,4,552
131450000L9,3677,2726,2253,91,243,56,80,4,473
13215000120,11481,8671,4921,618,2172,147,892,26,3750
130510XFTPU,0,0,0,0,0,0,0,0,0
130890000PH,1954,1535,91,71,1339,24,27,3,1444
13217000007,3458,2670,2063,81,425,46,49,2,607
13135000149,3169,2516,1134,238,494,35,642,2,1382
13135000034,4403,3219,672,970,579,99,978,7,2547
13135000065,4466,3288,572,1466,556,70,726,3,2716
130890000BM,5754,4593,136,148,4179,71,139,3,4457
1306700DV01,2783,2055,1472,182,220,52,137,5,583
1306700BT01,2944,2267,144,297,1810,59,17,6,2123
1306700SO01,2609,2027,1633,78,153,30,134,1,394
1312100SS04,5238,4324,2097,512,962,70,718,15,2227
132470000SM,5186,4061,1077,198,2665,45,122,4,2984
1312100CP02,1565,1338,243,110,978,16,25,0,1095
1312100006E,2725,2385,1641,162,379,28,188,4,744
1312100011H,687,575,25,14,538,10,5,0,550
1312100009M,3391,2530,1247,190,979,50,113,3,1283
131210002F2,1104,936,477,43,303,6,93,0,459
13245000302,2099,1583,301,67,1190,23,16,8,1282
1312100004B,3122,2865,137,78,2691,17,16,0,2728
1312100001F,1282,963,108,30,811,15,16,3,855
131450000PV,1648,1271,1106,27,95,34,8,2,165
13057000031,5146,3685,1974,1132,440,141,81,4,1711
130450714A2,2495,1851,1170,120,474,46,49,5,681
130890000KB,2908,2363,1982,90,83,23,160,0,381
130890000BE,5969,4300,1600,1968,427,161,317,2,2700
13073000111,2587,1936,1327,128,296,51,132,5,609
1306700FR01,3972,2866,2207,140,342,36,102,7,659
13135000107,2140,1562,674,167,329,30,364,1,888
13135000109,2760,2058,884,324,329,50,524,1,1174
13135000110,4597,3413,823,1275,949,135,395,8,2590
13107000052,301,252,99,0,153,0,0,0,153
13073000115,2798,2133,1306,116,462,57,177,26,827
13113000036,2405,1866,1293,101,387,37,42,1,573
130890000DG,2780,2004,1649,83,80,30,153,0,355
13281001581,38,35,28,6,0,0,0,1,7
13135000116,8379,6129,880,2630,1278,137,1357,11,5249
1306700MB01,2006,1492,1275,68,67,20,54,0,217
1326100N-26,524,427,359,19,31,6,10,1,68
1306700KL01,2560,1952,1444,170,204,49,75,0,508
1312100001P,1814,1241,29,58,1146,22,10,0,1212
1312100SS14,1865,1402,1192,78,52,22,44,3,210
1312100JC18,3428,2645,1983,133,253,35,235,2,662
131210CP07B,32,18,0,2,12,1,1,0,18
1312100010R,1440,999,0,91,923,7,2,1,999
1312100005B,2439,2159,598,58,1366,36,108,1,1561
1312100001H,1260,1037,112,40,848,33,39,0,925
1312100JC05,4042,2939,1445,233,424,37,818,5,1494
13135000074,4995,3625,366,1792,1202,124,280,6,3259
1305106-05C,2819,2191,966,187,944,31,77,9,1225
130890000CD,5280,4036,118,106,3798,52,25,6,3918
131210JC13A,2857,2181,1572,65,107,22,389,1,609
1312100SC02,993,824,8,3,806,4,6,0,816
1305105-01C,1559,1182,335,76,697,23,58,6,847
130890000MQ,3421,2491,2007,104,130,48,196,5,484
13135000017,6977,5064,789,1970,1536,115,808,9,4275
1305108-09C,1695,1250,34,15,1202,12,3,2,1216
13135000056,3671,2850,1250,602,594,72,357,15,1600
1305106-06C,2286,1781,1023,105,562,32,55,11,758
13199000014,266,235,209,9,13,5,0,1,26
1306700TR01,3091,2224,1783,97,87,22,222,0,441
1312100003G,627,497,15,41,450,10,2,2,482
131210ML023,2279,1565,1303,60,82,22,101,4,262
131210ML024,172,115,90,19,0,0,2,0,25
131210CP081,666,459,7,7,443,3,3,1,452
13135000137,7660,5497,2735,934,1212,130,601,9,2762
1312100012G,1027,820,45,34,724,16,22,0,775
13063000MO4,3227,2421,374,362,1443,51,250,1,2047
1305101-14C,2236,1858,1354,107,276,39,81,7,504
13135000130,7036,4832,2724,302,567,72,1163,14,2108
130890000TC,1734,1472,163,48,1261,29,20,2,1309
130890000CO,4747,3764,1704,1336,447,112,248,5,2060
130890000CC,2150,1572,55,25,1490,15,6,0,1517
1306700AD01,3173,2532,1633,239,302,49,260,4,899
13113000017,1749,1305,972,105,109,19,94,0,333
131210CP05B,188,144,0,4,137,5,0,0,144
13135000123,9540,6502,587,3744,1364,247,855,21,5915
131210011E1,1783,1287,20,44,1235,19,13,0,1267
131210JC03A,876,596,323,46,74,12,146,0,273
131210JC03B,2585,1890,720,142,304,24,694,11,1170
1312100004W,871,861,0,3,858,0,2,0,861
131210SS11D,513,411,328,30,25,1,26,0,83
13055000961,284,202,182,3,15,0,0,0,20
1306300JB05,2997,2123,423,242,1379,44,120,5,1700
1312100SS03,2154,1787,1138,157,280,32,178,7,649
130890000WL,1823,1430,1022,108,110,21,171,0,408
1306700ML01,4001,3110,2304,165,462,77,114,6,806
1312100RW16,2554,1957,1432,140,214,25,154,1,525
131210SS11B,4286,3026,761,1788,299,71,144,2,2265
1312100003H,1175,918,59,21,835,12,3,1,859
1312100004C,157,133,13,4,117,3,0,0,120
13135000132,4331,3348,1562,480,671,90,613,3,1786
13135000093,4882,3620,2178,329,579,63,473,3,1442
13135000002,5732,4148,822,469,2705,72,198,6,3326
13135000079,3882,2845,1456,422,584,50,339,6,1389
13113000020,1225,932,777,62,53,19,30,0,155
131210SS02B,1942,1615,794,219,445,32,133,0,821
131210SS11C,1066,812,165,372,215,20,56,3,647
13063000LJ4,5209,3907,292,262,3279,69,84,9,3615
1312100010I,365,305,10,0,295,4,0,0,295
1312100RW19,2721,1948,1547,68,159,22,150,0,401
13245000305,513,401,331,12,36,8,13,2,70
131210SS18A,781,592,483,23,34,4,48,1,109
131210JC04B,591,417,174,22,79,7,133,1,243
1312100AP10,1222,946,795,46,41,16,47,2,151
131210SS18B,260,222,186,4,12,2,17,1,36
