GEOID,TOTAL_POP,TOTAL_VAP,WHITE_VAP,HISPANIC_VAP,BLACK_VAP,NATIVE_VAP,ASIAN_VAP,PACIFIC_VAP,MINORITY_VAP
51117000901,377,305,278,0,24,1,0,0,27
51117000601,1407,1165,800,33,320,20,7,0,365
51117000201,1012,819,428,13,372,5,9,1,391
51117000803,1283,1052,627,15,395,8,6,0,425
51117000702,1339,1426,739,32,645,13,3,2,687
51053000201,2055,1482,738,176,538,29,20,3,744
51053000202,4049,3181,2148,110,811,56,45,3,1033
51053000502,4398,3281,1395,113,1691,67,30,0,1886
51053000102,1812,1458,1138,27,243,42,3,0,320
51053000402,1822,1406,944,27,392,38,11,0,462
51053000403,1010,819,437,14,353,18,4,1,382
51147000601,2608,2040,998,37,979,33,16,4,1042
51147000501,1339,1053,715,16,303,15,6,1,338
51163000203,987,929,795,29,60,17,23,2,134
51147000302,976,722,319,12,370,13,4,4,403
51147000301,1838,1451,828,23,562,26,14,3,623
51163000503,748,611,591,4,7,10,0,0,20
51117000802,1622,1376,993,28,345,8,3,0,383
51163000501,928,719,679,9,6,11,4,0,40
51163000301,1648,1259,1053,29,137,32,11,1,206
51009000303,957,766,653,3,87,12,0,0,113
51005005701,2088,1649,1338,28,236,32,7,2,311
51005005601,2233,1843,1636,22,153,18,7,2,207
51079000401,5392,4156,3262,258,335,84,215,5,894
51079000201,5609,4324,3247,334,474,83,145,6,1077
51113000003,1244,936,788,31,92,17,9,0,148
51137000101,3244,2660,2191,119,282,54,21,3,469
51003000603,4050,3189,2892,70,104,53,59,1,297
51079000101,1896,1466,1363,32,23,36,15,0,103
51079000301,4791,3754,3216,110,312,50,38,8,538
51113000006,1354,1094,996,9,63,16,10,1,98
51700000302,4924,3775,1028,465,2184,117,79,24,2747
51700000108,10176,7406,3034,1051,2906,191,416,72,4372
51700000106,8776,6452,2076,987,3029,192,363,34,4376
51700000311,4351,3488,1128,108,2167,79,52,8,2360
51700000102,8073,5644,1289,573,3504,143,258,32,4355
51700000314,2424,1964,921,81,880,44,55,6,1043
51163000202,2679,2252,2094,33,36,39,49,2,158
51163000201,1404,1152,1066,13,17,34,11,0,86
51163000504,1339,1110,1036,8,21,34,4,1,74
51163000502,1518,1152,990,28,67,31,32,4,162
51163000101,1660,1353,1285,21,9,19,16,1,68
51163000104,782,658,623,6,5,12,5,0,35
51163000302,1695,1325,1216,19,30,49,4,0,109
51023000301,3383,2641,2489,16,57,46,10,1,152
51125000101,2865,2397,2059,81,174,60,13,4,338
51125000401,2674,2161,1657,135,326,40,18,2,504
51053000303,2711,2157,1261,36,824,34,9,0,896
51161000105,4340,3480,2803,92,407,56,114,4,677
51770000001,5204,3867,1177,344,2202,70,104,4,2690
51161000304,4257,3351,2797,100,105,43,290,3,554
51810000024,3262,2625,1611,165,642,48,191,15,1014
51810000082,3608,2618,1751,167,359,68,297,11,867
51810000086,4251,3649,2392,156,504,37,566,6,1257
51810000093,6743,5026,1320,589,2798,95,353,12,3706
51810000001,4919,4200,3760,131,110,51,115,10,440
51810000042,4669,3606,1892,292,880,69,511,22,1714
51810000052,5935,4524,2499,254,872,94,814,14,2025
51163000401,1442,1176,1071,21,29,35,4,0,105
51163000402,2324,1929,1779,24,37,57,16,7,150
51117000701,1801,1385,816,25,532,13,2,0,569
51117000203,968,754,171,14,563,8,0,2,583
51117000302,1621,1246,735,107,380,21,9,0,511
51117000501,3852,2933,1728,42,1044,42,82,1,1205
51117000401,3296,2546,921,64,1509,44,14,1,1625
51117000103,2001,1583,779,29,739,21,10,0,804
51117000903,2576,2162,1788,34,289,28,28,0,374
51005005201,894,686,644,9,17,13,5,1,42
51107000615,4166,2897,1940,203,221,39,502,7,957
51107000625,1789,1263,876,71,39,11,255,1,387
51107000819,3481,2423,1340,231,180,29,650,1,1083
51810000037,7404,5448,3524,662,889,151,310,42,1924
51810000011,5116,4179,3625,215,182,78,92,14,554
51810000017,3263,2714,2367,103,84,52,104,11,347
51810000059,4381,3571,1985,343,879,83,303,13,1586
51710000512,2661,2229,1300,189,488,59,200,19,929
51810000041,6251,4783,1623,318,2541,90,308,17,3160
51161000104,2137,1663,1203,53,283,29,87,5,460
51770000003,5209,4148,2517,594,581,87,369,15,1631
51009000101,1767,1777,995,43,695,58,9,0,782
51031000601,3458,2716,2077,64,470,85,16,1,639
51009000201,4460,3653,2693,130,698,94,45,1,960
51005005101,1627,1317,1273,6,11,19,3,1,44
51107000416,4755,3544,2895,203,127,71,207,3,649
51107000409,4116,3181,2535,188,111,62,253,2,646
51107000403,5525,3862,2788,423,267,104,302,7,1074
51107000402,3980,3034,2577,165,91,50,151,8,457
51107000808,5323,3667,2454,296,277,50,598,10,1213
51107000122,5574,3786,1442,281,317,37,1734,11,2344
51107000124,4778,3330,1174,292,338,45,1480,12,2156
51107000120,5750,3874,1384,259,315,52,1887,7,2490
51107000112,4119,2720,1035,174,236,23,1256,7,1685
51107000119,4510,3187,1295,291,468,48,1120,4,1892
51083000401,1894,1657,912,35,658,32,20,1,745
51083000502,3127,2404,1623,74,629,24,57,3,781
51083000701,2095,1672,1313,43,294,20,5,3,359
51107000121,2970,2090,1032,224,178,28,638,3,1058
51107000210,5284,4106,2277,497,393,53,874,11,1829
51107000209,3902,2970,1886,336,215,33,476,12,1084
51107000401,5070,3632,2996,238,187,96,117,4,636
51107000421,509,394,332,18,15,15,9,0,62
51065000301,4858,3832,2498,129,1056,103,40,19,1334
51065000201,4457,3569,2591,86,775,72,34,8,978
51077000203,3158,3272,2330,195,692,51,6,4,942
51077000101,565,477,451,3,10,12,2,0,26
51085000704,4159,3264,2524,239,341,75,102,1,740
51085000101,3380,2641,1759,353,424,100,37,3,882
51085000602,4607,3710,3061,116,360,76,89,7,649
51085000406,1027,816,674,17,91,27,12,3,142
51087000209,2520,2010,408,64,1473,37,47,0,1602
51085000703,2928,2335,2007,33,194,39,42,2,328
51199000502,8172,5737,3523,411,1003,120,696,42,2214
51199000501,5581,4341,3245,220,458,85,359,11,1096
51199000201,9275,6136,3713,480,969,141,884,46,2423
51199000103,7419,5536,2944,509,1758,150,265,41,2592
51095000503,1347,1032,478,160,351,19,27,1,554
51700000110,6780,4912,1652,560,2341,109,361,21,3260
51095000502,4330,3774,3404,117,83,43,145,6,370
51077000202,907,754,706,15,20,9,3,0,48
51197000602,2004,1571,1503,8,20,23,3,0,68
51125000501,1092,901,784,29,55,22,5,2,117
51125000201,1802,1491,1180,53,201,33,28,2,311
51185000502,4625,4354,3675,134,324,86,83,7,679
51185000501,2601,2077,2010,6,13,29,6,5,67
51167000403,1295,1001,973,7,13,6,0,1,28
51167000303,1943,1570,1523,12,23,11,0,0,47
51167000602,2481,2000,1962,1,5,28,4,0,38
51167000402,2752,2272,2211,11,7,32,2,1,61
51107000207,2393,1799,1212,233,118,32,203,2,587
51107000307,1650,1400,1100,123,112,24,35,3,300
51107000503,1983,1539,1204,176,70,19,62,1,335
51107000114,5541,3834,1252,256,355,55,1949,14,2582
51107000107,4560,3038,1630,193,203,12,980,9,1408
51107000123,2751,1862,1181,129,134,14,403,9,681
51107000629,1644,1243,538,226,218,11,253,0,705
51107000117,2994,2128,720,275,372,31,744,6,1408
51107000411,2893,2270,1959,100,57,51,68,10,311
51167000501,4400,3521,3294,32,100,57,25,1,227
51167000302,693,555,548,3,2,1,0,0,7
51185000214,1033,810,790,4,3,11,1,0,20
51167000301,624,469,461,0,0,7,0,0,8
51077000108,319,285,266,6,10,3,0,0,19
51077000104,383,333,314,6,8,7,4,0,19
51107000316,6767,4566,2187,374,488,49,1505,5,2379
51107000312,5854,3822,1474,294,312,27,1704,14,2348
51107000321,4104,2641,949,187,188,15,1287,5,1692
51107000118,6416,4394,1663,237,452,33,2017,9,2731
51107000701,5613,4143,1393,1734,303,121,688,2,2750
51107000702,4896,3830,1258,1604,288,106,643,9,2572
51095000403,4340,3436,2822,104,350,69,90,9,614
51095000303,2083,1685,1397,51,166,45,31,5,288
51095000402,6920,5832,4499,273,831,89,146,7,1333
51095000401,6572,4685,3291,237,862,126,156,16,1394
51095000202,6112,5087,3506,282,937,98,252,16,1581
51095000304,5418,4116,2521,279,974,78,282,12,1595
51810000030,6820,5425,3752,598,712,107,264,39,1673
51810000070,6513,4865,3128,516,837,134,335,20,1737
51810000050,4589,3635,1884,326,1153,107,224,30,1751
51810000003,3549,2683,1941,191,353,65,132,26,742
51810000027,3878,3177,2228,166,388,56,327,28,949
51810000099,4125,3129,1284,270,761,71,797,20,1845
51810000044,4886,3753,2199,203,681,98,610,12,1554
51810000065,5679,4147,1690,269,1014,67,1145,21,2457
51810000038,4839,4046,3211,172,300,59,309,12,835
51810000019,2538,2044,1569,112,172,30,143,7,475
51141000501,748,621,540,21,42,8,3,0,81
51141000503,1367,1110,1016,32,19,21,7,2,94
51590000016,3270,2626,1676,138,742,32,44,2,950
51143000705,1868,1477,1262,35,142,23,8,0,215
51590000004,5155,3849,2013,216,1553,70,33,2,1836
51083000302,669,557,209,10,333,9,0,0,348
51083000103,1690,1394,778,6,591,14,1,1,616
51083000203,1727,1385,782,9,575,22,5,2,603
51141000301,2035,1639,1342,37,211,38,9,1,297
51141000203,1364,1071,949,15,87,10,2,0,122
51141000502,1189,1033,973,13,36,9,2,1,60
51141000202,1666,1352,1169,45,106,24,4,0,183
51141000302,1471,1199,1138,16,20,14,5,0,61
51141000401,1328,1059,992,26,8,16,10,2,67
51053000501,1041,853,328,27,463,17,14,1,525
51053000302,1962,1583,1060,52,435,34,12,2,523
51125000502,2118,1878,1700,39,81,19,20,6,178
51125000402,197,164,150,3,3,6,3,0,14
51163000403,899,692,626,28,17,16,2,1,66
51035000303,721,581,540,9,7,8,2,0,41
51035000301,3876,3062,2903,54,17,39,22,1,159
51011000102,2090,1613,1253,16,326,15,5,0,360
51011000202,2550,1977,1705,23,193,24,13,0,272
51011000401,3272,2474,1794,51,547,55,14,0,680
51011000101,1083,863,744,21,92,9,1,1,119
51011000501,2223,1712,1295,26,354,24,5,0,417
51057000301,2532,2093,1502,69,467,65,6,2,591
51035000102,1796,1440,1388,32,3,20,2,1,52
51035000105,1349,1175,1124,24,9,11,2,3,51
51035000103,1043,857,805,19,3,22,4,0,52
51810000083,5096,3723,2726,236,368,84,300,25,997
51810000046,5076,3732,1259,305,1139,57,1013,23,2473
51810000080,4609,3593,1493,350,1245,94,488,16,2100
51810000021,5940,4480,1523,363,2094,96,482,19,2957
51810000016,6755,5232,3167,442,980,154,504,30,2065
51810000039,6888,5663,3409,473,1133,163,509,21,2254
51810000063,6456,4953,3431,458,627,94,327,31,1522
51810000095,3286,2481,1777,211,303,69,154,11,704
51035000402,2565,2110,1951,74,32,33,8,3,159
51035000502,2467,1957,1849,59,16,24,4,0,108
51035000406,570,452,387,26,22,6,5,0,65
51035000503,1227,955,900,30,11,17,1,2,55
51035000202,1135,938,891,19,7,18,3,0,47
51185000401,7741,6156,5865,34,47,124,35,5,291
51185000402,472,377,363,0,4,8,0,0,14
51027000702,1109,889,850,7,11,6,12,0,39
51141000402,2081,1889,1693,53,98,21,12,3,196
51185000204,1067,862,809,8,12,20,13,0,53
51185000209,5789,4720,4275,58,257,87,40,1,445
51185000102,959,769,714,14,15,14,5,0,55
51107000622,5765,4375,2204,518,609,51,1006,14,2171
51107000626,1661,1651,1556,24,15,1,54,1,95
51107000707,3729,2861,1208,512,387,42,731,2,1653
51107000619,4155,3158,1127,897,480,81,624,9,2031
51107000308,1848,1519,1193,109,148,30,35,1,326
51043000302,907,753,661,27,12,13,16,1,92
51057000201,2489,2016,906,40,1024,53,11,0,1110
51107000311,4520,3145,2524,230,137,52,191,12,621
51107000305,1649,1228,1085,59,22,29,28,3,143
51107000315,1121,859,762,35,21,10,23,1,97
51590000003,2764,2246,898,81,1219,42,29,2,1348
51197000203,4909,3909,3463,73,270,72,37,1,446
51197000402,2486,1949,1862,2,25,49,5,1,87
51197000303,4918,4027,3525,75,270,72,71,4,502
51199000401,4905,3852,3163,153,180,91,261,10,689
51199000303,5224,3915,2387,226,1027,87,212,7,1528
51199000102,4701,3957,3063,181,473,74,159,18,894
51685000002,7165,5026,1263,3145,330,158,252,12,3763
51685000001,4972,3903,1393,780,945,57,748,12,2510
51685000003,5124,3772,1238,1269,625,110,603,11,2534
51167000102,1413,1120,1092,1,4,14,2,0,28
51167000202,837,637,615,0,13,9,0,0,22
51590000013,3296,2557,986,103,1430,38,31,2,1571
51125000301,2629,2082,1519,59,432,53,9,2,563
51035000201,3314,2683,2578,30,18,36,9,2,105
51197000102,3649,2867,2724,27,19,63,10,3,143
51197000101,1155,931,885,9,17,16,8,0,46
51199000302,4475,3577,2640,233,422,75,205,15,937
51199000301,5157,4023,3571,106,144,68,118,6,452
51127000501,1734,1388,1101,48,168,33,34,3,287
51107000319,9700,6125,2518,348,574,77,2620,13,3607
51107000318,6796,4434,2704,295,271,70,1091,18,1730
51107000322,4915,3158,997,215,382,43,1566,7,2161
51107000313,6116,3892,1825,287,386,53,1337,7,2067
51071000302,3227,2597,2398,37,87,67,4,1,199
51820000001,5305,3925,2638,426,757,84,33,11,1287
51015000603,3448,2823,2512,86,126,48,36,1,311
51125000202,1073,868,791,14,41,18,1,0,77
51199000403,3149,2479,1873,109,255,51,169,18,606
51043000201,2997,2329,1877,108,220,45,58,5,452
51043000101,3082,2509,2224,99,51,71,40,0,285
51043000301,2114,1743,1483,94,91,35,26,6,260
51590000011,3972,2967,988,131,1780,42,60,2,1979
51035000302,1206,974,941,10,3,16,2,0,33
51185000104,1115,891,837,15,10,22,7,0,54
51590000010,2678,2204,1078,51,987,48,63,2,1126
51590000017,2427,2006,1482,79,362,26,46,0,524
51069000302,9025,6676,4378,1357,589,157,231,7,2298
51043000401,2880,2334,1963,149,115,49,48,3,371
51069000401,4315,3293,2487,374,196,72,145,2,806
51161000106,3763,3658,3215,59,222,55,88,0,443
51161000103,3578,2922,2692,50,88,40,41,2,230
51775000009,3181,2460,2197,50,91,35,76,1,263
51161000302,4207,3186,2867,63,46,63,116,0,319
51161000507,4476,3582,3010,98,202,66,165,3,572
51810000014,4842,3748,2773,260,482,57,189,15,975
51810000025,6590,5195,2951,319,1287,110,551,23,2244
51810000023,4649,3475,2388,232,588,91,184,25,1087
51710000408,4397,3513,1511,300,1417,72,286,22,2002
51810000064,4040,3020,1644,251,619,69,501,14,1376
51810000034,1263,984,840,35,70,24,16,5,144
51810000005,6495,4932,2648,806,1208,133,181,36,2284
51810000004,4885,4172,3311,280,321,75,168,17,861
51043000501,2069,1598,1381,76,58,31,34,1,217
51155000202,849,654,568,4,57,19,1,1,86
51155000501,6494,5146,4471,78,425,122,35,5,675
51820000002,5359,4243,3487,243,361,88,49,7,756
51820000004,6052,4895,4108,180,355,79,152,11,787
51083000702,1374,1103,925,15,145,13,4,1,178
51141000201,703,599,544,11,23,16,2,1,55
51161000405,2731,2096,1911,14,105,23,38,2,185
51161000401,2628,2113,1911,50,55,35,50,4,202
51165000201,2537,1880,1799,30,13,17,10,6,81
51165000103,2253,1807,1740,19,15,26,7,2,67
51165000104,715,578,547,11,7,8,0,0,31
51165000204,2788,2184,2066,63,33,14,13,2,118
51165000406,4562,4012,3210,261,418,68,55,8,802
51165000401,2051,1585,1429,76,47,17,13,7,156
51165000205,4463,3257,2504,558,105,63,76,1,753
51165000402,2664,2052,1924,61,21,18,22,0,128
51085000303,3357,2602,2161,81,203,40,82,3,441
51085000506,2533,1994,1685,29,188,36,33,5,309
51101000501,3527,2811,2093,47,585,52,21,2,718
51085000601,5080,4038,3485,103,247,86,94,2,553
51085000603,3697,2721,1921,136,529,64,55,11,800
51165000502,4237,3368,3167,78,72,34,13,5,201
51165000501,2958,2295,2063,94,87,37,24,1,232
51185000103,2051,1633,1582,8,15,19,5,0,51
51185000301,4086,3287,3141,34,28,51,25,8,146
51185000303,2875,2279,2207,15,8,34,5,0,72
51049000501,2010,1542,896,41,552,33,20,2,646
51057000101,2769,2191,1149,57,915,50,44,1,1042
51107000218,4494,3572,1772,616,500,41,652,4,1800
51107000813,3836,2932,1620,290,378,62,606,7,1312
51107000309,1336,1029,787,81,104,16,37,3,242
51107000219,3983,2975,1574,694,282,72,384,6,1401
51107000208,2545,1877,1302,252,89,17,207,3,575
51107000504,4904,3699,2544,534,335,63,245,14,1155
51107000502,8882,6111,1963,2853,718,123,536,14,4148
51177000302,5667,4349,2751,522,802,131,171,11,1598
51177000301,6677,5145,3158,807,871,118,224,6,1987
51630000101,9001,6771,3653,781,1750,186,509,28,3118
51177000103,5801,4370,2964,352,816,148,114,21,1406
51177000102,4690,3543,2705,217,429,100,77,7,838
51177000602,7764,5494,3188,679,1272,153,284,18,2306
51177000601,6646,4859,2630,854,1083,147,216,11,2229
51177000504,4714,3566,2609,176,605,96,93,3,957
51177000303,7149,5643,4039,547,601,124,324,11,1604
51165000503,3653,2798,2436,219,66,61,19,0,362
51165000504,2019,1516,1326,112,58,30,17,1,190
51101000201,1185,928,685,29,156,53,14,2,243
51101000101,3436,2591,1983,72,398,65,75,3,608
51177000402,7900,5841,2934,603,1879,154,376,18,2907
51177000704,6864,5269,3284,412,1183,98,326,9,1985
51177000703,3366,2600,1527,294,644,55,104,3,1073
51083000101,1467,1167,801,5,344,14,0,0,366
51085000301,3525,2866,2449,60,254,47,53,0,417
51087000222,2328,1991,561,60,1288,36,70,0,1430
51087000223,5490,4311,2229,193,1378,114,433,8,2082
51087000103,6406,4819,3088,137,865,54,674,7,1731
51087000109,1428,1051,849,38,115,21,41,0,202
51107000314,5101,3176,1139,142,173,30,1706,1,2037
51107000320,9024,6112,1936,484,734,57,2908,14,4176
51107000616,5115,3311,1725,221,179,41,1130,7,1586
51107000628,7393,5399,2544,573,766,90,1496,11,2855
51107000125,4284,2954,651,105,155,22,2028,6,2303
51107000509,6530,4658,2040,895,650,90,1076,7,2618
51107000414,2420,1741,1041,130,170,26,372,3,700
51107000508,4470,3109,1872,388,337,72,466,6,1237
51107000413,204,141,92,17,12,1,17,0,49
51107000501,4335,3446,2599,439,253,49,116,11,847
51049000401,1909,1529,1085,19,379,26,7,1,444
51107000820,4085,2878,1399,216,247,34,1000,0,1479
51107000814,4795,3399,2088,215,218,45,826,5,1311
51690000005,2776,2225,1743,74,332,25,47,5,482
51195000401,3806,3080,2856,60,59,39,44,5,224
51195000102,1385,1084,1037,8,12,13,5,1,47
51740000024,2428,1871,817,66,923,41,37,6,1054
51740000022,3226,2408,1198,109,982,69,62,13,1210
51770000019,6898,4726,1046,263,3281,70,141,3,3680
51770000008,5497,3840,785,230,2794,66,30,4,3055
51770000009,6275,5556,3399,317,1462,151,249,3,2157
51770000020,5069,3862,502,201,3095,59,43,6,3360
51770000007,5541,4112,3127,221,564,138,69,4,985
51770000006,5990,4600,2963,464,928,163,124,5,1637
51161000403,3527,2692,2323,79,205,69,23,3,369
51510000109,3260,2817,2176,208,216,35,163,9,641
51510000110,4968,4229,2709,313,862,60,305,3,1520
51510000105,3596,3271,2393,201,356,24,267,2,878
51510000112,3687,3560,2270,309,551,70,395,17,1290
51510000103,5023,4351,3222,260,597,86,196,7,1129
51059000621,4182,3702,1788,601,821,80,479,7,1914
51510000108,5716,4575,3454,476,333,82,221,8,1121
51510000107,5967,4633,3299,475,518,94,256,20,1334
51510000106,10788,8024,2401,3806,1378,428,441,25,5623
51510000111,2753,2386,1255,279,517,30,319,6,1131
51013000050,5562,5132,2632,495,748,70,1179,15,2500
51013000003,2622,2037,1529,215,77,41,169,5,508
51013000052,3913,3201,1614,454,731,51,393,9,1587
51510000102,3252,2816,2358,149,188,19,74,5,458
51510000202,4149,2880,2349,227,126,69,140,13,531
51113000005,2641,2042,1708,69,219,36,8,2,334
51770000015,3404,2791,2474,50,146,40,69,0,317
51770000017,5317,4183,3151,248,550,69,162,0,1032
51770000011,4714,3922,3155,158,375,112,98,4,767
51770000002,5509,4303,1722,802,1571,95,152,5,2581
51173000401,2635,2045,1887,41,48,33,30,5,158
51173000402,1660,1284,1161,25,55,30,13,1,123
51173000201,3041,2405,2333,22,20,31,7,0,72
51770000014,4110,3507,2812,112,364,74,129,0,695
51770000013,4979,3805,3140,109,381,113,59,0,665
51023000403,2259,1810,1674,11,73,45,1,0,136
51195000302,4165,3240,3059,24,43,75,18,4,181
51740000014,3205,2296,159,86,2032,50,22,11,2137
51740000017,4756,3535,1245,242,1941,96,94,12,2290
51740000019,1818,1406,767,58,510,44,37,1,639
51550000025,4256,3181,1248,266,1535,81,107,9,1933
51740000016,4519,3068,1026,148,1785,88,64,24,2042
51740000005,3362,2512,413,138,1893,49,62,5,2099
51740000026,2409,1910,91,24,1783,12,12,1,1819
51740000028,2746,2363,105,37,2212,31,10,3,2258
51775000005,3353,2766,2252,105,295,64,60,7,514
51775000001,3840,3324,2846,113,258,58,66,13,478
51195000203,1184,1519,942,37,530,10,4,0,577
51195000104,3401,2674,2593,20,6,41,11,0,81
51199000402,5414,4211,3405,200,293,72,241,8,806
51065000101,6221,5640,4225,273,961,87,95,15,1415
51119000102,1172,992,868,15,96,15,3,0,124
51775000006,2026,1632,1311,85,193,27,31,2,321
51195000101,2383,1821,1713,11,40,46,9,0,108
51195000301,4898,4656,3562,77,906,86,26,2,1094
51740000001,4256,3943,1989,263,1514,83,159,9,1954
51173000502,1629,1360,1259,28,29,17,27,1,101
51770000012,3554,2883,2553,58,163,24,55,2,330
51161000505,2183,1705,1548,11,64,39,29,7,157
51023000102,3298,2703,2576,32,30,20,21,0,127
51023000101,3754,3008,2659,72,159,56,56,1,349
51023000406,4142,3441,3122,45,167,55,28,4,319
51165000101,4187,3094,2688,246,78,54,34,2,406
51165000404,4248,3344,2556,550,123,38,105,4,788
51165000302,2742,2123,1981,62,35,36,15,1,142
51165000403,443,364,332,21,0,5,3,0,32
51195000402,4042,3260,3052,16,119,55,12,1,208
51195000103,1360,1101,1045,20,11,18,1,0,56
51047000703,1966,1510,1146,117,190,36,28,2,364
51047000401,2926,2301,1786,125,284,69,33,9,515
51630000401,3460,2719,1368,200,947,58,158,6,1351
51630000201,5600,4982,3954,277,428,99,172,12,1028
51109007021,2097,1639,1307,23,241,41,19,2,332
51075000202,3580,2830,1963,62,714,48,52,6,867
51109007022,3,1,1,0,0,0,0,0,0
51075000102,2830,2237,1748,57,339,44,33,1,489
51109007023,8,8,0,0,8,0,0,0,8
51085000701,3218,2605,2218,53,203,59,53,0,387
51087000308,5491,3772,2094,74,171,26,1382,1,1678
51085000203,2696,2141,1913,40,115,19,30,2,228
51085000105,4229,3547,2381,142,858,57,93,8,1166
51085000201,4156,3226,2854,36,215,65,11,6,372
51033000601,2981,2184,1410,143,545,41,44,7,774
51033000402,1045,848,426,26,379,12,11,0,422
51161000202,2908,2246,1530,160,435,68,101,6,716
51173000601,2974,2538,2281,29,160,50,11,2,257
51177000702,7112,5331,3142,636,1188,131,277,18,2189
51177000401,7356,5215,3005,663,1245,126,184,15,2210
51177000403,7184,5286,3083,676,1251,104,241,4,2203
51177000701,4544,3319,2000,385,767,95,120,12,1319
51117000604,717,627,545,11,43,17,0,0,82
51117000301,1923,1565,1288,21,210,24,12,0,277
51041000208,5413,4138,1208,947,1875,74,116,2,2930
51041000108,6822,5501,3677,266,1325,118,166,9,1824
51041000405,4084,3366,2254,228,643,63,156,9,1112
51041000516,3001,2261,696,367,1118,52,54,5,1565
51041000409,2318,1755,1024,93,564,29,49,0,731
51041000301,8353,7130,1659,246,5080,122,143,15,5471
51730000701,4409,3458,427,166,2836,70,25,3,3031
51041000501,4247,3131,2106,410,470,49,110,2,1025
51041000513,3421,2608,880,669,937,56,113,2,1728
51119000201,2270,1968,1803,37,67,46,18,0,165
51119000501,2202,1832,1592,20,152,41,11,1,240
51740000021,1928,1477,83,52,1332,24,10,6,1394
51740000031,4768,3613,1539,113,1863,75,55,6,2074
51510000204,3614,2677,2153,159,181,28,138,4,524
51510000305,10474,8128,2074,2026,2989,153,1013,7,6054
51510000306,9503,7186,1543,2328,2504,125,811,14,5643
51510000304,7022,5840,1934,905,2134,125,860,15,3906
51510000309,4958,3959,984,800,1670,57,511,4,2975
51740000039,4800,3670,1175,110,2249,84,80,11,2495
51740000037,4772,3616,1397,148,1891,78,120,9,2219
51740000036,5593,4486,2484,198,1594,106,159,12,2002
51775000007,2487,1965,1697,56,99,39,57,6,268
51775000004,2104,1748,1590,25,47,24,53,3,158
51775000002,2022,1486,1122,45,271,19,30,1,364
51195000202,5210,4136,3906,39,48,83,36,6,230
51085000404,3574,2829,2545,49,112,81,37,2,284
51087000503,3560,2878,1684,107,1003,46,33,7,1194
51127000202,1839,1454,1253,23,121,49,19,2,201
51047000702,4161,3167,2394,247,392,75,65,5,773
51047000201,8575,5786,2695,1382,1371,209,243,3,3091
51683000001,8760,6032,1711,2924,962,202,394,11,4321
51683000003,6464,5051,2347,1199,855,160,584,8,2704
51683000006,4338,3372,1964,712,399,97,250,2,1408
51153000214,2794,2168,1599,311,84,64,103,3,569
51107000623,5720,4681,2947,283,327,48,1077,10,1734
51107000627,2092,1629,822,302,223,25,277,9,807
51107000620,4564,3498,2332,375,233,59,493,8,1166
51083000603,1996,1636,980,28,594,36,3,1,656
51155000102,3944,3308,2796,104,288,74,38,4,512
51155000301,3538,3684,3329,53,208,61,19,2,355
51155000101,1198,977,925,9,13,23,3,1,52
51155000304,1652,1383,1320,9,19,23,6,0,63
51195000201,1965,1546,1466,12,24,30,8,1,80
51740000025,2682,2145,1261,95,729,37,42,6,884
51071000202,712,570,555,0,9,4,0,1,15
51165000203,1696,1298,1052,153,34,35,29,0,246
51510000308,5143,4286,2634,336,687,77,561,11,1652
51510000209,7652,5771,2300,1283,1628,93,564,11,3471
51510000206,4483,3731,2190,550,703,63,293,8,1541
51071000103,3629,2770,2649,34,26,38,9,0,121
51071000201,4625,3662,3398,68,75,59,37,2,264
51071000203,523,382,364,1,5,5,1,0,18
51041000204,2866,2195,1249,160,673,37,78,2,946
51041000212,3063,2344,1390,171,661,47,109,4,954
51173000101,4132,3312,3186,33,12,44,15,0,126
51161000506,2209,1766,1513,69,87,24,74,0,253
51770000010,5037,4107,3270,124,512,100,88,5,837
51177000201,4544,3242,2164,317,611,80,89,2,1078
51177000203,3824,2795,2286,153,204,51,70,1,509
51071000101,302,242,228,2,0,9,2,2,14
51155000302,771,618,559,7,28,12,8,2,59
51087000110,8005,6379,2584,1183,1874,132,686,10,3795
51087000101,6021,4391,2791,217,495,39,837,2,1600
51087000312,3525,2807,1473,197,562,58,516,2,1334
51087000117,2783,2343,1911,139,152,26,116,2,432
51760000111,2291,1813,1614,86,48,6,48,1,199
51087000203,3856,3008,1640,178,1023,63,128,2,1368
51760000309,1718,1569,1210,37,281,27,9,2,359
51087000407,3101,2617,2002,216,252,29,122,1,615
51101000301,3758,2821,2320,51,332,91,28,5,501
51101000202,2153,1707,1128,16,452,106,9,2,579
51510000208,7002,6126,2680,979,1728,99,751,18,3446
51510000210,3649,2992,1692,467,574,77,259,9,1300
51510000205,5676,4467,2912,529,609,84,344,13,1555
51059000402,1805,1408,669,384,160,34,177,6,739
51083000305,2592,2013,796,18,1172,11,17,2,1217
51115000001,1948,1634,1446,40,84,46,6,6,188
51115000003,3556,2997,2579,49,254,85,33,4,418
51041000515,6061,4480,1085,1036,2207,103,166,9,3395
51041000207,2463,1815,557,283,929,17,31,3,1258
51041000216,5218,3896,882,634,2207,68,150,3,3014
51083000102,942,693,468,9,204,4,0,1,225
51173000301,3328,2682,2479,82,50,54,9,1,203
51173000501,2754,2194,2083,30,14,55,4,2,111
51165000405,3784,2866,2712,74,21,49,4,1,154
51165000304,2907,2257,1953,136,115,36,15,0,304
51165000108,1208,986,927,32,8,17,2,1,59
51165000107,1697,1351,1252,54,20,13,12,3,99
51165000102,2982,2208,1870,217,56,48,25,1,338
51023000302,2996,2495,2352,21,53,41,16,1,143
51019000601,2423,1997,1840,23,62,55,15,4,157
51770000005,4868,3851,2919,234,510,88,104,0,932
51770000004,5350,4119,2383,635,894,97,145,0,1736
51041000504,6059,4583,3860,129,197,32,340,2,723
51041000511,2738,2079,1841,54,63,18,81,4,238
51041000505,3985,3015,2688,80,126,53,49,5,327
51041000507,5330,3991,3543,88,116,39,185,3,448
51037000101,1772,1445,932,46,429,26,5,1,513
51037000702,1436,1164,728,18,402,15,3,0,436
51037000501,1797,1302,955,3,336,10,1,0,347
51037000401,1752,1398,964,48,338,21,11,4,434
51037000201,1515,1263,834,15,399,11,6,4,429
51690000001,1130,882,39,21,818,5,6,5,843
51041000503,4953,3834,2862,154,384,60,380,18,972
51041000518,5180,3845,3122,104,272,55,265,1,723
51041000508,4945,4076,2937,229,594,69,238,7,1139
51041000416,3448,2512,1672,132,396,38,259,1,840
51041000105,8081,5746,1791,2195,1593,170,151,18,3955
51041000214,2253,1567,154,831,565,35,39,0,1413
51195000403,1287,1034,982,10,3,30,2,1,52
51051000301,413,308,300,2,0,6,1,0,8
51740000007,2506,2018,880,102,926,58,81,21,1138
51740000030,2735,2154,1658,79,284,77,40,2,496
51165000505,2858,2269,1973,92,124,56,23,1,296
51023000501,2449,1936,1794,24,58,43,14,1,142
51023000502,4571,3570,3161,167,132,50,59,5,409
51173000602,1310,998,950,11,9,25,2,0,48
51770000018,4874,3879,2201,198,1346,74,74,4,1678
51775000008,1553,1270,942,152,151,20,15,3,328
51173000202,1161,932,900,10,6,13,1,0,32
51173000701,2609,2068,1979,23,17,34,6,0,89
51173000302,948,735,694,2,3,20,3,0,41
51023000202,3336,2641,2462,27,64,46,35,0,179
51087000513,5451,3889,555,111,3188,79,15,0,3334
51087000201,2879,2234,223,58,1891,37,34,0,2011
51087000511,6710,5233,1190,186,3781,83,63,4,4043
51087000220,5336,4104,466,112,3461,77,48,3,3638
51760000604,2364,1889,330,77,1441,28,30,3,1559
51087000515,3453,2662,1975,81,478,56,55,8,687
51520000002,3807,3056,2695,63,188,68,36,4,361
51520000003,4421,3327,2733,63,417,104,16,6,594
51003000302,4287,3312,2736,178,227,62,80,19,576
51139000301,5274,4133,3898,78,50,62,29,1,235
51139000201,4667,3747,3467,60,88,67,35,6,280
51139000401,4343,3467,3296,41,47,52,29,3,171
51047000603,1940,1444,806,336,262,38,22,1,638
51047000602,4285,3344,2544,226,474,48,50,15,800
51630000301,6540,5108,3151,622,1058,109,191,15,1957
51630000402,3620,2669,1124,462,904,61,169,8,1545
51041000209,6558,4914,2748,672,1271,110,144,18,2166
51710000201,7159,6266,3305,295,2073,46,563,7,2961
51710000208,2626,1905,1692,79,58,32,45,1,213
51139000501,4903,3765,3563,77,53,31,29,3,202
51620000601,1439,1101,613,42,412,30,17,1,488
51041000509,3796,3036,1768,267,703,47,253,4,1268
51041000410,2837,2203,1403,220,447,55,91,2,800
51041000110,2910,2292,1343,122,664,37,142,0,949
51041000101,4700,3509,1733,638,969,109,108,3,1776
51109000601,2266,1757,1556,39,91,46,26,4,201
51109000503,1460,1283,1102,31,87,32,15,2,181
51790000201,6336,5064,4002,148,738,105,49,4,1062
51790000501,5186,4467,3402,207,607,104,116,3,1065
51015000405,2497,2032,1881,29,76,27,10,3,151
51091000010,143,124,115,2,3,1,4,3,9
51069000503,6522,5062,3923,661,254,106,122,5,1139
51069000403,4099,3161,2527,245,217,94,70,2,634
51069000404,3815,2745,2259,202,137,46,102,5,486
51069000204,3883,3249,2925,167,58,45,45,0,324
51069000103,3691,2965,2669,132,67,47,44,8,296
51015000103,4671,4372,3803,193,282,72,25,4,569
51790000401,3885,3025,2597,69,266,57,18,0,428
51179000302,8135,5752,2497,1272,1585,205,349,18,3255
51179000301,7885,5652,2055,1614,1533,166,449,32,3597
51179000203,4637,3558,2555,438,317,130,146,23,1003
51179000201,4626,3374,2052,609,456,81,181,18,1322
51179000202,5898,4235,2379,597,884,139,302,17,1856
51179000602,5665,4191,2775,374,773,106,182,9,1416
51179000604,5609,3995,1683,579,1441,113,273,14,2312
51179000501,6549,4844,3552,357,566,181,207,11,1292
51179000502,4726,3493,2359,261,603,110,196,9,1134
51179000601,3951,3053,2512,175,193,93,82,6,541
51179000603,5382,4138,3251,214,327,239,97,5,887
51179000703,8143,5594,3022,726,1382,141,445,22,2572
51179000701,8288,5763,2920,840,1546,133,414,31,2843
51179000702,6373,4431,1871,815,1404,82,317,16,2560
51033000401,3655,3006,1568,78,1250,77,35,3,1438
51085000206,2974,2420,1838,47,430,30,65,4,582
51085000208,2615,2068,1798,53,145,27,52,4,270
51085000202,1699,1369,1081,27,206,42,4,1,288
51033000602,2254,1618,1129,92,312,63,40,5,489
51033000201,2791,2031,1207,122,617,56,30,6,824
51033000202,3243,2401,1742,106,452,56,33,3,659
51033000501,2837,2153,1045,105,939,53,37,2,1108
51710000303,4823,3613,307,133,3124,49,55,13,3306
51710000103,4227,3247,1916,387,674,125,211,16,1331
51710000104,10195,7713,3252,1292,2737,220,405,70,4461
51710000406,2879,2270,1042,212,672,40,326,6,1228
51710000212,3852,2894,634,168,1985,74,86,12,2260
51091000008,482,408,389,4,1,11,2,3,19
51041000408,6413,5021,2533,602,1547,88,270,5,2488
51131000401,2161,1813,1331,136,311,31,15,2,482
51131000101,2797,2337,1790,80,402,30,30,5,547
51131000301,2346,1908,789,160,934,25,7,0,1119
51131000201,2384,1884,816,157,867,28,22,1,1068
51520000001,3749,2983,2575,138,156,72,19,2,408
51191000603,2734,2231,2122,17,21,49,4,1,109
51169000102,1875,1490,1440,7,4,23,9,0,50
51730000401,4991,4157,1087,169,2833,73,45,13,3070
51730000501,4819,3746,508,124,3070,60,54,1,3238
51730000301,5021,4113,980,195,2855,94,78,5,3133
51730000101,5244,3997,824,464,2642,78,65,13,3173
51149000104,7142,5442,2284,1049,1791,97,259,75,3158
51041000412,5910,4485,2920,308,850,137,286,4,1565
51041000402,2662,2062,1233,134,550,49,96,3,829
51041000411,3948,3118,2640,92,237,43,107,3,478
51041000517,3251,1997,1663,73,120,19,101,2,334
51041000319,7094,4758,3623,204,509,59,346,6,1135
51041000417,2948,1996,1512,73,172,24,221,0,484
51041000309,4463,3002,2427,109,221,38,185,5,575
51041000318,1484,1141,791,36,260,15,40,3,350
51041000315,4808,3664,2862,180,459,74,99,6,802
51041000305,1719,1395,1223,53,86,21,17,2,172
51041000211,5495,4474,3382,144,742,65,131,4,1092
51131000501,2636,2115,1286,142,626,41,17,4,829
51660000104,7841,6492,4364,1172,487,94,446,1,2128
51660000101,8403,6118,3231,1706,867,123,304,17,2887
51660000102,3666,2858,1779,722,238,48,105,1,1079
51133000401,2599,2253,1933,31,252,19,9,5,320
51133000501,2504,2194,1869,34,242,35,19,2,325
51133000301,2114,1704,675,40,941,31,20,1,1029
51133000201,2521,2158,1651,57,377,28,29,1,507
51133000101,2153,1805,1318,59,366,28,13,2,487
51119000401,2023,1701,1252,38,336,46,16,0,449
51119000101,778,816,597,24,179,14,2,0,219
51003000504,3564,3037,2264,188,346,28,189,11,773
51003000507,2818,2198,1882,35,102,19,135,4,316
51193000101,2015,1631,664,82,854,21,3,3,967
51041000104,5855,4503,3096,314,935,79,110,7,1407
51041000201,4415,3925,2335,391,1020,122,79,13,1590
51730000601,4055,3084,178,87,2779,38,29,4,2906
51760000306,2481,2241,541,123,1533,37,59,4,1700
51760000204,3393,3132,2507,157,288,39,131,4,625
51760000206,2229,2151,1206,164,531,17,247,7,945
51760000503,3471,3004,1485,106,1316,44,75,6,1519
51760000410,3469,2907,1381,248,1201,38,84,4,1526
51760000414,2534,2171,1775,79,188,34,88,6,396
51760000409,2461,2072,1544,62,361,28,52,9,528
51041000502,2053,1634,1392,55,95,30,58,4,242
51760000413,2247,1963,1612,50,226,28,53,3,351
51760000508,1652,1407,1035,52,258,15,42,2,372
51033000301,1684,1372,797,322,203,21,19,11,575
51033000101,2788,2162,1568,77,436,46,32,15,594
51087000517,1242,1073,767,39,208,31,18,2,306
51087000306,4906,3749,2223,150,361,36,959,3,1526
51087000518,2775,2319,1530,44,642,54,23,2,789
51087000409,3462,2647,2023,152,315,34,114,1,624
51087000505,3683,2943,1482,59,1303,74,39,1,1461
51087000304,2726,2209,1658,117,220,34,157,4,551
51087000401,4126,3330,2511,145,440,38,186,7,819
51087000208,4493,3376,202,186,2964,48,31,2,3174
51087000417,4836,3562,3300,67,63,16,105,9,262
51760000707,4352,3948,2562,264,901,86,162,2,1386
51760000708,5373,5088,2988,305,1312,86,427,13,2100
51760000802,2926,2186,261,119,1777,53,21,1,1925
51033000102,1965,1609,1115,33,385,79,18,5,494
51033000502,2479,1877,1130,106,549,57,57,3,747
51145000202,3177,2401,2156,47,135,43,23,3,245
51730000201,5474,4501,673,162,3518,65,113,16,3828
51145000201,2583,1993,1780,40,94,34,24,6,213
51145000502,1722,1622,982,29,565,24,21,3,640
51003000301,4809,3590,3197,78,107,25,148,2,393
51003000506,4720,3477,2758,230,187,83,219,6,719
51003000106,5516,4199,3005,297,484,54,352,5,1194
51003000502,2011,1596,1416,42,63,23,31,0,180
51037000602,1642,1295,934,12,316,23,11,0,361
51157000301,1462,1220,1064,49,58,17,26,1,156
51157000401,1437,1213,1106,38,26,11,19,4,107
51017000501,801,668,621,3,24,9,8,2,47
51017000201,730,591,499,16,52,14,9,0,92
51017000101,768,644,581,15,39,14,3,1,63
51145000101,2913,2344,2141,33,82,47,19,5,203
51600000005,3392,2631,1483,439,104,36,566,3,1148
51670000601,3275,2390,575,185,1583,46,37,9,1815
51670000401,4009,3106,1477,198,1286,57,110,9,1629
51670000301,3430,2662,1860,196,517,68,43,8,802
51670000701,3036,2288,967,174,1093,44,45,3,1321
51153000304,5804,3899,2274,731,554,114,246,41,1625
51153000312,5190,3817,1068,590,1716,115,414,13,2749
51153000201,3954,2927,874,758,828,75,461,11,2053
51153000215,3762,2772,956,666,789,63,347,16,1816
51153000708,6053,4263,818,591,2451,92,427,19,3445
51153000311,8269,6008,1605,841,2670,118,906,19,4403
51153000710,5981,4238,625,902,2123,112,596,10,3613
51153000712,4136,3149,1210,411,1012,32,536,15,1939
51153000709,6443,4643,887,722,2382,89,664,7,3756
51153000704,6034,4541,909,1178,1851,113,611,11,3632
51153000706,6453,4772,1293,1963,1017,140,512,9,3479
51153000511,5310,3789,1818,390,1005,63,546,14,1971
51153000508,3604,2585,1059,391,795,58,305,29,1526
51193000401,3969,3151,2485,97,424,90,44,1,666
51193000302,1824,1440,848,177,348,52,12,2,592
51099000401,6660,5026,3555,215,1017,143,72,13,1471
51013000019,6480,6031,3691,522,375,64,1406,16,2340
51013000032,1987,1658,1065,180,173,46,224,5,593
51013000009,5813,4921,2577,845,854,122,571,21,2344
51069000502,5985,4455,3580,339,322,101,117,14,875
51790000301,4454,3638,3162,104,283,71,24,5,476
51069000303,5439,4406,3738,357,161,78,77,2,668
51069000202,3224,2586,2447,53,25,42,13,2,139
51069000602,4658,3573,2532,513,357,57,101,7,1041
51840000201,6980,5197,2717,1264,1032,182,93,8,2480
51760000501,3169,2858,1991,157,545,54,112,8,867
51760000607,4603,4377,2511,303,855,42,692,6,1866
51087000405,3990,3179,2720,87,149,33,176,1,459
51087000506,4643,3549,1442,92,1876,51,103,5,2107
51760000706,4890,3734,948,172,2490,88,77,10,2786
51087000413,4757,3533,2634,159,217,52,448,8,899
51087000214,2624,1994,1012,146,671,33,121,15,982
51087000402,4127,3262,2258,315,335,79,281,2,1004
51800000202,2621,2085,1440,43,529,32,39,0,645
51800000601,4663,3504,1556,64,1793,50,27,13,1948
51800000404,3683,2571,173,55,2343,17,10,1,2398
51800000302,5186,3720,692,152,2809,69,53,1,3028
51800000604,3492,2582,1403,87,981,72,75,4,1179
51800000605,2277,1677,96,16,1565,24,4,0,1581
51800000304,4189,3122,1419,136,1440,70,86,4,1703
51183000101,1597,1231,285,30,903,21,3,2,946
51183000402,267,212,39,5,164,1,0,0,173
51183000601,999,845,541,11,284,9,4,0,304
51183000602,548,443,287,14,121,15,7,1,156
51183000301,1606,2962,1181,110,1649,26,7,4,1781
51157000502,858,728,636,36,24,20,2,2,92
51157000101,1393,1198,1060,42,49,25,16,4,138
51157000501,739,571,507,17,16,14,6,2,64
51047000601,932,1444,799,187,418,20,25,10,645
51073000501,4607,3702,3324,85,109,94,58,8,378
51073000401,4421,3535,2877,122,370,76,71,5,658
51073000402,3422,2768,2417,86,165,53,52,6,351
51045000201,965,804,784,5,5,10,0,0,20
51710000506,7445,5623,2729,744,1863,175,238,35,2894
51710000210,4145,3659,2608,246,486,88,258,18,1051
51710000413,5792,4529,1086,280,3026,91,105,14,3443
51710000415,4319,3407,1354,300,1460,88,273,11,2053
51710000510,4810,3797,2581,328,614,126,181,17,1216
51710000511,5134,4005,2299,377,1071,133,186,12,1706
51710000217,4752,3607,1438,420,1450,111,241,6,2169
51003000202,7912,7614,2921,485,962,34,3231,4,4693
51003000201,4982,3961,3093,321,339,52,149,5,868
51003000304,1322,1086,919,47,39,10,53,0,167
51091000005,415,348,335,1,2,6,3,2,13
51069000104,2636,2037,1774,105,98,45,25,2,263
51061000102,4480,3541,2826,307,267,80,67,10,715
51760000703,3028,2374,585,76,1623,42,67,2,1789
51760000702,3196,2490,421,69,1949,59,37,2,2069
51760000609,5837,5247,2273,340,2312,111,323,10,2974
51760000806,6530,4442,470,1556,2359,129,78,12,3972
51760000911,3014,2214,193,334,1622,62,68,5,2021
51760000910,5165,3851,451,1424,1966,72,22,5,3400
51025000401,2567,3309,1016,104,2191,13,13,6,2293
51025000303,628,507,259,5,236,4,4,1,248
51029000601,2172,1722,896,17,762,29,14,1,826
51029000401,2420,1811,1251,39,477,18,26,1,560
51029000102,507,386,295,10,70,6,8,3,91
51029000701,2352,2036,1123,69,846,11,3,1,913
51029000502,1356,1083,841,24,182,20,9,1,242
51029000101,2038,1631,961,19,616,34,2,0,670
51111000301,799,643,474,25,134,6,6,1,169
51111000601,1558,1177,494,85,573,16,7,0,683
51111000302,994,763,518,23,209,10,5,1,245
51019000403,4793,3885,3242,165,278,50,131,1,643
51680000401,6953,5693,4063,257,1012,124,234,5,1630
51680000101,6908,5480,3225,315,1720,108,164,7,2255
51680000102,4843,3691,3177,84,265,39,117,4,514
51680000204,1852,1470,831,21,574,38,15,2,639
51680000103,3118,2456,2249,27,90,44,39,0,207
51680000301,2739,2138,1179,107,748,55,44,3,959
51680000202,6011,4821,1709,164,2829,97,60,16,3112
51183000502,473,378,149,10,213,5,1,0,229
51183000501,950,773,302,8,446,18,2,1,471
51045000403,561,466,430,7,1,16,5,2,36
51071000303,1413,1177,1122,6,10,28,4,0,55
51710000218,5055,4124,2964,254,626,76,211,9,1160
51710000215,3455,2833,1676,163,816,85,131,7,1157
51710000305,3365,2697,817,195,1607,73,72,5,1880
51087000418,3186,2403,1542,124,498,33,194,7,861
51087000514,4907,3713,482,82,3124,45,24,2,3231
51087000516,5024,3868,1253,108,2428,93,45,2,2615
51087000212,1318,1115,573,37,428,26,60,0,542
51087000411,5233,3775,1881,623,749,63,475,8,1894
51087000106,5360,5102,2537,573,1463,99,460,17,2565
51087000404,2322,1867,1630,84,52,26,54,4,237
51760000101,2822,2654,1851,210,223,21,326,2,803
51087000415,2849,2156,1024,329,285,48,444,7,1132
51087000314,4558,3643,2526,305,365,76,341,7,1117
51087000309,5846,3912,1997,140,269,31,1445,3,1915
51093000401,1382,1079,884,8,161,26,6,0,195
51093000504,2175,1747,1378,32,250,57,23,2,369
51087000213,2926,2099,621,116,1007,34,329,1,1478
51087000211,1625,1258,127,46,1076,17,13,2,1131
51087000224,2011,1147,49,10,1079,15,6,0,1098
51760000606,3076,2478,420,65,1954,45,25,4,2058
51760000304,2622,2114,457,75,1566,33,23,0,1657
51087000301,4245,3184,1945,159,352,40,672,1,1239
51087000305,4810,3557,3003,98,107,16,298,6,554
51073000302,4414,3434,2871,93,302,98,52,12,563
51073000201,2927,2454,2067,64,236,53,42,5,387
51073000502,3742,2926,2409,98,278,85,51,9,517
51045000303,395,311,296,4,0,11,1,0,15
51710000304,2648,2016,452,135,1259,52,148,13,1564
51710000405,6035,4992,192,172,4574,90,73,0,4800
51001000803,1009,846,662,54,114,21,2,0,184
51001000901,3773,2947,1317,198,1347,43,15,3,1630
51660000103,7132,6136,4209,879,537,104,464,14,1927
51025000302,1314,1035,575,11,426,19,7,1,460
51025000301,38,242,127,3,101,8,6,1,115
51025000501,3135,2574,771,49,1723,16,11,5,1803
51191000401,3091,2409,2256,17,70,44,11,1,153
51059000710,4781,3742,1531,947,207,81,998,3,2211
51059000525,7282,5595,1981,1965,219,118,1362,10,3614
51059000618,7963,6023,2802,1069,824,108,1271,30,3221
51059000411,3644,2827,1416,785,295,64,302,5,1411
51059000408,4920,3786,1638,1061,737,51,330,10,2148
51059000428,6867,5056,829,2125,1574,101,554,15,4227
51059000413,6663,4726,469,2177,1738,135,371,11,4257
51059000713,5981,4456,1698,1202,361,79,1164,2,2758
51710000203,2034,1745,1283,102,158,20,169,6,462
51710000211,5855,5578,3934,373,666,69,556,14,1644
51760000412,3561,3025,1168,220,1462,49,162,4,1857
51760000404,3960,3314,1609,191,1353,98,87,8,1705
51760000909,4000,3052,663,349,1981,94,57,3,2389
51760000207,3249,3013,2646,129,98,27,95,10,367
51760000504,5111,4626,2918,261,1091,53,335,10,1708
51143000204,1192,989,843,17,106,17,2,0,146
51143000108,1067,853,642,17,174,17,6,0,211
51143000307,2083,1597,457,33,1076,21,11,0,1140
51143000704,4214,3275,2518,94,554,73,38,3,757
51143000405,3640,2923,2203,49,604,51,14,2,720
51001000202,2890,2441,2165,58,124,63,23,0,276
51001000201,1519,1222,891,104,191,33,14,1,331
51001000301,3590,2786,1302,70,1331,55,33,1,1484
51021000301,681,543,530,2,7,4,1,1,13
51021000401,1471,1251,1155,18,50,20,7,2,96
51021000202,1364,1131,1080,11,14,19,8,1,51
51021000201,285,253,250,0,2,1,0,0,3
51710000409,3547,2881,1390,237,1002,62,254,13,1491
51710000411,3224,2714,198,80,2422,37,26,7,2516
51710000310,6773,5115,658,509,3812,95,153,17,4457
51710000504,3958,3206,1456,404,1109,84,239,12,1750
51710000507,5419,4310,2553,399,1071,109,198,30,1757
51073000101,2854,2266,1884,59,197,84,38,6,382
51021000102,806,661,641,1,1,15,3,0,20
51710000309,8065,6064,1942,470,3226,174,323,56,4122
51710000214,4180,3558,2309,188,846,63,160,2,1249
51710000101,6708,5479,2750,502,1947,140,238,24,2729
51710000106,17815,16422,7586,3089,4387,474,1336,175,8836
51710000306,2813,2136,485,95,1513,53,45,7,1651
51183000302,300,253,212,1,27,4,3,0,41
51183000401,1185,957,370,11,556,13,3,1,587
51087000512,2349,1750,806,72,808,44,20,0,944
51760000215,2690,2585,1911,112,373,33,169,2,674
51091000001,763,654,634,9,2,9,5,3,20
51790000101,6135,4811,3568,235,775,112,134,1,1243
51087000509,4027,3083,856,283,1829,66,81,5,2227
51087000408,4194,3324,2166,227,738,36,161,0,1158
51075000402,2571,2297,1886,89,151,26,124,1,411
51075000502,2254,1926,1597,48,90,27,160,2,329
51159000401,1560,1243,991,37,176,27,12,1,252
51159000101,1538,1198,608,38,528,18,13,1,590
51001000502,1922,1388,348,296,738,42,6,2,1040
51001000501,1806,1347,515,285,531,43,13,0,832
51001000601,2898,2336,1312,328,629,58,28,0,1024
51143000501,3288,2627,2016,39,514,42,20,1,611
51001000403,411,344,313,11,17,6,4,0,31
51670000501,3025,2333,1468,163,600,71,42,5,865
51670000201,3103,2186,495,120,1521,40,17,1,1691
51075000501,3344,2841,2371,88,264,30,75,0,470
51075000301,2331,2088,1682,54,299,22,13,0,406
51075000401,3268,2621,2092,101,350,28,36,4,529
51075000302,1268,1398,1096,42,203,33,20,1,302
51570000003,3693,2846,1933,159,567,80,113,6,913
51169000504,1270,1049,1007,6,7,20,4,2,42
51660000202,7043,5362,3515,1155,418,133,212,12,1847
51660000203,5408,4468,2870,963,411,75,241,8,1598
51660000201,6535,5183,3368,1242,423,95,129,7,1815
51165000202,4975,3751,3040,549,89,53,45,9,711
51059000717,3347,2651,1413,311,166,48,704,4,1238
51059000309,5058,3913,2387,146,136,31,1193,10,1526
51059000323,3178,2371,1440,100,73,9,733,3,931
51059000106,10666,7932,1395,3606,611,253,2316,17,6537
51059000235,5690,4209,1292,232,415,23,2237,8,2917
51059000332,10075,8124,2430,847,1781,112,3040,27,5694
51059000229,6061,4574,3081,246,191,68,969,8,1493
51059000616,4065,3100,1665,290,668,62,443,11,1435
51059000613,9709,6296,4344,655,768,136,421,35,1952
51059000219,5519,4222,2494,241,186,29,1232,3,1728
51059000721,7156,6421,3473,505,535,105,1832,19,2948
51059000723,4855,3865,1320,835,279,65,1422,9,2545
51059000718,4387,3396,1385,809,302,53,874,15,2011
51059000712,1942,1465,993,156,51,31,209,5,472
51059000708,9595,7476,3511,1206,459,72,2232,9,3965
51059000614,2856,2259,1652,260,149,44,180,11,607
51059000827,3716,2758,1882,287,194,43,352,3,876
51169000503,563,453,444,1,0,7,0,0,9
51171000202,3529,2746,2259,340,82,69,25,1,487
51171000103,5349,4272,3666,376,101,80,69,5,606
51171000601,7737,5899,5010,297,307,151,99,3,889
51171000504,2814,2221,2074,61,31,29,12,1,147
51540000101,5220,4298,3389,226,395,73,192,6,909
51540000202,5560,4188,3274,191,351,57,313,1,914
51540000201,5165,4271,2506,226,1089,41,413,6,1765
51059000128,3849,3073,1572,568,303,57,600,2,1501
51059000511,3633,2920,1825,371,206,39,471,2,1095
51059000502,1721,1357,1052,132,17,17,127,5,305
51059000512,2108,1673,1014,329,44,18,257,4,659
51059000931,5509,3995,1731,224,312,37,1703,7,2264
51059000905,1231,903,637,61,33,9,168,0,266
51059000927,3213,2405,858,167,123,34,1232,1,1547
51059000629,5116,4047,2129,361,738,40,794,14,1918
51059000628,7657,5513,1320,536,1578,80,2085,36,4193
51153000504,3119,2517,1427,472,381,51,206,11,1090
51059000208,7345,6117,3406,873,712,113,1039,20,2711
51059000238,5593,5199,3734,343,342,55,728,9,1465
51059000916,5744,4294,3206,203,97,50,732,4,1088
51059000911,5304,3950,1971,220,229,30,1489,5,1979
51059000920,4734,3538,1402,212,227,29,1662,2,2136
51059000914,3080,2277,1722,111,43,23,368,1,555
51059000851,3946,2981,1641,191,148,23,951,8,1340
51059000802,2543,2187,1055,194,252,27,663,10,1132
51059000848,6063,4721,1747,316,451,40,2170,13,2974
51059000926,10245,7904,2217,759,643,83,4263,10,5687
51059000131,6019,4716,2414,455,451,51,1369,13,2302
51059000427,4265,3111,1589,284,644,51,579,19,1522
51059000929,917,713,554,41,24,9,86,1,159
51059000304,3096,2387,1596,99,90,24,563,5,791
51059000318,2099,1516,964,74,53,14,401,5,552
51059000316,1299,964,716,48,40,7,146,1,248
51059000521,4044,3311,1227,757,262,52,1033,6,2084
51710000207,6789,5825,1844,285,3417,87,266,38,3981
51171000303,2776,2220,2060,96,29,41,5,2,160
51171000201,3399,2710,2553,71,29,43,15,1,157
51540000402,4575,4025,2801,264,371,52,543,3,1224
51540000401,3842,3565,2693,201,294,24,356,10,872
51015000502,1488,1183,1100,22,26,25,7,0,83
51015000504,4619,3539,3227,53,126,88,23,4,312
51015000501,3407,2827,2579,40,144,42,10,0,248
51191000101,5446,5223,4835,61,148,93,84,1,388
51191000202,2839,2260,2186,30,7,20,9,2,74
51191000502,2428,1928,1816,27,17,63,5,3,112
51191000501,4552,3620,3477,39,16,66,16,4,143
51029000501,1122,861,628,31,186,14,4,2,233
51029000201,1013,2192,1013,69,1083,21,12,5,1179
51087000502,1882,1523,367,57,1076,28,16,5,1156
51085000403,4519,3510,2907,97,327,98,76,4,603
51087000501,2342,1977,1655,38,206,58,16,0,322
51087000105,5210,4135,2624,456,681,99,283,8,1511
51710000301,4824,3626,804,270,2461,71,96,18,2822
51710000313,2312,1677,85,64,1513,31,22,6,1592
51710000102,3383,2886,1797,298,621,118,116,20,1089
51710000213,4157,3591,2813,179,349,63,180,17,778
51073000103,1893,1469,1227,41,133,49,11,1,242
51073000301,3415,2760,2350,64,235,70,47,2,410
51073000102,2605,2111,1669,69,260,84,37,1,442
51021000302,454,914,785,4,123,6,1,2,129
51710000311,7963,6222,2462,507,2692,162,522,29,3760
51045000301,624,483,469,6,0,7,0,0,14
51045000101,953,765,733,5,4,15,2,1,32
51530000002,3328,2716,2272,110,197,94,34,26,444
51163000102,1208,993,904,26,19,33,9,0,89
51530000001,3369,2638,2372,58,106,92,15,3,266
51550000004,3396,2619,2077,94,273,65,113,9,542
51550000027,3846,2870,1790,99,732,55,218,20,1080
51550000035,3143,2380,961,98,1156,59,127,13,1419
51550000001,4086,4006,2764,198,831,92,132,12,1242
51550000037,4443,3263,2672,125,296,50,120,8,591
51550000060,3842,2793,2230,86,247,67,133,6,563
51550000051,6161,4427,3373,255,441,97,269,12,1054
51550000036,4192,3083,2332,143,328,82,201,14,751
51550000034,4767,3575,2936,175,243,75,151,9,639
51550000043,3323,2581,2148,89,169,60,99,5,433
51067000301,1506,1204,1081,12,79,26,1,0,123
51149000202,3196,2517,1780,105,563,57,39,8,737
51149000203,1126,903,694,15,170,21,7,2,209
51179000102,4604,3807,2570,290,701,105,169,14,1237
51179000104,6687,4722,2990,434,917,102,262,21,1732
51179000503,5610,4189,2509,518,867,109,178,16,1680
51179000103,6139,5486,3321,579,1345,141,199,18,2165
51650000202,5098,4228,2656,228,1172,121,107,19,1572
51650000110,1313,1013,530,51,381,32,37,7,483
51650000112,6108,4676,1779,232,2494,135,141,17,2897
51650000210,8166,6287,1984,427,3477,151,326,40,4303
51063000401,3068,2455,2299,67,30,27,16,9,156
51063000501,3002,2382,2265,34,22,47,11,2,117
51650000101,4085,3333,699,201,2305,65,121,15,2634
51179000402,9235,6391,2463,1012,2422,192,445,28,3928
51121000301,4430,3399,3008,150,97,94,31,6,391
51121000304,4382,3351,2897,99,202,79,69,5,454
51121000103,5612,4537,3463,193,296,82,502,4,1074
51121002032,2273,1767,1402,114,121,35,92,2,365
51121000202,5779,4615,3831,175,414,116,77,11,784
51121000201,627,505,457,17,6,15,10,2,48
51121000101,3394,2690,2407,46,51,41,115,6,283
51121000102,4612,4189,3321,218,172,39,416,10,868
51121000204,5214,4125,3422,147,258,71,214,0,703
51121000405,3958,3185,2713,86,222,67,89,3,472
51027000103,2168,1708,1692,3,4,9,1,0,16
51830000001,8480,7500,4198,637,2093,164,474,28,3302
51830000002,6670,6410,2571,255,3431,74,111,6,3839
51199000101,3152,2419,1841,97,288,56,141,10,578
51105000404,1634,1270,1228,6,4,21,6,1,42
51105000501,1069,822,804,1,6,5,1,0,18
51179000101,7999,5892,4375,440,694,156,228,15,1517
51179000404,3873,2832,1932,359,344,74,141,20,900
51179000401,3112,2201,690,360,997,61,131,6,1511
51179000204,5725,4295,2810,384,769,126,261,8,1485
51550000031,6825,4823,1095,824,2803,140,92,0,3728
51550000011,5671,4104,2229,627,1081,136,90,16,1875
51550000046,3561,2574,1834,131,441,55,126,6,740
51550000033,2975,2356,1416,319,434,102,128,1,940
51111000401,526,426,331,4,78,6,4,0,95
51019000205,2420,2115,1938,40,59,42,18,5,177
51019000701,3352,2591,2280,58,130,53,60,2,311
51019000504,1584,1309,1171,14,96,14,7,0,138
51135000501,3016,2384,1416,102,809,43,39,2,968
51135000401,1714,1252,363,63,804,20,9,0,889
51015000303,2161,1677,1597,40,21,11,6,3,80
51015000302,1471,1134,1018,78,7,20,1,0,116
51027000403,2117,1633,1552,11,33,22,17,4,81
51027000302,1522,1296,1243,10,9,14,17,7,53
51027000202,1211,984,975,5,4,1,0,1,9
51027000701,1614,1329,1274,10,9,25,6,3,55
51027000301,1521,1220,1177,2,11,23,1,0,43
51105000503,265,218,215,0,0,1,1,0,3
51121000302,3352,2644,2384,42,111,52,45,0,260
51121000502,2595,2052,1832,38,83,52,34,5,220
51027000201,258,201,195,2,1,1,4,1,6
51027000502,403,351,342,4,0,2,0,0,9
51097000401,1386,1134,740,29,322,35,11,2,394
51171000304,1532,1243,1121,38,10,41,33,0,122
51760000602,4300,3133,170,56,2883,37,12,5,2963
51760000603,2871,2323,432,51,1796,51,29,1,1891
51760000213,5712,5325,2358,477,2005,78,455,15,2967
51760000811,4151,3194,494,292,2368,62,42,3,2700
51181000401,1358,1126,546,16,541,23,6,6,580
51135000101,2159,1810,1082,68,633,36,11,2,728
51135003012,922,2013,668,90,1256,15,6,5,1345
51135000202,710,544,422,12,109,7,0,0,122
51135000402,1352,1061,765,31,238,31,1,0,296
51121004031,3407,2629,2441,73,56,55,10,0,188
51105000302,2911,2576,1403,313,813,51,12,2,1173
51095001042,1743,1415,1109,68,124,34,69,8,306
51095000201,1657,1279,863,102,222,20,67,0,416
51089000601,2682,2129,1485,85,500,33,27,0,644
51089000103,3905,3116,2631,88,338,48,3,0,485
51089000302,1625,1239,619,133,472,18,7,0,620
51089000303,3118,2464,1483,161,758,45,28,1,981
51089000401,1855,1470,1064,169,204,26,7,0,406
51191000301,3676,2921,2793,25,12,48,31,0,128
51191000701,2964,2405,2278,46,20,43,16,2,127
51171000503,4265,3396,3080,152,56,68,25,1,316
51187000102,4537,3579,3252,85,72,95,44,3,327
51171000401,7805,5951,4769,673,300,125,99,3,1182
51135003011,521,462,272,2,177,10,1,0,190
51135000201,2426,1795,1082,121,564,39,10,1,713
51135000102,1072,837,595,12,210,21,2,2,242
51059000602,3015,2591,2058,187,171,44,133,6,533
51059000921,4826,3764,2157,436,237,67,902,9,1607
51059000311,2770,2046,1451,120,25,7,416,6,595
51059000303,2192,1565,971,74,36,8,461,1,594
51059000301,5029,3892,2801,222,76,29,722,4,1091
51059000422,5677,4534,2019,529,1167,69,772,3,2515
51036000201,2225,1876,640,37,884,319,12,6,1236
51191000504,344,282,264,1,0,12,5,0,18
51191000302,4213,3413,3161,46,102,71,26,3,252
51191000703,3449,2796,2627,53,34,56,23,6,169
51191007022,1176,944,906,12,5,13,6,2,38
51153000502,3308,2638,1324,466,512,49,308,16,1314
51153000512,6265,4734,1304,1192,1556,108,699,16,3430
51153000607,6389,4587,1079,1639,1264,144,613,6,3508
51051000101,2978,2317,2234,11,14,42,11,3,83
51051000201,1096,851,824,6,3,21,1,1,27
51051000203,1304,1026,976,4,20,16,2,3,50
51051000303,1591,1270,1242,6,0,14,2,1,28
51153000604,5342,4038,917,1444,1113,99,571,6,3121
51153000605,4963,3681,1035,1523,685,87,412,11,2646
51153000610,6315,4606,1046,1244,1718,108,578,21,3560
51153000407,4713,4405,3554,162,246,44,393,4,851
51153000409,5821,4193,2148,626,600,63,797,18,2045
51153000406,2033,1819,1511,75,94,12,129,0,308
51153000413,7053,4978,3125,382,509,75,891,6,1853
51153000410,5868,4155,2476,316,522,58,771,1,1679
51153000401,3899,3118,2551,199,127,62,141,11,567
51153000204,7091,5255,1756,2447,540,232,461,8,3499
51153001061,8089,5718,1315,2854,880,240,632,18,4403
51153000310,4111,3032,985,404,1275,70,372,10,2047
51540000102,6425,4998,3244,407,955,98,305,2,1754
51171000501,304,250,205,11,10,11,4,0,45
51033000302,3278,2608,1771,110,620,72,35,4,837
51069000301,2734,2193,1991,74,41,61,30,1,202
51191000402,4418,3703,3432,55,123,55,18,3,271
51013000034,3671,2518,2053,140,76,13,215,5,465
51153000707,5644,4205,1122,1948,733,132,399,17,3083
51015000201,5132,4013,3648,93,154,76,20,0,365
51015000801,2736,2181,2071,30,42,24,11,0,110
51015000404,627,532,520,1,3,5,2,2,12
51015000601,2514,1976,1800,34,82,37,17,4,176
51015000304,1690,1344,1272,14,20,19,14,1,72
51015000402,1844,1513,1454,10,16,24,5,1,59
51153000108,7875,5324,2664,727,991,69,923,6,2660
51153000102,6596,4616,2815,559,565,79,629,20,1801
51109000501,1410,1163,824,23,281,30,8,1,339
51061000402,3106,2597,2148,164,204,35,28,8,449
51061000403,3967,3184,2745,139,168,53,63,8,439
51061000404,1918,1529,1277,70,133,26,20,3,252
51061000203,4645,3618,2592,309,542,70,122,5,1026
51047000501,3596,2838,2352,181,201,45,40,2,486
51061000303,6876,4899,3074,961,645,156,134,10,1825
51061000301,3722,2776,2106,394,156,101,27,1,670
51650000205,6031,4793,3507,194,795,130,177,6,1286
51650000117,4518,3204,1028,179,1825,85,150,22,2176
51650000105,5002,4451,836,139,3421,69,67,9,3615
51650000104,9234,7792,2092,606,4674,170,368,53,5700
51650000214,6091,4852,2153,296,2237,92,173,12,2699
51127000201,3034,2378,1806,68,345,85,60,5,572
51127000403,1518,1186,956,42,101,57,14,3,230
51127000401,3106,2419,1886,59,348,62,51,3,533
51153000303,4430,3217,806,849,1339,89,202,18,2411
51153000506,7122,5146,1816,1547,961,141,790,16,3330
51153000302,5450,3805,618,789,1644,63,794,17,3187
51153000601,6031,4192,758,1816,1174,118,433,12,3434
51153000403,4651,3182,1775,338,420,45,631,10,1407
51153000412,2918,2187,1661,163,97,45,204,7,526
51059000923,3178,2489,1594,135,138,23,594,4,895
51153000402,5318,3826,2893,267,281,62,310,15,933
51153000101,3875,2901,2283,296,100,76,132,3,618
51191000102,2696,2186,1960,46,98,49,36,1,226
51191000204,2171,1730,1628,26,16,45,16,1,102
51089000501,1417,1118,724,51,319,17,6,3,394
51089000503,2977,2367,2031,135,132,36,19,1,336
51089000201,1575,1265,914,22,310,14,3,0,351
51153000112,6523,4593,2489,435,704,80,910,7,2104
51153000110,4788,3582,1840,418,576,85,712,9,1742
51153000109,6137,4479,2136,726,748,90,813,11,2343
51153000111,3057,2130,1312,263,205,41,291,0,818
51640000001,3507,2676,1930,455,212,67,32,7,746
51067000201,3430,2692,2407,100,149,36,11,0,285
51067000303,3169,2435,1743,155,488,52,9,0,692
51149000103,2985,2367,1484,78,698,55,62,13,883
51550000021,4061,3144,1911,171,884,65,153,4,1233
51550000038,3198,2434,1956,72,245,67,86,4,478
51550000020,3923,2946,1883,111,721,44,197,7,1063
51067000102,3554,2947,2652,54,137,59,29,1,295
51067000204,1997,1608,1476,22,53,46,1,0,132
51067000602,3047,2439,2210,48,92,62,11,2,229
51067000701,3451,2768,2127,82,447,56,48,1,641
51013000013,3316,2634,1199,605,293,87,518,9,1435
51153000211,4634,3548,1777,597,524,86,614,5,1771
51153000212,11083,7953,2173,3545,876,186,1301,10,5780
51025000304,623,498,280,9,204,5,3,0,218
51143000301,2028,2422,1097,57,1244,16,6,3,1325
51143000105,1600,1368,1117,56,165,4,18,1,251
51159000201,1783,2168,1204,163,783,9,17,8,964
51159000301,1495,1525,1010,51,441,10,19,7,515
51001000802,1921,1514,744,77,671,8,17,1,770
51001000701,3720,3012,2086,196,641,46,39,7,926
51550000029,3491,2763,2014,166,362,94,146,17,749
51550000022,3091,2338,1618,152,400,78,105,5,720
51550000032,6031,4299,509,200,3563,62,62,2,3790
51550000008,5779,4299,2212,435,1419,171,135,16,2087
51550000026,2761,1937,827,112,887,66,54,5,1110
51550000005,4152,2972,494,176,2175,56,147,10,2478
51061000501,3292,2705,2218,267,131,34,50,4,487
51061000503,2901,2331,2012,106,94,47,70,3,319
51059000803,5676,4523,3512,222,103,71,573,12,1011
51153000510,2516,1966,1479,188,117,58,150,2,487
51059000918,8269,6602,2610,1031,550,82,2344,23,3992
51059000925,3071,2290,918,379,270,40,715,5,1372
51059000132,8357,6708,3152,566,907,50,2059,12,3556
51059000121,3353,2532,1191,461,202,76,604,3,1341
51059000730,6503,5052,2384,492,413,54,1715,11,2668
51059000705,6681,4893,2036,1841,242,138,755,0,2857
51059000420,6819,5288,2740,611,1210,83,692,20,2548
51059000410,7218,5570,2795,919,863,127,953,22,2775
51710000402,3259,2320,92,76,2166,30,23,5,2228
51191007021,354,296,270,5,1,13,6,1,26
51191000601,3724,2947,2829,35,29,46,0,2,118
51520000041,5402,4358,4003,51,140,89,76,5,355
51191000203,1006,809,784,11,4,8,3,0,25
51015000203,3918,3019,2587,253,68,84,40,3,432
51031000502,2901,2276,1788,33,395,46,12,1,488
51031000302,1432,1169,977,18,140,20,12,1,192
51031000301,1595,1323,1056,34,192,22,10,2,267
51031000702,3539,2734,2002,27,648,39,5,1,732
51031000303,4555,3545,2487,64,914,63,34,3,1058
51600000003,5278,4320,2416,559,249,82,1037,2,1904
51099000301,6543,4869,3225,272,1053,140,195,24,1644
51143000207,3628,2991,2346,35,556,41,20,0,645
51143000308,945,760,373,14,363,12,3,0,387
51143000309,1181,896,519,13,348,11,2,1,377
51143000502,3295,2673,2113,27,500,37,9,0,560
51143000503,1729,1409,1074,19,290,13,6,1,335
51143000402,1986,1563,1333,38,156,24,7,1,230
51013000049,3318,3026,2081,275,213,55,438,5,945
51013000011,2839,2084,1583,162,60,25,247,3,501
51059000842,3133,2399,1451,181,121,30,634,14,948
51059000833,4952,3758,1632,705,354,59,1039,12,2126
51059000104,3433,2541,1701,233,86,23,481,2,840
51127000301,1987,1633,1091,27,446,31,20,3,542
51127000103,3157,2436,2140,66,142,66,18,5,296
51127000302,3127,2488,1666,78,608,77,39,14,822
51840000101,3911,3179,2712,119,153,40,146,5,467
51059000110,7476,5738,2190,1526,308,112,1653,4,3548
51059000115,2681,2013,995,330,69,51,584,2,1018
51059000910,7078,5319,1804,1326,607,114,1528,22,3515
51059000924,4864,3679,909,1133,490,138,1124,15,2770
51059000317,3405,2494,1620,181,100,46,554,9,874
51610000003,5109,3979,2948,273,179,43,514,4,1031
51059000327,4645,3624,2264,293,217,33,784,14,1360
51059000321,5399,4161,2825,343,246,35,679,12,1336
51059000849,6478,4774,3326,299,208,46,886,18,1448
51059000901,5596,4480,1733,592,489,95,1641,6,2747
51059000415,5117,3994,1208,1428,179,84,1177,4,2786
51059000903,5796,4563,2654,522,382,68,939,2,1909
51059000510,3487,2774,1155,756,210,80,631,9,1619
51103000201,2060,1689,787,21,847,17,18,7,902
51103000101,2171,1843,1447,12,344,27,9,0,396
51109000602,2645,2071,1716,38,255,50,13,2,355
51019000101,3751,3086,2858,82,69,47,18,2,228
51019000104,2480,1987,1895,27,20,34,9,0,92
51019000602,3072,2443,2317,10,24,53,14,0,126
51019000502,1080,831,708,7,87,20,4,0,123
51019000506,4850,3584,3154,85,171,67,63,3,430
51680000303,2767,2222,1506,109,525,60,31,5,716
51680000203,2272,1573,385,42,1099,54,19,0,1188
51181000302,627,526,249,0,260,11,5,0,277
51059000846,6347,5043,2437,607,613,58,1379,7,2606
51059000930,3217,2343,1485,156,95,24,567,4,858
51019000503,1128,939,820,11,81,12,4,0,119
51111000701,746,583,372,12,183,11,2,0,211
51111000402,1231,967,716,15,205,26,3,2,251
51143000404,3288,2575,2032,40,440,40,19,1,543
51001000801,1156,934,778,43,90,17,5,3,156
51680000105,2162,1712,1418,55,158,33,41,4,294
51680000201,7744,5819,2112,172,3420,125,40,8,3707
51550000010,2413,1841,1112,118,520,67,51,2,729
51067000402,2592,2176,1760,127,224,31,49,17,416
51067000501,1959,1542,1318,58,122,29,14,0,224
51051000401,2733,2411,2352,20,15,21,6,5,59
51550000009,5409,3901,3109,173,370,97,152,14,792
51550000014,5747,4391,3179,202,635,86,288,35,1212
51550000030,2243,1622,163,81,1347,49,20,7,1459
51109007011,2788,2153,1822,22,241,40,19,3,331
51109007012,14,6,0,1,2,4,0,0,6
51059000720,4174,3111,2051,255,113,48,648,2,1060
51059000815,3384,2704,2030,106,81,14,444,8,674
51059000805,1956,1512,1161,85,48,12,193,2,351
51059000130,3419,2535,1586,318,153,22,448,6,949
51059000627,10293,7402,2346,1855,2230,188,930,64,5056
51059000214,4641,3359,2374,244,111,29,599,8,985
51059000711,3472,2570,1437,294,145,33,660,1,1133
51059000406,3348,2520,1860,196,248,36,195,9,660
51059000726,7533,6336,2797,722,555,63,2226,10,3539
51059000731,8193,7243,3542,529,610,70,2485,19,3701
51800000702,4970,4019,2313,152,1272,45,253,3,1706
51800000104,4918,3479,1951,193,1082,72,182,16,1528
51800000501,4425,3399,2395,88,806,74,43,4,1004
51800000401,2227,1794,1186,57,458,53,30,4,608
51800000504,4054,3251,2520,85,574,57,46,3,731
51800000603,1660,1979,858,77,1006,23,28,4,1121
51800000204,4581,3348,1421,184,1532,88,135,16,1927
51800000203,5132,3915,1727,139,1886,81,104,6,2188
51710000404,4012,2625,176,78,2332,43,36,3,2449
51067000304,1026,810,579,14,200,13,7,0,231
51067000603,1924,1550,1437,17,44,32,9,0,113
51027000603,728,596,584,1,2,4,1,0,12
51027000102,850,653,644,0,0,8,1,0,9
51027000501,1372,1121,1105,7,2,7,4,1,16
51105000502,2226,1664,1598,2,11,34,10,1,66
51105000301,2704,2179,2074,18,35,38,17,6,105
51105000203,2329,1821,1780,10,2,16,3,0,41
51105000401,972,773,735,3,2,22,4,1,38
51105000103,2234,1786,1725,15,4,30,3,1,61
51027000503,1083,879,863,3,2,10,0,1,16
51027000601,837,672,664,2,0,5,0,0,8
51169000502,907,730,690,5,3,14,0,1,40
51169000302,891,725,715,2,2,2,4,0,10
51169000204,449,364,350,1,1,9,2,0,14
51169000603,511,414,392,5,3,13,1,0,22
51580000401,1189,958,871,15,40,17,7,3,87
51580000301,1168,867,545,29,263,14,10,5,322
51061000302,4770,3625,2685,377,410,111,47,6,940
51800000502,3973,3095,2223,74,686,113,27,3,872
51111000101,1395,1073,827,8,206,24,4,5,246
51111000502,891,723,276,15,420,16,2,1,447
51111000702,1232,1722,892,48,743,18,17,6,830
51019000305,1309,1052,922,12,96,20,3,0,130
51019000704,4711,3744,2864,96,664,86,36,2,880
51019000604,4348,3449,2746,46,525,96,29,4,703
51680000403,6728,5696,3971,247,1188,98,190,11,1725
51031000701,2690,2093,1514,20,522,23,0,1,579
51111000501,650,516,273,6,227,7,2,2,243
51019000302,2441,1992,1736,29,182,32,6,0,256
51019000201,1339,1084,907,22,124,25,9,0,177
51680000304,2870,2208,1362,132,598,25,77,8,846
51680000302,7098,7063,5713,504,379,23,225,12,1350
51059000845,5063,3919,2714,214,236,60,685,5,1205
51153000514,5266,3886,1849,814,785,73,438,13,2037
51750000002,3238,2530,2085,75,276,46,48,2,445
51031000202,4604,3472,2922,82,307,70,82,5,550
51031000102,4518,3547,2828,116,429,71,97,3,719
51179000303,2972,2215,1498,258,284,91,108,8,717
51111000201,1258,986,624,73,263,24,5,1,362
51019000203,3513,2968,2695,51,132,46,22,0,273
51019000202,2006,1607,1400,37,111,46,8,2,207
51019000204,1315,1019,913,19,72,12,2,0,106
51019000103,2695,2166,1947,28,116,59,14,2,219
51019000306,2014,1593,1347,39,101,29,65,4,246
51019000301,3357,2504,2174,52,150,50,67,1,330
51019000303,1414,1098,974,16,67,19,6,0,124
51031000501,5618,4471,3466,199,607,73,109,2,1005
51179000403,6910,5242,3429,550,917,131,273,19,1813
51169000501,825,660,610,19,1,15,0,1,50
51169000202,1229,981,947,8,2,16,2,0,34
51169000401,3728,3002,2819,27,67,63,8,3,183
51169000101,1749,1459,1404,11,8,24,10,1,55
51121000501,5991,5003,3987,258,317,93,356,2,1016
51121000602,6581,5664,3804,314,249,58,1232,9,1860
51121000601,6028,5227,3544,248,178,75,1154,11,1683
51121000503,7066,7026,4726,458,491,11,1396,1,2300
51105000101,1018,870,851,3,1,12,0,0,19
51121000603,2861,2853,1948,191,126,9,594,2,905
51149000205,11171,10404,3990,1331,4635,217,346,49,6414
51149000201,4756,3809,2545,201,859,79,111,19,1264
51145000102,1937,1656,1485,18,85,30,19,5,171
51145000401,4353,3369,3006,82,156,68,32,2,363
51145000501,2618,2026,1418,45,503,67,15,4,608
51015000602,5538,4364,4036,93,93,79,43,5,328
51610000001,5115,3722,2513,515,196,80,417,12,1209
51105000201,403,338,322,2,2,3,1,1,16
51550000003,3148,2365,347,106,1883,37,47,12,2018
51550000054,3744,2693,967,110,1454,52,129,4,1726
51550000006,3799,2792,1532,138,935,70,119,9,1260
51550000064,5231,3705,2102,252,1112,91,176,19,1603
51081000402,1886,3958,1362,147,2440,12,22,20,2596
51081000302,2113,1770,609,33,1072,21,46,4,1161
51081000401,554,427,263,4,149,6,6,1,164
51003000503,3494,2530,1917,93,158,31,337,6,613
51003000402,2202,1802,1575,63,98,32,28,3,227
51065000401,5632,4466,3983,104,231,55,67,2,483
51660000105,5911,5827,4513,341,457,32,496,18,1314
51570000002,3493,2670,1988,172,355,79,77,3,682
51099000201,6247,4649,3607,207,547,139,113,6,1042
51099000101,5044,3601,2638,176,564,135,145,9,963
51640000002,1714,1362,1137,87,87,32,29,2,225
51067000103,5071,4516,4271,67,55,68,30,2,245
51067000401,2819,2236,2006,40,132,51,11,0,230
51067000302,1307,1056,955,11,74,10,7,2,101
51067000403,1480,1195,1146,17,6,20,2,2,49
51067000502,2593,1980,1791,58,93,15,9,1,189
51067000203,613,492,402,20,57,7,2,0,90
51051000501,699,568,548,3,0,4,1,1,20
51067000503,1303,1049,970,34,17,18,6,2,79
51067000601,3285,2602,2365,63,94,56,20,3,237
51570000001,3095,2356,1598,150,513,65,70,8,758
51187000402,2441,1925,1677,99,65,29,39,5,248
51187000301,4402,3370,2667,181,396,97,49,5,703
51187000101,3305,2504,2002,161,213,64,49,1,502
51187000501,5199,3945,3225,184,332,101,65,0,720
51700000209,3346,2533,2030,151,208,63,80,3,503
51117000101,945,812,448,9,340,2,4,0,364
51117000801,403,357,227,3,124,7,1,0,130
51113000008,1097,884,752,15,79,11,21,1,132
51147000201,2890,2312,1363,49,846,38,11,0,949
51147000101,2795,2349,1341,66,857,40,57,3,1008
51147000701,2893,2650,1172,563,814,44,64,4,1478
51147000801,2350,2133,360,65,1703,30,14,1,1773
51700000204,4138,3694,1288,226,2076,27,86,15,2406
51700000202,5862,4959,2199,338,2280,57,120,5,2760
51700000205,3839,3109,2372,141,441,44,112,9,737
51700000212,1823,1500,1307,46,57,28,45,6,193
51700000313,3197,2254,64,44,2135,55,13,4,2190
51590000001,1378,1126,337,27,742,19,15,0,789
51113000004,144,129,94,9,18,3,2,0,35
51117000603,504,418,262,12,140,6,0,0,156
51700000218,6957,5681,3036,578,1559,114,509,30,2645
51117000602,797,628,488,23,116,3,3,0,140
51117000402,371,310,123,7,176,4,1,0,187
51700000211,7668,5737,2351,1231,1780,168,330,17,3386
51700000217,3181,2565,1807,106,419,46,193,10,758
51700000105,1538,1291,598,90,557,37,36,5,693
51700000219,8123,6582,2797,594,2756,117,443,18,3785
51700000320,8246,6460,3461,697,1899,171,288,15,2999
51595000201,808,624,138,26,452,5,8,4,486
51650000216,2750,2173,838,143,1068,34,116,6,1335
51107000617,2466,1883,455,376,240,27,790,1,1428
51107000505,4379,3211,2296,270,292,35,311,3,915
51107000126,5663,3772,1418,317,456,55,1568,8,2354
51107000108,4873,3175,1273,263,358,29,1276,6,1902
51810000007,2586,1962,1696,86,41,19,102,9,266
51810000092,2857,2148,1713,96,155,17,151,6,435
51161000301,950,758,685,24,24,15,14,0,73
51063000101,3065,2428,2252,39,58,46,16,1,176
51590000012,3401,2709,1046,53,1561,30,30,1,1663
51700000101,7224,5462,1365,984,2817,165,371,20,4097
51700000103,6866,5145,2068,439,2327,143,283,23,3077
51810000049,4327,3948,3565,125,89,41,125,9,383
51161000108,2096,1658,1506,32,58,29,36,0,152
51095000301,5190,4248,3348,179,513,80,129,7,900
51095000204,4376,3706,3209,132,212,43,99,3,497
51095000203,3843,3111,2483,123,240,52,209,2,628
51095000501,4221,3112,1210,496,1288,116,60,9,1902
51005005401,1140,958,867,8,55,15,12,0,91
51077000301,1561,1265,1174,21,51,17,6,0,91
51750000003,3743,2856,2427,65,268,81,35,4,429
51700000215,2659,2128,1200,121,726,40,51,7,928
51810000084,4808,3663,1452,347,1103,77,787,11,2211
51161000201,3437,2795,2246,143,267,37,104,0,549
51107000215,5422,4117,1741,1460,371,112,513,9,2376
51595000101,888,646,125,17,500,9,3,0,521
51810000031,5293,3649,2971,166,157,57,266,14,678
51810000100,1516,1276,1168,27,14,25,30,1,108
51810000058,4666,3401,1618,228,768,55,759,14,1783
51810000061,7817,6112,1783,723,3151,154,453,32,4329
51700000308,1800,1254,50,36,1147,35,8,8,1204
51650000107,3586,2863,530,111,2123,65,101,10,2333
51810000077,5215,4168,2501,374,930,120,303,30,1667
51810000020,4714,3699,2316,401,605,66,337,16,1383
51810000090,2824,2392,2054,91,118,34,65,2,338
51810000073,5010,3870,1633,385,1271,107,566,25,2237
51810000098,3564,2811,1193,299,933,53,366,19,1618
51810000051,3968,3190,2082,217,591,63,270,17,1108
51009000402,1692,1272,907,32,281,40,8,2,365
51009000401,4978,3844,2887,42,772,103,37,7,957
51009000302,3762,2982,2623,23,248,64,14,0,359
51810000071,2815,2092,968,128,544,41,409,21,1124
51810000097,4635,3380,1351,282,1116,58,642,14,2029
51810000029,6091,4502,1989,505,1490,134,475,14,2513
51810000087,3896,2858,1570,194,546,45,506,12,1288
51810000013,5894,4643,2979,418,755,153,372,36,1664
51113000001,1738,1347,1066,55,155,28,42,3,281
51053000103,2504,1961,1664,50,208,27,11,2,297
51005005302,1444,1191,1120,20,15,22,6,4,71
51005005202,1117,836,764,9,35,26,3,1,72
51161000406,3882,3080,2767,58,129,77,34,1,313
51019000102,1437,1164,1097,24,6,26,7,0,67
51095000103,6230,5125,4374,192,232,50,272,14,751
51810000056,1888,1540,1185,87,151,47,77,7,355
51810000002,5917,5051,3729,352,645,129,232,43,1322
51700000307,1736,1153,39,32,1069,34,8,3,1114
51009000103,1288,1014,830,18,110,44,5,0,184
51053000401,2606,2120,1442,27,589,38,22,1,678
51197000502,2593,2046,1939,9,27,42,7,0,107
51197000601,1120,893,840,12,29,10,0,0,53
51590000015,3182,2455,1266,109,1019,50,28,2,1189
51035000501,934,783,741,16,5,12,9,0,42
51035000401,2801,2230,2022,126,22,44,9,6,208
51011000302,1836,1429,1115,16,260,38,1,0,314
51107000214,4641,3599,2401,467,227,32,472,4,1198
51107000422,3585,2278,1748,160,118,22,221,2,530
51107000408,5313,3904,2494,437,319,66,628,6,1410
51187000502,1622,1256,1145,27,27,37,12,1,111
51187000401,6424,4944,4327,269,115,131,91,8,617
51005005502,1553,1268,1224,6,7,23,2,2,44
51009000102,2873,2241,1707,73,376,54,15,3,534
51077000402,1724,1423,1345,35,18,21,8,0,78
51077000103,562,481,466,6,2,6,2,0,15
51077000102,324,284,266,0,4,10,0,0,18
51161000205,4588,3666,3230,86,180,36,107,3,436
51161000402,882,720,633,19,43,12,14,1,87
51161000203,4037,3264,2806,54,208,53,136,4,458
51820000003,5722,4361,3091,340,776,81,77,10,1270
51161000306,2759,2127,1638,96,229,40,115,3,489
51165000301,1918,1452,1203,163,52,33,15,0,249
51165000305,4189,3229,2576,258,186,49,171,3,653
51165000307,3911,3083,2736,118,65,23,141,4,347
51077000106,479,403,396,5,1,0,0,0,7
51107000708,3662,2815,1680,296,182,39,613,2,1135
51077000105,423,375,366,7,0,1,0,0,9
51083000202,1221,930,629,6,282,6,3,1,301
51077000107,247,217,203,4,7,2,2,1,14
51683000005,7565,5727,2429,1999,848,118,419,9,3298
51107000302,3954,2775,2347,174,96,42,103,1,428
51107000510,2500,1810,1490,132,71,43,78,1,320
51155000201,1982,1633,1552,17,21,26,10,3,81
51155000402,1309,1077,1021,19,9,24,3,0,56
51155000203,3905,3147,2787,52,208,56,23,4,360
51071000102,1304,1064,995,13,13,29,13,0,69
51810000060,5146,3838,2924,236,279,55,335,18,914
51007000401,2508,2035,1557,53,382,31,12,1,478
51007000501,2835,2295,1576,54,603,49,19,2,719
51007000301,2692,2119,1566,62,439,37,19,0,553
51007000101,2549,1950,1384,51,437,55,18,0,566
51007000201,2766,2189,1671,38,412,39,26,1,518
51161000504,3356,2694,1908,117,323,53,295,1,786
51177000502,3161,2518,2061,100,251,76,31,4,457
51177000503,3485,2676,2195,101,278,75,24,3,481
51107000303,3339,2540,2163,156,82,46,92,5,377
51165000306,860,665,612,24,1,24,6,0,53
51117000202,422,337,151,5,176,4,0,0,186
51177000505,4959,3835,3048,159,412,89,116,3,787
51177000202,4601,3352,2594,238,296,95,95,11,758
51009000202,1646,1346,1125,33,148,32,3,1,221
51167000101,1772,1434,1381,4,12,26,5,0,53
51167000103,1097,878,843,5,7,16,3,1,35
51167000201,3228,2572,2466,16,40,42,3,2,106
51169000301,1428,1080,1045,8,6,17,1,3,35
51187000504,1048,852,783,15,5,23,10,1,69
51187000302,3909,3387,2926,141,183,57,55,2,461
51187000201,4091,3137,2659,198,149,68,83,4,478
51167000304,1207,975,947,10,7,14,4,0,28
51137000301,5141,4178,2863,255,919,95,59,14,1315
51137000302,1306,1064,866,50,111,17,11,1,198
51137000102,3509,2781,2134,99,460,61,26,3,647
51049000301,1815,1433,715,41,655,22,6,0,718
51077000302,2121,1722,1592,48,33,30,4,0,130
51077000403,951,764,669,43,43,10,3,0,95
51810000045,6512,4501,1709,390,1597,126,764,23,2792
51810000036,6349,5010,2681,452,1377,124,457,33,2329
51810000072,4104,3392,2950,109,120,91,107,9,442
51740000023,2765,2193,1570,83,385,81,69,5,623
51740000034,2408,1945,1457,69,324,56,44,7,488
51137000502,4047,3287,2783,126,238,79,41,2,504
51137000402,4329,3127,2020,255,702,86,98,7,1107
51137000201,3844,2990,2333,105,468,51,27,3,657
51137000401,3714,2902,2477,93,228,82,31,0,425
51137000202,3224,2513,2108,106,223,52,13,9,405
51085000705,1647,1390,1228,33,89,10,20,0,162
51085000702,2883,2295,1803,38,372,52,14,1,492
51085000209,848,662,532,7,82,20,12,0,130
51065000501,5340,4331,3749,150,305,68,69,5,582
51177000501,3507,2809,2293,98,268,69,42,4,516
51740000009,3408,2502,597,76,1790,42,28,11,1905
51740000010,1838,1413,831,74,448,46,34,6,582
51167000601,2063,1630,1588,10,7,22,5,1,42
51043000502,758,627,561,25,14,11,19,2,66
51107000213,2029,1583,813,284,233,22,220,6,770
51683000004,7049,5156,1925,1997,720,133,493,17,3231
51683000002,8740,6322,2087,3178,641,198,383,5,4235
51177000104,4965,3663,2373,321,726,109,151,11,1290
51810000048,4985,3949,3149,199,362,72,140,8,800
51810000009,3704,2834,2518,91,61,40,107,5,316
51810000096,4410,3349,1875,310,984,78,176,11,1474
51810000008,5776,4488,3124,281,759,86,253,16,1364
51810000067,3293,2619,1592,244,592,108,129,20,1027
51810000055,6926,5211,2268,598,1515,161,771,23,2943
51155000103,1940,1577,1477,23,42,16,13,1,100
51041000303,5981,4635,2563,156,1805,95,37,5,2072
51041000213,3298,2547,667,523,1253,61,100,4,1880
51041000302,2061,1561,1155,114,214,42,52,2,406
51041000415,4614,3498,2675,152,392,68,221,6,823
51041000308,2146,1794,1060,117,498,34,105,2,734
51041000414,8170,6226,3889,677,1339,158,214,8,2337
51023000201,3425,2679,2489,45,82,42,14,0,190
51083000403,2005,1640,1085,32,495,8,23,2,555
51041000307,8789,6037,4198,370,974,91,451,6,1839
51041000215,2571,1865,544,345,893,54,53,8,1321
51041000203,1957,1433,885,245,255,43,27,2,548
51085000304,7965,5831,4705,132,525,90,356,4,1126
51085000210,886,747,693,3,26,14,11,1,54
51047000101,7859,5705,3437,968,1006,165,178,13,2268
51047000304,1809,1346,739,352,211,32,34,2,607
51041000107,4956,3519,1779,242,1244,76,172,3,1740
51047000502,3242,2549,2193,134,104,64,32,6,356
51109000301,4410,3426,2079,107,1099,100,33,5,1347
51109000302,1209,965,712,31,191,21,6,2,253
51109000201,3010,2257,1590,101,503,51,21,1,667
51069000201,2272,1845,1738,37,14,37,13,2,107
51069000603,6549,4734,3608,490,338,111,213,9,1126
51017000401,876,743,703,9,11,15,3,0,40
51069000102,4635,3554,3185,132,69,84,44,4,369
51069000203,4576,3622,3318,96,70,62,39,7,304
51069000101,3114,2510,2318,70,35,42,26,2,192
51069000601,3272,2535,1956,335,125,56,69,6,579
51041000103,6847,5130,3068,338,1364,98,321,4,2062
51041000202,6171,4678,1663,967,1882,115,147,6,3015
51101000401,3832,2886,2300,74,381,91,24,5,586
51085000504,1980,1531,1424,22,60,9,7,1,107
51003000406,3923,3263,2762,122,206,44,114,1,501
51003000407,5007,4004,1952,850,624,69,533,2,2052
51003000405,3820,3471,2720,163,338,43,190,9,751
51003000601,4713,3646,3243,110,123,51,102,4,403
51003000606,5117,3569,2990,162,136,45,229,6,579
51003000604,4064,3018,2648,57,163,22,109,4,370
51760000810,3955,2852,392,840,1546,82,53,6,2460
51041000304,3393,2701,1996,95,490,56,56,5,705
51041000314,2222,1799,1470,51,191,62,24,3,329
51041000111,3580,2903,1945,105,740,54,66,10,958
51183000201,1023,813,292,13,496,8,4,2,521
51183000202,418,344,153,5,182,4,0,0,191
51027000404,443,1105,622,48,434,0,1,0,483
51027000602,1191,951,922,6,4,17,2,1,29
51121000303,1185,985,932,17,4,27,10,1,53
51161000102,960,792,759,6,4,14,1,2,33
51580000101,1192,965,761,23,147,27,11,5,204
51620000101,1465,1226,969,19,185,22,41,4,257
51620000201,1468,1075,669,22,366,19,10,2,406
51119000302,2088,1726,1110,35,552,50,10,0,616
51840000402,3866,3135,2351,260,225,64,226,5,784
51840000401,3680,2879,1842,595,302,69,98,3,1037
51840000301,6884,5328,3279,1127,706,151,88,8,2049
51069000402,2661,2050,1601,233,114,44,43,3,449
51720000001,3734,2895,2591,46,172,46,35,4,304
51047000402,4539,3521,2881,167,347,76,38,8,640
51580000501,1110,900,858,14,15,4,6,1,42
51650000108,6246,4802,941,317,3440,116,138,25,3861
51650000103,3917,2934,700,149,2036,70,52,22,2234
51127000502,2383,1909,1628,42,123,87,28,7,281
51650000213,5904,4585,2941,210,1172,135,181,12,1644
51650000209,5031,3878,1913,189,1553,124,164,8,1965
51650000215,1754,1212,259,65,859,25,29,3,953
51650000102,4158,3314,416,143,2661,78,76,12,2898
51031000602,4205,3262,2595,79,479,67,34,2,667
51031000401,2572,2030,1767,30,182,47,6,1,263
51031000703,1299,1048,813,6,192,28,4,0,235
51031000402,4947,4245,3464,79,548,98,48,4,781
51019000703,1523,1249,1126,17,63,23,15,0,123
51019000603,820,675,598,21,26,26,1,0,77
51019000505,2859,2283,2024,34,161,41,23,0,259
51003000306,2310,1855,1309,75,434,36,9,3,546
51059000129,2644,1991,1045,366,125,44,434,3,946
51059000840,4442,3294,1944,338,406,51,577,12,1350
51059000610,3623,2652,1275,299,773,54,289,1,1377
51059000606,3772,2791,2381,120,118,30,120,4,410
51059000608,2834,2260,1444,242,314,24,224,6,816
51059000409,7299,5629,1636,1488,879,122,1605,4,3993
51059000403,2163,1744,759,206,343,20,435,2,985
51059000417,6493,5057,1491,932,630,68,1975,15,3566
51059000619,6246,4897,2284,662,1133,121,765,5,2613
51059000630,1101,808,419,73,132,7,182,0,389
51059000732,5366,4176,2734,305,237,56,826,12,1442
51059000701,8535,6467,2975,1078,507,86,1837,23,3492
51015000101,2100,1715,1518,31,83,50,40,0,197
51075000101,1868,1477,1037,25,353,28,17,0,440
51003000401,2414,1887,1611,67,138,36,23,1,276
51027000203,1476,1199,1186,4,3,5,0,1,13
51121000401,2111,1685,1534,35,63,25,18,1,151
51075000201,835,690,459,11,201,17,9,0,231
51025000102,1163,954,608,17,322,5,2,1,346
51025000201,337,292,177,0,111,2,2,1,115
51025000103,1152,1010,721,19,258,11,7,1,289
51059000302,3502,2627,2108,147,64,11,263,3,519
51059000108,3494,2634,1461,435,138,69,541,11,1173
51059000133,1045,780,463,100,54,1,160,0,317
51059000113,5691,4283,2805,270,162,53,959,12,1478
51193000102,1304,1053,543,54,441,21,1,0,510
51193000301,1949,1570,914,99,505,33,16,2,656
51193000201,2328,1955,1274,59,578,47,16,5,681
51193000202,1428,1162,876,39,222,25,10,0,286
51013000025,3896,3117,2125,398,211,68,337,1,992
51013000005,4564,3531,1907,882,344,78,363,6,1624
51115000002,3086,2581,2184,34,293,44,22,2,397
51103000401,2075,1735,829,21,813,23,43,3,906
51103000501,2359,2101,1903,18,144,13,14,5,198
51103000301,1545,1355,1171,11,126,32,17,0,184
51650000201,4877,3793,2312,184,1066,121,126,9,1481
51650000115,2355,1942,1273,79,462,54,59,12,669
51650000203,5445,4313,2200,333,1420,124,284,16,2113
51143000604,2098,1620,1150,48,396,21,7,0,470
51059000727,3494,2615,1855,160,92,38,478,3,760
51059000729,5728,4313,2371,339,241,45,1288,7,1942
51063000301,2998,2394,2096,127,96,56,8,5,298
51063000201,3427,2749,2518,68,71,64,18,7,231
51001000402,1742,1386,898,125,315,42,22,1,488
51143000702,2545,2052,1836,35,153,20,12,0,216
51760000415,2358,2167,1642,59,366,17,71,0,525
51013000046,5218,4880,3308,325,236,45,937,8,1572
51013000040,5653,5171,3654,350,247,41,843,19,1517
51153000210,4092,3141,2152,252,370,77,284,7,989
51153000509,4237,3319,2342,292,349,44,302,6,977
51153000609,5687,4162,1181,831,1277,106,849,17,2981
51153000701,6440,4951,1635,1582,1214,128,481,22,3316
51001000401,1384,1090,732,149,177,48,15,0,358
51059000507,6021,4724,1865,954,920,74,962,4,2859
51059000523,4409,3398,1385,610,509,59,861,1,2013
51059000518,6913,5270,1163,2023,553,140,1544,7,4107
51059000513,3775,3045,1559,434,372,32,662,5,1486
51059000213,5797,4270,2930,345,107,52,811,13,1340
51059000526,6358,5037,1641,986,1474,113,935,16,3396
51059000806,4969,3664,2063,320,440,39,798,17,1601
51059000838,3117,2328,1667,146,181,28,307,6,661
51059000807,3297,2304,1486,193,160,30,424,14,818
51800000405,990,788,539,19,205,20,10,1,249
51013000026,5904,4923,2573,883,781,128,658,13,2350
51013000038,5339,4432,1762,756,903,74,993,16,2670
51153000702,5374,4310,1233,780,1788,77,546,25,3077
51153000711,8802,6317,1045,3241,1508,195,541,13,5272
51153000703,5235,3543,517,1622,1071,125,364,19,3026
51153000205,5310,3996,2304,444,603,118,567,11,1692
51153000606,5628,4106,1036,2010,700,114,357,8,3070
51760000812,5299,3981,646,900,2346,88,93,1,3335
51041000205,6219,4814,1489,930,1991,115,405,1,3325
51760000203,2014,1719,1331,35,296,24,44,0,388
51175000102,1580,1284,876,17,353,20,15,4,408
51037000302,1647,1262,785,29,405,42,7,2,477
51540000303,4739,4396,2228,329,515,57,1300,10,2168
51540000302,6279,5080,3555,281,681,87,481,7,1525
51540000301,4985,4059,2064,233,1429,41,306,5,1995
51036000301,2223,1877,880,16,882,91,14,5,997
51735000002,4359,3284,2983,85,33,59,104,13,301
51171000101,1943,1577,1467,51,12,39,15,0,110
51013000018,7931,7250,4569,786,724,96,1089,11,2681
51013000044,3581,3175,2089,365,220,46,463,7,1086
51153000301,5711,3972,875,1668,1158,164,269,39,3097
51153000105,6924,4773,2525,594,684,68,933,13,2248
51153000103,4537,3174,1815,344,335,47,655,3,1359
51153000513,4468,3263,1743,756,405,58,332,13,1520
51153000503,4818,3569,1429,716,1066,78,364,10,2140
51153000404,6621,5236,1813,1350,1186,140,884,13,3423
51153000411,9305,6559,1428,2762,1411,187,907,18,5131
51193000501,3814,3093,2400,73,439,103,60,5,693
51175000601,1954,1547,925,14,593,12,6,4,622
51175000201,1685,1351,647,27,647,48,2,3,704
51093000201,4476,3391,2587,99,557,86,64,0,804
51093000202,5512,4246,2838,181,1012,110,134,3,1408
51093000403,3000,2325,1501,98,604,66,51,9,824
51093000501,1529,1199,1060,15,103,20,4,0,139
51109000202,2478,1935,1573,42,268,37,17,1,362
51025000202,1235,1018,298,13,702,3,2,2,720
51109000401,4163,3401,2794,107,367,72,45,7,607
51175000701,1169,879,292,12,554,21,4,0,587
51175000702,1295,1008,690,7,281,40,0,2,318
51175000502,887,715,475,11,216,15,7,0,240
51093000301,2918,2382,1369,19,893,59,25,0,1013
51093000101,4313,3434,2812,75,438,70,35,6,622
51093000505,1022,853,682,16,110,46,4,0,171
51093000503,1093,885,670,19,174,13,9,1,215
51181000501,833,694,429,10,230,19,4,3,265
51143000703,607,467,345,11,105,6,0,0,122
51760000902,4627,3166,108,2116,927,117,18,3,3058
51061000502,3597,2723,2279,180,107,68,90,4,444
51061000504,6706,4674,3808,288,289,62,203,5,866
51061000202,3590,2710,2266,130,143,56,99,8,444
51061000106,2413,1802,1456,100,176,39,43,3,346
51061000201,5431,4215,3103,353,525,76,164,16,1112
51061000105,1985,1511,1192,125,109,53,33,4,319
51061000103,1946,1533,1186,94,164,46,45,0,347
51001000101,3357,2917,2674,66,43,81,31,5,243
51175000401,1467,2165,997,42,1102,22,6,4,1168
51175000202,623,466,263,9,183,9,1,2,203
51840000102,2954,2517,2115,134,178,58,46,1,402
51067000703,1915,1501,1054,49,359,19,18,4,447
51550000042,3970,3121,1309,193,1276,78,293,16,1812
51550000015,5424,4380,2183,310,1453,122,353,18,2197
51550000056,3883,3269,1622,209,1117,57,304,16,1647
51710000505,3723,2950,1675,426,595,75,196,16,1275
51710000509,5337,3968,2689,366,506,134,285,38,1279
51710000503,6442,5255,3345,425,1150,135,214,31,1910
51710000501,5436,4438,2841,383,904,148,176,26,1597
51171000302,2940,2377,2079,161,46,64,11,3,298
51550000062,3568,2688,2239,98,234,50,72,1,449
51550000063,2574,1910,1599,69,105,44,88,6,311
51051000502,2046,1686,1654,1,6,13,1,2,32
51051000302,812,646,639,0,1,2,1,0,7
51081000202,1059,880,525,15,335,7,0,2,355
51013000004,4796,4025,2746,432,261,53,551,12,1279
51013000023,4144,3088,2129,384,222,25,338,5,959
51013000028,7508,5656,2088,1612,1056,166,894,15,3568
51153000505,4391,3248,1815,481,628,93,305,10,1433
51153000501,4227,3075,1607,346,706,61,386,9,1468
51081000403,423,336,195,2,140,2,1,1,141
51081000103,885,612,81,11,519,2,0,0,531
51081000102,330,273,145,5,119,6,0,1,128
51081000101,784,662,299,5,346,8,1,0,363
51087000307,2480,1965,1425,154,236,28,96,3,540
51087000419,3570,2838,2242,116,267,26,166,2,596
51087000406,3021,2383,2048,89,99,23,102,0,335
51087000504,3288,2447,945,263,1147,59,38,0,1502
51087000115,5130,4177,2990,130,691,52,298,2,1187
51013000010,7522,6760,4245,799,599,115,1043,14,2515
51013000002,4718,3920,2724,479,234,89,408,5,1196
51045000501,970,789,763,1,2,15,3,1,26
51710000412,3234,2587,600,153,1772,48,50,12,1987
51710000414,5386,3566,279,125,3141,66,39,10,3287
51013000033,4175,2889,2369,189,64,44,207,5,520
51013000037,3559,2467,2042,151,38,20,190,2,425
51153000208,3283,2476,1595,348,312,58,164,8,881
51153000213,3198,2319,714,598,656,66,339,6,1605
51153000207,6448,4585,1866,1130,1075,128,506,19,2719
51029000302,1139,872,670,20,166,15,1,2,202
51019000402,2154,1718,1406,57,180,17,61,2,312
51019000404,2831,2178,1914,49,106,24,66,3,264
51031000101,3944,3071,2586,74,272,59,68,1,485
51145000503,1511,1120,964,22,82,25,10,1,156
51145000402,1758,1365,1198,18,110,19,10,3,167
51149000204,4214,3165,1533,186,1298,63,112,5,1632
51149000102,4732,3703,2784,112,662,119,38,6,919
51550000065,3943,3096,1891,146,649,60,377,4,1205
51550000049,3815,2933,1544,175,756,62,386,14,1389
51550000013,3557,2635,1699,121,662,68,84,17,936
51550000018,4072,2929,1253,210,1294,82,119,10,1676
51550000019,2555,1837,1452,65,235,37,50,1,385
51191000201,1691,1318,1259,12,11,32,2,1,59
51067000504,1940,1522,1403,34,40,30,11,1,119
51067000702,2710,2096,1502,100,451,33,25,5,594
51067000202,2059,1781,1568,34,142,29,7,0,213
51089000204,2380,1953,1559,53,318,27,8,2,394
51001000602,440,362,355,0,0,5,2,0,7
51800000102,5087,3971,2967,121,634,89,139,5,1004
51800000305,1698,1248,654,51,475,23,45,2,594
51089000405,1590,1281,777,26,438,24,10,0,504
51015000803,5234,4079,3299,160,454,79,72,14,780
51013000021,2362,1994,1227,147,329,27,264,4,767
51013000053,5990,5546,2931,589,751,92,1226,18,2615
51015000202,2258,1798,1648,50,44,40,5,2,150
51015000401,2036,1620,1555,13,25,14,8,1,65
51015000802,4304,3430,3106,72,158,36,48,4,324
51143000201,1724,1384,1101,21,232,29,3,0,283
51143000305,1384,1175,593,33,533,19,1,0,582
51678000001,7335,6489,5407,247,450,64,346,13,1082
51081000201,991,773,219,2,550,1,1,1,554
51800000201,2330,1933,1601,46,206,34,43,1,332
51800000301,1202,915,360,17,512,22,13,3,555
51800000402,2419,1972,1603,32,250,53,24,5,369
51059000134,6470,4519,1548,781,1366,65,738,16,2971
51059000117,4094,3254,1790,244,184,43,988,3,1464
51013000029,3984,2816,2138,267,80,40,273,7,678
51059000305,3472,2482,1755,126,74,14,488,3,727
51013000016,4289,3618,2685,317,165,28,402,1,933
51013000035,4049,2996,2531,179,45,23,198,3,465
51800000602,1427,1076,420,32,621,18,3,1,656
51169000601,875,710,680,4,5,18,1,3,30
51800000403,2569,1759,195,38,1503,29,15,3,1564
51059000734,4162,3388,1567,264,271,52,1268,3,1821
51059000709,7255,5643,2094,867,520,79,2116,9,3549
51059000707,3270,2449,1693,146,85,34,477,2,756
51059000843,5243,4176,2094,370,413,53,1239,7,2082
51059000904,3510,2530,1093,1012,108,66,281,2,1437
51059000517,6051,4465,875,2116,447,368,1037,10,3590
51059000505,5356,4213,1503,1207,447,84,1027,14,2710
51059000126,3658,2875,1444,359,276,36,771,7,1431
51059000319,7108,5351,2508,1193,476,126,1145,3,2843
51059000320,8985,6629,2026,2779,578,163,1195,8,4603
51059000109,1695,1296,775,98,44,12,362,4,521
51053000101,1075,817,659,9,128,24,2,0,158
51053000301,1105,872,664,15,161,29,10,1,208
51147000401,2709,2357,1002,38,1301,37,9,1,1355
51147000502,1329,1317,754,49,492,20,5,1,563
51810000035,3967,3351,2665,141,254,38,243,7,686
51810000028,2972,2356,1805,122,236,61,134,6,551
51810000075,4508,3720,3295,153,68,60,131,8,425
51810000062,4870,3619,2301,275,562,87,443,15,1318
51810000088,4412,4295,2682,256,1023,68,285,26,1613
51009000501,5861,4583,3187,113,1125,146,36,7,1396
51810000018,4861,3656,2756,185,292,68,359,7,900
51810000012,5397,4169,2329,401,1078,166,275,26,1840
51161000502,2095,1639,1436,36,77,19,63,3,203
51590000009,2315,1942,791,151,947,24,22,2,1151
51005005402,1281,1056,982,6,58,11,2,0,74
51117000102,415,368,325,4,30,7,4,1,43
51085000401,3350,2715,2417,41,158,51,38,3,298
51011000301,1471,1101,894,11,158,17,18,0,207
51107000506,3634,2846,1399,728,427,51,254,9,1447
51107000810,4406,3153,1934,389,283,50,483,12,1219
51107000818,3614,2638,1462,194,203,28,761,1,1176
51107000621,5927,4125,2172,488,355,66,1062,6,1953
51810000047,4479,3487,3043,112,90,47,174,9,444
51810000054,3538,2606,1406,233,518,51,418,4,1200
51590000007,3020,2182,478,48,1633,34,8,2,1704
51083000503,1332,1063,834,17,190,13,6,1,229
51141000102,1057,853,795,13,23,9,5,1,58
51035000504,1322,1068,1006,19,6,40,0,0,62
51011000201,840,668,399,11,245,8,1,0,269
51690000002,3010,2455,1270,98,1028,39,43,12,1185
51035000203,1474,1229,1179,19,5,16,3,2,50
51035000101,1547,1216,1126,41,18,23,4,2,90
51810000053,3583,2853,1929,217,494,60,189,11,924
51810000079,5253,3942,1815,331,1474,78,346,15,2127
51810000015,4360,3349,2099,288,675,70,215,25,1250
51690000006,587,457,15,16,425,11,3,2,442
51199000202,3581,2799,1743,175,407,70,412,7,1056
51197000401,2182,1723,1661,9,22,21,5,0,62
51197000501,2037,1609,1538,12,12,40,3,0,71
51185000101,2014,1759,1545,22,164,20,3,2,214
51810000043,5145,3833,1688,349,1158,87,631,15,2145
51810000069,4181,3195,1234,292,1373,85,277,8,1961
51810000057,3297,2591,1574,105,605,64,248,5,1017
51161000206,2163,1812,1283,137,244,45,113,1,529
51085000502,3458,2566,2152,59,189,34,123,5,414
51085000104,3018,2259,1809,68,271,48,57,0,450
51141000103,1389,1121,1011,32,58,14,1,2,110
51185000112,499,381,361,1,2,16,1,0,20
51107000310,5938,4175,3183,452,217,85,232,10,992
51510000104,3723,3222,2384,146,420,42,208,3,838
51510000201,3835,3010,2378,366,209,41,115,15,632
51770000016,3281,2887,2654,55,76,59,39,1,233
51740000038,6152,4507,828,207,3371,99,92,12,3679
51740000020,2977,2238,661,100,1409,49,61,5,1577
51141000101,1241,986,886,34,41,17,6,0,100
51740000027,2624,2874,311,58,2484,13,23,4,2563
51165000105,1657,1320,1211,63,13,27,10,0,109
51740000032,1870,1542,1072,27,367,27,29,2,470
51510000303,5259,4577,1540,647,1826,71,568,14,3037
51047000303,2514,2017,1605,115,221,28,34,5,412
51740000013,2478,1593,93,51,1436,18,11,1,1500
51510000207,5626,4425,2444,753,799,93,413,17,1981
51059000423,4060,3058,1870,450,301,65,380,11,1188
51155000401,5857,4565,4034,85,297,103,39,1,531
51041000510,4206,3163,2745,101,170,44,100,6,418
51071000301,1180,961,902,16,19,24,0,0,59
51087000215,3701,2927,209,74,2604,42,39,2,2718
51087000111,6282,5017,3527,492,678,100,220,4,1490
51087000114,1312,1080,961,40,27,13,34,0,119
51760000102,1695,1312,1089,22,146,15,31,1,223
51059000520,5285,4301,1776,472,1138,38,891,11,2525
51083000801,4155,3411,1159,91,2116,24,29,1,2252
51083000201,1148,873,620,27,207,13,2,0,253
51165000303,1457,1140,1038,71,14,10,4,0,102
51173000702,1511,1196,1136,12,17,24,4,0,60
51690000004,3463,2737,1108,161,1429,49,16,6,1629
51041000206,4394,3209,522,940,1665,73,72,0,2687
51740000029,1758,1449,1084,51,228,52,40,8,365
51177000101,3998,3058,2617,65,225,95,45,2,441
51085000107,2139,1629,1384,39,114,19,49,0,245
51045000402,93,80,72,0,1,5,0,0,8
51139000101,4705,3869,3457,62,209,84,55,4,412
51041000404,4474,3444,2044,347,864,77,145,9,1400
51041000112,4033,3134,1692,214,1111,55,96,13,1442
51760000402,3710,3087,2512,119,319,59,70,5,575
51087000416,1430,1072,951,26,53,12,24,0,121
51087000410,2014,1478,1377,25,5,3,54,0,101
51087000412,5390,4055,2582,467,593,62,328,0,1473
51087000510,2813,2206,783,48,1294,40,50,1,1423
51087000414,2502,1776,1676,30,8,15,22,0,100
51600000004,3565,2955,1888,326,116,32,573,2,1067
51670000101,3469,2580,1506,181,812,55,45,2,1074
51153000305,4421,3184,1802,363,653,74,305,5,1382
51153000307,3884,2847,1647,319,575,57,273,8,1200
51760000510,3559,2916,986,149,1686,67,46,7,1930
51760000701,3665,2208,46,42,2123,31,12,4,2162
51760000104,2541,1969,1812,48,35,12,39,1,157
51061000104,1739,1438,1146,92,132,29,37,2,292
51760000705,2179,1901,994,85,702,43,92,5,907
51760000307,2425,1987,1273,54,580,36,48,2,714
51093000402,3337,2548,1801,74,576,44,36,1,747
51029000301,1366,1029,692,6,308,23,7,4,337
51087000403,2412,1850,1681,37,46,19,60,0,169
51087000206,3824,2943,122,55,2756,45,19,2,2821
51760000908,4350,3389,731,313,2271,64,63,6,2658
51143000103,4172,3268,2857,41,282,40,39,4,411
51021000101,705,575,549,4,1,20,1,0,26
51087000508,3925,2890,689,89,2032,58,43,7,2201
51087000207,3306,2804,1099,127,1470,54,102,3,1705
51143000206,1328,1080,917,16,138,7,1,0,163
51143000603,2320,1852,1433,109,286,19,8,0,419
51760000610,3777,2503,188,164,2144,53,15,3,2315
51087000202,6445,4936,1053,269,3527,74,102,13,3883
51760000308,2290,1900,1423,29,363,22,55,4,477
51760000301,2181,1626,215,43,1351,32,11,3,1411
51059000329,4600,3543,2243,182,95,27,982,1,1300
51059000203,4987,3779,2103,172,177,28,1266,5,1676
51059000220,7469,5544,2129,1453,957,118,968,4,3415
51059000508,4267,3342,1666,702,143,40,816,4,1676
51059000240,3465,2624,1720,139,84,23,635,1,904
51059000421,5966,4702,2294,545,1124,97,697,19,2408
51087000210,2426,1838,549,107,989,26,185,2,1289
51550000002,4048,2975,2509,148,164,90,69,8,466
51550000017,3063,4134,2363,89,1597,48,52,18,1771
51650000111,1589,1368,815,71,447,30,25,3,553
51650000106,4296,3400,1558,142,1545,71,129,10,1842
51650000118,4787,3810,603,118,3016,68,58,17,3207
51650000208,6571,5130,2475,255,2112,164,232,20,2655
51179000304,3268,2336,1077,536,545,48,159,20,1259
51600000002,3880,3061,1780,536,167,48,509,11,1281
51600000001,4137,3332,1689,638,195,44,782,8,1643
51121000701,6183,5160,3776,211,224,53,870,4,1384
51097000201,1419,1164,900,24,196,34,5,2,264
51057000401,2902,2298,1483,69,691,34,24,0,815
51760000115,1971,1610,1486,38,38,16,24,1,124
51760000214,5164,4979,2211,445,1156,67,1176,5,2768
51760000505,3644,3512,2091,268,607,24,532,5,1421
51760000310,2324,1239,25,25,1167,35,15,2,1214
51650000217,2036,1633,1080,63,352,30,99,4,553
51089000203,1935,1571,560,35,956,19,7,0,1011
51089000604,1983,1576,1268,47,221,29,21,1,308
51089000603,2983,2345,1886,97,313,32,10,2,459
51089000504,1006,817,613,20,166,14,9,1,204
51089000402,2560,1929,1192,236,456,36,18,1,737
51059000509,1845,1524,776,102,394,8,234,4,748
51013000031,3993,2875,2149,244,176,36,252,2,726
51103000302,752,665,594,6,59,3,3,1,71
51191000602,718,543,507,5,8,8,2,1,36
51089000101,1356,1080,690,82,279,39,6,1,390
51550000045,1600,1248,516,118,548,47,27,2,732
51550000048,5152,3631,528,164,2837,73,106,13,3103
51550000028,775,565,342,23,180,24,12,0,223
51550000023,4331,3604,2121,192,1072,49,175,12,1483
51550000059,3367,2674,1602,122,631,44,293,11,1072
51550000058,1565,1266,523,78,606,22,49,4,743
51153000209,2953,2333,1798,240,90,83,117,3,535
51143000607,828,647,535,16,83,11,3,1,112
51159000501,1524,1214,861,126,197,16,11,1,353
51059000607,6668,5670,2901,983,1031,105,688,19,2769
51059000919,7138,5390,2078,773,506,57,2007,7,3312
51059000933,1243,910,420,128,89,10,277,4,490
51059000601,3422,2612,1577,588,269,53,162,0,1035
51059000405,4986,3678,976,1288,976,116,439,17,2702
51059000825,4019,2991,1826,233,199,44,693,1,1165
51015000403,2273,2793,1930,117,698,53,10,4,863
51015000301,5544,4334,3991,128,84,93,30,6,343
51600000006,3927,3144,1585,643,231,72,637,10,1559
51059000202,4020,2928,2224,163,36,25,425,3,704
51059000204,1914,1446,695,328,96,17,323,0,751
51059000418,4978,3687,659,1705,245,92,1075,5,3028
51059000222,3259,2680,1647,382,339,73,297,6,1033
51059000841,1952,1540,1218,68,35,10,196,5,322
51059000804,2479,1932,1304,127,129,28,337,5,628
51059000218,3090,2308,1568,152,154,19,401,6,740
51059000120,4178,3239,2260,262,129,40,530,6,979
51059000328,4489,3342,2268,161,91,50,758,3,1074
51059000118,6455,4866,2206,1072,393,108,1138,6,2660
51059000114,3000,2344,1470,238,64,30,543,0,874
51550000007,3598,2834,1867,164,500,68,248,1,967
51550000039,3042,2320,1520,111,568,50,78,9,800
51550000052,3369,2251,1252,137,717,51,119,13,999
51149000105,1162,895,681,38,135,23,18,3,214
51580000201,1108,870,668,9,173,10,4,4,202
51059000604,7551,5685,1892,1644,1552,133,546,19,3793
51059000801,7746,5848,2401,1093,653,92,1645,23,3447
51059000626,5366,4160,2002,622,657,78,834,15,2158
51059000623,4753,3618,1434,684,709,79,809,13,2184
51059000812,4414,3245,1709,418,342,69,759,9,1536
51059000917,2830,2222,1197,278,144,30,572,2,1025
51059000932,3216,2435,981,580,307,43,544,5,1454
51059000312,4112,2922,1818,197,57,22,777,2,1104
51059000913,5926,4490,2117,241,274,47,1806,7,2373
51105000403,850,671,625,4,1,36,0,1,46
51121000404,1519,1188,1136,23,3,18,2,0,52
51121002031,1065,867,800,11,25,22,5,2,67
51105000202,1585,1207,1152,12,2,37,3,1,55
51059000617,4675,3300,619,691,1331,56,671,0,2681
51059000233,4457,3454,2507,183,122,33,569,7,947
51059000201,5212,4283,3092,329,279,51,525,16,1191
51680000402,2371,1951,1282,96,503,39,45,2,669
51059000105,6976,5262,3103,681,401,81,988,8,2159
51179000504,4478,3379,1786,350,896,64,298,13,1593
51610000002,4438,3348,2323,247,199,53,525,9,1025
51019000401,3631,2769,2302,88,182,34,143,2,467
51145000301,2904,2284,1966,57,166,59,26,4,318
51145000103,1882,1507,1318,37,64,37,28,1,189
51550000061,4679,3470,2889,139,199,56,184,5,581
51003000104,4153,3250,1819,478,671,47,233,4,1431
51570000005,3152,2565,2150,89,144,33,140,8,415
51700000203,5628,4386,2714,290,972,86,339,24,1672
51700000317,1022,764,38,30,710,17,4,5,726
51700000304,1742,1260,67,47,1138,26,6,4,1193
51113000007,2544,2003,1737,49,137,45,21,8,266
51700000315,3022,2427,1399,127,766,71,97,8,1028
51590000006,2116,1495,447,40,1000,13,3,1,1048
51590000008,2174,1694,575,39,1072,26,5,0,1119
51700000306,1132,611,14,16,581,20,2,0,597
51161000107,1416,1134,1052,13,19,35,9,2,82
51161000503,2555,1992,1756,55,77,31,54,1,236
51005005501,539,426,383,5,30,6,1,0,43
51700000109,3483,2717,1132,256,1118,65,191,35,1585
51700000316,4273,3268,1340,224,1519,60,142,9,1928
51161000404,4588,3614,3008,94,326,102,62,6,606
51107000710,5252,3878,1158,1830,310,129,549,12,2720
51107000705,7299,5503,1882,2505,378,170,701,10,3621
51700000201,1781,1459,570,154,608,24,127,4,889
51113000002,2478,1950,1626,38,242,26,11,2,324
51810000068,3624,2896,2003,131,409,43,322,15,893
51810000078,3813,2849,1534,214,669,45,434,8,1315
51810000089,3827,2990,1841,140,560,52,393,29,1149
51810000091,5280,4028,2057,340,1140,102,452,25,1971
51095000504,4559,3818,3167,125,298,67,146,5,651
51113000009,668,537,500,12,16,7,2,0,37
51095000102,3439,2598,2021,141,274,41,112,10,577
51700000319,6202,4982,2614,356,1756,138,230,33,2368
51810000010,4493,3355,2906,109,42,36,234,7,449
51095000101,4289,3378,2999,120,109,53,86,0,379
51005005103,611,474,462,0,2,5,1,0,12
51095001041,8,2,0,2,0,0,0,0,2
51810000094,2465,1932,1297,134,368,55,97,5,635
51810000040,6075,4737,2490,750,1073,149,418,20,2247
51085000505,1642,1316,1126,22,112,38,16,1,190
51185000109,513,396,380,2,5,8,1,0,16
51185000203,340,269,251,9,3,3,2,0,18
51187000202,3594,2842,2400,180,72,92,81,9,442
51049000201,2056,1613,1167,25,373,39,6,4,446
51049000101,1950,1584,1061,22,446,39,23,1,523
51185000207,314,251,244,1,0,7,0,0,7
51117000902,663,554,477,15,53,11,0,0,77
51740000035,2954,2321,1599,85,538,54,62,11,722
51041000316,4912,3591,2562,235,659,85,78,9,1029
51041000106,7974,5904,2960,435,2142,171,226,25,2944
51041000102,6793,4859,2486,1068,1125,132,116,6,2373
51017000301,674,546,525,7,8,8,1,0,21
51003000602,2016,1629,1452,64,51,32,31,2,177
51003000501,1933,1577,1234,69,206,28,26,0,343
51109000101,4092,3291,2641,118,402,69,63,3,650
51760000114,3504,3202,2746,167,127,44,128,6,456
51760000903,4774,3449,446,849,2144,52,37,6,3003
51620000501,1299,932,38,26,867,13,8,0,894
51620000301,1426,1050,99,14,918,20,7,0,951
51036000101,2376,2026,1052,26,800,121,28,9,974
51650000109,5142,3885,579,146,3063,84,82,10,3306
51700000318,1693,1292,177,56,1036,35,17,4,1115
51003000103,2395,2042,1352,203,325,57,150,5,690
51059000811,3493,2534,1094,397,404,20,645,3,1440
51059000501,6952,5201,1613,1577,1202,153,800,5,3588
51059000530,3439,2683,1056,659,454,50,493,12,1627
51059000310,3207,2284,1450,137,45,14,612,8,834
51003000105,4419,3474,2673,165,369,54,217,1,801
51031000201,3967,3153,2382,231,412,58,85,2,771
51105000504,429,317,305,3,3,4,3,1,12
51019000702,1647,1387,1243,14,104,22,4,2,144
51003000307,937,719,666,5,17,11,5,0,53
51003000203,5645,4583,2345,560,1175,97,440,2,2238
51059000615,5510,4180,1777,910,1049,92,383,7,2403
51013000012,3390,2684,2209,212,94,36,113,7,475
51097000101,1254,990,500,15,435,40,2,0,490
51650000212,5577,4560,1448,197,2608,82,344,11,3112
51650000204,3964,3169,1246,189,1615,46,153,7,1923
51143000606,1788,1422,775,53,552,30,15,1,647
51093000502,787,640,309,3,319,4,7,0,331
51093000302,3477,2775,1209,30,1475,39,23,5,1566
51143000605,1866,1449,1080,53,278,29,10,0,369
51059000426,1908,1894,1574,215,22,7,80,3,320
51059000850,3839,2881,2092,154,179,33,415,4,789
51013000027,4898,3799,2078,767,489,91,426,10,1721
51760000814,2875,2103,185,507,1395,25,12,4,1918
51760000105,2433,2092,1872,86,56,13,51,0,220
51153000602,7296,5219,1208,1696,1503,148,819,15,4011
51153000608,4788,3527,936,1374,833,87,376,7,2591
51175000302,1293,1046,686,22,302,32,6,5,360
51175000602,708,551,486,8,51,10,0,0,65
51175000501,1993,1572,1243,12,261,32,14,0,329
51175000301,1273,1001,555,11,415,14,6,3,446
51760000305,2851,2413,798,125,1368,27,124,7,1615
51175000101,1217,928,806,9,80,19,6,3,122
51760000112,2041,1706,1429,91,94,25,66,0,277
51143000202,530,424,312,8,104,0,0,0,112
51550000053,6535,5316,3067,279,1405,93,455,25,2249
51550000057,4936,4067,2008,331,1453,111,221,27,2059
51013000020,3780,2775,2278,189,46,26,200,0,497
51153000107,6579,4641,2846,548,564,82,641,20,1795
51750000001,3783,3411,2614,184,428,67,86,4,797
51750000004,5386,5035,3283,277,1147,56,108,6,1752
51073000202,4637,3647,3029,116,352,86,37,6,618
51013000017,4408,3342,2557,210,121,26,404,9,785
51013000036,4700,3686,2663,349,309,26,318,4,1023
51550000016,4204,3099,2485,126,284,84,140,13,614
51149000101,1670,1336,943,38,287,21,35,4,393
51089000404,3355,2625,1828,118,567,44,39,2,797
51089000505,1042,882,665,20,172,14,4,0,217
51121000402,3117,2397,2257,35,33,39,22,1,140
51109000102,2363,1874,1415,86,305,60,18,2,459
51181000201,1354,1109,512,23,561,14,1,2,597
51089000602,972,755,442,50,246,17,3,0,313
51013000039,2823,2044,1258,397,87,62,257,1,786
51153000104,5468,3914,2565,430,453,79,388,4,1349
51061000101,1785,1350,1142,95,59,45,17,4,208
51169000303,1026,821,795,6,7,10,0,1,26
51059000915,3591,2735,1847,178,134,34,540,0,888
51013000024,5903,4483,2871,584,483,71,470,6,1612
51153000203,5111,3713,2061,590,540,78,481,10,1652
51153000206,3414,2619,1922,260,210,61,135,3,697
51013000015,2824,2257,1355,369,172,27,344,3,902
51013000054,2050,1878,1419,141,85,11,222,0,459
51013000041,4945,4390,2885,541,269,64,639,5,1505
51059000315,5627,4254,2095,829,193,81,1085,6,2159
51059000516,7085,5251,1441,1444,1349,75,983,14,3810
51059000908,3111,2291,1480,142,69,16,593,2,811
51059000909,3060,2281,1436,98,93,19,627,4,845
51059000504,5675,4235,743,1453,722,102,1328,6,3492
51059000519,3056,2476,1106,344,167,38,836,4,1370
51595000501,761,503,17,19,464,4,4,2,486
51700000305,3321,3289,1156,472,1494,87,138,9,2133
51810000032,1959,1518,1312,48,96,31,21,5,206
51107000420,3508,2809,2155,136,173,28,293,4,654
51107000407,2819,2014,1247,172,230,13,353,5,767
51107000822,3032,2059,1231,146,191,14,471,5,828
51107000815,4707,3767,2719,169,207,27,624,11,1048
51107000709,5223,3887,1302,1277,412,51,890,3,2585
51077004012,981,754,717,5,14,11,4,0,37
51810000006,4293,3440,2940,109,200,37,128,2,500
51810000081,5350,4078,1829,399,987,104,820,23,2249
51810000026,3632,2906,2047,136,426,47,234,4,859
51107000817,5752,4169,2543,383,401,78,763,4,1626
51197000603,1470,1167,1121,12,11,21,3,1,46
51167000401,242,196,185,0,0,10,0,0,11
51161000101,1060,887,831,12,21,16,7,1,56
51810000022,3376,2658,1760,186,489,71,184,16,898
51083000703,1037,814,624,11,156,25,1,0,190
51085000106,1546,1202,1087,15,77,6,19,0,115
51085000305,3404,2389,2126,31,122,33,67,2,263
51165000106,1563,1239,1144,67,14,12,1,0,95
51107000301,4519,3208,2684,155,151,48,146,17,524
51510000203,3868,3308,2333,499,243,63,181,11,975
51740000011,2665,1694,52,20,1614,23,6,3,1642
51011000502,869,708,511,6,173,18,1,1,197
51177000603,4345,3242,1866,647,569,94,101,10,1376
51177000204,5885,4336,2613,524,907,127,191,14,1723
51041000317,6303,4764,3350,253,833,87,257,4,1414
51083000601,1682,1313,924,27,347,13,3,3,389
51083000605,716,577,382,9,176,6,2,1,195
51041000109,7758,5837,3076,501,1602,92,590,4,2761
51041000514,5224,3868,3055,153,338,49,295,4,813
51085000503,3279,2432,1889,83,309,72,70,3,543
51085000507,3284,2471,2058,83,170,48,90,0,413
51047000302,2799,2147,1835,101,135,39,25,1,312
51041000407,2424,1883,1500,81,165,32,92,4,383
51091000007,262,224,216,0,0,5,0,0,8
51047000704,1000,784,670,28,39,29,8,0,114
51091000003,170,145,138,3,1,5,0,0,7
51041000306,5038,3892,3277,102,350,85,71,7,615
51570000004,4814,3800,2632,214,668,87,222,11,1168
51169000602,1966,2088,1982,38,32,23,6,7,106
51017000102,143,127,115,4,5,3,1,0,12
51153000603,4882,3537,620,990,1508,69,417,17,2917
51153000611,4187,3013,722,798,1039,44,462,10,2291
51087000316,5039,3617,1551,137,476,36,1400,2,2066
51087000311,3483,2419,1388,83,104,26,815,4,1031
51760000302,2162,1803,561,15,1197,21,16,1,1242
51680000305,5889,4849,3204,288,899,97,347,6,1645
51087000303,5134,3746,1904,115,345,48,1337,8,1842
51087000507,934,801,681,18,73,20,14,1,120
51025000402,582,471,137,6,326,3,3,1,334
51061000401,4269,3343,2533,398,270,94,74,7,810
51087000102,6777,5265,2055,700,1838,112,581,17,3210
51760000106,2637,2020,1905,31,34,12,35,0,115
51760000303,1541,1204,340,28,803,21,25,0,864
51760000509,3637,2712,596,107,1922,52,40,5,2116
51059000609,3142,2478,1834,299,204,44,113,12,644
51059000611,4248,3001,2559,150,107,38,121,6,442
51059000605,3510,2471,2086,152,47,30,125,10,385
51059000209,4942,3893,2445,335,537,47,535,5,1448
51059000902,8630,6510,1908,1644,635,98,2320,13,4602
51059000735,2199,1828,1087,128,77,6,520,3,741
51087000216,1566,1302,835,88,272,30,72,4,467
51105000102,1102,864,837,6,1,21,0,0,27
51760000113,2991,2740,2300,126,162,36,104,6,440
51135000302,700,563,381,18,149,11,3,0,182
51089000202,2311,2008,1419,43,506,25,7,3,589
51013000006,4588,4272,2480,373,456,71,884,11,1792
51013000007,4440,3380,2575,279,138,36,340,3,805
51153000705,5151,3737,934,1887,544,135,364,10,2803
51640000003,1572,1280,1139,68,53,17,7,1,141
51059000704,3533,2757,1539,161,91,23,912,20,1218
51059000733,6921,5311,2839,352,389,31,1679,13,2472
51059000324,8583,6533,2130,2245,732,207,1389,11,4403
51059000237,8584,6277,1639,624,917,63,3078,15,4638
51059000221,3447,2691,2094,171,121,41,247,10,597
51059000714,5893,4614,1784,676,334,57,1756,14,2830
51059000119,5831,4376,2680,505,296,64,834,7,1696
51089000304,2731,2245,1162,79,973,15,19,3,1083
51059000234,3545,3003,2291,185,216,37,288,6,712
51059000839,4718,3572,2420,199,282,43,603,15,1152
51059000515,3069,2439,769,988,65,75,615,4,1670
51059000404,5790,4721,2330,523,932,98,903,17,2391
51680000404,4968,3857,2667,122,909,78,94,1,1190
51550000050,3942,3069,1530,198,1130,90,199,11,1539
51550000024,4675,3475,1672,237,1437,86,104,10,1803
51059000401,4936,3748,2204,486,509,78,488,14,1544
51059000419,5481,4261,1733,737,885,87,884,22,2528
51059000331,2979,2210,1479,93,49,9,557,3,731
51059000503,2315,1856,1181,385,72,43,204,4,675
51059000844,5476,4575,2210,499,601,70,1216,9,2365
51121000702,6650,5863,3695,388,408,59,1294,6,2168
51169000203,1619,1342,1311,6,3,16,0,1,31
51143000106,1948,1538,1273,36,187,27,8,0,265
51059000612,2130,1442,1247,64,32,22,60,9,195
51099000102,2373,1803,1306,100,268,95,46,3,497
51105000402,701,524,508,0,0,10,1,0,16
51015000503,1720,1371,1320,11,8,25,7,0,51
51700000312,1192,797,38,14,740,9,8,2,759
51700000107,5834,4537,1988,352,1831,103,336,11,2549
51595000401,1044,832,343,27,436,21,27,10,489
51107000703,5470,4098,1276,1331,455,54,1020,10,2822
51700000213,1656,1319,966,52,211,27,87,2,353
51700000104,4596,3511,1046,375,1827,88,280,24,2465
51810000085,5554,4209,3288,259,288,104,275,12,921
51163000103,710,587,552,10,4,19,2,1,35
51163000303,767,624,562,8,34,14,3,0,62
51079000102,2959,2192,1859,89,159,31,31,5,333
51590000002,1292,1278,712,21,519,10,17,0,566
51590000014,560,440,49,10,369,10,8,0,391
51107000217,4458,3309,2138,239,177,38,708,11,1171
51775000003,1445,1135,1029,18,34,24,29,3,106
51041000413,4234,3251,1962,323,746,85,165,1,1289
51041000310,4257,3276,2762,121,243,40,96,3,514
51157000201,1484,1209,1075,33,42,24,23,3,134
51620000401,1214,909,128,17,755,17,3,3,781
51650000116,2320,1777,603,114,973,75,69,8,1174
51087000315,8428,6799,2404,487,1783,87,2023,11,4395
51003000101,4043,3105,2161,185,433,45,271,2,944
51059000333,2492,1779,1267,122,50,11,300,9,512
51059000225,7143,5538,2583,1264,937,138,698,11,2955
51059000527,3380,2686,946,545,296,41,868,10,1740
51059000622,6913,5206,1361,1037,1798,109,1049,21,3845
51059000314,3724,2911,1824,183,119,26,769,6,1087
51181000101,1301,1089,827,12,229,15,3,2,262
51093000102,3774,2878,2099,86,554,62,74,7,779
51059000227,2345,1761,1341,94,45,11,270,2,420
51059000429,10342,7103,926,3558,1951,208,675,9,6177
51109000502,2138,1649,1257,63,283,55,9,1,392
51025000101,768,606,295,22,280,7,4,0,311
51735000001,4245,3279,2937,100,68,69,77,16,342
51025000203,1030,821,319,6,494,4,2,0,502
51051000202,369,290,288,1,1,1,0,0,2
51087000313,6554,4877,3194,168,283,49,1158,2,1683
51087000217,1390,1029,511,43,227,22,215,2,518
51550000044,3334,2541,1152,151,1000,55,203,8,1389
51089000102,2668,2093,1797,118,129,64,8,2,296
51089000502,1749,1593,1232,45,285,24,7,2,361
51089000305,1475,1166,700,58,393,15,16,0,466
51013000030,5052,3882,1226,1016,1221,106,423,9,2656
51013000047,3514,2945,1226,761,500,84,443,0,1719
51800000706,6724,4912,1205,290,3246,108,163,16,3707
51800000101,3774,2852,1117,242,1320,59,145,7,1735
51800000704,4223,3043,1289,183,1408,61,135,4,1754
51153000313,3843,2780,927,448,921,86,476,29,1853
51059000226,4501,3313,2525,143,77,36,523,5,788
51059000506,5651,3752,202,3185,34,404,310,0,3550
51127000102,1133,886,739,29,82,34,11,4,147
51510000307,5912,4853,1777,855,1472,100,748,12,3076
51087000113,1786,1445,903,108,297,24,113,0,542
51041000210,6388,4788,1986,395,2078,91,284,11,2802
51087000108,5409,4300,2813,238,589,51,591,1,1487
51045000401,344,275,259,3,1,10,0,1,16
51041000401,2577,2129,1643,97,214,33,102,2,486
51041000406,3240,2491,2133,57,153,19,96,2,358
51041000403,5022,3755,2877,172,386,40,270,6,878
51145000302,2268,2249,1770,76,363,30,19,3,479
51087000112,4754,3715,2095,288,685,61,549,1,1620
51710000302,3534,2803,811,317,1444,50,208,11,1992
51059000322,4248,3163,2207,136,88,44,669,2,956
51153000306,4270,3510,2003,361,832,75,283,6,1507
51013000051,947,917,721,35,27,4,132,0,196
51013000014,2957,2689,2015,170,113,20,365,6,674
51013000001,5967,4608,1161,1633,1088,97,713,7,3447
51059000847,4245,3186,1679,312,200,44,961,10,1507
51059000123,6179,4830,2718,517,276,59,1233,15,2112
51550000041,6713,4662,2567,254,1423,133,292,25,2095
51059000928,3923,2977,1498,162,125,23,1162,3,1479
51059000703,4033,3256,1326,963,365,111,566,8,1930
51700000303,2955,2234,716,107,1364,52,36,11,1518
51700000208,2082,1725,1472,70,106,32,46,3,253
51700000309,1676,1198,72,29,1082,35,5,12,1126
51161000305,4692,3680,3151,108,148,54,200,6,529
51161000303,2424,1920,1637,73,100,32,78,1,283
51810000033,2041,1645,1499,41,24,30,30,2,146
51095000302,1850,1429,818,93,462,30,48,3,611
51700000210,5603,4392,2501,310,1198,94,355,25,1891
51700000310,2387,1553,54,37,1464,30,6,1,1499
51595000301,824,638,257,19,337,14,15,2,381
51009000301,1805,1441,1064,28,246,78,8,3,377
51161000204,3270,2696,2178,81,264,43,132,5,518
51810000076,5646,4598,2067,502,1699,151,296,22,2531
51740000033,1746,1402,1172,39,123,38,19,5,230
51041000113,4477,3512,1912,196,1254,57,111,7,1600
51041000506,4418,3364,2436,219,457,45,202,0,928
51059000824,5917,4283,2850,382,382,67,607,11,1433
51153000405,8321,6154,1874,2519,971,194,764,6,4280
51059000522,1840,1457,1064,96,36,7,216,0,393
51153000308,2608,1884,1220,214,331,51,84,5,664
51153000314,3278,2381,1090,280,669,50,336,5,1291
51760000208,2809,2515,2128,113,125,22,125,3,387
51735000003,3882,3030,2692,77,38,59,136,9,338
51153000202,4846,3576,2304,637,393,83,183,7,1272
51059000224,6501,5507,4049,396,334,62,622,11,1458
51810000066,3803,2879,2208,175,271,68,176,8,671
51775000010,3349,2796,2302,54,261,34,125,5,494
51510000101,3385,3222,2346,193,422,46,190,5,876
51137000501,3762,3089,2592,135,196,59,92,5,497
51173000703,247,204,181,5,4,9,4,0,23
51087000204,1113,901,539,82,198,35,50,3,362
51003000305,3771,2862,2262,140,233,16,189,1,600
51153000315,3738,2602,359,491,1474,53,310,12,2243
51059000307,3741,2619,1874,104,42,27,541,5,745
51015000102,3034,2348,2002,101,175,38,19,0,346
51550000055,2206,1837,573,58,1164,19,27,1,1264
51550000012,3082,2375,448,91,1749,43,84,5,1927
51059000127,7137,5418,3045,830,424,73,1095,8,2373
51680000104,2014,1710,1257,73,267,25,54,19,453
51059000306,2619,2037,1599,95,49,20,260,4,438
51059000116,3132,2328,1599,182,74,39,425,2,729
51059000424,3632,2917,1673,392,455,53,347,12,1244
51107000507,2378,1839,1371,172,147,18,115,5,468
51161000501,2401,1756,1488,24,27,27,174,0,268
51810000074,4630,3570,1588,310,1103,88,547,33,1982
51595000601,720,582,309,46,225,3,5,5,273
51005005301,833,676,654,4,0,13,3,0,22
51700000216,2227,1850,1299,81,374,48,80,6,551
51085000405,2213,1601,1297,32,164,27,68,0,304
51041000313,6564,4702,3721,181,496,66,252,3,981
51153000408,4141,3013,1159,1367,257,132,209,3,1854
51109000402,1275,982,736,19,203,21,7,2,246
51059000236,1813,1407,942,128,93,15,216,3,465
51107000216,3620,2652,1912,139,138,34,388,1,740
51125000302,417,345,259,12,72,6,0,1,86
51185000302,878,705,693,4,3,5,0,0,12
51510000302,5615,4712,1692,789,1748,61,479,10,3020
51153000507,4420,3284,1300,555,885,78,551,2,1984
51087000218,475,416,248,27,125,14,1,0,168
51059000514,2670,2187,826,768,396,30,204,4,1361
51097000301,1386,1162,795,34,284,25,18,0,367
51097000501,1205,1006,821,26,125,23,6,0,185
51013000008,6095,5699,3176,631,576,87,1255,22,2523
51059000125,4248,3211,2056,330,152,41,654,1,1155
51059000528,1730,1287,802,81,51,19,329,3,485
51169000304,334,288,279,1,2,4,0,0,9
51181000502,458,371,78,3,285,5,0,0,293
51083000304,1163,923,646,12,255,12,3,0,277
51185000107,248,197,181,3,1,13,1,0,16
51153000114,4969,3251,1715,386,443,56,682,3,1536
51013000043,6486,4676,625,2408,937,192,699,16,4051
51013000045,5135,4057,1643,1363,555,191,511,7,2414
51087000221,738,629,434,44,121,27,12,2,195
51181000301,671,514,283,12,208,9,2,0,231
51087000310,5075,3603,2577,130,171,33,662,3,1026
51013000022,3788,3193,2320,400,241,46,196,8,873
51595000701,808,573,119,62,388,5,3,2,454
51059000325,6247,4593,970,1757,640,89,1212,6,3623
51013000042,3852,3374,2059,453,508,56,307,3,1315
51059000223,5360,4302,2859,337,366,62,666,8,1443
51690000003,2636,1903,754,258,875,25,19,4,1149
51087000302,3383,2787,2280,95,170,25,212,2,507
51069000501,4312,3177,2571,241,180,63,133,1,606
51059000216,2951,2131,1051,528,73,30,456,4,1080
51085000604,2476,2085,1816,63,129,26,33,2,269
51153000309,3230,2271,1278,258,532,75,183,5,993
51087000219,411,339,97,15,205,7,13,0,242
51077004011,82,65,59,2,3,2,0,0,6
51185000106,771,679,581,12,74,10,0,0,98
51013000048,3476,3162,2380,212,101,34,429,7,782
51019000304,1420,1116,965,19,95,17,7,0,151
51017000302,233,193,191,1,2,0,0,0,2
51087000205,453,449,439,3,9,1,0,0,10
51520000042,0,0,0,0,0,0,0,0,0
51059000700,278,610,225,89,266,5,31,2,385
51153001062,77,535,132,134,269,0,5,5,403
51121004032,4,3,0,0,0,3,0,0,3
