GEOID,TOTAL_POP,TOTAL_VAP,WHITE_VAP,HISPANIC_VAP,BLACK_VAP,NATIVE_VAP,ASIAN_VAP,PACIFIC_VAP,MINORITY_VAP
45079000401,944,584,31,2,547,5,0,0,553
45079000132,1205,985,34,15,935,11,9,1,951
45079000458,3678,3167,539,179,2449,29,3,5,2628
45079000446,2846,2241,270,229,1747,27,53,4,1971
45079000426,4466,3567,777,357,2426,64,55,8,2790
45079000129,2030,1631,224,36,1356,14,15,8,1407
45071000005,857,652,112,51,482,19,4,0,540
45071000020,934,729,433,100,171,33,5,0,296
45071000001,724,532,249,60,216,21,3,2,283
45071000034,157,126,109,2,12,2,0,0,17
45071000040,1083,875,776,15,62,14,2,0,99
45071000015,2076,1761,1581,31,107,27,5,0,180
45079000448,3420,2457,1124,110,1133,46,68,8,1333
45079000126,10666,8494,3891,1891,2191,120,491,71,4603
45079000483,4592,3524,1647,265,1405,53,177,12,1877
45079000484,3436,2545,1182,155,934,50,234,4,1363
45071000002,2330,2120,1540,257,296,23,11,0,580
45071000019,679,548,399,19,114,15,0,0,149
45071000042,1504,1160,789,88,269,12,1,0,371
45071000027,2131,1599,649,290,636,19,13,4,950
45079000480,2522,1896,312,71,1484,31,21,2,1584
45079000479,1810,1326,165,52,1101,10,12,2,1161
45079000102,2394,2333,1565,133,462,26,158,1,768
45079000455,2531,2070,851,62,1098,33,41,1,1219
45079000507,2530,1928,727,145,974,32,70,3,1201
45079000442,2151,1738,279,46,1406,22,7,2,1459
45079000441,1825,1482,234,26,1210,4,6,3,1248
45079000403,2585,2119,1739,74,177,34,93,3,380
45079000402,2309,1723,1213,71,241,37,162,0,510
45079000431,2515,1867,1059,79,643,40,56,3,808
45079000420,1931,1402,967,42,277,26,84,2,435
45079000478,2726,2050,443,110,1415,54,54,4,1607
45079000413,3169,2239,553,100,1504,20,74,7,1686
45079000474,3503,2603,788,145,1586,46,95,4,1815
45079000452,2980,2262,83,80,2086,24,9,0,2179
45079000440,1865,1536,703,82,719,27,21,2,833
45079000492,1883,1502,983,41,434,16,30,1,519
45079000493,1954,1494,965,57,334,26,115,1,529
45079000491,1567,1143,907,20,145,20,46,3,236
45079000109,1379,1233,119,34,1059,18,21,4,1114
45079000449,4335,3200,962,165,1966,70,105,9,2238
45079000408,3818,2876,1291,119,1387,31,65,3,1585
45079000501,3572,2677,2358,70,113,69,55,3,319
45079000421,3596,2456,1903,91,304,37,120,0,553
45079000400,2200,1725,1016,67,539,23,76,5,709
45079000513,3325,2611,544,109,1880,48,70,1,2067
45071000007,1297,884,111,88,678,22,2,0,773
45071000008,1998,1522,810,105,579,24,21,1,712
45079000123,1308,1040,806,17,170,13,33,0,234
45079000457,2326,1840,1336,65,352,40,49,5,504
45079000417,1696,1312,589,68,577,23,55,5,723
45079000118,2026,1669,478,83,1073,18,13,4,1191
45079000464,4509,3472,1418,160,1734,80,137,11,2054
45079000508,3719,2875,1404,368,908,62,172,14,1471
45079000514,3982,3350,2018,130,904,44,270,6,1332
45079000463,1758,1387,639,59,617,24,55,8,748
45079000465,2863,2255,570,143,1468,53,55,2,1685
45079000114,2026,1670,1474,48,101,12,29,1,196
45079000467,1120,821,563,19,204,24,9,1,258
45079000466,1871,1358,886,62,310,50,73,1,472
45079000468,1532,1120,647,57,374,15,35,0,473
45071000039,1027,833,578,52,193,7,2,1,255
45071000013,889,779,590,11,161,15,0,0,189
45071000036,1099,838,481,31,307,10,6,0,357
45071000051,1632,1282,810,42,404,22,6,0,472
45071000028,1504,1207,915,23,245,13,10,2,292
45079000462,2478,2028,871,81,1032,37,20,4,1157
45079000113,2788,2332,1962,94,173,35,64,10,370
45079000494,3706,2931,1584,116,1106,54,67,14,1347
45079000450,4179,3211,660,83,2408,33,55,12,2551
45079000459,1070,927,503,28,374,5,17,2,424
45079000406,2980,2377,1672,92,493,48,84,11,705
45079000430,1995,1652,1396,39,165,25,38,8,256
45079000131,1728,1494,236,45,1200,20,13,0,1258
45079000103,2011,1654,1074,41,475,27,48,8,580
45079000405,3208,2668,240,83,2340,37,19,2,2428
45079000415,2288,1695,85,73,1523,23,14,0,1610
45079000427,1046,885,12,18,860,16,1,0,873
45079000122,2175,1727,169,68,1487,11,8,6,1558
45079000439,3481,2811,1238,124,1337,45,78,16,1573
45079000472,1784,1276,574,56,586,25,40,4,702
45079000125,2579,1965,1660,121,146,20,17,1,305
45023000001,2059,1568,810,29,699,26,5,0,758
45023000003,1237,1018,672,11,315,13,3,5,346
45023000011,2436,1867,1268,46,492,42,16,3,599
45079000497,4584,3231,682,175,2196,66,176,14,2549
45079000454,2991,2011,277,109,1544,28,71,16,1734
45079000509,5427,4054,674,189,3067,43,115,6,3380
45027000016,1615,1469,559,45,866,11,1,0,910
45027000019,349,284,96,15,170,3,1,0,188
45027000006,2116,1812,1051,51,677,38,12,1,761
45027000020,2784,2431,1533,45,775,51,19,5,898
45027000021,565,482,146,5,325,5,1,0,336
45079000506,1467,1231,929,55,187,21,52,4,302
45079000410,3590,2665,826,134,1628,53,67,2,1839
45079000411,3750,2939,795,255,1729,46,187,13,2144
45079000460,4819,3560,598,417,2389,69,154,1,2962
45079000445,3359,2581,413,242,1785,70,124,2,2168
45059000007,1703,1357,875,44,398,26,20,0,482
45059000001,1037,795,288,28,461,0,6,0,507
45059000006,1848,1502,1097,52,315,22,14,2,405
45059000004,1308,997,226,25,733,14,13,0,771
45059000005,2349,1864,1170,186,490,27,31,0,694
45079000433,2035,1552,785,100,591,50,45,4,767
45079000471,1534,1267,728,61,373,21,84,0,539
45063000054,2730,2274,1583,85,458,53,120,7,691
45079000503,4099,3106,819,163,2053,37,62,6,2287
45089000022,474,382,130,4,246,2,2,1,252
45089000014,3978,3126,1426,34,1566,36,63,3,1700
45035000049,1644,1280,923,40,260,29,26,10,357
45035000092,1166,949,859,8,52,12,12,2,90
45035000043,2214,1666,1208,73,288,57,48,4,458
45035000072,4762,3249,2254,125,745,79,43,11,995
45035000107,1273,924,722,39,97,42,10,4,202
45035000073,2190,1715,1156,81,361,30,88,4,559
45035000063,3361,2591,1531,197,642,58,176,12,1060
45079000511,1598,1324,495,47,758,29,4,1,829
45079000423,1502,1205,140,18,1045,22,5,0,1065
45079000496,2109,1734,656,78,940,43,46,2,1078
45079000104,1969,1776,1225,37,453,29,33,2,551
45079000515,5058,3767,892,823,1873,94,157,28,2875
45079000447,2553,1988,887,76,976,50,23,5,1101
45079000106,1834,1534,926,56,501,30,21,3,608
45059000013,2759,2349,1679,76,529,20,43,2,670
45059000022,4556,3378,2228,313,737,91,11,6,1150
45045000337,8550,5966,4439,482,649,105,266,14,1527
45083000027,1977,1555,1315,91,111,33,4,2,240
45079000453,6737,4889,2711,209,1773,53,184,17,2178
45015000002,350,276,240,11,12,9,3,0,36
45015000035,1586,1217,1017,36,120,24,12,2,200
45015000085,3422,2410,1422,130,743,50,96,7,988
45015000088,42,35,32,0,0,2,1,1,3
45015000093,2566,1805,935,109,663,41,53,8,870
45015000098,0,0,0,0,0,0,0,0,0
45015000029,2245,1746,1587,37,82,28,9,1,159
45015000096,306,224,213,3,1,3,4,0,11
45015000001,1230,977,487,4,464,19,2,1,490
45015000087,3803,2849,1490,230,947,55,101,7,1359
45015000099,6,5,4,0,1,0,0,0,1
45015000057,3754,2690,1430,175,800,48,193,12,1260
45015000058,4026,2947,1517,282,912,54,182,20,1430
45015000054,2179,1678,795,179,547,85,84,11,883
45015000012,2858,2353,2085,148,25,12,67,6,268
45015000063,3549,2620,2286,103,103,57,57,6,334
45015000064,3772,3016,2250,140,497,43,70,0,766
45015000062,4103,3206,2853,115,55,35,118,7,353
45059000018,2938,2153,1332,188,542,64,21,11,821
45059000029,919,737,661,7,52,7,5,0,76
45059000015,2086,1585,661,34,846,30,6,1,924
45057000009,3126,2302,1176,225,865,29,8,0,1126
45057000023,1176,921,600,28,272,18,5,0,321
45057000026,1302,1041,774,47,195,18,9,1,267
45057000013,1550,1251,870,19,334,17,6,1,381
45023000018,1533,1205,904,53,199,34,6,5,301
45059000002,964,676,184,29,444,13,3,0,492
45059000003,2155,1544,711,220,611,21,5,2,833
45059000009,2870,2127,1328,321,437,55,8,4,799
45059000020,2098,1664,1053,139,423,39,8,0,611
45059000010,1644,1252,846,83,269,44,5,1,406
45029000024,901,702,542,16,92,56,2,0,160
45029000029,1918,1480,767,45,628,19,30,1,713
45029000019,1754,1195,569,29,529,32,42,1,626
45029000015,948,771,414,9,329,18,7,0,357
45029000025,1245,1026,453,17,531,25,0,1,573
45029000031,1960,1505,337,25,1134,17,4,0,1168
45029000040,2119,1600,871,65,625,44,3,3,729
45029000032,2161,1723,1101,63,479,47,41,5,622
45029000036,2136,1665,1246,62,309,23,26,2,419
45029000017,2134,1638,1063,46,479,37,6,3,575
45059000014,3039,2296,1782,105,346,52,10,1,514
45029000033,404,312,204,4,100,1,1,2,108
45079000505,2620,1945,1743,52,76,28,25,9,202
45079000504,2866,2119,1868,44,103,17,76,0,251
45079000105,8651,8406,6360,431,757,76,796,10,2046
45089000011,1974,1599,578,20,979,10,14,2,1021
45015000027,716,574,292,4,267,9,2,0,282
45015000034,2159,1612,1233,62,279,28,8,1,379
45015000070,2162,1521,874,89,499,26,17,5,647
45015000031,3070,2409,1480,41,826,32,28,2,929
45015000049,3703,2678,1686,111,753,62,47,7,992
45015000084,3499,2595,1626,238,574,62,111,9,969
45015000086,1017,739,447,60,180,15,42,0,292
45015000097,2619,2058,1559,138,253,36,73,10,499
45015000007,1522,1236,336,48,821,17,16,4,900
45015000038,2055,1446,932,148,247,64,31,10,514
45015000040,2109,1542,960,120,378,36,36,4,582
45015000071,1991,1505,941,110,388,62,35,1,564
45015000045,2110,1754,1308,56,185,30,171,1,446
45015000047,3016,2263,1291,394,400,87,112,6,972
45015000073,1899,1449,1064,87,194,27,70,2,385
45015000072,2595,2072,1350,180,417,55,74,0,722
45015000066,3657,2616,1489,296,682,78,90,1,1127
45057000010,4299,3090,1501,307,1227,68,15,1,1589
45057000005,2160,1632,345,104,1169,18,10,1,1287
45057000018,3857,2947,1746,256,899,50,11,3,1201
45057000041,1738,1421,1093,47,239,27,20,5,328
45057000033,1761,1359,1039,126,148,11,34,1,320
45057000035,5711,4298,3088,382,511,73,223,12,1210
45057000032,4291,3091,2317,242,329,47,143,1,774
45057000021,4742,3514,2447,387,352,77,229,2,1067
45023000026,1813,1356,856,11,456,26,8,1,500
45023000031,2099,1594,814,41,706,38,22,1,780
45023000033,1654,1262,884,36,313,21,2,0,378
45007000045,855,683,579,17,65,20,1,0,104
45057000038,6426,4715,3476,370,695,60,122,8,1239
45057000036,1601,1505,1310,39,105,25,18,0,195
45057000019,2459,2213,1231,64,869,40,7,0,982
45035000109,2002,1406,915,90,238,34,126,7,491
45035000076,6235,4277,2338,381,1167,59,317,16,1939
45035000102,2264,1574,909,116,464,34,54,7,665
45057000007,3035,2351,2059,41,192,44,20,1,292
45057000022,1729,1368,1202,15,126,15,4,0,166
45061000004,970,775,158,11,594,12,2,1,617
45061000008,781,607,246,19,333,10,0,0,361
45085000116,1262,1017,600,18,384,15,4,0,417
45089000016,2843,2269,159,10,2093,5,10,0,2110
45089000015,1608,1152,67,19,1070,19,12,5,1085
45089000004,418,362,167,2,192,8,1,0,195
45035000048,2965,2271,1175,110,889,81,44,2,1096
45035000069,2971,2186,1538,81,465,54,25,3,648
45035000031,1452,1179,697,32,413,38,9,2,482
45035000027,1711,1369,648,27,665,22,10,3,721
45089000002,1078,850,352,6,487,6,2,1,498
45089000009,466,362,243,4,110,3,1,1,119
45089000005,1032,834,279,13,541,5,3,1,555
45089000013,1632,1308,274,6,1014,10,5,1,1034
45035000044,2367,1804,1536,78,113,33,43,2,268
45035000029,1344,1078,625,22,415,9,6,1,453
45035000028,1184,932,540,7,361,24,3,1,392
45035000026,1053,816,492,11,277,24,13,2,324
45089000008,1645,1342,241,21,1075,14,2,1,1101
45089000029,2542,2288,441,231,1598,36,16,3,1847
45085000153,2088,1391,829,177,260,27,87,28,562
45085000105,2498,1927,1097,54,668,57,51,7,830
45085000110,1610,1296,799,79,320,43,63,1,497
45023000004,918,750,535,14,191,7,3,0,215
45023000030,1439,1070,304,15,729,14,10,0,766
45035000096,836,616,394,39,156,14,14,1,222
45023000013,1120,922,731,15,147,26,4,0,191
45085000128,1213,826,152,46,626,10,1,0,674
45085000127,1967,1393,284,70,1029,18,3,1,1109
45085000131,1222,957,93,40,840,13,0,0,864
45085000108,614,478,94,11,360,11,2,1,384
45085000126,1774,1219,181,99,939,19,2,2,1038
45007000066,1107,923,865,16,31,12,1,0,58
45007000071,3465,2675,2072,116,428,51,8,2,603
45035000104,2136,1645,860,90,619,37,48,8,785
45035000038,2082,1534,703,115,626,48,45,6,831
45035000095,1186,962,414,11,511,16,10,2,548
45027000007,864,665,314,20,321,11,8,0,351
45027000011,1042,787,256,12,513,10,6,0,531
45085000130,1084,813,64,8,736,15,1,0,749
45085000152,3117,2378,1065,80,1105,31,104,5,1313
45085000155,1849,1521,891,30,559,21,20,2,630
45007000015,1232,931,825,29,54,20,1,0,106
45007000064,4138,2999,2630,96,119,93,25,0,369
45077000131,2186,1725,1541,55,52,50,18,0,184
45077000156,1768,1371,1217,65,37,31,6,1,154
45007000013,3108,2423,1957,58,315,69,13,0,466
45007000053,4750,3822,2651,154,809,93,106,3,1171
45077000101,2016,1647,1283,70,205,28,59,2,364
45035000105,1332,944,603,51,225,41,25,1,341
45035000066,3470,2407,1749,103,418,41,74,1,658
45035000087,1008,804,605,28,129,24,16,3,199
45035000079,2266,1696,1160,96,352,37,59,4,536
45035000034,1268,1018,535,51,258,167,6,1,483
45015000024,2729,2330,1113,55,1119,32,7,0,1217
45035000101,2001,1791,624,53,1085,30,11,0,1167
45089000032,341,270,212,0,56,3,0,0,58
45089000030,534,412,290,10,106,8,3,2,122
45089000018,986,793,85,5,694,8,6,3,708
45035000090,2849,2110,1320,210,447,86,42,5,790
45035000108,2321,1581,1100,89,292,61,45,0,481
45035000042,3521,2658,2178,111,265,68,37,4,480
45087000003,1576,1242,905,9,298,18,5,5,337
45087000018,1651,1270,545,13,700,6,5,3,725
45087000011,1352,1097,780,16,275,19,5,0,317
45087000023,380,311,231,1,76,4,0,0,80
45015000082,5590,4682,3281,632,468,74,247,38,1401
45015000081,3030,2279,993,285,743,52,174,7,1286
45015000100,957,755,378,46,177,28,110,1,377
45015000068,2829,2207,1632,204,245,57,78,10,575
45087000012,936,762,654,3,77,27,3,3,108
45089000006,1016,790,537,30,220,5,4,0,253
45015000011,1630,1331,824,28,430,32,13,0,507
45015000069,1770,1439,409,22,980,30,6,3,1030
45015000026,1972,1536,760,50,696,22,4,0,776
45015000030,1324,1046,702,10,320,10,3,1,344
45015000003,1892,1470,993,21,425,21,12,0,477
45015000037,1755,1422,291,12,1111,14,5,2,1131
45007000068,3080,2364,2052,129,91,78,10,1,312
45007000070,4799,3645,3038,189,286,89,27,7,607
45007000062,4165,3145,2688,112,187,94,53,0,457
45007000057,1486,1266,1185,23,25,26,4,0,81
45007000111,2832,2190,1737,54,347,38,23,0,453
45007000011,3376,2632,2007,89,465,61,11,1,625
45007000039,2192,1646,1402,16,207,13,8,0,244
45007000010,586,455,426,7,9,7,5,0,29
45001000012,1906,1474,1234,20,186,23,3,5,240
45001000006,730,602,499,9,77,14,0,0,103
45007000042,2001,1617,1484,22,64,38,9,2,133
45001000013,1572,1292,1140,12,95,28,12,3,152
45007000058,1172,928,736,17,161,10,5,1,192
45015000042,2059,1582,337,14,1192,32,15,1,1245
45015000079,3979,2921,942,565,1115,117,175,6,1979
45015000080,3114,2275,1045,581,403,69,188,6,1230
45015000077,2960,1981,1480,89,213,27,161,5,501
45015000078,2732,2009,1492,148,185,34,117,6,517
45015000076,1863,1449,912,155,291,44,50,1,537
45015000023,2486,1920,982,506,333,41,61,3,938
45015000022,2578,1958,1261,337,241,45,61,3,697
45015000067,3894,2777,1818,183,599,79,112,12,959
45015000060,1511,1071,530,65,418,29,25,6,541
45015000008,2474,1953,1514,116,135,105,42,2,439
45015000094,2005,1479,935,68,404,43,24,4,544
45015000059,3433,2345,1174,152,879,56,93,9,1171
45015000090,2008,1522,1211,75,134,33,58,6,311
45085000125,2173,1583,331,62,1165,27,18,2,1252
45085000158,1316,1030,693,25,274,12,22,3,337
45015000009,1460,1096,840,89,109,22,40,1,256
45015000083,2172,1661,1105,128,308,38,51,7,556
45015000092,3345,2441,1187,225,925,61,66,7,1254
45007000069,893,685,549,18,93,13,6,0,136
45027000022,1385,1096,219,25,845,12,6,0,877
45027000014,2131,1583,236,42,1283,10,15,1,1347
45015000041,488,399,278,4,114,4,0,0,121
45051000109,3853,3339,2965,119,134,55,32,8,374
45051000219,2697,2471,2332,45,27,32,22,2,139
45051000163,1328,1007,757,24,198,27,4,2,250
45051000138,2768,2499,2332,40,31,72,18,0,167
45051000231,2309,2102,1875,69,75,25,43,5,227
45051000232,3298,3040,2655,127,108,35,72,2,385
45051000154,1778,1603,1329,72,90,50,38,3,274
45051000168,2021,1579,1129,57,383,26,4,1,450
45015000044,4310,2861,1410,592,690,104,34,5,1451
45015000074,2648,1977,1053,199,596,69,54,13,924
45015000033,3461,2527,1179,84,1156,98,31,8,1348
45085000156,2515,1870,862,113,769,62,83,3,1008
45085000150,2392,1779,1373,17,329,46,8,3,406
45085000111,2366,1777,998,48,644,34,43,1,779
45085000124,1061,879,632,27,201,13,12,2,247
45085000102,652,541,88,14,431,5,7,0,453
45089000024,611,518,82,4,431,3,1,1,436
45035000070,2206,1629,1381,56,101,45,36,2,248
45007000049,3379,2673,1955,56,590,61,10,1,718
45007000024,2091,1737,1522,38,84,41,37,5,215
45007000033,3705,2989,2586,75,230,70,19,1,403
45015000046,3338,2587,1528,311,570,73,120,2,1059
45027000008,1025,774,609,28,130,7,0,0,165
45007000047,1751,1341,1016,57,229,36,2,4,325
45007000028,2591,1991,1628,36,233,70,14,1,363
45007000032,2953,2253,1408,252,541,40,17,1,845
45007000029,1967,1668,1529,25,73,17,13,4,139
45007000073,1193,940,891,9,23,11,1,1,49
45031000026,1978,1582,988,24,537,22,13,0,594
45041000003,1142,924,475,19,417,8,2,1,449
45051000222,6090,4869,4090,204,373,82,77,12,779
45051000165,2887,2456,2225,80,77,17,19,2,231
45015000065,5038,3224,2181,233,564,85,157,4,1043
45015000091,3131,1975,1419,106,334,31,73,3,556
45015000048,1636,1223,525,46,563,70,24,2,698
45015000089,1877,1793,1645,35,66,25,19,2,148
45015000101,459,301,217,25,49,4,8,0,84
45057000011,1954,1497,1010,16,425,35,2,1,487
45057000004,790,621,428,9,172,7,2,0,193
45057000015,2024,1594,1356,18,197,24,6,2,238
45023000009,1611,1274,1001,30,201,30,10,1,273
45023000015,1228,973,748,22,169,30,2,1,225
45023000021,1946,1501,986,35,406,47,13,0,515
45023000022,1972,1522,1055,41,348,44,25,0,467
45035000056,620,482,347,24,88,13,7,1,135
45045000306,2296,1795,1190,266,277,55,24,0,605
45045000218,2136,1482,1401,21,21,15,23,1,81
45031000001,2372,1897,1200,29,646,24,1,0,697
45031000041,2283,1776,1126,35,581,30,6,1,650
45031000038,3945,3127,1928,41,1075,58,41,4,1199
45031000019,2061,1544,796,49,681,24,18,1,748
45031000017,3295,2520,1683,36,717,36,45,0,837
45045000260,2728,2083,1381,158,481,50,28,3,702
45045000346,2435,1879,1411,123,226,96,10,2,468
45045000286,3378,2661,2398,80,82,81,20,5,263
45045000259,5157,3906,2392,339,1087,64,32,3,1514
45015000032,2658,2029,1023,101,820,65,20,4,1006
45007000000,2489,1770,704,102,937,21,6,7,1066
45007000038,933,749,643,29,54,15,6,1,106
45007000051,1434,1097,960,49,37,41,6,1,137
45047000044,1679,1332,1113,27,105,15,72,1,219
45047000029,710,595,468,16,93,5,4,0,127
45047000009,928,737,668,3,43,9,5,0,69
45047000003,3385,2942,1808,147,928,32,38,1,1134
45047000007,2396,1880,645,278,952,32,20,1,1235
45047000035,1245,1022,681,34,260,12,32,2,341
45047000022,315,255,161,14,79,4,0,0,94
45047000025,1211,1009,479,23,491,9,9,0,530
45089000010,701,529,437,8,61,24,3,0,92
45015000095,2502,1991,1627,136,91,78,37,5,364
45015000014,3611,2758,1665,210,586,83,107,10,1093
45007000041,2661,2085,1808,33,176,54,10,0,277
45007000061,1232,975,805,5,135,29,2,0,170
45045000269,2193,1969,1871,29,23,35,5,2,98
45077000119,2141,1781,1667,34,27,39,8,1,114
45061000014,256,213,39,0,174,1,1,1,174
45061000017,458,377,84,2,283,2,8,0,293
45051000137,342,245,207,15,19,4,0,0,38
45051000104,3011,2267,1941,43,237,33,9,2,326
45015000013,2513,1848,1624,47,116,17,40,5,224
45015000061,2658,1876,1699,41,68,15,45,2,177
45015000005,3890,3047,1722,191,846,61,147,8,1325
45015000043,2178,1663,885,24,687,62,8,6,778
45047000020,945,776,655,18,88,9,5,3,121
45047000013,1198,876,756,16,87,15,6,1,120
45047000046,1154,894,687,11,180,13,5,1,207
45061000001,695,585,395,13,148,20,2,1,190
45051000189,2273,1795,927,65,763,35,21,5,868
45051000117,3667,2611,961,439,889,47,262,6,1650
45051000173,2458,2093,1801,71,114,25,64,0,292
45061000019,1164,919,256,6,648,5,4,0,663
45061000002,896,705,461,19,208,17,2,1,244
45061000009,526,444,65,7,376,3,0,0,379
45061000012,758,635,75,3,549,7,8,3,560
45047000049,1709,1362,1088,41,169,23,28,1,274
45047000008,1255,1024,626,71,322,9,1,0,398
45051000143,1597,1207,839,29,310,29,4,0,368
45061000016,628,500,286,6,204,4,0,2,214
45075000124,680,493,326,4,152,7,4,0,167
45075000139,1769,1446,814,30,538,53,11,1,632
45075000126,904,715,486,3,204,15,3,1,229
45045000349,2680,2137,1805,148,124,44,22,4,332
45045000303,3075,2506,1546,206,520,32,191,1,960
45045000251,2632,2086,1562,159,236,37,94,13,524
45045000297,4944,4058,2978,515,452,100,62,5,1080
45047000048,1706,1404,941,53,359,19,32,0,463
45035000077,3087,2148,611,222,1208,51,62,14,1537
45045000302,3984,3262,2177,382,543,66,101,8,1085
45045000249,2313,1732,1573,43,49,19,45,2,159
45045000282,2654,1937,1404,118,178,24,208,0,533
45045000332,4337,3298,1976,459,755,74,54,2,1322
45045000350,2213,1749,1473,85,128,41,15,2,276
45045000367,2462,1979,1299,229,372,41,39,2,680
45083000033,2380,1756,420,336,965,47,14,3,1336
45047000010,1061,850,544,11,245,22,33,2,306
45047000005,1200,872,222,111,528,14,10,0,650
45047000033,1192,978,768,32,167,6,7,0,210
45061000021,221,193,128,1,63,2,1,0,65
45047000023,216,177,126,8,40,1,0,0,51
45047000031,344,282,182,10,80,2,3,0,100
45007000083,2459,1844,520,142,1142,57,7,4,1324
45007000018,2437,1896,1619,65,146,44,1,0,277
45007000054,1663,1273,1090,48,101,21,6,1,183
45045000295,5218,3902,2594,234,934,89,32,5,1308
45007000025,3590,2931,2029,117,621,46,124,8,902
45007000084,2878,2305,1743,123,368,44,29,8,562
45031000018,1751,1360,41,1,1317,4,1,0,1319
45031000012,1999,1565,598,11,918,20,4,1,967
45031000032,1364,1066,720,17,323,8,2,1,346
45031000020,3642,2857,2355,37,351,57,57,0,502
45031000002,843,660,137,26,483,4,0,0,523
45045000284,5928,4233,1705,1807,645,151,33,9,2528
45045000256,4688,3681,2590,462,430,80,131,7,1091
45045000275,2888,2299,1930,58,167,78,19,1,369
45051000113,3035,2689,2369,92,129,60,27,2,320
45051000215,1094,898,784,29,65,23,5,0,114
45051000123,2167,1730,1214,63,396,37,10,1,516
45051000218,3104,2930,2720,63,66,38,24,3,210
45051000151,5234,4128,2681,106,1211,71,40,3,1447
45051000174,3233,2868,2460,99,180,77,48,5,408
45051000175,4312,3540,2592,207,637,69,26,3,948
45051000225,2452,2080,1694,56,253,36,35,2,386
45051000161,4425,3940,3395,151,250,84,48,9,545
45051000170,1747,1582,1370,66,97,8,28,0,212
45051000216,6674,5392,4124,454,602,124,110,5,1268
45051000171,2332,1977,1488,152,241,44,53,0,489
45051000191,1749,1358,923,61,319,36,7,0,435
45051000177,1514,1206,973,47,129,25,23,1,233
45047000034,1145,953,857,16,57,10,12,0,96
45047000050,1271,1042,897,12,103,30,8,2,145
45047000047,1243,948,385,21,515,19,8,0,563
45035000089,4253,2998,2059,322,462,98,55,12,939
45035000045,2026,1605,1150,32,353,36,27,3,455
45045000339,4589,3436,1336,841,1179,120,27,6,2100
45045000277,6409,5194,3381,483,852,76,374,14,1813
45045000224,7307,6205,4259,440,1084,130,283,16,1946
45045000214,2879,2096,289,45,1723,31,22,0,1807
45045000281,2930,2348,1519,227,471,68,69,2,829
45045000270,5479,4092,2159,930,864,157,54,6,1933
45051000127,1707,1379,1042,74,196,44,17,1,337
45051000214,1421,1141,482,41,583,23,18,7,659
45051000128,4339,3420,2250,108,990,60,29,3,1170
45051000183,2972,2545,1875,261,282,44,68,8,670
45051000182,2330,2040,1813,101,64,24,28,3,227
45051000112,2619,2000,1668,121,135,42,19,4,332
45051000133,3161,2486,1895,263,191,91,46,4,591
45051000230,2555,2091,1761,154,90,41,31,4,330
45013000180,1651,1307,304,51,935,7,7,1,1003
45013000185,1192,1122,1063,11,21,7,17,3,59
45013000208,1300,1246,1154,22,28,7,26,0,92
45013000131,2121,1671,1139,90,394,15,37,3,532
45013000140,1447,1168,810,41,282,9,23,1,358
45013000113,8096,6448,4035,1087,1081,90,209,26,2413
45013000181,1663,1309,410,71,818,14,8,3,899
45013000204,3809,2745,1034,1130,514,86,21,9,1711
45013000151,2070,1639,852,121,584,38,53,6,787
45013000150,1960,1585,1076,111,333,43,44,4,509
45013000225,1196,1104,980,63,25,19,15,2,124
45013000316,2053,1750,1614,54,44,22,12,0,136
45013000311,2308,1832,1530,115,101,26,73,0,302
45013000318,1906,1438,1074,153,144,24,34,0,364
45013000317,2483,2027,1721,114,114,18,59,1,306
45013000300,2568,2333,1987,157,137,16,35,0,346
45013000305,2380,1794,1151,457,143,53,22,1,643
45013000313,2881,2209,1793,161,137,31,75,7,416
45013000364,1463,1460,1391,25,25,11,5,0,69
45013000365,1345,1330,1284,19,15,5,8,1,46
45013000135,1738,1371,1164,65,105,19,28,0,207
45075000154,1310,1084,545,23,492,18,10,0,539
45075000132,753,601,452,4,141,8,1,0,149
45075000120,895,718,251,27,432,11,6,0,467
45075000118,1169,970,381,19,499,20,64,3,589
45075000110,1018,834,263,4,510,8,51,0,571
45075000145,1844,1629,1087,23,424,36,51,3,542
45031000003,926,756,464,20,261,12,3,1,292
45031000040,2768,2085,1227,26,793,31,6,4,858
45051000217,1795,1617,1443,74,55,29,14,0,174
45051000202,2633,2071,1386,450,128,70,47,8,685
45051000199,3175,2535,1999,168,201,68,86,16,536
45051000201,5795,4524,3845,255,229,110,88,7,679
45051000150,940,791,677,39,53,16,7,1,114
45051000211,2168,1780,1386,98,249,42,15,0,394
45051000192,4769,4349,2781,292,1108,72,84,5,1568
45051000213,1334,1042,556,31,410,27,21,1,486
45051000114,1554,1431,1334,26,49,12,4,1,97
45051000179,2720,2482,2239,81,72,38,29,8,243
45051000186,1047,790,634,59,78,18,2,1,156
45051000207,3405,2983,2670,93,77,54,94,6,313
45051000205,1068,959,903,14,14,23,5,2,56
45051000210,2808,2298,2017,77,112,67,27,4,281
45051000124,3552,3151,2855,58,103,42,90,4,296
45047000011,1824,1418,921,85,389,19,9,2,497
45013000103,1932,1548,1284,46,155,27,28,5,264
45013000115,2785,2152,1613,112,294,36,97,11,539
45013000101,1606,1234,532,82,592,9,16,3,702
45013000102,1438,1224,930,44,195,37,19,0,294
45047000030,2025,1512,626,41,805,22,26,2,886
45047000027,1032,757,151,35,553,6,11,0,606
45047000041,1741,1242,576,212,430,25,4,1,666
45047000040,1176,914,721,14,153,16,4,0,193
45087000004,1491,1159,969,37,123,25,7,1,190
45087000010,1819,1397,1000,29,345,22,7,3,397
45017000009,416,333,249,0,75,6,1,0,84
45017000012,1937,1549,863,35,620,32,20,8,686
45017000005,2510,2009,578,50,1357,24,5,3,1431
45017000002,844,696,348,11,323,11,6,0,348
45075000140,1789,1382,667,19,645,52,3,0,715
45087000013,1915,1502,1230,10,239,22,8,0,272
45087000022,663,476,178,9,279,9,2,2,298
45029000006,2438,1982,1420,39,448,49,14,3,562
45029000021,1562,1195,837,24,292,38,5,0,358
45029000014,1477,1168,937,38,98,91,7,2,231
45059000012,2550,1959,1258,30,616,25,19,4,701
45059000017,2348,1824,1417,49,313,20,22,2,407
45059000021,2496,1990,1660,81,186,43,18,0,330
45059000034,2311,1831,740,31,1001,26,28,1,1091
45061000015,401,339,188,9,130,11,0,0,151
45051000105,2252,1767,1152,70,499,41,11,0,615
45051000181,1813,1622,1441,67,51,27,33,3,181
45051000115,4770,4364,3139,223,886,57,65,3,1225
45051000206,3248,2859,2494,76,137,51,75,38,365
45051000194,3368,2758,2375,126,135,71,33,9,383
45075000147,1601,1257,621,9,587,36,12,0,636
45075000127,2071,1558,823,38,639,45,6,2,735
45013000200,557,493,456,2,14,11,10,0,37
45001000014,1008,810,626,5,163,13,3,1,184
45001000007,2347,1909,912,30,934,34,4,1,997
45045000359,5570,4144,2595,385,963,60,118,1,1549
45031000016,1468,1033,339,37,631,15,8,3,694
45057000016,2899,2168,932,69,1129,34,16,2,1236
45013000179,3232,2170,1266,389,379,68,91,8,904
45013000112,2843,2207,1323,241,571,43,29,11,884
45013000163,2161,1630,734,81,777,27,8,6,896
45013000120,1772,1608,1464,35,79,14,9,0,144
45013000303,3263,2593,1835,543,137,45,32,2,758
45045000343,4225,3268,1761,144,1233,86,42,3,1507
45045000250,2250,1637,481,185,932,36,23,2,1156
45045000313,3140,2441,1383,344,631,70,24,6,1058
45045000352,2277,1735,1441,66,154,34,35,4,294
45045000328,3650,2673,1483,342,698,65,96,0,1190
45045000321,3525,2750,1815,304,488,51,90,4,935
45045000255,3234,2520,1914,201,251,46,91,2,606
45045000357,2122,1690,1425,104,101,40,22,1,265
45045000271,3436,2734,2012,208,411,44,52,3,722
45045000323,5075,3754,2673,449,392,66,189,1,1081
45045000289,3861,2786,2227,128,169,41,186,2,559
45045000205,3722,3176,2308,122,619,46,77,2,868
45045000206,1326,999,241,257,488,53,9,3,758
45045000226,3075,2404,1213,249,846,58,56,9,1191
45045000348,4104,3139,2609,227,188,65,43,3,530
45083000139,3242,2501,2070,181,156,80,21,5,431
45045000266,3512,2573,1183,406,956,50,16,3,1390
45045000242,2657,1905,454,422,983,60,17,3,1451
45045000354,3560,2650,2031,128,368,43,68,0,619
45045000353,2388,1868,1317,123,355,34,36,0,551
45045000219,3488,2535,692,143,1688,28,20,0,1843
45045000322,2677,2039,1666,102,106,30,123,1,373
45013000141,1624,1333,1027,90,142,21,43,2,306
45013000116,3109,2766,1364,719,567,57,96,12,1402
45013000308,1677,1548,1504,10,10,4,9,0,44
45013000223,1505,1370,1310,21,12,7,16,1,60
45041000051,664,486,461,6,10,7,3,1,25
45041000063,4948,3833,2404,167,1008,50,193,2,1429
45041000012,1995,1610,1058,47,326,32,151,1,552
45041000047,1602,1245,976,37,205,19,4,2,269
45041000033,3368,2546,1267,63,1147,37,25,2,1279
45041000043,5161,4227,2003,136,1987,60,20,11,2224
45057000024,1814,1440,1244,22,128,38,4,0,196
45057000025,2033,1634,1294,48,239,45,16,1,340
45057000040,2853,2808,2614,58,76,17,35,0,194
45057000039,3523,2672,2118,160,236,44,107,1,554
45057000002,2503,2454,2323,49,37,10,22,1,131
45057000020,1904,1466,1011,27,409,19,3,0,455
45029000035,1253,1186,1096,9,46,24,4,2,90
45075000134,2662,2090,908,30,1048,97,16,1,1182
45059000025,1850,1454,1160,44,228,28,2,2,294
45075000135,2405,1927,530,14,1333,10,40,2,1397
45075000148,1904,1589,494,19,1054,27,7,0,1095
45013000111,2305,1623,433,210,918,30,31,2,1190
45031000011,2187,1697,229,30,1437,12,7,0,1468
45045000299,4524,3625,1925,254,1347,91,28,6,1700
45045000279,4642,3708,2373,241,894,79,90,11,1335
45045000264,2810,2333,2195,50,31,43,5,3,138
45045000330,4784,4176,3746,163,152,71,45,11,430
45013000174,1100,879,129,13,732,11,7,1,750
45013000110,3780,2740,1534,339,711,83,101,4,1206
45085000141,2001,1565,816,44,638,25,31,14,749
45085000145,2592,2021,1116,34,815,41,12,5,905
45075000114,769,641,244,54,334,7,6,3,397
45075000149,1613,1216,158,20,1033,11,2,0,1058
45075000113,2035,1563,197,72,1262,12,17,5,1366
45075000119,2460,1867,262,24,1487,9,99,4,1605
45075000102,988,696,61,14,610,11,5,0,635
45075000122,1038,840,405,28,398,9,2,0,435
45051000129,2832,2544,2238,69,157,42,34,5,306
45051000135,5010,4086,3395,220,287,113,58,8,691
45057000006,2896,2369,1558,103,666,28,10,1,811
45051000106,4354,3774,3188,102,337,67,71,1,586
45051000223,1727,1464,1124,53,256,18,16,0,340
45083000010,4093,3293,2721,82,346,55,61,0,572
45083000065,4420,3409,1724,292,1257,58,95,5,1685
45015000036,2417,1973,1638,24,244,52,10,2,335
45083000095,4138,3049,1541,954,469,104,38,5,1508
45083000112,5936,4543,3192,337,820,81,132,1,1351
45083000129,3545,2791,2129,75,481,86,25,0,662
45087000009,1571,1272,989,14,242,23,6,0,283
45083000028,1219,949,775,22,130,16,8,0,174
45083000118,5659,4020,3015,212,555,85,143,9,1005
45083000137,4456,3304,2202,158,635,58,221,2,1102
45083000030,3407,2607,1920,210,285,58,111,4,687
45083000011,6603,5027,4423,133,275,84,106,8,604
45083000003,3246,2405,980,709,484,70,215,1,1425
45087000019,1319,1036,416,13,593,13,8,4,620
45087000014,695,543,399,5,134,8,2,0,144
45087000005,644,533,82,0,444,9,0,0,451
45083000128,1994,1623,1401,42,128,19,23,2,222
45083000007,2639,2136,1655,60,332,26,55,3,481
45083000064,4379,3392,2761,153,345,55,54,3,631
45083000050,4488,3644,3096,151,267,67,40,4,548
45083000088,1522,1074,112,30,920,9,6,1,962
45083000116,4474,3461,2619,130,570,80,69,4,842
45083000013,3992,3111,2849,85,80,39,51,1,262
45083000054,1649,1278,1143,32,37,32,26,5,135
45083000113,3495,2684,2311,47,185,58,70,2,373
45083000022,1393,1082,885,36,113,31,12,0,197
45083000122,1608,1308,1134,36,99,27,18,0,174
45083000097,4862,3581,2132,209,1052,104,90,1,1449
45083000045,5423,4143,3002,195,701,93,160,2,1141
45013000114,3410,2562,1507,296,655,58,60,11,1055
45013000202,1923,1612,991,281,305,32,12,0,621
45013000170,1434,1219,656,28,508,17,12,1,563
45013000130,2323,1744,1102,153,399,59,28,4,642
45013000304,3776,2788,1373,1077,258,51,34,3,1415
45013000315,3197,2214,857,796,507,32,33,3,1357
45013000301,2885,2127,1252,514,266,67,47,1,875
45013000367,2685,2447,1681,165,502,23,79,4,766
45013000360,1417,1408,1325,36,35,1,7,0,83
45087000020,1226,885,380,11,485,7,5,1,505
45083000062,3580,2732,2144,141,345,39,62,4,588
45083000138,4636,3412,2575,298,352,104,84,9,837
45083000051,6647,4931,3561,339,822,97,112,5,1370
45083000136,2665,1926,1082,277,493,60,34,2,844
45083000090,1804,1358,688,101,516,48,8,2,670
45083000135,4799,3663,2579,232,757,78,29,0,1084
45083000108,1323,1041,614,11,391,15,13,0,427
45083000105,1891,1549,1202,31,256,21,42,2,347
45083000123,7524,5517,3846,345,917,79,306,5,1671
45083000114,1970,1590,1184,99,265,45,9,0,406
45083000031,2893,2266,1256,320,607,41,67,6,1010
45083000057,5388,4158,3664,101,221,95,60,7,494
45083000056,2213,1746,1538,39,114,42,18,2,208
45059000011,1899,1480,1034,40,365,30,13,1,446
45001000003,2169,1738,981,11,707,29,9,2,757
45059000027,2259,1899,1458,25,379,38,8,1,441
45059000033,1123,919,838,7,50,7,9,0,81
45083000083,4050,3036,1109,283,1489,76,132,4,1927
45083000036,5948,4466,2795,355,1107,79,145,5,1671
45083000019,2841,2167,1670,109,252,51,91,4,497
45083000125,3126,2468,1593,199,509,37,123,2,875
45041000008,4361,3419,1570,172,1444,72,180,4,1849
45083000040,2501,1935,1799,45,26,36,20,2,136
45083000086,4464,3727,1744,216,1677,42,72,14,1983
45083000012,4474,3450,2748,195,339,133,44,4,702
45043000105,2135,1715,379,12,1317,15,3,0,1336
45043000128,874,726,248,12,468,1,3,0,478
45041000058,1474,1104,39,10,1045,7,4,1,1065
45041000054,6121,4711,2356,106,2140,52,64,0,2355
45041000037,1359,1092,538,13,529,11,5,1,554
45041000064,2156,1609,1104,25,341,18,120,0,505
45041000002,1150,931,266,13,639,10,7,1,665
45013000219,1059,986,908,29,16,8,14,0,78
45041000029,3103,2408,1581,56,654,43,80,1,827
45041000032,3555,2569,473,86,1967,43,22,3,2096
45041000061,2017,1532,778,68,643,39,12,2,754
45041000057,3023,2194,496,95,1592,19,10,0,1698
45041000014,2575,1948,1402,34,472,25,15,1,546
45041000048,1944,1468,842,25,575,17,8,0,626
45041000060,2145,1680,280,20,1357,19,8,2,1400
45041000040,2414,1776,622,38,1055,29,45,3,1154
45091000028,3208,2428,1267,84,988,51,14,6,1161
45069000008,2587,2323,981,58,1242,53,4,1,1342
45069000003,1095,869,420,14,374,60,2,4,449
45051000121,4572,3976,3446,158,167,68,117,6,530
45051000220,3431,3063,2892,59,43,29,22,4,171
45051000148,2121,1656,1485,27,88,39,12,4,171
45041000026,1078,803,29,7,762,11,3,3,774
45091000091,2496,1747,1213,142,317,55,28,2,534
45091000009,2855,2100,1634,98,250,72,42,4,466
45091000090,2250,1728,1153,61,460,34,13,0,575
45091000092,2154,1635,1421,55,96,33,29,0,214
45091000004,5156,4039,3259,191,401,84,83,7,780
45091000024,2916,2206,1550,136,418,44,48,1,656
45091000030,2449,1894,1230,238,302,51,70,2,664
45091000096,5409,4203,2204,468,1307,84,160,3,1999
45091000056,2695,2094,920,251,781,90,84,1,1174
45091000052,1895,1495,1001,156,238,52,60,5,494
45091000029,3126,2470,1619,309,427,66,72,4,851
45091000022,2445,1932,1504,81,261,71,9,0,428
45091000011,2889,2267,1967,77,118,64,32,1,300
45091000041,3685,2712,1332,109,1160,76,41,2,1380
45019000607,2354,1801,206,69,1513,26,11,2,1595
45019000606,2048,1552,153,65,1317,8,13,4,1399
45019000629,2738,2011,525,946,475,80,46,6,1486
45059000008,1922,1550,1018,46,453,32,3,1,532
45019000215,2793,1827,565,54,1177,25,28,2,1262
45019000601,1110,895,64,38,795,6,4,3,831
45083000038,2157,1704,1526,40,113,25,10,1,178
45021000031,2451,1841,1606,69,102,57,4,2,235
45083000099,2110,1620,664,95,582,27,264,1,956
45083000131,5134,3942,3043,239,528,112,31,2,899
45083000111,3205,2372,1926,156,159,63,63,3,446
45001000010,2698,2228,1626,62,493,25,13,4,602
45001000001,2348,1890,1361,31,456,24,12,1,529
45001000015,1089,861,631,21,187,6,7,1,230
45059000024,1492,1167,840,31,231,49,11,1,327
45001000002,2160,1617,561,15,1022,17,6,1,1056
45051000172,2301,2020,1754,91,107,32,32,1,266
45051000125,2274,2135,2002,43,34,25,34,0,133
45051000126,1246,1104,1027,28,18,8,19,0,77
45051000160,2524,2183,1935,85,79,58,18,3,248
45051000166,2132,1569,1393,53,89,31,0,1,176
45041000011,3944,2901,1738,74,904,51,138,0,1163
45041000055,1317,1032,588,10,408,26,2,1,444
45041000028,3662,2910,2063,84,628,55,98,2,847
45019000110,3471,2589,1267,185,1034,90,45,7,1322
45019000507,2117,1783,1470,69,156,26,52,4,313
45083000109,2556,2010,1135,168,610,49,63,4,875
45005000004,2276,2018,548,76,1384,11,7,1,1470
45005000003,723,615,225,8,372,6,7,0,390
45005000008,1083,856,278,19,537,23,4,2,578
45041000004,2856,2228,1517,42,622,35,14,1,711
45041000013,1595,1371,939,22,361,37,4,1,432
45041000053,925,740,633,27,70,10,5,1,107
45083000101,3284,2744,1111,365,1136,35,114,3,1633
45083000016,1766,1451,1162,53,167,27,38,1,289
45083000100,2894,2209,1477,120,464,31,104,5,732
45057000037,5297,3625,2598,258,327,59,370,2,1027
45041000001,1101,858,533,20,285,17,2,1,325
45041000038,2213,1607,337,19,1250,6,7,1,1270
45041000039,1668,1334,826,24,450,29,13,1,508
45005000005,343,305,86,1,217,2,0,0,219
45011000015,1368,1031,609,24,372,20,10,1,422
45011000016,5,4,4,0,0,0,0,0,0
45011000012,1665,1277,721,23,524,4,9,0,556
45083000134,4548,3422,1040,618,1675,83,21,1,2382
45029000030,1996,1543,662,90,766,35,7,1,881
45009000011,2738,2195,638,30,1483,31,4,3,1557
45009000001,228,179,131,1,47,1,0,0,48
45009000003,1013,837,519,10,292,2,6,2,318
45009000012,1598,1282,265,18,989,5,8,1,1017
45009000013,2664,2067,1048,6,965,32,20,5,1019
45077000150,2156,1701,1569,32,28,52,7,1,132
45077000151,1689,1341,1231,36,32,33,7,5,110
45077000153,2426,1988,1293,222,378,41,53,0,695
45077000108,3616,3212,2187,179,495,42,307,7,1025
45077000106,2784,2333,1914,64,122,16,214,3,419
45073000027,3336,2558,2230,120,98,77,15,1,328
45073000026,4767,3797,3364,111,207,89,22,2,433
45019000317,3786,3114,2755,99,119,44,78,3,359
45019000533,1037,793,609,38,92,19,28,1,184
45019000415,2166,1844,1559,68,131,46,33,5,285
45019000307,1353,1124,1016,33,29,22,24,4,108
45091000051,4179,3326,2415,172,598,81,58,4,911
45091000010,2488,1831,1507,62,163,60,20,0,324
45019000521,1385,1129,717,107,254,25,27,0,412
45019000310,1358,995,898,22,20,9,22,0,97
45019000311,1903,1597,1475,35,45,11,24,0,122
45019000173,1884,1660,1084,45,502,25,6,1,576
45019000463,2385,2032,1579,40,360,30,20,3,453
45019000329,385,307,278,4,14,4,5,0,29
45019000330,2607,1907,1697,42,56,19,74,3,210
45019000332,3609,2502,2287,65,31,32,63,12,215
45019000331,2093,1575,1217,52,251,20,32,1,358
45019000208,1697,1458,850,69,490,34,25,9,608
45019000536,2058,1621,1288,64,164,28,59,2,333
45019000414,1129,895,813,13,26,16,16,3,82
45019000410,2195,1748,1468,39,139,36,37,6,280
45091000015,4390,3215,2258,201,420,89,259,2,957
45091000046,2336,1776,1091,75,530,47,27,2,685
45091000001,3160,2487,2277,38,78,66,27,0,210
45019000502,1393,1231,1052,38,77,16,45,0,179
45019000422,1920,1598,1459,37,59,23,17,3,139
45019000527,6553,5075,3535,203,1024,70,265,9,1540
45037000009,1323,1039,767,36,215,18,8,4,272
45037000010,547,448,221,7,211,9,0,0,227
45037000008,1331,1026,940,19,32,28,5,0,86
45033000006,1731,1412,794,17,560,44,2,1,618
45019000132,5160,3862,1797,428,1444,113,129,10,2065
45067000016,1835,1492,1071,34,356,21,19,1,421
45067000014,2185,1825,679,30,1092,33,9,0,1146
45091000097,2704,1793,1362,95,108,22,212,2,431
45091000095,3691,2442,1938,142,149,27,169,3,504
45091000068,2952,2150,1397,147,263,29,315,1,753
45091000067,3275,2320,1507,181,348,33,250,2,813
45033000009,3287,2495,1048,105,1223,117,4,2,1447
45033000004,3774,2844,1352,31,1375,86,9,2,1492
45033000001,2713,2192,1678,28,421,36,40,2,514
45033000002,3535,2548,556,73,1844,78,8,2,1992
45033000012,1457,1094,602,32,405,60,6,1,492
45077000130,1915,1463,1256,54,81,55,6,0,207
45077000155,1871,1387,1187,57,89,40,11,0,200
45077000126,1798,1421,1304,30,26,40,11,1,117
45077000125,2090,1638,1430,45,68,71,5,2,208
45077000124,2028,1624,1515,20,57,25,3,1,109
45077000102,7248,7111,5677,341,671,101,330,6,1434
45073000019,2567,2168,1726,60,300,48,41,5,442
45073000016,2988,2544,2383,44,17,83,11,0,161
45041000034,1007,822,696,26,85,10,3,0,126
45041000049,1558,1198,875,45,255,20,7,1,323
45073000024,5967,4563,3816,422,138,154,19,3,747
45073000025,5316,4069,3196,585,124,153,31,7,873
45077000134,1893,1496,1221,113,90,60,12,4,275
45073000022,1865,1550,1405,42,40,45,8,2,145
45073000012,2043,1587,1427,38,58,41,16,0,160
45077000129,2192,1692,1509,73,49,41,6,2,183
45077000128,2051,1612,1409,48,77,59,13,0,203
45077000145,2241,1707,1316,222,123,37,12,0,391
45077000132,1998,1559,1326,86,116,17,7,0,233
45073000004,1314,1087,1012,18,20,27,9,1,75
45077000112,1851,1466,1328,25,65,36,10,1,138
45077000115,1391,1107,1027,26,20,29,5,0,80
45077000109,1938,1573,1269,69,178,40,16,3,304
45077000140,2225,1699,1297,101,242,43,17,5,402
45005000007,276,227,112,6,106,4,0,0,115
45041000056,4235,3359,1935,87,1219,33,90,1,1424
45041000050,963,732,225,22,464,17,9,0,507
45041000036,3452,2530,1737,42,696,30,14,0,793
45043000107,743,597,488,9,93,4,8,0,109
45009000002,410,344,245,1,91,6,0,0,99
45077000161,1770,1469,1143,53,180,48,37,1,326
45077000160,907,692,540,51,53,24,17,0,152
45077000143,1814,1475,1267,45,93,20,39,0,208
45077000152,1909,1486,1410,12,9,41,10,0,76
45045000317,5430,4222,3624,229,173,137,50,5,598
45077000118,1971,1656,1556,33,11,38,7,2,100
45077000121,2094,1681,1535,24,27,76,7,0,146
45077000122,2264,1724,1513,44,115,39,7,0,211
45077000123,2147,1674,1249,53,294,47,13,1,425
45091000093,3602,2655,2125,120,244,58,93,2,530
45091000020,3565,2491,1879,165,311,36,73,2,612
45091000084,3242,2438,1887,156,278,52,53,6,551
45091000065,4953,3722,2499,320,346,77,490,3,1223
45091000074,2475,1819,1256,156,202,51,175,1,563
45091000089,2600,2057,1598,115,246,51,46,1,459
45091000048,5363,4200,2324,362,1324,93,126,9,1876
45091000063,1806,1501,1283,46,51,24,97,2,218
45043000120,1927,1685,1580,39,21,35,8,3,105
45037000005,1603,1248,556,25,646,17,7,3,692
45069000011,1169,865,575,6,132,151,4,0,290
45069000006,521,407,202,8,159,41,4,1,205
45069000015,5040,4217,1303,298,2551,72,38,3,2914
45073000031,2076,1697,1339,95,220,25,20,0,358
45073000030,3068,2510,1975,99,313,69,49,2,535
45073000032,4356,3370,2103,176,967,92,39,1,1267
45073000029,4318,3385,2241,142,873,72,59,1,1144
45073000011,2717,2281,1968,106,124,54,32,1,313
45073000003,3842,3284,2681,103,230,62,190,3,603
45073000017,2750,2661,2559,33,9,27,17,0,102
45073000006,652,513,483,4,13,14,1,0,30
45073000015,1620,1283,1131,47,65,28,15,3,152
45077000117,1940,1606,1472,27,14,66,9,0,134
45077000116,2161,1868,1755,25,19,49,7,0,113
45077000138,2398,1787,1523,95,119,21,20,3,264
45077000158,1539,1242,975,64,162,31,8,3,267
45011000002,2430,1979,1137,41,737,27,29,0,842
45009000004,3078,2531,420,10,2062,14,32,5,2111
45043000102,1623,1186,491,54,630,12,6,0,695
45043000114,2691,2029,1272,99,613,37,17,0,757
45043000124,2809,2530,2309,49,124,25,15,1,221
45043000125,3231,2756,2537,54,84,51,16,1,219
45043000123,4544,3816,2875,109,739,55,26,1,941
45077000105,3546,3186,2184,133,229,43,584,6,1002
45073000007,2771,2293,2105,49,34,66,21,1,188
45073000018,2801,2486,2387,37,4,26,10,0,99
45073000010,923,719,676,8,17,17,3,0,43
45073000021,1764,1427,1322,32,11,47,8,1,105
45073000009,1326,1114,1051,17,8,26,6,1,63
45073000020,2247,1828,1719,35,14,48,4,2,109
45005000002,1388,1099,48,13,1036,4,1,0,1051
45077000120,2208,1724,1611,20,18,65,4,0,113
45045000325,4421,3377,2218,450,602,86,45,13,1159
45077000111,1668,1297,1162,31,28,55,18,0,135
45073000008,628,512,471,13,9,15,2,1,41
45065000015,724,616,336,18,237,21,6,1,280
45043000110,1148,917,643,7,251,16,0,1,274
45043000129,1153,931,604,5,297,14,0,0,327
45043000132,1671,1318,299,40,972,8,2,0,1019
45083000041,6402,5195,2116,1387,1480,107,140,9,3079
45083000141,2106,1588,764,201,528,39,74,3,824
45083000014,4154,3116,1910,232,754,74,171,5,1206
45083000026,2821,2190,1738,166,227,55,4,5,452
45083000075,2023,1525,530,86,891,21,26,2,995
45073000023,1349,1044,722,55,227,32,5,3,322
45077000136,2164,1628,988,152,442,42,12,2,640
45077000139,1866,1487,1188,59,185,34,10,1,299
45077000137,2475,1920,1427,178,243,45,24,2,493
45019000107,4771,3746,1495,669,1367,85,170,21,2251
45019000442,7318,5859,4831,373,414,98,109,8,1028
45019000309,1354,1047,992,20,1,12,20,1,55
45019000301,1904,1383,1187,30,144,4,11,0,196
45019000211,2040,1911,1588,56,159,20,82,3,323
45019000323,2724,2143,1644,71,279,31,99,9,499
45019000336,2481,1886,1417,54,313,20,72,0,469
45019000529,5106,4185,3193,230,452,55,238,7,992
45019000339,5875,4119,3569,147,174,44,151,3,550
45019000032,1891,1487,1411,30,12,12,17,1,76
45019000004,1621,1363,791,7,555,12,3,0,572
45009000009,161,134,130,0,4,0,0,0,4
45081000001,770,606,476,33,90,9,0,0,130
45003000025,2565,2083,1251,222,502,38,80,1,832
45003000010,2099,1548,529,257,723,17,24,4,1019
45003000067,1676,1287,1084,38,103,31,26,2,203
45063000069,2300,1721,1492,75,66,63,9,4,229
45063000094,2044,1551,1280,77,141,43,8,0,271
45063000022,2527,1985,1638,226,35,73,12,0,347
45063000081,3266,2467,2027,142,138,120,19,6,440
45063000095,5471,3575,2222,211,996,80,99,0,1353
45055000119,3060,2330,1665,161,394,53,29,1,665
45069000009,1913,1536,467,25,934,117,1,1,1069
45069000002,399,335,210,4,114,13,0,0,125
45021000013,1688,1327,380,74,849,30,11,0,947
45081000006,1303,922,371,271,268,11,1,0,551
45081000008,1697,1377,1251,52,58,18,3,0,126
45081000014,924,785,724,17,19,21,8,0,61
45021000025,2129,1668,1195,54,337,46,35,1,473
45021000017,1976,1580,1129,50,336,25,23,5,451
45021000023,2846,2262,1650,85,445,39,39,0,612
45021000003,2366,1879,1718,44,61,33,11,0,161
45021000021,1810,1357,808,108,415,19,12,0,549
45003000016,1930,1380,770,101,448,52,13,6,610
45063000044,1929,1707,1190,106,255,30,138,3,517
45063000035,2866,2597,1896,130,360,39,180,3,701
45063000041,3061,2557,1626,172,584,49,131,5,931
45063000055,2176,1787,1205,79,358,48,93,2,582
45063000047,2838,2270,1495,171,490,63,50,1,775
45063000037,1041,881,680,35,129,26,18,0,201
45063000057,2431,1951,1459,95,291,35,65,2,492
45003000060,1461,1179,1035,36,84,30,6,2,144
45003000077,1882,1531,1306,48,86,31,50,2,225
45003000075,2359,1795,1396,60,245,42,53,1,399
45003000039,2870,2244,1456,56,679,52,7,7,788
45003000042,1184,906,537,51,301,16,3,0,369
45003000000,0,0,0,0,0,0,0,0,0
45003000071,2999,2333,1555,169,515,75,28,4,778
45063000077,1720,1312,954,53,250,42,11,3,358
45063000087,2743,2150,1502,115,429,62,31,3,648
45021000019,2047,1594,1430,42,86,28,12,1,164
45063000060,2684,2217,1688,95,297,53,79,1,529
45003000041,2939,2290,1718,132,350,67,19,4,572
45003000051,3282,2432,1648,78,595,54,69,5,784
45003000005,1616,1359,784,45,507,14,10,1,575
45003000072,1425,1108,720,49,273,21,41,5,388
45003000057,2311,1859,1220,57,532,33,9,0,639
45003000032,888,675,323,7,318,19,7,1,352
45063000001,3002,2306,1125,128,1012,19,32,8,1181
45063000049,2449,1849,975,82,689,54,46,14,874
45063000009,2488,1947,1154,88,594,37,63,4,793
45063000036,2839,2123,1066,84,880,63,48,0,1057
45063000031,3352,2655,1860,191,480,59,72,0,795
45063000007,3311,2493,2117,178,114,83,7,1,376
45063000040,3746,2998,1867,405,606,99,58,0,1131
45003000038,3073,2403,1611,169,519,48,66,7,792
45063000010,2856,2413,2273,36,44,54,7,5,140
45063000066,2732,1788,1165,170,148,37,260,0,623
45063000096,4281,3004,2464,77,160,60,242,6,540
45063000021,3015,2538,1947,128,317,46,105,1,591
45063000064,4006,2979,2484,98,152,39,194,4,495
45063000079,2040,1645,1168,104,276,43,68,5,477
45063000075,3512,2600,1752,358,383,123,10,5,848
45063000043,1876,1481,1112,44,252,36,31,0,369
45063000051,2190,1751,993,73,598,31,66,2,758
45063000052,2530,1931,836,96,875,36,102,10,1095
45003000002,1717,1349,498,65,757,34,5,3,851
45003000047,1460,1128,903,34,144,26,11,2,225
45003000001,1505,1314,1209,21,56,17,8,1,105
45065000009,1234,985,325,7,622,20,5,2,660
45069000014,1377,1104,165,9,897,23,11,0,939
45091000044,4234,3139,576,125,2370,38,41,6,2563
45091000027,3919,3103,2550,95,362,55,30,2,553
45069000007,1993,1576,944,16,531,86,6,0,632
45003000079,1571,1339,952,67,227,22,78,0,387
45003000070,1597,1270,867,60,254,52,42,0,403
45003000049,2282,1792,1263,227,251,46,10,1,529
45003000017,2182,1721,1347,40,265,55,19,7,374
45003000061,2651,2069,1029,65,910,81,15,1,1040
45063000025,1437,1133,817,36,237,31,5,2,316
45063000008,3645,2728,2214,229,165,92,13,2,514
45063000020,2329,1733,1346,131,196,48,2,0,387
45063000002,2387,1805,1396,193,172,42,10,3,409
45063000026,2574,1929,1430,179,239,78,20,3,499
45063000090,1852,1486,1206,72,96,29,78,4,280
45063000073,3091,2197,1802,67,200,45,74,2,395
45003000037,2655,2125,1490,93,483,65,6,3,635
45003000064,1897,1783,1589,60,98,26,4,5,194
45003000020,2408,1991,1424,73,411,38,43,4,567
45063000050,2750,2276,1611,68,501,34,70,5,665
45063000038,5361,4110,1371,408,2206,102,51,2,2739
45063000019,6417,4545,3576,287,431,112,118,6,969
45039000007,726,594,147,5,429,11,1,2,447
45039000011,1114,932,543,9,358,8,11,1,389
45055000102,1231,936,657,13,248,9,4,1,279
45055000143,2641,2103,1736,39,260,49,11,0,367
45055000154,2602,1990,1322,93,507,46,15,0,668
45091000086,2231,1699,787,91,715,30,77,0,912
45039000004,345,300,91,0,209,1,2,0,209
45065000010,1037,891,456,6,419,11,2,1,435
45065000002,502,494,468,1,24,2,0,0,26
45065000006,2551,2248,808,32,1364,41,10,5,1440
45065000003,1946,1905,1734,23,92,23,21,3,171
45019000218,1735,1432,649,39,727,19,19,7,783
45069000012,2465,1971,684,10,1221,47,14,1,1287
45019000617,1526,1176,230,117,816,21,9,1,946
45019000612,1379,1036,871,48,83,14,18,0,165
45081000018,2429,1744,813,509,394,60,2,0,931
45081000003,597,479,439,9,11,12,3,1,40
45081000005,928,760,299,41,411,17,2,0,461
45003000007,1431,1099,620,130,323,32,9,1,479
45021000010,2786,2130,1669,63,364,38,1,0,461
45021000014,1596,1289,392,50,841,14,6,0,897
45021000002,3323,2482,1252,171,1029,48,1,0,1230
45021000027,1587,1228,602,139,452,32,5,1,626
45019000602,1789,1538,333,102,1098,7,6,0,1205
45063000011,2284,1667,1410,61,155,37,8,3,257
45063000082,2666,2081,1467,89,464,41,17,2,614
45003000031,1242,974,732,10,211,26,1,0,242
45021000011,2385,1858,1633,79,107,29,5,1,225
45077000159,1655,1364,1262,27,45,15,10,1,102
45077000142,1883,1517,1273,44,111,30,51,2,244
45019000609,2754,2252,1226,337,561,49,78,2,1026
45019000103,7708,6504,3379,844,1869,171,264,8,3125
45019000102,2730,1838,764,124,851,44,54,8,1074
45015000052,2624,2131,1420,220,286,77,72,2,711
45019000523,1491,1247,905,54,199,37,49,0,342
45019000337,4732,3540,2475,139,824,40,65,4,1065
45019000338,2331,1845,1691,58,56,11,27,0,154
45019000400,2687,2254,1796,73,297,47,40,2,458
45019000412,1661,1284,1146,33,26,25,26,1,138
45055000107,2357,1740,792,56,839,22,34,1,948
45055000121,798,638,433,57,137,10,1,0,205
45055000146,1376,1069,297,45,709,5,11,1,772
45039000002,477,405,75,3,324,3,1,1,330
45055000117,2009,1609,948,49,588,26,5,0,661
45039000003,421,348,252,15,70,5,4,0,96
45039000014,2890,2450,997,43,1335,51,21,7,1453
45073000028,3010,2372,2057,160,71,85,7,3,315
45077000104,2291,1977,1290,103,438,27,123,0,687
45063000070,4896,3780,2794,454,299,73,242,8,986
45037000004,1815,1499,452,266,756,12,11,1,1047
45063000015,3790,2801,2362,190,147,76,26,3,439
45003000081,1804,1422,924,68,366,42,18,4,498
45003000048,1613,1247,835,54,323,24,12,1,412
45019000419,2233,1914,1626,49,139,24,57,1,288
45019000516,1233,1027,857,15,118,9,20,1,170
45019000517,2290,1867,1495,46,231,33,35,9,372
45021000024,2116,1613,1399,65,120,26,1,1,214
45021000018,3198,2506,1900,203,304,44,59,1,606
45021000020,2154,1704,1514,31,93,61,6,1,190
45037000001,1211,976,609,16,334,10,8,0,367
45063000091,3753,2821,1860,252,604,93,33,8,961
45063000071,5186,4020,2997,222,535,81,186,8,1023
45063000033,4224,3345,2758,131,225,69,143,13,587
45019000420,1976,1640,1386,51,142,27,23,3,254
45049000006,211,155,49,4,101,1,0,0,106
45049000011,479,383,53,3,327,2,0,0,330
45049000018,1025,804,380,15,394,11,2,1,424
45049000003,1982,1569,914,20,595,12,32,1,655
45019000217,1307,1077,655,21,356,14,22,4,422
45019000404,1108,841,738,18,29,23,27,1,103
45019000624,5435,4164,1499,458,1988,94,188,33,2665
45019000618,3448,2518,672,420,1341,44,70,7,1846
45019000625,1018,797,197,63,519,17,7,0,600
45077000154,1896,1514,1393,32,32,45,9,0,121
45073000002,1433,1087,996,18,25,36,5,1,91
45055000103,1838,1475,961,48,424,33,9,5,514
45019000409,1837,1553,1316,45,141,21,16,0,237
45019000318,1528,1165,1070,16,31,30,16,1,95
45019000520,3922,3329,2021,155,887,53,202,1,1308
45019000519,424,349,65,21,253,2,5,4,284
45019000623,3360,2667,1193,330,1006,48,95,10,1474
45053000101,599,488,125,9,353,2,2,0,363
45077000163,1566,1249,1042,25,145,36,3,1,207
45077000148,2076,1628,1254,114,224,23,6,3,374
45077000144,2252,1835,1486,60,181,48,58,0,349
45005000001,1488,1168,225,33,900,12,4,0,943
45005000006,462,399,284,6,104,12,1,1,115
45067000010,284,236,74,4,157,0,1,0,162
45003000021,1868,1495,733,234,507,30,7,3,762
45003000014,2614,2014,1441,134,365,70,10,3,573
45037000006,2025,1669,794,95,748,33,12,3,875
45063000004,3132,2257,1995,74,55,31,100,0,262
45063000089,5274,3500,2732,176,319,70,195,5,768
45063000034,2995,2422,1659,109,563,53,51,2,763
45063000056,1987,1563,1311,62,153,16,18,3,252
45063000039,3187,2471,1875,145,323,97,44,4,596
45049000007,4109,3423,687,376,2339,31,28,3,2736
45049000004,2675,2043,863,31,1128,27,4,3,1180
45053000102,816,661,321,37,298,8,1,0,340
45053000108,3059,2298,824,444,971,37,18,0,1474
45053000103,1675,1330,732,99,466,30,16,3,598
45049000005,587,468,214,6,239,4,2,2,254
45081000015,897,727,583,39,84,17,2,0,144
45081000002,348,265,239,12,9,7,1,0,26
45003000068,3300,2445,1841,103,357,64,75,1,604
45063000012,3412,2646,1754,176,650,62,15,1,892
45009000010,497,400,281,11,102,2,4,0,119
45009000008,187,142,124,4,13,1,1,0,18
45019000175,1442,1236,539,28,626,38,8,3,697
45019000464,2400,1889,536,125,1195,42,14,1,1353
45019000461,1261,1023,522,38,435,12,7,0,501
45033000018,526,401,211,3,176,11,2,0,190
45019000403,1875,1366,1269,43,5,20,13,1,97
45011000009,792,622,347,32,232,8,0,2,275
45021000033,1533,1119,967,31,84,22,11,3,152
45019000604,1807,1434,294,85,1031,41,17,3,1140
45019000411,2559,1939,1673,48,154,16,37,2,266
45019000462,1786,1478,679,36,744,18,8,5,799
45003000019,1463,1128,803,87,181,68,7,1,325
45063000024,1997,1572,1002,48,457,33,26,5,570
45063000013,3973,3038,2339,247,319,134,18,1,699
45063000092,2756,2047,1517,90,325,62,57,1,530
45063000080,3638,2701,1836,286,495,90,11,3,865
45003000018,2324,1757,1339,76,283,50,7,1,418
45003000015,1678,1296,981,66,185,54,11,2,315
45063000032,2172,1653,1272,109,195,37,20,3,381
45055000152,2552,2009,1564,50,318,59,8,0,445
45003000011,2546,1930,623,125,1142,64,5,4,1307
45063000028,4743,3481,2751,154,421,62,85,4,730
45053000113,1007,759,303,48,384,17,2,9,456
45053000112,1993,1425,575,298,514,33,16,0,850
45063000023,1323,1002,812,36,112,29,8,4,190
45063000083,2508,1891,1547,118,164,48,15,1,344
45039000016,924,778,209,16,548,4,0,1,569
45055000105,1767,1373,1138,18,169,39,3,1,235
45055000125,3154,2390,1627,163,530,70,22,0,763
45027000023,1498,1095,750,28,296,19,1,1,345
45027000017,1320,1026,386,30,600,8,7,0,640
45027000024,1718,1364,520,35,794,20,5,0,844
45079000424,2771,1903,68,34,1794,18,5,2,1835
45071000011,441,366,303,15,46,7,1,0,63
45071000003,1519,1190,591,159,420,21,19,0,599
45071000017,1831,1360,794,208,347,12,5,0,566
45071000031,1661,1101,311,78,697,34,7,2,790
45071000010,1333,1047,673,162,182,30,11,3,374
45055000130,592,453,387,19,40,7,2,0,66
45039000017,1761,1266,486,59,672,29,33,4,780
45055000101,1946,1524,1008,94,394,28,6,0,516
45055000131,663,614,492,6,104,17,3,0,122
45055000109,2222,1802,1301,55,424,15,5,0,501
45027000013,1802,1426,841,28,480,19,62,1,585
45049000013,1371,1074,398,23,633,21,6,1,676
45079000407,3379,2494,1390,76,962,49,28,3,1104
45079000470,6111,5575,3508,229,1541,68,222,5,2067
45079000112,2039,1823,1523,45,165,21,59,3,300
45079000120,2383,1991,944,46,930,44,48,3,1047
45079000101,6183,6045,4582,258,651,30,536,18,1463
45071000023,2009,1553,1265,33,226,19,14,0,288
45003000008,2354,1876,886,106,815,57,15,3,990
45081000013,285,228,122,11,92,3,0,0,106
45053000105,943,758,562,16,161,18,0,1,196
45053000115,2688,2658,2528,48,35,17,31,3,130
45053000109,1178,912,449,104,332,27,10,0,463
45053000117,1893,1710,1159,258,269,6,28,1,551
45013000121,2442,1981,1644,102,151,37,30,3,337
45079000510,6558,6089,2371,198,3441,38,59,2,3718
45079000110,1991,1696,1469,55,69,14,96,5,227
45079000124,1365,991,925,19,29,6,14,0,66
45079000498,2010,1455,1174,45,201,20,14,2,281
45081000009,1402,1086,719,46,299,12,10,0,367
45025000013,1876,1477,1070,17,367,31,4,0,407
45025000011,2989,2294,1691,19,540,28,10,0,603
45079000121,2570,1874,97,69,1699,33,14,4,1777
45007000065,1140,906,805,17,57,26,4,0,101
45007000031,1366,1069,977,3,77,11,0,0,92
45007000020,1411,1059,753,22,258,23,6,1,306
45007000136,2618,2137,1883,61,119,30,51,1,254
45007000121,5048,3805,3055,265,302,61,98,3,750
45079000419,1683,1269,1023,35,178,18,17,1,246
45079000115,1271,960,844,21,69,8,13,0,116
45025000023,1599,1279,894,27,323,28,8,0,385
45007000080,2544,2013,551,69,1352,40,16,1,1462
45079000469,1335,1037,723,52,241,9,13,0,314
45079000429,1968,1571,1023,55,432,19,27,2,548
45007000076,1962,1505,1260,51,142,33,27,5,245
45007000063,1304,975,876,9,66,11,4,4,99
45007000079,2093,1489,768,48,623,37,13,0,721
45007000016,1332,1031,797,22,178,21,9,0,234
45079000418,3133,2492,292,184,1984,28,50,2,2200
45079000437,3319,2681,1435,191,937,39,97,2,1246
45079000516,2909,2171,1902,57,81,27,92,5,269
45035000060,1875,1412,905,69,355,50,43,5,507
45035000091,3371,2580,1553,187,701,61,106,5,1027
45035000106,2322,1776,1168,132,318,33,133,1,608
45035000025,1717,1419,789,19,581,23,5,2,630
45079000481,3022,2289,458,65,1758,34,4,0,1831
45035000033,1375,1107,732,22,320,29,7,1,375
45089000017,1595,1254,218,12,1030,16,1,1,1036
45035000037,793,612,500,24,59,21,10,0,112
45035000098,2819,2122,1291,107,535,54,139,7,831
45035000088,2486,1823,1236,75,436,38,35,6,587
45085000133,708,501,9,12,486,5,1,1,492
45039000019,1368,1119,591,29,472,18,12,2,528
45055000140,2169,1686,922,152,553,27,22,3,764
45039000018,2063,1635,476,31,1105,21,12,2,1159
45023000023,643,532,419,7,89,22,1,0,113
45029000002,464,331,194,20,112,5,1,0,137
45035000099,961,775,667,24,57,17,13,3,108
45035000046,2208,1658,998,91,466,67,38,7,660
45035000047,1417,1044,922,35,55,12,16,0,122
45015000028,1161,898,722,11,119,35,4,1,176
45045000201,2198,1780,1534,63,79,37,53,11,246
45045000240,1788,1380,971,79,233,23,59,0,409
45017000011,2347,1901,1534,47,263,45,7,6,367
45045000341,3693,2795,1504,768,436,59,41,11,1291
45045000217,2107,1610,1428,32,94,21,27,1,182
45057000001,1256,1029,829,17,152,24,7,0,200
45051000122,1990,1477,1314,31,88,29,11,3,163
45051000196,4298,3241,1403,984,680,90,59,14,1838
45051000141,1553,1477,1365,42,25,22,11,1,112
45051000212,3161,2451,1208,88,1090,45,27,2,1243
45089000033,1068,835,174,4,655,4,2,0,661
45035000074,3780,2563,707,639,1046,56,110,20,1856
45049000001,897,685,439,11,225,8,3,1,246
45017000007,309,253,152,8,91,1,0,0,101
45017000003,1588,1277,654,29,580,16,4,1,623
45017000010,605,495,205,10,274,6,1,2,290
45075000131,2519,1970,531,22,1393,18,7,4,1439
45075000137,1757,1342,958,25,301,57,1,0,384
45075000151,1650,1290,589,34,636,30,8,0,701
45045000252,3829,3032,2645,112,166,77,15,2,387
45045000331,3420,2714,2063,193,284,50,117,4,651
45045000310,4067,3114,2040,340,606,57,63,1,1074
45007000085,2602,1892,778,123,957,39,5,1,1114
45047000038,994,805,716,15,51,8,13,2,89
45047000045,1998,1420,549,206,652,32,12,5,871
45047000006,1889,1376,589,100,663,23,12,2,787
45047000043,1199,785,176,147,456,14,1,0,609
45045000298,5224,3866,2459,357,849,65,120,6,1407
45045000314,3783,2710,1519,290,748,65,97,4,1191
45045000368,3123,2384,1706,216,378,40,52,4,678
45045000274,4336,3310,2055,635,499,78,60,3,1255
45031000036,861,716,287,11,406,15,2,0,429
45031000008,2238,1719,638,19,1034,21,7,1,1081
45007000009,1916,1435,778,130,499,28,7,3,657
45007000023,1617,1258,1178,11,33,26,3,0,80
45007000164,6104,4455,3858,158,256,106,58,0,597
45031000023,2363,1902,1663,36,164,29,6,0,239
45031000010,1854,1447,508,19,914,11,2,3,939
45031000033,2938,2292,1238,61,976,29,8,2,1054
45031000027,933,742,273,14,449,10,0,0,469
45031000004,1862,1465,1111,59,255,32,10,1,354
45045000345,4058,2819,623,944,1226,84,7,2,2196
45045000336,4440,3336,1895,823,421,82,146,1,1441
45007000077,5186,4374,3389,239,630,51,78,24,985
45007000086,2297,1766,1047,157,485,70,10,4,719
45007000081,3352,2440,844,65,1476,35,21,10,1596
45045000312,3685,2979,2298,206,346,60,61,3,681
45045000315,3936,3002,2010,287,566,66,77,11,992
45045000369,3160,2504,2078,87,269,44,12,2,426
45075000106,1095,889,240,22,614,16,12,1,649
45045000272,3942,2881,1639,271,841,59,69,7,1242
45045000294,1570,1104,946,54,43,19,39,2,158
45045000351,4167,3132,2129,363,220,56,366,4,1003
45045000329,5118,4121,2872,314,464,61,398,5,1249
45083000061,3298,2248,1659,141,175,34,209,4,589
45045000241,3597,2729,2158,102,123,24,293,0,571
45045000204,4465,3369,1623,538,1109,82,54,10,1746
45045000308,3694,2895,2252,287,199,51,66,9,643
45029000026,980,787,611,20,129,18,2,0,176
45007000019,4083,3263,2663,73,415,73,33,0,600
45007000157,3616,2828,2324,76,371,39,9,5,504
45045000334,3582,2823,2518,69,128,59,18,3,305
45085000107,1564,1320,815,19,458,15,11,1,505
45085000140,1024,805,477,22,270,14,31,0,328
45075000143,1372,1082,262,12,801,6,4,1,820
45075000121,1720,1370,424,20,909,24,3,0,946
45075000144,758,606,296,17,280,17,0,0,310
45075000141,1671,1320,537,14,744,17,5,1,783
45045000207,4509,3506,1470,483,1494,74,39,1,2036
45045000234,2797,2072,223,220,1617,31,7,4,1849
45029000008,1105,913,261,8,633,6,1,0,652
45029000012,457,367,121,1,236,7,0,4,246
45029000010,1050,798,569,21,174,33,4,1,229
45029000034,608,475,381,26,58,5,6,0,94
45085000134,746,607,8,5,596,6,2,2,599
45085000112,1513,1236,481,32,705,17,5,0,755
45085000101,2888,2479,572,50,1844,20,4,3,1907
45045000239,2739,2142,1493,261,277,36,81,2,649
45045000246,3467,2647,1557,261,705,58,60,0,1090
45085000144,2258,1694,909,56,665,38,18,2,785
45085000109,480,407,62,10,321,18,0,0,345
45085000113,1723,1389,777,17,573,17,3,1,612
45007000094,3365,2537,2231,60,107,51,54,4,306
45013000362,1662,1654,1595,21,28,1,3,0,59
45013000363,1336,1328,1291,16,11,6,6,0,37
45013000183,1556,1272,647,29,572,22,11,1,625
45013000182,1396,1388,1337,17,23,2,6,1,51
45013000309,1289,1112,984,68,28,10,13,0,128
45013000310,1384,1233,1162,22,26,7,12,0,71
45075000123,1425,1098,671,6,399,14,10,0,427
45075000116,1308,1012,502,17,488,12,6,1,510
45007000055,3100,2314,2028,51,128,34,64,1,286
45085000114,1686,1308,600,30,641,25,6,1,708
45085000154,1588,1226,287,42,853,30,22,3,939
45013000161,2057,1433,668,153,550,36,29,4,765
45045000254,3543,2746,2490,69,88,64,25,4,256
45045000262,5893,5316,4360,265,461,61,164,5,956
45045000243,3090,2461,1395,295,718,47,26,7,1066
45045000216,2502,1940,1747,75,64,20,37,2,193
45045000276,2970,2396,1472,139,602,53,114,1,924
45045000229,3740,2798,857,292,1518,42,83,9,1941
45041000015,1484,1199,883,60,238,22,4,0,316
45041000018,1954,1483,61,15,1410,16,5,2,1422
45051000208,1940,1499,913,62,504,13,8,2,586
45051000233,2220,2074,1974,28,35,23,11,0,100
45051000180,2024,1886,1734,46,39,26,26,0,152
45045000311,3107,2525,1660,222,512,54,75,2,865
45085000142,2106,1587,405,29,1131,13,18,2,1182
45085000120,1297,988,625,39,286,23,26,3,363
45085000139,2353,1884,1156,37,612,20,41,0,728
45085000151,1811,1432,505,52,841,17,25,7,927
45045000326,4357,3261,2567,202,387,32,71,5,694
45051000136,3452,2641,1840,229,463,68,22,9,801
45013000320,4169,2761,2105,254,235,71,118,1,656
45013000307,3831,2951,2280,393,168,51,49,0,671
45013000321,931,822,738,33,30,12,13,0,84
45013000314,2976,2034,1459,308,182,40,38,1,575
45013000312,3038,2553,2306,113,69,41,21,1,247
45013000160,1448,1133,355,33,727,9,8,0,778
45013000187,1568,1218,958,111,111,23,21,1,260
45013000134,1138,949,728,18,173,4,9,2,221
45013000132,2096,1647,1353,85,142,40,22,3,294
45051000116,1778,1330,361,129,799,27,7,0,969
45013000207,906,826,792,13,5,3,8,0,34
45013000162,1196,933,301,22,598,9,6,1,632
45085000135,1237,1009,67,7,932,8,1,0,942
45085000132,2970,2315,1433,70,739,44,33,6,882
45045000257,2321,1928,1096,101,349,17,361,3,832
45051000119,2463,2191,1857,171,83,43,19,6,334
45051000190,2803,2124,669,98,1318,38,20,3,1455
45045000366,2619,2033,1660,69,228,54,24,3,373
45041000010,4992,3852,2806,123,683,51,186,9,1046
45041000020,1864,1378,478,51,809,19,21,5,900
45041000019,1125,961,593,39,304,14,25,2,368
45045000355,1813,1359,1090,48,94,36,74,1,269
45045000347,2014,1596,1349,65,114,12,48,0,247
45045000223,2783,2147,1856,41,200,21,35,3,291
45045000283,3421,2771,2340,100,186,25,105,6,431
45061000007,373,304,191,1,109,2,0,1,113
45083000029,4920,3661,2917,176,334,74,162,1,744
45083000004,4795,3812,3002,347,330,112,48,3,810
45019000515,2036,1741,749,64,801,41,89,7,992
45083000060,1635,1273,1095,50,98,23,14,0,178
45083000034,2322,1819,1518,105,138,46,2,3,301
45083000132,2594,1891,493,119,1213,28,33,1,1398
45083000106,1353,1028,514,57,390,16,55,3,514
45083000076,3122,2509,1941,70,442,20,40,3,568
45083000078,2294,1808,902,57,756,27,62,2,906
45045000356,4034,2730,1965,243,294,27,171,4,765
45019000105,3280,2617,1118,210,1005,66,211,19,1499
45019000413,2088,1506,1415,27,14,13,23,0,91
45019000201,795,686,656,13,4,2,10,0,30
45043000122,3539,3199,2988,53,94,35,16,3,211
45091000059,3983,2761,2257,155,170,67,110,9,504
45091000087,3272,2237,1843,116,128,45,92,3,394
45057000017,1531,1175,594,77,476,26,7,0,581
45057000008,2238,1795,1251,74,413,50,7,0,544
45083000121,3612,2828,1540,198,828,60,204,4,1288
45083000140,2445,1908,1465,76,238,19,103,1,443
45091000064,3684,2719,1880,152,409,35,236,2,839
45091000088,3674,2550,1355,604,349,81,199,5,1195
45091000035,2394,1884,589,131,1147,35,7,5,1295
45091000012,3211,2481,2126,74,199,64,24,0,355
45091000007,2748,2046,1452,211,313,46,23,0,594
45091000014,2805,2235,1926,80,145,65,28,1,309
45091000078,2992,2400,1611,105,595,44,57,1,789
45043000101,2446,1850,627,43,1165,13,11,2,1223
45043000134,1299,1115,920,40,134,17,7,1,195
45043000117,3991,3533,3275,66,86,43,41,4,258
45091000082,4332,2938,1776,224,503,51,403,11,1162
45091000018,1686,1275,1071,10,149,25,4,0,204
45091000023,4180,3157,1913,115,1058,44,26,1,1244
45091000021,1401,1161,941,31,144,29,13,3,220
45091000036,4236,3282,1793,545,779,110,98,3,1489
45091000034,2352,1896,1427,111,296,32,24,8,469
45091000025,2156,1716,1374,70,160,37,64,5,342
45091000058,7581,4914,3750,299,485,76,284,7,1164
45091000032,2890,2228,311,80,1815,25,19,5,1917
45091000049,2915,2351,1909,53,285,37,63,0,442
45091000061,2997,1855,1649,59,40,23,74,2,206
45091000094,1798,1283,1159,47,18,15,37,1,124
45091000038,2164,1663,1345,36,210,65,4,1,318
45091000008,4313,3402,2702,114,407,122,25,2,700
45077000113,2330,1834,1734,24,24,39,7,0,100
45077000114,2243,1701,1591,29,11,52,11,1,110
45083000082,3347,2543,1153,189,1153,35,40,5,1390
45083000119,2334,1868,1009,144,590,37,93,0,859
45083000120,2629,2074,1010,127,843,32,34,23,1064
45083000068,2596,1968,642,99,1191,26,27,2,1326
45019000503,1571,1348,585,31,695,20,19,4,763
45019000511,1127,903,810,19,44,10,28,2,93
45019000206,1736,1578,1257,63,203,15,31,1,321
45091000002,2376,1708,1370,90,157,33,39,0,338
45091000075,5042,4399,1872,228,2174,65,66,16,2527
45091000006,646,501,445,14,30,7,0,0,56
45091000080,2077,1672,998,103,443,32,97,6,674
45041000052,1316,1049,319,13,711,7,6,0,730
45019000302,1564,1391,1230,71,26,27,36,2,161
45019000303,1914,1639,1333,41,215,16,30,0,306
45067000001,1997,1594,625,104,851,22,4,5,969
45067000011,1669,1260,394,27,808,33,0,0,866
45043000109,1275,974,38,25,905,12,4,0,936
45043000111,1032,877,621,29,210,9,13,1,256
45001000005,1725,1391,1179,13,146,38,2,0,212
45019000440,2742,2190,1599,186,338,32,19,3,591
45043000112,2283,1624,239,63,1297,28,9,6,1385
45043000133,2875,2196,1064,100,1002,30,4,6,1132
45019000322,2266,1674,1354,49,189,20,61,2,320
45019000321,2194,1896,1702,52,53,18,61,1,194
45019000213,1457,1299,844,31,378,17,17,1,455
45041000022,1161,877,667,43,126,22,25,1,210
45041000017,1930,1554,314,28,1190,16,10,2,1240
45041000025,2034,1576,22,7,1545,3,0,0,1554
45067000006,1851,1467,843,14,558,30,13,4,624
45067000009,1634,1317,789,13,486,33,2,0,528
45067000005,1743,1320,336,22,919,13,39,2,984
45067000003,1731,1403,521,18,850,4,6,0,882
45067000004,1026,818,267,14,522,9,3,2,551
45043000116,1604,1287,1017,57,181,22,9,1,270
45043000119,1233,1089,978,10,71,29,4,0,111
45067000008,4040,2915,680,53,2177,16,8,0,2235
45019000010,1120,935,892,17,5,9,11,1,43
45019000304,2032,1706,1536,32,40,18,42,3,170
45019000306,2648,2201,1823,142,153,39,49,4,378
45019000325,1402,1062,971,31,22,17,6,0,91
45019000220,1576,1293,899,34,318,20,23,2,394
45019000608,1267,1044,733,55,218,34,22,0,311
45019000209,1389,1256,920,44,247,9,24,2,336
45019000444,2184,1809,1070,159,529,32,8,1,739
45019000417,2355,1985,1599,60,220,33,57,2,386
45019000100,1975,1615,772,8,826,8,3,0,843
45019000526,1848,1537,965,58,426,28,35,5,572
45063000061,3919,3221,3003,59,40,48,52,2,218
45063000084,2160,1760,1606,45,41,44,12,3,154
45063000029,2916,2233,1075,667,422,46,56,4,1158
45063000042,2813,2307,1931,90,187,51,48,0,376
45003000073,1878,1595,1211,213,157,19,15,3,384
45019000531,1800,1385,951,139,202,45,38,2,434
45019000312,3436,2910,2552,93,131,28,80,3,358
45019000466,2907,2398,1615,109,605,50,20,0,783
45011000004,1888,1447,549,28,842,15,14,0,898
45011000003,2223,1685,980,46,588,39,31,9,705
45011000007,695,531,283,13,225,15,0,1,248
45019000315,2919,2245,1904,49,227,15,28,1,341
45011000011,1298,1023,903,9,96,9,3,1,120
45019000212,4169,3713,2637,147,789,57,120,16,1076
45019000205,1053,944,867,17,11,12,37,1,77
45067000013,2281,1727,548,15,1152,17,4,1,1179
45069000013,2960,2319,716,22,1519,68,8,3,1603
45019000626,922,637,100,247,270,27,4,0,537
45021000006,2166,1628,1381,28,184,31,9,0,247
45021000026,1401,1092,1004,26,23,24,5,0,88
45021000015,1999,1542,811,51,649,21,11,1,731
45065000008,413,358,88,4,265,3,3,2,270
45025000021,1073,857,651,7,183,9,4,2,206
45025000025,949,754,599,5,141,9,2,2,155
45025000019,3250,2490,1314,266,856,45,20,1,1176
45025000018,1201,941,833,17,66,20,0,1,108
45025000005,1355,1064,511,13,488,34,15,0,553
45039000022,1571,1435,1181,9,201,20,18,1,254
45055000123,2644,1940,1332,71,456,50,30,1,608
45055000127,2041,1471,877,75,463,36,25,7,594
45055000122,3419,2579,1831,93,574,52,50,0,748
45025000006,2067,1548,749,94,671,39,9,2,799
45025000017,564,430,329,12,77,14,3,0,101
45025000016,1520,1192,926,162,67,29,4,0,266
45025000015,2402,1880,1165,213,460,41,7,1,715
45025000020,3116,2393,1338,149,857,50,21,1,1055
45033000003,2429,1791,414,41,1301,50,7,2,1377
45033000005,513,386,266,4,95,23,1,0,120
45033000019,888,670,529,12,112,17,1,2,141
45025000007,1940,1521,923,21,498,22,52,2,598
45063000053,2909,2321,1790,160,270,72,49,6,531
45063000014,3261,2574,2000,115,347,60,55,4,574
45019000180,2012,1952,1857,28,24,10,23,1,95
45019000460,1103,848,240,25,575,9,1,1,608
45069000005,1983,1558,887,9,584,81,7,3,671
45019000518,2724,2219,1067,123,955,44,37,13,1152
45021000022,584,467,391,16,44,14,4,1,76
45021000012,1501,1016,392,46,559,15,5,0,624
45021000004,1810,1405,1249,56,58,31,11,1,156
45053000114,1348,1017,553,125,326,10,3,0,464
45081000010,620,475,354,27,90,5,0,0,121
45081000016,1120,922,422,82,418,7,2,0,500
45081000019,776,636,556,28,42,9,2,0,80
45037000013,2789,2229,1028,88,1075,34,11,3,1201
45037000011,711,601,252,4,344,4,2,0,349
45037000007,3369,2655,2158,64,334,52,34,4,497
45043000103,1675,1315,1184,21,88,16,4,1,131
45043000113,658,550,388,14,133,4,11,1,162
45053000107,1668,1168,313,367,464,44,16,3,855
45053000116,941,875,763,40,62,9,7,1,112
45053000106,2211,1588,432,626,487,42,18,1,1156
45043000126,3367,2948,2769,60,40,37,22,2,179
45063000074,1069,855,603,38,191,15,9,1,252
45003000034,2730,2134,1615,139,334,29,11,9,519
45003000030,1804,1381,1131,83,123,29,5,4,250
45003000069,2136,1924,1704,56,80,23,55,5,220
45003000013,2379,1904,1438,110,265,52,39,2,466
45025000014,3080,2336,1572,78,618,37,26,2,764
45025000004,2423,1933,888,48,941,40,7,5,1045
45019000465,1821,1427,737,160,506,30,8,1,690
45037000012,4776,3819,3048,126,483,112,50,2,771
45039000012,734,604,182,12,414,3,1,1,422
45055000147,2096,1613,1223,32,290,59,5,0,390
45055000133,2692,2038,1460,83,428,45,13,0,578
45063000076,5407,3779,3159,143,296,57,105,9,620
45003000044,2152,1607,1038,101,406,53,11,4,569
45003000074,1083,858,551,68,181,31,18,0,307
45003000076,2642,2110,1768,69,167,31,63,1,342
45003000045,3058,2387,1649,109,537,39,41,7,738
45025000003,740,590,463,22,95,11,2,0,127
45025000012,1565,1198,905,67,195,33,4,1,293
45003000052,1521,1211,837,70,228,44,39,2,374
45003000083,1492,1182,801,63,262,25,38,4,381
45063000030,2086,1760,1575,28,101,22,33,2,185
45049000017,789,596,343,7,231,13,2,1,253
45049000015,103,74,49,1,25,3,0,0,25
45079000436,2022,1631,19,26,1590,4,1,0,1612
45071000030,1792,1491,1323,15,115,33,5,0,168
45079000425,3005,2313,1120,186,902,48,106,6,1193
45079000409,4721,3417,1350,264,1663,58,121,18,2067
45079000412,4389,3441,969,215,1967,63,243,11,2472
45079000432,2064,1621,940,93,506,53,50,0,681
45079000434,1606,1313,102,24,1169,9,10,0,1211
45079000482,5320,3955,1074,846,1688,95,328,2,2881
45071000050,1247,1002,749,16,219,15,5,1,253
45071000049,1300,1003,738,16,213,30,5,1,265
45079000438,2831,2446,1473,185,692,80,48,7,973
45071000018,1121,925,183,84,655,16,1,1,742
45079000435,1378,1110,496,57,534,24,9,1,614
45079000456,4292,3299,1118,272,1655,51,258,14,2181
45079000416,1436,1103,967,34,56,17,27,3,136
45079000488,4697,3340,909,179,2106,56,121,10,2431
45079000487,3895,2885,832,150,1719,34,168,7,2053
45079000134,1476,1333,931,36,325,25,15,0,402
45079000130,2342,2207,1505,164,329,22,163,6,702
45023000029,2323,1779,643,13,1091,26,10,2,1136
45023000014,339,282,181,21,64,16,4,0,101
45027000010,3309,2822,2235,36,456,55,20,2,587
45027000015,1681,1225,501,30,661,22,16,1,724
45079000404,2018,1488,222,82,1009,37,169,3,1266
45079000444,693,569,275,46,232,10,12,0,294
45079000443,3759,3057,1504,187,1294,72,23,3,1553
45015000039,2316,1877,1310,156,307,60,30,7,567
45001000004,1188,925,606,15,291,16,4,0,319
45029000023,370,307,164,5,134,6,0,0,143
45015000055,4146,3102,1493,381,1011,115,134,8,1609
45015000056,1993,1513,727,271,403,59,44,2,786
45015000004,2100,1715,1449,33,159,45,19,3,266
45023000010,2442,1887,809,25,1027,24,0,1,1078
45007000027,2051,1616,1399,23,144,21,18,3,217
45007000050,2584,1998,1708,53,118,24,84,1,290
45061000003,2118,1923,409,53,1461,10,0,0,1514
45089000031,358,295,78,1,213,0,1,1,217
45035000061,2166,1547,908,122,411,64,27,6,639
45035000039,2522,1862,1132,87,597,33,21,2,730
45035000062,924,698,487,43,140,11,16,3,211
45035000078,2109,1631,1217,139,194,46,27,3,414
45023000024,772,637,348,3,276,11,2,0,289
45085000129,814,594,12,18,566,4,1,1,582
45089000035,1005,843,597,10,223,8,4,1,246
45035000040,1339,1025,660,63,228,46,33,6,365
45085000121,2195,1696,1424,38,156,37,50,4,272
45089000001,430,349,153,2,192,3,0,0,196
45087000007,603,446,216,9,210,9,3,1,230
45087000021,1594,1235,764,22,427,17,8,5,471
45015000010,1777,1441,941,47,399,34,8,0,500
45035000103,1657,1196,784,60,303,30,25,5,412
45007000035,2603,1974,1597,50,240,56,17,1,377
45085000119,2593,2089,901,107,953,32,111,4,1188
45015000015,2516,1948,1267,156,360,55,107,5,681
45051000152,1129,890,715,13,131,26,3,0,175
45051000229,6778,5480,4236,442,522,114,131,4,1244
45061000018,794,668,190,9,464,4,2,1,478
45085000147,3361,2569,1602,87,781,60,46,6,967
45085000103,1527,1200,612,56,501,14,25,2,588
45085000146,2335,1661,868,84,665,41,5,5,793
45007000078,1798,1453,779,73,555,35,16,7,674
45007000067,2162,1656,1445,25,92,25,59,0,211
45007000040,2228,1664,1377,54,130,21,81,2,287
45007000092,2776,2186,1776,73,272,41,32,1,410
45007000072,5038,3795,3096,389,205,96,6,1,699
45023000032,1419,1097,391,32,664,13,7,0,706
45045000248,3455,2692,1858,264,430,56,84,8,834
45045000296,1985,1529,1284,93,116,26,3,3,245
45047000024,1004,801,637,12,126,15,4,3,164
45047000017,1605,1302,1165,21,75,25,13,3,137
45007000046,3316,2717,2269,35,306,61,32,3,448
45045000365,3695,2665,2121,103,301,90,45,3,544
45047000018,1381,1079,713,78,247,15,25,1,366
45047000042,1559,1203,853,32,235,16,59,4,350
45047000036,1361,1213,1142,17,31,8,9,0,71
45061000013,943,715,183,5,522,7,0,0,532
45061000011,986,812,432,14,354,15,6,3,380
45051000107,2844,2180,1814,66,196,91,24,0,366
45045000208,4567,3871,2259,219,1282,67,67,8,1612
45047000014,1201,908,578,23,257,26,12,0,330
45047000015,1941,1528,1205,25,266,19,5,0,323
45007000087,3816,3061,1928,155,887,60,24,10,1133
45007000030,2241,1936,1785,28,48,46,19,2,151
45045000227,2999,2708,2184,167,157,32,182,15,524
45045000210,4258,3839,2697,181,864,31,66,4,1142
45051000149,513,427,264,8,141,10,1,0,163
45051000193,3554,2871,2043,332,353,64,60,3,828
45051000131,7144,5812,4534,291,577,126,167,12,1278
45051000224,3534,2712,2272,142,174,44,83,2,440
45051000197,5472,4410,3501,287,381,118,122,7,909
45013000222,2663,2033,1390,305,287,20,27,1,643
45013000201,2249,1699,1039,456,151,29,24,1,660
45051000204,3054,2742,2560,49,45,54,21,3,182
45051000142,2976,2567,2274,99,78,48,41,13,293
45051000159,2435,1970,1135,49,748,35,5,5,835
45047000028,1700,1443,1123,34,253,13,23,0,320
45047000021,1448,1134,877,41,174,29,5,0,257
45013000206,1002,815,778,14,4,4,6,1,37
45047000039,1437,1082,856,35,160,12,17,3,226
45087000015,1013,794,721,8,53,6,2,0,73
45075000129,950,762,228,5,509,20,3,0,534
45075000146,1507,1152,81,7,1054,12,7,0,1071
45087000006,1206,971,774,10,175,7,5,2,197
45059000023,2036,1624,1383,82,94,46,13,0,241
45051000120,2329,1850,1442,72,296,44,4,1,408
45051000176,2692,2056,1340,82,522,42,64,2,716
45051000153,2911,2371,1511,494,265,47,42,2,860
45075000109,805,649,155,3,438,5,44,6,494
45075000130,1861,1577,1017,13,494,42,7,1,560
45075000125,1673,1372,50,10,1305,18,3,2,1322
45013000226,1050,975,929,9,10,11,8,0,46
45045000291,2924,2389,1624,150,426,47,137,2,765
45045000342,5107,3731,1594,1260,796,142,52,2,2137
45013000216,1608,1473,1210,102,93,25,39,0,263
45041000042,477,373,220,5,135,9,0,0,153
45041000016,1595,1242,88,10,1141,8,1,2,1154
45029000022,847,687,451,19,203,14,1,1,236
45029000013,734,568,433,36,93,9,0,0,135
45029000027,978,762,523,25,187,23,2,1,239
45029000020,924,742,214,16,506,9,1,0,528
45029000009,1353,1108,383,26,688,15,3,0,725
45031000028,2306,1873,934,16,893,31,4,0,939
45075000133,2468,1955,409,14,1518,12,10,2,1546
45075000117,2517,2024,959,45,921,21,76,1,1065
45013000306,2351,1724,1089,367,183,36,47,4,635
45031000021,4043,3014,1525,43,1414,38,5,0,1489
45031000024,1907,1511,851,14,596,46,6,1,660
45045000307,4745,3677,3250,188,132,56,27,6,427
45045000360,4570,3440,3051,140,93,76,36,4,389
45075000101,1035,840,304,15,483,24,32,2,536
45015000020,3439,2674,1849,186,247,62,249,6,825
45087000002,499,418,174,8,230,9,2,0,244
45083000127,2556,1935,1537,85,225,39,64,1,398
45083000096,4901,4047,3221,101,626,58,22,1,826
45087000001,928,755,670,5,62,6,1,1,85
45013000184,1756,1382,503,99,758,25,4,2,879
45059000031,3523,2785,2463,95,142,65,18,0,322
45045000258,3047,2380,2078,114,112,55,19,2,302
45017000008,1226,1043,629,24,374,14,3,0,414
45017000004,267,224,125,16,82,0,1,0,99
45083000084,1445,1206,784,101,260,33,26,1,422
45059000019,1293,1016,685,65,234,26,5,2,331
45059000026,2286,1948,1370,52,484,44,3,1,578
45083000035,5043,3918,2274,612,713,132,236,4,1644
45043000104,2338,1908,1513,123,241,24,22,1,395
45013000221,1462,1385,1329,16,19,4,7,0,56
45013000220,1878,1677,1525,65,37,18,17,1,152
45091000026,2637,2044,1243,171,566,64,20,1,801
45051000234,2276,2054,1878,50,42,27,35,0,176
45051000139,1528,1282,1230,11,7,24,10,0,52
45051000164,2147,1760,1376,63,260,33,22,2,384
45051000147,2512,1984,1418,139,343,40,29,8,566
45051000145,2334,1920,1599,77,189,61,4,1,321
45051000110,4796,3581,2803,208,314,58,138,11,778
45051000132,5088,3617,2981,187,211,72,154,3,636
45091000098,2279,1765,1366,73,245,31,35,1,399
45091000055,1579,1193,1065,24,60,24,20,2,128
45045000244,4410,3101,2375,174,322,58,168,3,726
45041000005,3889,3030,1732,79,1108,51,71,2,1298
45019000327,4062,2872,2539,81,71,28,146,1,333
45083000008,6645,4869,3258,337,881,86,311,6,1611
45011000001,1275,937,387,21,485,22,23,4,550
45083000073,2420,1987,1705,64,138,17,35,0,282
45083000124,2149,1666,1420,63,114,36,46,1,246
45019000008,1164,980,575,14,378,12,8,0,405
45067000015,2858,2222,914,34,1242,33,11,2,1308
45091000069,1629,1232,1100,52,45,26,16,2,132
45019000202,976,869,830,16,12,3,9,0,39
45019000316,948,708,669,3,10,4,7,1,39
45019000528,4758,3749,2508,226,821,52,142,2,1241
45019000508,1100,908,349,29,519,8,7,1,559
45091000060,2460,1878,1554,87,125,38,73,1,324
45091000083,1612,1190,928,43,167,36,21,2,262
45091000079,2054,1593,1028,77,230,202,61,4,565
45091000047,2181,1756,1483,44,116,79,19,0,273
45019000610,2970,2170,484,611,1037,53,23,1,1686
45011000005,1299,1008,350,20,615,28,6,0,658
45067000007,2146,1655,745,25,858,17,12,1,910
45091000039,1134,924,853,12,29,20,3,0,71
45091000076,1954,1458,928,74,97,357,13,7,530
45091000031,2444,1928,165,53,1695,38,5,6,1763
45033000007,793,612,333,11,258,6,2,1,279
45033000017,1629,1220,880,33,262,51,1,0,340
45077000133,1611,1220,1035,51,70,46,5,1,185
45077000157,1600,1206,983,95,99,31,3,0,223
45077000141,1616,1299,1045,86,115,33,7,0,254
45011000013,1863,1431,544,34,817,41,4,2,887
45041000035,784,610,462,17,126,4,0,1,148
45041000024,2411,1920,1629,40,190,12,38,0,291
45077000146,2398,1925,1650,116,74,59,21,2,275
45077000103,5468,5025,4128,230,239,63,328,8,897
45083000133,2078,1601,1111,87,339,36,37,0,490
45043000106,356,282,177,7,87,8,1,0,105
45019000104,5042,4119,2033,322,1496,64,200,5,2086
45069000004,453,373,258,5,84,25,1,0,115
45077000110,1598,1264,978,64,132,29,65,3,286
45043000115,896,706,208,10,477,13,4,0,498
45011000014,825,636,432,12,172,17,1,0,204
45019000328,1560,1129,1024,36,35,9,22,1,105
45019000184,920,792,768,4,4,6,6,0,24
45021000028,1035,859,308,30,508,7,6,0,551
45063000017,2575,1918,1407,180,248,53,26,1,511
45003000023,2247,1728,983,68,618,43,13,0,745
45021000030,1423,1106,1035,6,28,28,6,2,71
45003000056,1878,1511,974,88,396,51,2,6,537
45003000026,1559,1163,663,50,419,22,20,5,500
45003000080,1279,1073,840,47,129,28,30,2,233
45003000062,1827,1419,662,134,583,43,17,3,757
45063000063,3304,2497,2285,57,75,38,44,3,212
45055000149,1149,958,654,11,271,16,2,1,304
45069000010,2156,1691,808,14,494,382,4,2,883
45069000001,556,440,246,3,154,39,0,0,194
45091000019,2150,1675,811,129,666,37,26,5,864
45065000004,262,213,89,4,114,7,1,1,124
45065000013,284,238,162,4,64,9,4,2,76
45003000055,1352,1124,933,50,95,24,22,4,191
45003000035,2953,2614,1681,91,743,40,65,5,933
45003000024,1315,1021,818,27,144,30,3,0,203
45055000115,2601,2006,1467,73,416,46,11,3,539
45039000009,1114,911,329,27,554,8,4,0,582
45055000150,2434,1906,1182,72,607,38,26,2,724
45055000111,1103,869,716,21,109,13,19,0,153
45019000622,2642,2023,618,370,969,28,35,4,1405
45019000605,2709,2025,250,65,1686,32,25,2,1775
45063000045,1650,1215,284,419,497,31,9,4,931
45019000621,2704,2105,697,569,778,48,50,7,1408
45003000006,1387,1215,1114,30,46,16,9,0,101
45063000003,3078,2317,2095,68,57,41,47,0,222
45019000443,5443,4421,3652,212,414,88,48,2,769
45055000126,2255,1672,1131,153,312,54,12,6,541
45063000068,3212,2520,2319,73,32,40,47,3,201
45063000088,4509,3278,2487,142,260,97,297,2,791
45049000021,393,331,42,8,282,4,2,1,289
45019000181,2178,2100,2049,16,12,12,9,0,51
45019000012,1758,1537,1465,27,12,15,12,0,72
45049000010,431,350,105,13,232,5,2,0,245
45037000002,4157,3566,1355,292,1890,45,26,1,2211
45019000407,1842,1595,1130,33,389,17,27,3,465
45019000510,1484,1281,759,39,413,31,29,15,522
45003000054,2076,1645,757,222,604,34,32,2,888
45063000018,6015,4472,3359,230,650,139,77,3,1113
45053000104,4213,3445,1079,477,1846,25,21,7,2366
45003000043,2037,1558,1050,243,214,43,10,0,508
45003000082,1762,1363,960,162,189,55,7,0,403
45019000628,3038,2355,715,840,711,37,84,5,1640
45019000532,1476,1184,939,58,133,18,34,1,245
45019000174,1406,1177,696,29,433,8,5,2,481
45033000014,575,427,144,8,195,76,0,1,283
45033000011,686,504,318,15,158,13,3,0,186
45003000040,2206,1738,1096,97,479,43,12,2,642
45063000059,2685,2379,2097,42,144,35,59,5,282
45003000004,1087,845,208,30,594,14,2,0,637
45003000036,962,768,457,20,270,13,4,0,311
45003000003,3160,2198,447,80,1627,25,21,7,1751
45039000015,1140,939,471,25,430,10,7,3,468
45079000473,3460,2522,570,107,1772,47,67,1,1952
45079000475,2592,1946,224,111,1520,24,90,8,1722
45003000053,1529,1387,1227,19,88,12,38,1,160
45027000012,1329,1050,427,20,581,15,11,3,623
45055000108,559,464,307,15,132,7,4,1,157
45055000113,534,453,367,16,62,2,6,0,86
45049000009,1023,825,628,4,178,13,2,0,197
45081000017,2449,1800,578,465,737,38,10,1,1222
45079000490,2275,1894,564,104,1176,25,45,1,1330
45079000512,3214,2557,703,97,1687,24,74,7,1854
45007000036,3547,2542,2112,85,202,27,101,2,430
45007000132,2700,2099,1566,51,408,37,38,0,533
45079000119,2163,1505,67,40,1378,23,28,0,1438
45035000081,2115,1704,1020,93,483,42,72,2,684
45035000086,1522,1128,713,104,262,23,34,2,415
45035000094,1679,1259,835,26,365,31,6,0,424
45035000036,1091,786,392,15,363,12,9,1,394
45035000110,1044,813,370,48,341,26,36,3,443
45035000064,1405,1047,554,94,297,34,85,2,493
45051000101,3879,3120,2234,192,583,88,24,0,886
45051000187,1329,1032,902,19,95,11,0,0,130
45089000012,801,645,295,8,336,4,1,0,350
45089000003,734,609,235,12,354,8,2,1,374
45075000128,1541,1236,912,58,249,14,3,2,324
45075000136,2616,1937,607,101,1157,11,55,0,1330
45045000237,3443,2534,1097,705,648,85,46,3,1437
45047000026,1613,1178,630,122,390,30,5,1,548
45045000278,3409,2666,1313,351,882,51,81,2,1353
45031000005,1000,818,622,11,173,9,2,0,196
45031000025,1081,840,296,8,512,19,3,0,544
45045000228,1588,1343,735,115,447,16,37,4,608
45031000013,1966,1638,1314,48,228,28,24,8,324
45075000150,2430,1872,565,38,1222,34,14,4,1307
45029000018,365,279,199,3,66,9,1,0,80
45075000108,1022,770,286,13,439,7,29,0,484
45045000203,3338,2515,2220,74,110,54,42,13,295
45087000016,941,785,394,2,376,9,1,0,391
45085000123,1750,1468,212,66,1156,37,22,4,1256
45085000122,1576,1286,813,45,383,30,29,4,473
45075000152,2622,1906,817,93,953,57,4,2,1089
45013000361,1148,1138,1081,8,35,4,3,0,57
45013000319,2470,1659,893,516,171,41,53,0,766
45075000112,748,610,10,3,589,7,4,2,600
45045000324,2958,2147,1940,73,38,33,52,2,207
45007000043,1516,1153,902,47,142,33,27,0,251
45085000149,2507,1941,1500,53,272,33,78,3,441
45085000117,2980,2231,372,102,1694,42,38,5,1859
45051000130,4136,3331,2404,328,381,84,122,0,927
45051000227,3109,2553,1838,400,193,36,71,1,715
45051000228,3213,2564,2123,97,151,57,94,3,441
45051000158,3408,2685,1928,238,398,76,62,6,757
45085000136,810,674,148,15,512,3,4,2,526
45085000148,2093,1584,780,48,703,32,20,3,804
45045000305,2245,1799,385,133,1252,46,9,2,1414
45051000200,3171,2419,1863,329,111,76,35,2,556
45083000053,3008,2356,2137,57,79,45,27,0,219
45083000001,2356,1842,1364,146,274,42,17,2,478
45019000402,1069,890,241,21,603,19,13,3,649
45057000012,2818,2245,1490,88,624,43,10,1,755
45091000077,1326,970,656,72,160,60,21,5,314
45091000085,1774,1424,1228,34,94,47,14,1,196
45091000042,5078,3821,2445,200,1064,91,36,2,1376
45091000040,3120,2488,2173,56,153,66,31,0,315
45091000033,3576,2682,1456,171,977,54,40,7,1226
45091000072,2293,1727,1152,85,432,52,20,3,575
45091000071,1663,1254,826,64,303,16,33,0,428
45083000044,5562,4265,3697,192,176,123,51,2,568
45083000018,3928,2897,1500,142,1084,42,138,3,1397
45019000408,2568,2249,1916,55,193,34,37,1,333
45019000530,2771,2424,1794,97,404,38,77,0,630
45019000620,1280,1021,455,186,328,29,30,3,566
45091000062,2313,1798,1439,95,178,51,30,1,359
45019000335,7539,5553,4931,200,169,69,169,6,622
45001000011,1021,842,610,13,202,15,4,0,232
45019000333,5428,4033,3684,150,45,31,107,3,349
45019000522,1516,1306,1081,38,137,14,30,2,225
45019000401,1408,1181,358,38,739,14,19,4,823
45041000041,2767,2005,114,52,1831,25,5,2,1891
45043000118,3000,2593,2185,48,300,37,14,0,408
45019000204,1145,935,762,17,140,8,14,0,173
45067000002,341,283,102,4,170,9,1,1,181
45043000108,1396,1111,412,17,667,8,1,1,699
45019000011,1524,1221,1134,19,12,12,29,3,87
45019000512,1305,1060,903,19,100,10,21,2,157
45019000106,1540,1278,678,73,399,52,80,3,600
45019000509,1743,1293,298,21,957,8,13,0,995
45019000630,2995,2305,666,226,1272,65,69,15,1639
45003000029,2320,1941,1391,107,318,42,78,4,550
45019000445,1860,1490,730,222,495,35,24,3,760
45019000514,1977,1640,995,204,368,18,26,17,645
45019000221,1168,902,255,17,618,11,2,1,647
45019000319,2968,2546,2164,134,107,29,106,1,382
45019000324,1040,856,756,37,32,17,20,0,100
45019000537,6444,5261,4015,289,553,84,294,4,1246
45019000501,885,751,465,20,230,19,20,0,286
45021000005,1611,1196,912,32,227,24,3,0,284
45025000009,2658,2024,760,51,1183,30,25,1,1264
45025000024,849,691,505,6,153,25,0,0,186
45039000001,99,92,31,2,56,1,2,1,61
45025000001,1082,819,563,28,211,8,3,0,256
45033000010,373,303,170,3,119,10,2,0,133
45033000015,950,712,257,62,370,28,4,2,455
45019000603,1594,1409,966,95,265,37,50,2,443
45063000048,3241,2514,1514,140,700,47,108,16,1000
45021000032,928,749,715,8,12,13,1,1,34
45081000007,1227,1077,1023,12,19,21,3,0,54
45063000006,3318,2704,2548,42,39,40,23,0,156
45021000016,2019,1699,1026,61,552,32,14,2,673
45063000046,1034,949,811,34,72,18,13,1,138
45003000012,1424,1019,470,150,382,18,8,2,549
45025000010,2318,1828,860,18,885,40,38,2,968
45011000006,769,612,178,5,420,9,0,0,434
45025000008,1610,1341,725,17,538,31,32,4,616
45079000489,987,724,60,18,640,12,5,8,664
45079000495,951,743,299,21,390,20,21,1,444
45079000117,2113,1660,1464,87,55,17,28,1,196
45079000111,2190,1754,1084,79,538,18,41,2,670
45079000502,3870,3051,1583,150,1184,47,111,20,1468
45079000461,2127,1652,468,73,1067,15,40,4,1184
45027000001,1177,920,460,47,394,15,5,0,460
45079000422,2474,1767,1246,59,387,41,40,1,521
45015000075,2092,1654,1284,88,167,44,64,4,370
45015000051,2417,1875,1375,84,274,27,87,5,500
45007000017,3341,2563,2228,60,195,47,20,4,335
45085000115,1731,1329,358,35,923,22,6,3,971
45035000082,1045,778,708,14,28,7,12,4,70
45035000030,1016,779,477,25,256,23,3,0,302
45035000055,1788,1404,1189,61,109,33,19,0,215
45035000057,1344,1054,795,39,150,27,43,0,259
45015000050,1824,1397,1064,58,153,32,81,5,333
45007000021,4982,3740,2746,137,432,59,345,6,994
45051000195,3365,2768,1762,310,472,118,82,17,1006
45051000111,3046,2514,2016,101,296,27,67,4,498
45027000003,207,150,103,6,39,4,0,0,47
45031000031,1544,1224,1096,16,80,30,2,1,128
45035000071,4919,3613,2231,293,773,92,245,17,1382
45089000026,328,268,166,6,88,10,0,0,102
45061000005,958,786,354,10,412,6,7,0,432
45047000016,1437,1139,617,14,482,19,2,0,522
45051000157,3535,2690,2000,297,296,74,22,0,690
45051000184,6073,5032,4065,378,324,105,108,9,967
45061000006,1595,1253,331,8,901,11,5,2,922
45051000188,742,613,79,2,522,6,1,0,534
45047000001,1765,1330,238,231,846,26,8,0,1092
45047000032,505,383,327,8,38,4,5,0,56
45047000012,1317,1002,608,19,348,17,5,1,394
45045000231,1693,1341,1199,43,47,26,23,2,142
45051000226,4849,3734,3080,167,241,79,120,6,654
45013000203,2048,1746,1198,350,158,36,8,2,548
45013000205,1703,1596,1477,41,47,15,17,0,119
45045000362,4074,2892,1815,326,299,66,374,0,1077
45087000008,2166,1702,1116,17,538,20,14,2,586
45059000016,970,732,476,16,221,20,3,0,256
45051000169,1028,773,608,55,76,43,3,1,165
45057000014,2756,2035,1325,29,630,50,6,1,710
45045000287,4822,3462,2624,222,498,48,86,8,838
45045000361,4300,3193,1494,519,1052,54,80,10,1699
45045000327,4775,3535,1530,777,1171,125,19,4,2005
45045000363,3721,2751,2046,215,247,53,179,3,705
45013000214,1474,1346,1241,35,17,29,17,0,105
45041000044,2265,1735,1190,42,440,40,23,2,545
45041000059,2613,2037,1241,46,716,33,13,0,796
45075000103,2075,1458,121,23,1314,8,2,0,1337
45013000302,1769,1283,857,297,91,28,13,0,426
45031000022,1178,968,635,24,298,12,0,0,333
45001000009,851,663,582,17,50,10,1,0,81
45059000028,1078,850,761,18,35,30,0,0,89
45075000142,1973,1461,839,34,550,27,6,0,622
45051000102,1175,913,777,21,91,16,11,1,136
45083000072,1687,1296,1206,13,45,12,22,0,90
45083000024,1963,1581,1172,91,241,48,42,2,409
45083000098,3200,2510,1564,234,491,70,173,2,946
45083000142,2749,2216,1685,124,241,32,136,0,531
45083000070,2374,1645,140,100,1382,29,29,5,1505
45087000017,1056,831,474,13,331,12,4,0,357
45083000115,3386,2549,1793,221,464,47,34,7,756
45059000030,1830,1487,1385,13,40,43,0,1,102
45041000027,1428,1107,662,25,394,19,10,3,445
45011000010,1207,967,289,13,652,11,2,0,678
45019000334,2358,1818,1550,48,98,33,81,1,268
45041000023,2826,2143,1401,49,616,23,61,0,742
45041000030,964,636,146,6,477,7,4,1,490
45067000017,854,710,479,13,190,25,8,1,231
45019000504,1993,1643,1483,47,51,27,29,1,160
45091000073,2355,1811,1339,44,362,35,27,0,472
45091000053,4050,3327,2387,294,452,52,139,3,940
45033000020,706,577,406,10,136,21,6,5,171
45077000107,1625,1331,941,53,121,22,197,5,390
45073000014,1177,903,825,13,26,36,0,1,78
45043000121,531,407,38,1,366,1,1,0,369
45019000207,2498,2426,2075,128,192,10,22,4,351
45019000405,2102,1575,1108,30,391,11,31,1,467
45019000406,2684,2088,1847,41,106,33,65,4,241
45003000009,2621,1965,1017,99,800,49,19,3,948
45003000065,2170,1817,1567,54,138,19,23,2,250
45091000050,3018,2089,1799,82,94,35,67,0,290
45091000037,1601,1173,181,31,929,44,10,4,992
45063000027,3806,2841,2033,346,365,83,8,3,808
45003000084,1548,1145,867,13,196,51,23,1,278
45003000063,1341,1040,738,49,229,22,14,1,302
45063000093,3348,2289,1596,210,386,61,46,1,693
45063000016,3727,2706,2189,136,266,75,48,5,517
45019000616,1555,1310,560,96,614,30,23,0,750
45019000320,1715,1414,1218,24,127,13,21,0,196
45019000219,986,863,389,13,440,11,13,4,474
45019000615,2365,1754,298,135,1275,24,42,3,1456
45019000314,2113,1898,1637,59,107,24,57,1,261
45019000313,1630,1468,1241,57,121,6,22,2,227
45055000112,794,616,240,38,328,12,3,1,376
45055000132,2070,1546,1011,53,430,28,17,0,535
45049000002,1632,1266,617,20,600,10,21,1,649
45049000016,418,315,272,1,35,5,3,1,43
45019000216,1384,1253,678,38,501,24,17,3,575
45033000013,1435,1078,408,42,580,48,3,1,670
45003000050,4804,3433,1999,357,941,90,44,10,1434
45055000134,2228,1699,1371,44,233,35,15,0,328
45003000033,970,799,629,33,114,15,5,0,170
45027000005,689,554,135,10,404,3,6,0,419
45027000009,468,393,314,8,63,4,1,0,79
45079000428,1545,1238,1153,23,26,13,22,2,85
45079000107,1809,1325,49,17,1262,9,9,3,1276
45079000486,4189,3102,778,147,2042,58,119,8,2324
45079000485,2404,1766,301,114,1325,12,45,1,1465
45025000002,581,445,388,14,31,13,1,0,57
45007000037,854,665,606,7,28,23,2,1,59
45079000451,4965,3484,1657,192,1380,68,190,11,1827
45035000100,1964,1585,799,56,682,35,26,8,786
45051000118,819,619,513,12,77,16,1,0,106
45075000115,1805,1357,332,23,972,26,12,0,1025
45007000091,4150,3242,2338,116,670,66,53,4,904
45045000293,2799,2155,1795,78,139,23,98,2,360
45045000238,2750,2090,1737,86,143,41,87,0,353
45045000221,1793,1563,1449,26,50,6,24,1,114
45045000247,3930,3001,2602,124,122,79,38,3,399
45057000034,2722,1984,1542,154,182,29,71,3,442
45045000364,2507,1943,1375,167,325,35,46,0,568
45085000157,1441,1143,878,45,174,28,30,1,265
45045000236,1623,1219,396,132,647,35,25,2,823
45045000285,2803,2186,1953,76,61,52,33,2,233
45045000319,3337,2921,1875,338,558,47,101,3,1046
45045000225,3400,2807,1364,620,685,29,108,12,1443
45045000292,1705,1446,1269,72,41,30,29,6,177
45045000316,4056,3061,2796,115,39,82,19,6,265
45083000107,3037,2277,694,194,1234,51,131,1,1583
45045000230,2882,2116,814,597,694,37,5,2,1302
45057000003,1242,978,858,18,75,16,2,0,120
45091000066,4779,3372,2261,172,429,52,448,1,1111
45091000016,2608,1969,1726,80,66,30,55,0,243
45091000017,2938,2144,1440,176,450,32,43,0,704
45019000441,3313,2651,1347,290,923,50,47,3,1304
45029000007,466,396,179,5,201,14,0,0,217
45029000005,763,625,367,12,237,14,0,0,258
45091000013,1556,1242,1006,50,133,32,22,5,236
45019000525,2305,1967,1212,65,542,23,101,10,755
45019000627,3061,2114,509,898,658,49,26,1,1605
45019000308,1193,895,841,19,12,10,6,0,54
45019000619,1843,1395,248,114,966,9,57,4,1147
45019000614,931,856,585,41,171,17,35,0,271
45019000505,1669,1305,1226,13,28,13,25,0,79
45025000022,466,372,309,8,39,19,0,1,63
45019000203,1062,945,887,20,17,11,13,0,58
45039000013,83,74,38,0,35,1,0,0,36
45039000021,187,144,41,1,98,4,2,2,103
45039000010,868,714,337,15,354,10,2,3,377
45021000001,1748,1355,1231,34,46,34,4,0,124
45055000135,1838,1397,1117,57,178,31,25,2,280
45011000008,987,774,708,18,29,18,7,2,66
45081000020,695,555,245,81,223,11,3,0,310
45009000005,352,274,180,5,88,0,1,0,94
45079000477,2115,1630,1133,111,320,27,61,3,497
45079000476,1292,897,824,18,23,7,26,0,73
45079000133,1388,1244,693,35,467,10,36,4,551
45079000414,2657,2086,665,68,1300,17,41,7,1421
45079000108,1591,1569,481,34,987,18,47,4,1088
45089000027,544,436,415,0,12,7,0,0,21
45035000035,1419,1093,750,34,267,46,3,0,343
45035000093,2389,1746,1052,91,520,59,26,3,694
45035000058,881,705,596,35,44,21,16,1,109
45027000025,360,279,152,6,115,5,1,1,127
45015000021,2527,1915,1181,191,449,51,45,0,734
45051000185,1045,812,681,39,60,18,0,0,131
45061000024,297,253,99,6,143,4,0,1,154
45085000118,4461,3384,1789,202,1149,64,188,9,1595
45085000143,1290,933,323,59,528,29,17,1,610
45031000007,450,359,156,4,190,15,1,0,203
45035000052,1429,1130,903,45,144,18,23,2,227
45007000093,1878,1572,1113,302,137,11,42,1,459
45051000103,246,201,93,13,81,5,4,0,108
45035000054,794,646,189,11,435,8,8,1,457
45051000108,2897,2599,2397,41,50,43,50,5,202
45051000221,2435,2004,1745,56,119,35,35,0,259
45045000300,3213,2364,2057,99,100,30,67,4,307
45013000217,1716,1584,1471,58,33,1,13,0,113
45031000037,1499,1088,698,24,350,14,0,0,390
45051000198,2021,1656,1453,57,89,45,2,0,203
45045000222,3046,2352,2142,67,82,20,20,6,210
45045000235,4279,3222,2488,209,284,65,161,4,734
45013000133,1732,1301,1096,81,82,25,6,0,205
45013000186,1336,990,778,44,134,18,12,1,212
45045000358,2484,1828,1392,105,246,17,51,1,436
45029000011,734,602,445,19,134,4,0,0,157
45075000107,958,767,338,3,394,14,22,1,429
45015000016,869,697,221,1,465,9,3,0,476
45041000007,1730,1308,984,94,204,25,2,3,324
45091000043,2347,1705,1271,91,266,32,63,2,434
45091000057,3390,2615,2124,84,289,81,33,1,491
45083000117,4245,3230,2507,112,435,79,81,1,723
45091000005,2396,1826,1548,33,99,73,70,0,278
45033000016,292,225,98,5,103,21,0,0,127
45091000003,2305,1993,1860,24,47,33,24,0,133
45009000007,274,225,119,6,96,6,0,0,106
45043000131,1257,988,237,38,706,2,8,1,751
45043000127,962,722,399,113,192,13,2,0,323
45019000214,1748,1578,1187,50,272,18,35,2,391
45019000506,1432,1144,1089,16,13,8,9,1,55
45003000022,2507,1973,1391,77,420,29,55,4,582
45003000078,1438,1126,756,180,154,26,7,0,370
45091000070,1222,1011,800,37,96,50,19,0,211
45063000058,2905,2322,1118,144,920,81,88,9,1204
45019000611,1055,911,786,19,70,17,15,0,125
45055000124,1969,1496,1050,71,302,31,27,7,446
45063000067,2646,2042,1481,147,324,81,32,6,561
45019000185,1196,1061,1015,18,8,7,12,0,46
45039000005,2237,1882,758,10,1095,13,5,2,1124
45053000110,966,726,109,69,532,3,6,1,617
45071000035,817,643,508,20,105,5,1,0,135
45079000116,1642,1216,1138,33,12,15,13,4,78
45035000097,880,676,527,23,98,23,8,1,149
45075000111,1296,1118,15,4,1091,3,2,4,1103
45047000019,1570,1194,740,33,397,22,6,3,454
45045000220,1610,1246,1090,50,70,16,22,1,156
45075000104,2768,2660,115,34,2482,29,25,1,2545
45045000318,3356,2553,1393,379,747,27,13,2,1160
45085000106,2040,1486,697,48,655,44,43,4,789
45041000045,1246,953,667,26,243,19,2,2,286
45041000031,766,617,509,3,97,9,0,0,108
45083000017,1496,1169,1047,49,46,19,6,4,122
45019000535,2078,1694,1408,58,133,33,48,0,286
45001000008,1483,1127,955,10,133,13,4,0,172
45019000534,3060,2513,2135,48,239,26,50,2,378
45019000513,1603,1293,980,57,187,6,62,0,313
45065000001,265,228,57,3,162,5,0,0,171
45081000012,395,292,183,48,53,6,1,0,109
45039000020,303,242,68,0,173,0,1,0,174
45003000046,1967,1516,214,39,1228,27,13,4,1302
45079000500,2584,2194,1027,141,906,48,102,1,1167
45071000025,78,61,13,5,40,3,0,0,48
45035000068,2153,1631,1047,74,412,58,36,10,584
45035000080,1179,930,646,40,201,23,16,0,284
45089000021,284,210,15,3,194,1,0,1,195
45023000012,303,236,122,5,100,4,2,0,114
45023000002,988,812,659,4,134,15,2,1,153
45035000084,2209,1600,1343,35,139,46,29,1,257
45085000138,1767,1414,952,24,363,13,61,1,462
45027000002,766,584,483,11,82,6,0,0,101
45045000253,3795,2910,2060,362,260,61,191,0,850
45047000004,1491,1168,616,46,462,19,23,3,552
45013000228,936,887,847,8,5,7,11,0,40
45045000232,4068,3007,2394,130,119,34,301,1,613
45045000288,2740,2168,1693,137,230,43,76,2,475
45045000233,2641,2073,1454,324,152,40,98,0,619
45013000142,1781,1312,900,44,321,25,25,4,412
45085000137,1019,787,442,38,288,15,16,0,345
45013000211,1078,983,925,16,11,17,18,3,58
45013000366,1222,1201,1113,31,31,14,15,0,88
45041000046,858,659,278,13,364,5,3,0,381
45041000006,1447,1115,851,64,190,14,5,2,264
45003000027,1927,1539,1367,38,89,35,16,1,172
45065000014,308,266,251,1,6,7,3,1,15
45063000085,4121,3077,2764,107,109,56,40,3,313
45063000005,3267,2472,1593,334,423,88,66,0,879
45063000072,1904,1424,1255,26,31,24,81,0,169
45019000613,1662,1183,188,218,761,24,10,1,995
45007000012,829,678,305,10,349,10,2,0,373
45035000067,993,744,576,20,104,21,26,4,168
45075000138,1579,1128,16,2,1103,7,0,4,1112
45051000140,2475,2301,2183,36,44,22,9,0,118
45045000344,3493,2776,2148,149,260,38,172,1,628
45051000162,2014,1872,1728,19,89,25,4,1,144
45091000081,1673,1323,1054,63,138,47,13,5,269
45073000005,3195,2543,2115,113,222,82,23,1,428
45067000012,708,597,300,3,292,5,2,1,297
45019000326,734,599,20,19,556,1,2,1,579
45019000524,2004,1534,828,51,601,14,27,13,706
45071000048,649,520,450,9,46,13,1,0,70
45027000004,638,516,342,9,159,7,2,0,174
45035000050,1733,1401,792,64,463,38,49,7,609
45085000104,1948,1485,795,62,520,36,68,3,690
45007000075,1772,1344,1160,54,77,14,28,1,184
45045000280,4817,3844,2287,286,975,72,212,19,1557
45047000002,2229,1670,142,317,1207,15,3,0,1528
45035000083,1538,1173,968,23,112,34,32,5,205
45047000037,1401,1063,683,31,309,18,23,1,380
45013000227,588,549,530,4,4,2,3,0,19
45009000006,111,80,38,2,41,0,0,0,42
45077000127,1725,1354,1210,25,40,45,14,3,144
45077000147,1627,1259,1050,66,105,27,7,0,209
45003000028,1392,1092,963,16,77,12,22,1,129
45077000149,1591,1308,1177,41,34,42,9,3,131
45063000078,3939,3089,2411,137,416,67,67,0,678
45035000085,1956,1563,1036,72,357,42,42,7,527
45053000111,1593,1284,789,178,267,29,23,2,495
45007000074,2837,2223,1459,143,464,38,106,1,764
45075000105,1022,861,88,32,736,14,8,5,773
45043000130,842,660,460,14,176,8,2,1,200
45079000499,1964,1649,683,35,877,21,39,0,966
45061000010,478,383,213,4,161,7,1,1,170
45061000020,235,197,134,0,62,2,0,0,63
45017000001,1398,1090,781,45,232,26,9,0,309
45041000009,2328,1844,1439,41,246,16,101,0,405
45017000006,672,553,330,17,187,13,2,0,223
45041000062,954,699,559,2,123,12,5,0,140
45091000054,2139,1563,1302,84,45,26,94,0,261
45003000066,1463,1253,956,30,216,14,25,0,297
45039000008,432,366,78,1,278,10,1,2,288
45049000014,117,91,89,0,2,0,0,0,2
45045000309,2967,2203,1842,102,106,27,114,1,361
45013000209,1125,987,927,33,12,2,5,2,60
45003000059,2668,2011,1576,121,232,67,26,3,435
45049000019,319,256,198,2,56,0,0,0,58
45035000075,2931,2260,1639,133,327,69,97,4,621
45045000245,2355,1844,1599,81,98,34,17,1,245
45013000212,975,912,875,16,12,1,5,0,37
45027000018,306,262,64,2,186,3,12,0,198
45045000340,2137,1739,1400,132,122,26,56,4,339
45091000045,1759,1320,1045,65,162,37,18,3,275
45003000058,2036,1618,1303,29,207,32,45,4,315
45013000213,1041,937,882,14,9,11,15,1,55
45083000126,2337,1760,1496,63,145,20,31,1,264
45013000210,1140,1022,980,18,7,9,4,0,42
45019000305,1644,1280,1203,26,12,13,24,1,77
45063000062,2120,1661,1158,73,334,31,66,4,503
45039000006,91,77,52,4,20,0,1,0,25
45019000210,1336,1304,959,78,235,21,23,0,345
45035000041,1657,1259,1087,46,71,28,33,0,172
45063000065,4115,3130,2436,156,383,112,50,2,694
45063000086,3141,2575,1905,107,370,48,132,1,670
45013000224,969,831,531,237,46,12,14,0,300
45073000001,421,344,305,12,9,10,6,0,39
45045000304,2152,1811,1652,44,57,15,37,0,159
