GEOID,TOTAL_POP,TOTAL_VAP,WHITE_VAP,HISPANIC_VAP,BLACK_VAP,NATIVE_VAP,ASIAN_VAP,PACIFIC_VAP,MINORITY_VAP
01133000007,2450,1968,1880,17,7,51,2,3,88
01133000002,7603,5899,5248,327,68,213,36,4,651
01133000004,1329,1063,991,17,9,37,3,1,72
01133000005,2741,2311,2223,17,19,41,5,0,88
01133000003,1730,1372,1310,22,6,21,4,0,62
01133000001,2907,2311,2191,21,13,63,5,1,120
01063000202,407,339,73,3,259,6,2,1,266
01057001101,935,710,627,19,41,18,5,1,83
01057000101,5385,4277,3089,114,966,104,21,3,1188
01057001701,252,206,98,2,104,0,2,0,108
01069000101,3348,2607,2003,37,482,54,12,2,604
01063000104,352,299,59,2,236,1,0,0,240
01063000201,967,835,270,12,546,5,6,0,565
01063000401,950,756,183,4,561,11,0,0,573
01063000501,751,549,66,3,478,8,1,0,483
01069000331,5454,4221,3255,116,654,71,113,3,966
01069000501,5122,3996,3205,146,449,93,100,13,791
01069000311,4360,3117,2561,146,301,77,38,6,556
01069000181,8331,6523,4287,421,1518,157,138,10,2236
01069000410,7366,5795,4602,202,612,134,230,12,1193
01069000352,6964,5555,4486,171,586,118,176,5,1069
01069000323,5937,4550,2541,286,1503,117,139,18,2009
01069000371,8558,6411,2305,215,3742,136,62,15,4106
01069000211,3143,2529,2160,71,189,83,13,3,369
01069000141,3038,2383,1970,37,316,54,4,3,413
01069000251,2628,2068,914,50,1044,21,46,2,1154
01069000271,762,630,404,10,205,18,1,2,226
01069000121,1745,1397,1132,12,221,25,6,4,265
01069000233,3056,2295,1379,88,783,21,21,1,916
01069000341,1865,1461,1117,44,239,49,15,2,344
01063000105,776,596,106,10,476,1,3,0,490
01077000115,3744,2977,2551,61,251,78,34,3,426
01077000108,1923,1577,1170,45,297,45,13,6,407
01077000004,3109,2523,2332,41,55,68,22,0,191
01077000005,7060,5542,5220,96,51,120,14,2,322
01077000103,2410,1915,1159,72,601,65,26,1,756
01103003011,3310,2438,232,429,1751,49,15,3,2206
01103000101,1163,793,279,374,101,31,4,1,514
01103001501,10416,7847,7032,146,323,258,49,2,815
01103002801,880,707,668,10,15,13,1,0,39
01103001301,3290,2571,2359,32,42,90,14,0,212
01103000403,2522,2022,1913,18,37,29,22,0,109
01103000402,3907,2987,2292,244,296,112,34,6,695
01103000501,7618,5906,5224,135,193,258,85,5,682
01103000303,5432,3812,1257,966,1483,97,37,15,2555
01069000131,2826,2236,1781,62,290,86,17,0,455
01017000014,13033,10253,6293,274,3206,151,308,16,3960
01017000013,4642,3660,2479,75,1027,57,26,1,1181
01017000007,6376,4940,1661,315,2917,70,21,7,3279
01017000012,862,679,422,16,223,10,7,0,257
01103002101,2527,1993,1855,32,34,63,9,0,138
01103002201,2515,1954,1837,23,19,59,9,0,117
01063000301,1088,778,32,3,742,5,2,1,746
01017000006,650,554,454,3,74,18,2,0,100
010170001-A,484,408,250,9,146,7,0,2,158
01017000005,363,314,133,1,179,3,0,0,181
01017000002,312,267,175,2,87,4,1,0,92
010170007-A,566,462,366,7,82,1,8,0,96
01041000003,873,700,208,14,466,8,4,2,492
01041000014,2637,2109,1398,31,637,13,28,2,711
01041000012,232,188,136,1,41,9,1,0,52
010330006-1,715,577,511,9,33,19,4,0,66
010330016-1,777,632,505,13,97,13,1,0,127
010330016-4,2249,1775,1424,35,256,40,11,5,351
010330016-2,2429,1890,1169,94,553,76,7,1,721
010330016-3,1508,1164,391,22,738,6,9,0,773
010330016-7,1500,1210,1091,19,54,20,6,1,119
010330016-6,930,712,489,29,160,28,9,0,223
010330017-3,2634,1997,1588,53,281,48,16,0,409
010330014-1,1048,843,758,18,43,16,8,0,85
010330014-2,1639,1254,1138,41,41,22,9,2,116
010330014-3,1321,967,657,34,211,23,30,0,310
010330017-4,1430,1142,800,35,263,43,3,0,342
010330017-1,1264,1000,890,20,66,6,18,0,110
010330011-1,1042,833,545,24,235,24,4,2,288
010330002-2,3014,2410,1373,51,956,31,2,0,1037
01085000031,598,488,93,4,387,8,3,0,395
01077000008,2564,2015,1916,34,16,33,6,1,99
01077000003,2716,2142,2023,31,9,62,7,2,119
01071000004,2181,1743,1590,15,11,117,5,1,153
01071000028,2901,2318,2090,86,17,117,5,0,228
01071000001,3360,2670,2302,31,177,140,15,0,368
01071000002,243,202,173,1,0,22,1,0,29
01071000003,4352,3346,2689,131,319,186,13,1,657
01071000006,1108,870,748,13,37,62,3,1,122
01113000501,5851,4333,803,206,3292,95,39,18,3530
01039000021,965,761,733,8,7,11,2,0,28
01039000001,10370,8037,5735,171,1866,142,114,6,2302
01071000015,468,374,305,29,12,28,4,0,69
01049000003,18610,13922,10330,2336,622,855,103,12,3592
01049000004,17182,13236,11533,719,150,769,52,3,1703
01039000007,1009,825,706,7,81,26,4,0,119
01103001001,1400,1098,990,50,11,48,5,0,108
01103001901,1194,885,797,12,44,30,1,0,88
01103001502,7245,5521,4764,169,298,198,49,2,757
01095000026,7979,6230,5702,160,42,205,97,7,528
01095000028,2651,1998,1637,288,29,58,11,0,361
01095000010,22410,15728,10124,4268,783,704,184,16,5604
01095000001,7779,6183,5114,209,599,181,79,2,1069
01095000015,1784,1368,1228,47,30,48,12,0,140
01095000021,2418,1835,1665,44,4,101,11,1,170
01095000019,1840,1491,1375,21,5,56,15,2,116
01095000012,3138,2539,2354,46,24,99,15,1,185
01095000002,10247,7567,5822,1176,206,333,74,74,1745
01095000007,1914,1632,1502,33,19,46,12,1,130
01095000008,1136,980,847,39,17,56,14,0,133
01095000030,3517,2653,2487,28,26,91,5,2,166
01113000002,7688,5949,4510,195,1019,146,54,20,1439
01113000706,879,699,372,24,269,31,3,6,327
01083000101,28753,22360,16062,1697,3677,656,268,47,6298
01083001001,6219,4779,3443,522,637,176,14,5,1336
01083001401,1685,1356,776,185,331,75,3,3,580
01083000201,25316,19861,14363,690,3874,486,415,28,5498
01083000801,6991,5332,4492,331,263,186,35,11,840
01083000401,3272,2539,2283,35,118,68,15,0,256
01083000301,10748,8318,7458,254,219,263,81,10,860
01039000023,840,662,629,4,9,19,4,1,33
010130012.2,2871,2277,921,36,1249,29,59,1,1356
01071000021,14971,11926,10189,478,629,466,128,11,1737
01113000405,11099,8119,3033,265,4665,145,55,20,5086
01113000301,366,272,172,13,79,11,0,0,100
01075001301,365,303,298,1,1,2,0,0,5
01103000901,3801,3009,2673,142,28,126,30,2,336
01103000701,2183,1754,1537,42,83,56,15,0,217
01075002001,161,126,121,0,2,0,3,0,5
01049000002,18656,13588,10407,2448,91,767,31,10,3181
01049000001,17160,13174,11144,1097,173,841,84,6,2030
01103003012,1127,1026,386,31,590,16,8,3,640
01103001601,2983,2266,1739,185,230,98,15,2,527
01103000401,2124,1735,1571,37,38,46,23,3,164
01103000309,1876,1380,894,171,238,68,31,6,486
01103000601,1092,917,788,14,58,40,3,1,129
01103000201,706,558,484,32,3,31,8,0,74
01103000307,1619,1254,709,247,263,44,9,5,545
01103000308,8271,6286,3219,1308,1530,193,80,10,3067
01103003015,5877,4546,2830,417,1102,138,75,3,1716
01077000001,2018,1586,1516,15,12,47,3,0,70
01077000006,5101,3905,3531,52,152,115,29,0,374
01017000008,3229,2652,873,71,1697,31,5,0,1779
01017000009,712,584,332,4,242,4,3,0,252
01017000010,1078,893,402,19,444,28,2,1,491
010170010-A,280,244,183,4,55,1,1,0,61
01017000001,613,538,477,11,34,20,5,1,61
01017000003,339,288,189,3,91,0,4,0,99
010170003-A,106,89,76,2,12,0,0,0,13
01017000004,291,254,212,2,37,3,0,0,42
01071000039,672,541,488,5,3,42,2,0,53
01071000038,1515,1184,1053,7,3,112,7,0,131
01071000029,1898,1520,1369,9,6,131,5,0,151
01071000010,1908,1535,1232,38,180,83,2,0,303
010330017-2,2435,1859,1431,49,291,43,41,0,428
010330002-4,2014,1578,1471,24,36,43,4,0,107
010330002-3,2307,1802,1318,34,371,73,10,0,484
010330002-1,1336,1095,823,32,201,38,3,0,272
010330002-5,1158,906,778,17,85,20,2,0,128
01103003010,7748,6131,4221,256,1389,145,124,9,1910
01103001401,2649,2089,1872,52,35,101,13,2,217
01071000030,1401,1116,1020,7,4,80,5,0,96
01095000024,2343,1850,1564,202,21,64,17,1,286
01085000131,1338,977,255,11,703,5,7,0,722
01103002401,911,689,618,13,4,44,4,0,71
010330004-1,2340,1858,1512,35,265,37,3,2,346
010330017-5,3531,2795,1987,69,597,78,58,1,808
010330017-6,3842,2902,1961,106,670,78,79,2,941
01071000020,596,467,412,5,0,47,2,1,55
01071000014,1344,1108,993,13,19,73,5,0,115
01071000022,1592,1261,1115,35,5,99,0,0,146
01071000013,517,418,384,5,9,22,1,0,34
01071000018,129,105,98,2,0,4,1,0,7
01075000701,577,447,396,2,43,3,2,0,51
01031000029,7263,5456,3896,547,642,216,188,32,1560
01031000028,7928,5757,4128,559,644,158,299,33,1629
01005000011,601,510,188,9,305,5,3,0,322
01005000007,575,469,125,2,330,9,1,0,344
01005000009,1055,871,381,12,472,9,2,1,490
01005000006,2836,2491,886,29,1584,2,3,1,1605
01005000010,501,420,291,9,103,13,2,0,129
01005000008,351,290,63,1,226,0,1,0,227
0100500008A,272,215,118,5,85,5,3,0,97
01013000009,455,354,174,0,179,1,1,2,180
01013000008,489,359,211,5,134,4,6,0,148
01013012.4A,981,780,422,7,348,7,0,0,358
01035000131,735,603,362,1,209,31,2,0,241
01013012.4B,2237,1632,333,17,1260,25,10,1,1299
01013000002,299,235,201,0,27,1,3,1,34
010130012.3,3443,2637,1263,59,1258,29,35,5,1374
01083000901,3829,3136,2744,112,183,71,23,4,392
01071000024,2152,1691,1528,33,19,100,7,1,163
01113000702,678,544,174,18,343,7,2,0,370
01075001501,985,814,730,3,80,0,0,1,84
01075001401,1140,879,583,10,265,17,1,1,296
010330018-1,2197,1712,1564,22,58,59,3,0,148
010330007-1,175,141,127,3,3,8,0,0,14
01035000061,130,92,24,1,65,2,0,0,68
01083001101,2288,1866,952,76,708,68,67,4,914
01039000003,7467,5795,4593,85,935,126,38,0,1202
01039000014,842,645,600,4,27,10,6,0,45
01001000018,2762,2051,1778,32,170,42,15,9,273
01001000016,12213,9213,6508,347,2068,199,87,30,2705
01001000013,2269,1655,1252,40,281,38,24,1,403
01001000004,10255,7434,4825,303,1630,155,483,14,2609
01001000007,4440,3305,2844,64,286,92,18,1,461
01001000011,602,506,177,25,290,10,5,1,329
01077000104,1715,1439,1144,63,177,46,11,5,295
01019000010,1874,1468,1337,54,16,54,3,2,131
01031000011,1995,1495,1152,80,180,53,25,2,343
01031000026,735,587,332,26,206,20,11,1,255
01031000013,815,668,531,4,106,26,2,1,137
01031000012,343,268,236,0,20,8,0,0,32
01031000016,2424,1923,1468,27,371,44,6,3,455
01031000025,1215,989,285,29,665,10,3,2,704
01031000003,807,673,479,9,158,34,1,2,194
01031000017,1148,933,827,11,51,30,12,2,106
010330003-1,517,436,304,7,111,10,4,1,132
010330013-1,1111,946,879,7,32,17,4,0,67
010330008-1,361,293,261,8,2,22,0,0,32
01039000009,2323,1866,1506,49,255,42,7,0,360
01031000020,913,714,629,10,43,29,1,0,85
01031000023,2464,1940,1734,71,47,65,21,5,206
01077000012,4839,3859,3327,74,307,99,38,4,532
01077000007,4649,3724,3437,47,98,106,25,0,287
01077000106,2260,1630,941,167,488,37,8,5,689
01083000501,839,614,557,25,8,19,3,0,57
01039000018,1048,818,602,8,176,21,7,0,216
01039000015,1294,1066,967,11,52,25,7,0,99
01083001301,10669,7167,4760,334,1095,202,791,12,2407
010130014.5,1843,1458,548,12,888,12,0,1,910
01013000018,971,782,542,5,226,9,2,1,240
01071000032,437,343,307,7,4,19,0,0,36
01085000051,798,654,143,2,506,2,6,1,511
01013000017,236,197,127,4,54,3,8,0,70
01075001701,468,398,386,6,2,6,0,0,12
01075000301,141,112,88,6,16,3,1,0,24
01075002201,163,124,86,35,1,5,0,0,38
01075000201,533,401,359,7,18,15,0,0,42
01035000041,708,596,152,1,436,6,1,0,444
01035000062,881,710,514,7,172,11,3,0,196
01035000152,346,295,182,1,104,8,0,0,113
01077000011,2516,2098,1859,50,93,67,23,2,239
010330001-1,2037,1726,1566,29,93,34,8,1,160
01077000102,1708,1292,309,28,927,23,9,3,983
01077000100,1255,1023,768,70,172,11,9,2,255
01077000015,2429,1973,1581,33,320,40,6,0,392
01077000107,2258,1860,1416,52,302,56,40,1,444
01035000081,482,370,326,5,30,10,1,0,44
01035000101,350,286,152,1,129,4,0,0,134
01035000111,1442,1121,636,53,405,16,24,4,485
01073003040,9144,7103,5396,202,728,120,651,5,1707
01073003210,5549,4251,2556,174,1021,40,449,0,1695
01073005010,14092,11124,4403,1005,4656,224,889,31,6721
01073003110,3632,2860,2415,70,233,48,82,2,445
01073003130,3376,2559,2330,61,73,44,45,2,229
01073003090,5343,4020,2277,152,1473,99,18,4,1743
01073003250,1823,1336,169,174,976,18,7,1,1167
01073003060,8626,6791,1603,227,4878,63,24,3,5188
01073001350,1878,1301,69,23,1207,13,10,1,1232
01073005070,6932,5668,4833,215,334,70,184,5,835
01073005140,6566,4699,3880,160,248,71,328,11,819
01073005160,6208,5452,4041,209,793,75,311,1,1411
01073003160,8055,5839,3614,173,1465,88,481,1,2225
01073003310,632,559,436,24,64,15,17,0,123
01073002350,5680,4960,2313,215,1945,76,432,2,2647
01073004060,7835,5568,1254,647,3608,82,15,8,4314
01073004180,3897,3013,2310,208,352,116,16,3,703
01073005040,6662,4976,4578,76,75,61,171,3,398
01073005130,4756,3497,3320,44,30,27,62,0,177
01073001120,4309,3386,815,197,2335,61,38,4,2571
01073001230,2658,2088,322,102,1639,33,20,0,1766
01073001110,4013,3241,1382,69,1725,44,25,0,1859
01073004040,10161,7611,5877,228,1063,179,230,10,1734
01073004080,7710,5645,4802,77,563,90,85,3,843
01073004230,2266,1755,901,405,390,39,15,1,854
01073003260,1913,1531,1400,43,33,43,9,2,131
01073003200,2088,1711,1159,44,441,59,11,3,552
01073003100,5527,4294,4038,43,35,147,10,3,256
01073003070,5999,4675,4331,62,104,132,24,2,344
01073002190,2197,1708,20,37,1641,17,7,1,1688
01073002050,3792,2988,82,100,2802,26,11,1,2906
01073001150,3271,2542,981,80,1413,63,10,0,1561
01073003120,4235,3277,1642,87,1489,60,10,1,1635
01073001320,2061,1575,542,55,942,36,8,2,1033
01073001160,2936,2235,313,94,1817,12,4,1,1922
01073001090,4162,3306,415,57,2811,35,7,0,2891
01073001240,2172,1772,27,21,1721,8,6,0,1745
01073000021,2672,2131,103,22,2000,13,2,0,2028
01073001050,4882,3636,348,155,3101,47,9,4,3288
01073003020,13971,11020,6963,300,3376,211,133,7,4057
01073003080,6694,5428,3062,304,1721,105,258,2,2366
01073003270,1464,1152,552,53,520,27,6,0,600
01073003300,1347,1064,877,11,111,55,1,4,187
01083000601,1532,1214,1123,21,20,38,7,0,91
010330012-1,2667,2086,1957,47,13,42,14,1,129
010330011-2,1479,1160,591,24,517,26,5,1,569
01073004070,6828,5117,1708,788,2497,112,25,62,3409
01073001060,5324,4129,550,256,3291,46,18,6,3579
01073004015,6719,5374,4700,130,320,138,67,3,674
01073004200,5086,3798,2004,623,999,138,63,6,1794
01075002101,259,215,213,0,0,1,0,0,2
010330001-2,1374,1100,925,15,122,28,5,1,175
01039000016,2189,1720,1609,14,46,26,18,0,111
01073003170,4231,3616,2364,24,1175,40,6,1,1252
01073004050,7405,5864,4134,172,1329,175,48,2,1730
01073004110,4981,3779,2173,205,1298,87,29,2,1606
01073004090,5852,4557,2425,263,1696,91,73,9,2132
01073001270,1838,1466,94,58,1307,15,4,0,1372
01073002230,2119,1851,1675,44,74,26,30,0,176
01073001190,2926,2224,168,172,1853,45,3,21,2056
01073004010,10490,8211,6199,190,1407,197,189,12,2012
01073003280,1645,1256,981,33,191,39,10,1,275
01073004210,3077,2362,2208,11,52,56,16,0,154
01073001250,2671,2197,655,91,1405,46,8,1,1542
01073002100,2441,1964,90,82,1785,15,17,6,1874
01073002170,2693,2178,87,58,2019,24,6,0,2091
01073002040,4747,3771,161,70,3508,37,13,3,3610
01073002290,1833,1412,23,19,1368,6,2,1,1389
01073002030,2957,2333,81,70,2182,17,3,4,2252
01075000501,427,326,315,1,3,4,1,0,11
01075000102,2101,1643,1371,17,238,11,2,0,272
01115000004,10434,7876,7134,97,350,220,50,2,742
01115000003,4416,3540,2450,58,935,66,6,2,1090
01115000025,4202,3001,2298,50,516,81,34,0,703
01115000015,5812,4415,3463,117,683,107,29,4,952
01115000016,2852,2280,2084,47,53,52,14,1,196
01115000024,3446,2627,2228,36,251,70,31,3,399
01115000010,2261,1706,1527,60,60,53,0,0,179
01075000801,240,200,198,0,0,1,1,0,2
01075000402,354,312,298,0,7,7,0,0,14
01075000902,814,653,526,5,115,4,0,0,127
01057000501,1346,1029,942,25,34,32,4,1,87
01065000008,576,448,230,3,213,6,4,1,218
01005000005,12935,9723,4712,470,4378,139,74,3,5011
01005000001,862,693,414,10,254,12,5,1,279
01005000004,1290,1048,707,22,297,22,3,1,341
01073002160,4221,3750,1398,132,2156,25,50,5,2352
01073002310,1991,1631,132,66,1421,15,5,0,1499
01073002010,6291,4891,147,128,4623,59,8,4,4744
01073002260,1743,1429,16,170,1237,17,6,0,1413
01073003140,3337,2731,2038,45,582,38,19,3,693
01073003050,8856,6817,3295,387,2964,128,38,1,3522
01073003150,3837,3043,2817,24,67,94,4,3,226
01073001010,10562,8007,1779,418,5671,108,56,0,6228
01073004160,6202,4329,726,213,3353,60,16,3,3603
01073004030,9756,6969,1674,298,4883,101,27,16,5295
01057000901,1472,1080,960,17,68,30,6,0,120
01057001501,275,224,202,7,3,5,1,0,22
01021000050,1647,1248,1073,68,95,19,1,0,175
01021000240,2696,2036,1109,174,707,49,8,3,927
01115000009,2100,1631,1364,15,190,47,6,2,267
01115000007,3156,2349,2015,57,171,85,13,1,334
01115000017,12576,9592,7792,317,939,290,204,5,1800
01115000030,2082,1648,1400,67,121,38,18,1,248
01115000023,2028,1527,1354,64,18,55,5,0,173
01041000011,562,467,405,2,38,18,0,0,62
01065000006,1324,1064,171,2,887,3,1,2,893
01073001020,7929,5875,1620,210,3936,78,64,3,4255
01073004100,5322,4057,1941,186,1791,85,73,4,2116
01095000025,4516,3491,3227,88,22,115,10,0,264
01095000018,2213,1657,1414,154,10,84,9,2,243
01073002370,703,576,6,2,560,5,0,0,570
01073002390,1134,923,31,30,856,12,5,0,892
01073003010,948,736,435,27,244,25,4,0,301
01073003025,1310,1043,294,57,661,22,20,0,749
01073003290,1155,934,710,12,186,17,1,1,224
01073003030,9052,7085,2876,73,4012,113,14,6,4209
01073004170,4612,3331,2959,53,172,113,25,2,372
01073001260,2204,1637,186,148,1285,15,11,1,1451
01073004150,3246,2659,1985,118,459,64,14,2,674
01073002200,2522,1990,62,53,1870,24,2,0,1928
01073002060,4211,3338,98,66,3167,20,8,1,3240
01073001330,2202,1401,56,49,1290,19,3,3,1345
01073001360,1928,1276,352,43,860,16,10,2,924
01073004130,3955,3059,2515,47,385,97,18,0,544
01073001100,3115,2370,119,52,2192,24,0,3,2251
01035001141,532,406,82,35,285,3,2,0,324
01035000042,374,314,87,7,216,6,0,1,227
01073002090,3096,2573,105,225,2230,46,9,1,2468
01073005290,335,250,41,35,148,9,15,2,209
01073005210,3808,2911,2095,242,404,56,106,7,816
01073002430,1690,1654,964,73,354,21,237,3,690
01073002420,2411,2329,1279,147,531,30,342,2,1050
01073002250,1682,1351,5,41,1302,5,2,0,1346
01073001300,2461,2001,39,124,1824,27,0,2,1962
01073001340,1436,1165,100,142,910,16,5,3,1065
01073005100,5846,4336,3283,155,567,86,245,3,1053
01073005050,10177,8283,4987,263,2757,69,216,3,3296
01073005030,6736,5228,4012,168,552,72,410,3,1216
01073005220,2486,1888,1713,46,39,22,57,0,175
01073005020,7168,5294,4796,116,155,51,167,0,498
01073005120,5262,4014,3059,143,413,52,336,2,955
01065000003,196,155,106,0,46,3,2,0,49
01021000260,4293,3352,2838,79,326,71,37,0,514
01021000270,2942,2160,1634,226,220,47,26,0,526
01115000020,2027,1637,1346,33,193,43,15,1,291
01115000019,4948,3939,3285,90,415,79,60,1,654
01021000030,1656,1250,1122,16,93,16,0,0,128
01073004140,4022,3018,1830,291,797,90,16,3,1188
01073005090,6970,5440,4346,240,646,128,56,3,1094
01039000002,549,428,403,5,6,10,3,0,25
01099001302,110,85,38,5,42,0,0,0,47
01019000012,5946,4846,4367,78,260,99,24,5,479
01019000008,2892,2310,2067,25,140,64,9,1,243
01019000015,1184,907,772,12,104,18,1,0,135
01019000018,1148,913,882,9,3,17,1,1,31
01019000020,1098,874,834,5,13,20,1,0,40
01099000306,672,543,304,7,229,3,2,0,239
01099000005,742,611,210,3,385,12,1,0,401
01099001301,1158,917,758,0,66,88,3,2,159
01099001405,194,149,118,1,19,7,1,0,31
01099000303,2745,2164,1073,11,1013,32,23,0,1091
01025000006,173,150,28,1,118,3,0,0,122
01025000020,3940,3079,1971,14,1048,17,23,1,1108
01025000014,1259,1002,341,5,652,5,3,0,661
01073003220,2305,1820,1700,18,15,57,4,3,120
01073004020,8998,6888,5714,110,798,101,159,1,1174
01073003190,1922,1594,105,29,1444,17,3,3,1489
01073002120,1973,1561,42,51,1470,13,5,1,1519
01073003015,7514,5799,4348,226,788,94,344,8,1451
01073004190,3162,2719,1551,147,938,38,57,0,1168
01073004220,2887,2464,1268,116,950,68,81,1,1196
01073005190,2801,2071,1942,26,35,22,46,0,129
01073005150,4787,4197,3472,231,357,74,65,0,725
01073001370,814,677,12,20,641,4,0,1,665
01073002300,2358,2150,958,39,1112,9,27,24,1192
01073003240,1765,1403,1276,15,38,49,9,0,127
01073003320,329,278,231,9,28,8,2,0,47
01073001210,1955,1585,138,42,1394,17,9,3,1447
01043000171,3447,2630,2380,93,11,116,10,5,250
01043000010,16016,12362,10999,588,198,319,190,15,1363
01043000181,3397,2625,2373,111,12,92,15,3,252
01043000300,2323,1876,1700,72,15,69,15,0,176
01043000360,1596,1209,1044,47,19,49,18,8,165
01043000340,1449,1074,925,55,5,51,25,1,149
01043000350,1245,966,869,50,5,34,8,0,97
01079002801,1721,1337,1030,31,96,185,6,3,307
01079000601,733,585,396,20,123,50,5,2,189
01079000501,883,698,359,23,287,20,9,2,339
01115000021,499,382,353,5,12,9,1,0,29
01021000170,4652,3489,2514,797,82,136,11,1,975
01021000140,2776,2126,1844,190,37,46,7,5,282
01115000026,3983,2973,2318,87,419,104,34,1,655
01115000031,3904,2806,2128,63,516,63,38,0,678
01015000004,15136,11730,9467,685,1174,326,72,7,2263
01015000017,3396,2690,2430,40,118,79,8,2,260
01015000013,3773,2863,1805,255,617,72,109,4,1058
01015000019,8980,7043,5042,228,1474,173,109,10,2001
01015000014,1268,1001,962,6,11,15,4,1,39
01015000005,6576,5101,4090,152,602,154,75,30,1011
01015000015,18027,14186,5442,475,7940,284,114,19,8744
01015000009,5408,4214,3521,92,445,114,23,5,693
01015000016,913,728,672,13,23,14,0,0,56
01015000010,1201,945,865,28,22,27,3,3,80
01073002150,2333,1822,71,251,1489,31,8,2,1751
01073005240,2552,1872,1714,29,49,29,41,2,158
01073005280,1324,1127,1054,23,13,23,16,0,73
01073001180,3091,2369,203,167,1976,30,15,3,2166
01073001070,4391,3822,2968,96,610,54,72,5,854
01073001220,2281,1846,219,87,1511,26,15,2,1627
01073001290,1601,1106,56,32,1011,15,1,1,1050
01073004250,1237,968,833,25,52,42,11,7,135
01043000142,709,558,526,8,2,12,7,2,32
01043000032,2037,1555,1383,63,44,50,9,0,172
01043000250,673,499,457,13,0,13,7,0,42
01115000014,748,572,507,11,24,29,3,0,65
01043000202,1101,846,802,13,1,15,3,3,44
01043000120,2210,1782,1670,27,13,65,5,0,112
01043000090,1192,953,900,9,4,30,3,0,53
01073004120,4968,3736,1904,181,1564,73,42,6,1832
01073004240,1385,1156,860,63,178,33,17,0,296
01073001040,4095,3330,60,20,3236,10,3,2,3270
01073002130,5227,4951,3989,179,572,92,124,0,962
01073002080,5023,4796,2757,195,1170,63,584,19,2039
01073002320,2876,2526,1116,214,1043,43,125,6,1410
01073002220,3814,3448,2183,227,489,81,445,11,1265
01073005080,5544,4059,3783,72,65,45,76,0,276
01073005250,2196,1868,1451,58,262,39,53,3,417
01115000012,5175,4252,3678,56,388,81,36,3,574
01117000022,6047,4456,3559,123,439,82,229,6,897
01117000032,3473,2698,2050,55,199,41,333,2,648
01021000200,3173,2406,2008,180,163,37,15,1,398
01019000009,757,658,577,4,64,10,1,0,81
01019000001,752,611,582,4,3,15,4,0,29
01023000013,2548,2022,1288,30,667,17,18,2,734
01023000023,449,369,142,3,218,4,1,1,227
01023000024,294,243,101,0,139,0,1,0,142
01023000046,363,298,258,4,33,4,1,1,40
01023000001,724,570,167,3,397,4,0,0,403
01023000003,76,58,22,0,36,0,0,0,36
01023000039,641,531,343,4,173,8,2,0,188
01023000049,632,508,135,1,372,0,0,0,373
01023000043,268,220,139,1,77,5,1,0,81
01023000041,179,146,130,0,13,2,0,0,16
01023000036,185,142,52,1,88,0,0,0,90
01023000033,202,160,155,1,0,4,0,0,5
01023000042,95,64,52,0,11,1,0,0,12
01021000120,1642,1292,1185,40,31,37,2,1,107
01021000220,1370,1078,907,43,112,20,3,0,171
01073002140,3305,2513,323,318,1853,43,3,5,2190
01073002110,3165,2158,29,46,2079,22,1,0,2129
01073002340,1851,1401,173,101,1130,14,2,1,1228
01073002210,2822,2170,555,343,1242,45,8,3,1615
01073003230,2381,1824,905,158,722,35,11,3,919
01073002240,2304,1860,134,156,1562,27,3,2,1726
01073005170,4844,3377,2790,132,258,50,138,1,587
01073002020,6757,5457,2119,504,2602,73,211,6,3338
01073001080,3159,2498,45,37,2418,5,7,2,2453
01117000020,11033,8486,5950,1274,839,246,199,15,2536
01117000029,10336,7924,5187,1024,1280,204,256,12,2737
01117000025,2892,2202,875,435,820,65,28,2,1327
01117000016,3008,2276,2098,34,34,55,45,1,178
01117000007,5919,4208,3486,127,390,123,66,4,722
01117000024,11126,8365,6127,647,1182,219,183,17,2238
01117000008,3425,2737,2194,100,263,50,105,3,543
01117000034,9599,6865,4162,476,1965,191,71,4,2703
01117000035,9427,6978,4468,350,1884,173,97,5,2510
01117000037,6762,5444,4116,199,974,126,13,4,1328
01117000041,1826,1519,1425,26,9,36,7,3,94
01117000039,2773,2245,1996,55,106,56,9,0,249
01117000038,1545,1137,1058,20,24,30,4,4,79
01117000005,1858,1499,1122,23,305,37,5,0,377
01015000012,4634,3481,2883,172,267,84,53,3,598
01015000002,4874,3769,3281,34,327,84,24,11,488
01127000001,5523,4326,3791,109,247,89,84,6,535
01127000014,2733,2093,1913,90,29,50,6,0,180
01015000007,2103,1696,1610,12,17,39,11,1,86
01067000007,1365,1096,674,31,339,37,11,0,422
01127000007,2968,2390,1792,273,246,59,26,0,598
01127000023,912,745,709,7,7,19,0,1,36
01127000011,976,773,735,6,13,16,0,1,38
01127000019,550,468,442,3,6,12,0,0,26
01127000022,2632,2083,1743,41,235,47,3,6,340
01015000020,3331,2595,1947,136,384,61,69,8,648
01015000018,1750,1331,1225,18,42,33,10,0,106
01015000022,10588,8778,5822,434,2202,153,195,15,2956
01015000001,15277,12961,7182,364,4725,256,409,27,5779
01015000021,1793,1388,1224,19,96,28,12,0,164
01019000017,1217,992,930,8,21,25,4,0,62
01073005260,1128,892,835,15,15,7,24,2,57
01073001140,3324,2763,1262,86,1339,48,34,1,1501
01073005180,3020,2067,1999,20,6,18,22,0,68
01131001001,1180,963,561,19,371,11,6,0,402
01131002002,96,72,20,0,49,2,0,0,52
01021000070,2811,2111,1695,162,221,32,1,0,416
01021000090,2309,1809,1582,51,126,43,5,1,227
01021000250,3056,2415,2010,116,219,54,30,2,405
01021000020,1426,1108,760,21,301,23,3,0,348
01117000036,1980,1521,1154,201,96,53,19,4,367
01019000019,769,615,589,0,18,5,1,1,26
01079002901,1539,1188,1029,31,20,94,7,0,159
01003000025,7696,5754,4664,397,383,216,62,15,1090
01003000024,6489,4801,3882,449,228,171,63,2,919
01003000009,2668,1986,1610,73,219,59,14,0,376
01003000018,2835,2174,1933,56,64,104,18,1,241
01003000022,3687,2843,2476,107,40,172,13,0,367
01003000008,2305,1939,1227,94,542,42,22,1,712
01003000047,12645,10003,7450,1095,959,291,124,9,2553
01003000038,7512,5981,4391,522,773,161,108,7,1590
01003000031,5891,4494,3821,282,201,152,33,8,673
01003000032,4914,3884,3323,262,111,142,20,3,561
01003000033,4244,3719,3363,115,76,87,63,6,356
01003000048,8943,7271,6348,306,200,177,121,3,923
01003000041,8438,7183,6707,137,54,158,60,4,476
01003000034,1153,963,856,44,13,38,5,0,107
01003000004,1175,965,695,4,224,35,6,1,270
01003000015,9357,7311,5301,137,1551,267,63,8,2010
01097000009,3213,2499,1881,24,418,154,14,1,618
01003000002,251,214,86,4,119,8,0,0,128
01003000005,1632,1316,357,30,910,18,10,3,959
01123000901,347,290,247,0,32,2,0,0,43
01123000701,3279,2608,1443,31,1079,33,16,0,1165
01027000601,416,341,320,10,5,4,1,0,21
01099000601,353,289,81,2,203,3,1,0,208
01099000301,1338,1063,794,1,240,19,8,0,269
01105000001,1673,1261,204,6,1049,1,3,2,1057
01105000002,1816,1339,196,14,1135,12,1,0,1143
01025000001,1460,1115,209,2,897,12,3,0,906
01079000301,627,512,197,0,307,10,1,0,315
01025000010,3252,2567,1685,24,810,31,12,0,882
01025000022,883,704,600,6,91,7,2,1,104
01125000021,6923,5359,3948,220,1010,120,88,4,1411
01125000017,6352,4525,3769,213,403,100,35,6,756
01125000009,1351,1050,952,20,36,28,16,3,98
01125000015,8196,5934,4699,328,457,97,356,4,1235
01125000049,4022,3031,2456,132,360,49,9,0,575
01125000050,3772,2801,2225,140,349,61,20,0,576
01125000045,7678,6019,2143,249,3469,61,114,5,3876
01125000007,1262,963,842,5,94,18,3,0,121
01125000002,513,396,363,9,12,15,0,0,33
01125000001,121,90,79,2,1,7,0,0,11
01125000008,1823,1491,1392,17,39,20,14,0,99
01125000011,4199,3231,2597,66,482,59,15,1,634
01125000012,6256,4728,4118,99,321,131,19,2,610
01125000013,2522,1901,1691,36,87,51,5,10,210
01025000021,285,244,101,0,143,0,0,0,143
01025000002,375,306,84,2,212,7,3,1,222
01125000044,11629,9113,3593,266,4978,129,160,14,5520
01125000041,4530,3645,1967,130,1419,70,59,3,1678
01125000043,2886,2201,1441,217,437,68,40,2,760
01125000046,8892,7105,2355,220,4344,68,153,6,4750
01125000040,5305,4358,2316,170,1637,80,165,8,2042
01125000052,7585,5585,3178,98,2200,91,17,0,2407
01125000038,4805,3985,1109,119,2664,50,64,8,2876
01125000028,6558,6287,5199,227,491,57,285,11,1088
01125000026,8107,6590,3052,324,2931,127,186,14,3538
01125000042,3442,2763,1797,162,694,71,33,8,966
01125000024,4930,3756,1358,407,1917,60,48,2,2398
01125000018,686,542,501,22,10,7,3,0,41
01125000004,222,182,164,6,6,4,1,0,18
01125000033,851,622,546,26,31,14,4,1,76
01125000032,1335,1012,886,83,24,21,6,0,126
01099000302,703,574,356,8,201,8,1,0,218
01081000001,2649,2098,1908,35,108,36,9,4,190
01081000008,538,449,270,7,161,11,0,0,179
01081000006,10595,8110,5799,317,1630,164,190,5,2311
01081000003,6824,5081,1643,139,3067,90,198,4,3438
01081000005,7813,6199,4019,443,1397,122,225,11,2180
01081000002,4743,3718,780,216,2641,65,64,6,2938
01081000004,5025,3802,2133,609,905,101,66,7,1669
01081000014,25795,21166,13656,961,4084,354,2137,40,7510
01081000009,3685,2945,1361,138,1374,57,26,1,1584
01081000010,17409,13656,8341,482,3188,218,1409,26,5315
01081000007,5063,3549,2547,101,302,64,533,4,1002
01081000023,9227,7150,5135,326,1341,206,175,21,2015
01081000022,19595,14406,10090,673,3091,367,202,35,4316
01081000013,11743,10015,6879,408,2009,144,590,9,3136
01081000012,18098,14845,9566,816,2424,236,1812,7,5279
01081000015,5548,4309,3164,65,891,129,28,3,1145
01025000007,3955,3141,2226,25,828,46,19,0,915
01003000046,3655,2906,2505,96,113,73,92,3,401
01003000045,6789,5155,4562,150,198,148,80,4,593
01003000007,11405,8256,6518,348,850,206,273,15,1738
01003000039,7343,6339,5751,149,125,137,61,4,588
01003000040,865,808,776,5,6,14,3,0,32
01003000028,6775,5831,5308,138,129,137,49,5,523
01003000006,2002,1458,1113,45,213,58,36,1,345
01003000035,13338,10626,7981,411,1709,299,160,19,2645
01003000020,13326,10041,8164,425,1006,231,191,9,1877
01003000023,6119,4335,3717,152,256,124,53,9,618
01003000042,10231,8231,7061,158,726,158,84,15,1170
01109000034,49,45,8,0,37,0,0,0,37
01109000007,74,56,41,2,12,3,0,0,15
01109000003,397,327,163,0,157,6,0,0,164
01109000021,2849,2398,963,41,1294,52,55,4,1435
01109000013,4669,3610,2313,124,994,92,95,10,1297
01109000001,3211,2483,536,28,1861,30,49,2,1947
01109000022,2660,2106,1445,49,553,27,27,0,661
01109000006,5892,5406,3291,157,1565,79,300,5,2115
01053000190,961,795,528,5,205,58,0,0,267
01109000033,258,203,152,10,24,15,3,0,51
01109000023,166,131,112,2,15,2,0,0,19
01109000019,1430,1168,238,24,905,14,0,0,930
01109000032,241,196,130,2,58,4,2,1,66
01109000008,191,164,132,0,32,0,0,0,32
01129000006,757,621,588,3,24,4,1,0,33
01129000007,824,623,489,6,113,10,1,2,134
01023000007,434,364,46,6,313,3,0,0,318
01023000010,506,415,34,5,373,6,6,0,381
01023000006,546,450,77,1,367,3,0,0,373
01023000047,195,162,41,3,119,0,0,0,121
01023000012,234,195,31,0,164,2,0,0,164
01079001701,1806,1424,1185,22,15,188,13,0,239
01079003101,108,84,63,1,1,19,0,0,21
01079002401,494,386,327,4,3,53,1,1,59
01053000030,6231,4954,2981,65,1762,96,40,11,1973
01053000300,2260,2003,908,17,886,191,0,0,1095
01053000320,2832,2186,843,35,1189,121,6,3,1343
01053000270,836,671,520,8,71,78,2,0,151
01053000260,2972,2295,1392,43,693,142,32,2,903
01001000014,1571,1291,567,24,663,34,9,0,724
01047009512,2608,2051,1053,20,949,8,29,0,998
01047000801,1676,1324,684,25,603,18,1,0,640
01047000302,3890,3047,1601,25,1380,25,16,5,1446
01047001001,1840,1419,860,7,516,23,13,0,559
01047000501,4048,3073,148,13,2911,20,0,5,2925
01047001201,427,350,96,3,249,2,1,1,254
01047000101,768,594,412,4,175,3,0,0,182
01107001800,227,195,140,1,49,3,2,0,55
01107001300,454,372,317,1,44,9,2,0,55
01001000012,1969,1554,955,55,485,36,3,3,599
01107001500,2716,2159,1259,35,852,22,2,1,900
01127000004,2075,1634,966,206,422,57,13,1,668
01131005003,313,235,36,3,196,0,0,1,199
01131005001,274,207,4,0,203,0,0,0,203
01127000033,1522,1173,1101,11,9,49,2,0,72
01127000034,671,498,463,10,10,7,4,0,35
01127000005,2143,1723,1511,28,101,64,7,2,212
01127000002,4519,3500,3188,91,102,77,32,0,312
01127000044,768,597,548,18,13,17,1,0,49
01131006001,429,328,107,3,213,5,0,0,221
01091000301,1512,1208,723,21,450,13,3,0,485
01091000306,221,185,156,0,29,2,0,0,29
01091000501,482,383,118,0,261,5,2,1,265
01091000407,800,613,298,8,304,11,3,0,315
01091000502,989,818,535,16,259,9,1,4,283
01091000405,354,292,136,1,154,2,1,0,156
01091000408,1459,1111,232,10,867,11,1,1,879
01097000029,6577,4758,1309,54,3290,71,30,0,3449
01099001403,162,126,86,2,38,1,0,0,40
01099000001,645,554,389,1,109,51,1,2,165
01097000056,6613,5199,997,98,4020,79,48,9,4202
01097000055,4442,3292,1446,179,1518,48,108,6,1846
01097000037,3828,2763,547,91,2080,42,25,4,2216
01097000032,2101,1695,7,7,1684,11,3,0,1688
01097000033,2527,2017,24,9,1968,31,11,3,1993
0109700VP25,3144,2292,122,29,2141,18,3,1,2170
01097000030,2481,1848,89,19,1748,8,1,1,1759
01097000068,4491,3610,2243,149,1094,65,60,7,1367
01097000067,9817,7938,5099,279,2111,156,293,13,2839
01097000062,3041,2411,1649,76,547,40,87,1,762
01097000005,2210,1739,1274,32,320,90,6,1,465
01097000006,3484,2735,2415,38,135,127,14,2,320
01097000002,4393,3216,2251,43,631,265,18,2,965
01097000023,8571,6247,3676,232,2079,139,104,4,2571
01097000024,3996,3132,1747,91,1187,75,24,2,1385
01097000013,4905,3767,3097,85,396,144,42,6,670
01097000018,5239,3949,3388,200,186,155,18,5,561
01097000041,1931,1569,70,32,1457,37,2,0,1499
01097000044,5211,4211,2794,131,1180,76,32,5,1417
01097000058,2517,1874,1555,60,160,64,34,0,319
01097000046,3072,2328,1732,69,411,53,59,4,596
01097000027,3269,2445,517,26,1869,32,25,2,1928
01097000048,2912,2667,762,5,1883,16,4,2,1905
01097000045,4648,3825,3029,98,538,75,47,2,796
01097000020,6457,4719,2626,116,1811,138,38,2,2093
01097000017,4728,3585,2848,79,411,149,87,3,737
01097000012,6939,5383,4587,51,494,199,28,11,796
01097000015,3936,2915,1840,71,832,167,18,2,1075
01003000001,357,313,227,2,51,29,1,0,86
01003000049,10989,8351,7243,422,373,183,110,8,1108
01003000043,5976,4660,4138,180,140,141,45,1,522
01003000010,3036,2467,2080,55,288,36,14,2,387
01003000044,5504,4453,3986,173,92,133,30,9,467
01043000100,1624,1298,1222,9,5,48,7,1,76
01089000081,6357,4920,3939,154,446,293,69,9,981
01089000026,5517,4620,3701,185,403,129,181,12,919
01089000017,9297,7693,5016,645,1718,202,151,22,2677
01089000046,6508,5034,1913,1163,1793,213,99,20,3121
01089000054,7985,6786,4111,381,1754,150,381,23,2675
01089000063,6555,5119,3244,324,1047,138,379,4,1875
01089000009,5237,4722,2638,494,1278,111,211,41,2084
01089000021,8417,6515,4938,293,618,202,446,12,1577
01089000090,6815,5289,4242,171,381,105,342,14,1047
01089000023,6814,5386,4130,333,534,164,223,3,1256
01089000004,6104,5193,4207,149,628,99,100,6,986
01089000002,2794,2135,1050,109,912,59,34,5,1085
01089000068,5374,4231,3829,88,62,190,28,9,402
01089000075,5846,4418,3663,170,229,215,98,17,755
01089000029,998,777,638,31,40,24,36,3,139
01089000061,8966,6302,5072,261,483,169,285,14,1230
01089000011,7436,5666,4975,150,200,113,218,2,691
01089000019,4999,3992,3474,131,81,110,177,5,518
01089000012,4489,3349,2889,95,155,63,118,6,460
01089000014,3842,3225,2821,99,100,66,122,2,404
01089000013,3463,2803,2477,69,30,51,169,4,326
01089000069,3579,2762,1987,111,414,71,161,10,775
01089000027,10227,8122,1879,522,5505,180,155,34,6243
01037000710,906,753,552,9,171,16,3,1,201
01037001513,474,414,392,1,18,5,0,0,22
01037001205,1701,1414,1325,7,56,18,0,0,89
01037000302,1347,1071,559,36,453,14,6,4,512
01037000401,2055,1650,518,19,1095,19,5,0,1132
01131004006,442,380,278,1,96,3,0,1,102
01131003003,476,367,79,3,287,0,0,0,288
01087000410,1777,1400,731,42,611,23,1,2,669
01087000408,1205,994,258,14,717,13,0,1,736
01087000409,1011,819,482,27,300,12,3,0,337
01087000102,642,531,272,19,224,17,0,1,259
01087000203,809,669,208,17,436,8,5,0,461
01087000105,1974,1946,98,57,1736,6,37,2,1848
01087000306,578,471,98,8,352,16,5,1,373
01073005035,1742,1316,986,73,129,15,107,2,330
01097000001,2186,1617,1338,21,154,97,5,1,279
01097000073,5374,4072,3480,87,353,100,30,0,592
01097000077,2144,1749,1535,38,104,25,27,4,214
01097000069,5275,4225,2571,154,1260,109,142,7,1654
01097000078,2610,2100,1770,69,96,84,39,16,330
01097000014,3012,2499,1731,67,566,107,6,2,768
01097000063,2752,1984,451,70,1445,24,11,3,1533
01097000051,8602,6435,4319,332,1213,211,337,3,2116
01097000066,10282,7906,5273,227,1727,182,461,17,2633
01097000074,8701,6543,4887,245,1002,193,180,7,1656
01119000003,1281,1019,297,4,716,6,2,3,722
01097000057,4130,3013,81,25,2904,35,8,4,2932
01097000064,4295,3175,135,44,2976,28,19,6,3040
01097000047,4970,4030,1989,80,1863,90,23,8,2041
01097000011,8216,6333,4980,59,985,185,84,4,1353
01097000019,1352,1034,157,6,863,16,0,2,877
01043000112,1906,1567,1437,49,14,55,7,2,130
01097000070,4915,3466,797,66,2550,48,23,1,2669
01097000031,2051,1595,15,5,1568,10,2,1,1580
01097000026,3094,2288,92,10,2166,20,4,1,2196
01097000086,7327,5573,3818,180,779,146,643,7,1755
01097000087,1989,1644,1466,27,67,41,18,3,178
01097000003,2951,2250,638,13,680,923,5,4,1612
01079003601,1437,1086,901,45,21,102,7,1,185
01073002410,1423,1175,23,12,1141,9,0,0,1152
01073001170,2486,1709,16,28,1663,16,1,1,1693
01097000081,4562,3517,2567,148,387,142,251,11,950
01097000075,6122,4625,3157,209,820,154,280,4,1468
01097000079,5070,3871,2767,140,708,125,123,1,1104
01119006012,435,346,125,1,211,5,1,0,221
01043000022,1567,1182,1097,20,11,43,2,0,85
01043000031,3530,2910,2613,111,85,73,21,0,297
01089000049,10573,7923,3194,1861,2509,352,179,29,4729
01061000007,3298,2602,1998,98,419,90,6,1,604
01061000009,1181,938,758,15,127,30,7,2,180
01061000005,3114,2433,1876,106,342,84,19,2,557
01061000006,1608,1251,1067,66,61,46,6,0,184
01097000054,6204,4874,1684,265,2531,88,333,11,3190
01097000060,5377,4304,2165,173,1707,104,156,7,2139
01097000053,8471,6839,4599,235,1624,105,290,6,2240
01061000003,3182,2469,2172,94,109,82,7,4,297
01055002001,1522,1181,1084,33,17,39,0,0,97
01091000201,3831,2973,1959,99,870,26,19,0,1014
01003000019,609,491,440,5,4,26,5,0,51
01003000021,316,251,236,2,0,10,3,0,15
01093000008,2841,2226,2066,61,17,68,13,2,160
01097000016,5304,4120,1110,52,2862,95,21,0,3010
01079003301,2461,1940,1643,69,42,178,7,0,297
01079001101,404,310,239,4,6,55,1,0,71
01079001201,819,613,492,13,35,71,2,1,121
01079002501,2526,1986,1657,23,112,187,7,2,329
01043000270,2464,1911,1696,124,9,47,15,2,215
01127000008,2195,1681,949,89,591,64,9,1,732
01091000101,1775,1364,381,30,940,5,21,0,983
01091000102,2474,1741,343,45,1343,14,5,0,1398
01007000001,4049,3004,2765,93,88,49,2,3,239
01007000060,2236,1777,1440,64,220,51,1,1,337
01009000010,1075,836,749,42,5,16,5,0,87
01009000024,1279,998,890,51,3,30,3,2,108
01009000008,1323,998,884,52,5,49,4,1,114
01117000006,6290,4609,3887,166,335,111,88,3,722
01117000004,2366,1890,1458,26,358,39,3,0,432
01117000017,6299,5187,3904,214,686,97,279,8,1283
01117000042,2284,1942,1686,45,93,26,84,1,256
01117000028,2901,2191,1911,81,106,52,27,3,280
01117000010,8860,6619,5383,199,684,120,211,6,1236
01117000002,1422,1129,1042,25,21,32,2,1,87
01117000009,5683,4281,3593,85,289,69,231,1,688
01117000012,1394,1135,963,20,81,16,52,0,172
01117000030,4778,4085,2861,244,854,105,29,16,1224
01117000033,4141,3176,1780,468,801,124,17,7,1396
01117000015,7420,6142,4180,302,1082,126,416,15,1962
01117000021,16952,11925,9333,547,1435,297,273,15,2592
01073002280,1747,1420,17,48,1346,17,2,0,1403
01091000508,549,446,148,5,293,2,0,0,298
01091000507,283,234,82,2,146,0,0,0,152
01009000014,3625,2825,2491,239,25,77,8,4,334
01009000021,1444,1055,786,221,10,25,8,2,269
01009000022,6797,5313,4020,761,355,128,55,10,1293
01009000023,1925,1440,1207,160,9,39,4,1,233
01009000017,3166,2527,2312,68,23,85,9,5,215
01009000019,2314,1751,1568,68,24,54,19,1,183
01009000006,2424,1829,1630,80,11,80,2,3,199
01093000017,667,548,514,16,7,10,0,2,34
01093000018,1497,1183,1109,12,8,38,8,0,74
01093000014,4818,3849,3403,87,236,98,12,3,446
01093000020,4022,3106,2752,124,134,68,23,4,354
01093000015,2949,2347,2022,38,208,48,8,0,325
01117000023,7050,5222,3681,551,805,138,75,6,1541
01117000027,7675,5685,3880,849,707,192,79,5,1805
01009000012,2071,1576,1282,240,9,34,3,1,294
01127000025,420,322,300,5,5,3,4,0,22
01127000026,301,241,230,1,3,3,2,0,11
01009000004,5809,4358,4031,38,105,136,18,6,327
01009000002,2364,1866,1753,35,15,49,2,4,113
01087000211,3090,2475,95,11,2354,24,10,4,2380
01121000014,5128,4320,3178,54,1013,74,5,1,1142
01121000005,8908,7175,1936,223,4952,71,29,3,5239
01121000004,9854,7676,4832,118,2539,144,60,4,2844
01121000006,1798,1555,510,15,1024,14,2,3,1045
01121000002,6315,4873,3541,135,960,102,126,4,1332
01121000015,3403,2606,1976,23,524,65,20,9,630
01121000001,9312,7234,5274,120,1592,166,64,7,1960
01121000008,2927,2292,2040,22,180,45,2,3,252
01121000013,2617,2093,1862,31,153,44,2,3,231
01121000010,10615,8335,5326,147,2657,151,28,7,3009
01121000009,14119,11113,6915,220,3696,188,77,16,4198
01047009521,2065,1617,323,11,1264,19,12,0,1294
01101000301,8503,6742,4215,251,1965,157,179,12,2527
01101000407,3208,2451,1038,221,1112,58,31,2,1413
01119000802,276,227,54,0,173,0,0,0,173
01101000303,6922,5622,3541,130,1756,76,114,1,2081
01101000102,8448,6773,2554,134,3691,68,329,13,4219
01101000302,5752,4292,2238,160,1774,102,44,4,2054
01101000404,5549,4738,1724,151,2702,36,143,14,3014
01101000511,2449,2049,1298,53,554,21,127,0,751
01101000510,10268,7754,3977,187,3229,107,278,4,3777
01101000512,13686,10503,5870,268,2302,111,1949,14,4633
01101000101,7194,5849,4406,157,1107,59,121,15,1443
01127000032,1655,1309,1249,15,12,31,3,0,60
01119001201,382,315,92,11,210,3,2,3,223
01007000004,2354,1839,663,38,1115,22,0,0,1176
01007000009,3294,2571,1828,81,626,35,7,1,743
01097000022,7910,5921,4821,198,622,191,62,0,1100
01121000007,3575,2889,1709,28,1077,53,11,2,1180
01101000505,8451,6117,920,609,4364,91,168,9,5197
01101000105,9614,7021,1013,371,5495,79,148,5,6008
01101000204,9417,7248,484,107,6637,63,26,2,6764
01101000509,7159,5173,3018,258,1387,81,434,11,2155
01101000209,553,453,294,9,136,7,9,1,159
01101000210,2214,1816,1147,26,611,26,7,4,669
01101000201,6136,4600,1147,171,3182,56,53,4,3453
01101000401,1808,1461,147,40,1263,24,7,0,1314
01101000202,5631,4403,71,80,4247,28,5,0,4332
01101000411,254,232,135,11,84,1,1,1,97
01059000002,10196,7202,4012,2340,703,347,29,6,3190
01059000010,1168,884,679,164,15,47,1,0,205
01059000011,1248,917,743,116,29,44,8,1,174
01059000009,1991,1541,1449,45,6,38,1,0,92
01059000019,1410,1048,954,52,2,40,1,0,94
01127000020,137,120,113,2,0,5,0,0,7
01127000031,1233,950,913,14,2,18,2,0,37
01131003001,1139,830,105,4,720,6,0,0,725
01117000018,7626,5899,5189,132,253,142,161,1,710
01073005230,3183,2599,1655,116,691,54,75,1,944
01117000003,624,508,427,10,56,13,0,0,81
01125000047,12499,9249,5009,153,3752,107,249,14,4240
01125000014,3531,2635,2272,67,203,73,20,1,363
01125000010,504,382,339,9,11,18,2,0,43
01009000016,2774,2148,1776,284,24,55,19,0,372
01127000006,513,416,401,4,3,7,2,0,15
01127000013,2476,1947,1614,6,236,54,18,1,333
01127000042,869,696,625,1,51,7,0,0,71
01127000036,609,485,432,9,19,21,1,1,53
01127000010,612,533,519,0,3,7,1,0,14
01127000017,2594,2108,1975,26,23,66,10,4,133
01125000035,843,685,160,8,507,12,1,1,525
01125000037,5054,3855,145,51,3643,16,11,2,3710
01125000036,6855,5244,628,150,4386,55,45,5,4616
01125000003,774,571,525,13,6,24,2,0,46
01125000006,2008,1535,1422,20,59,37,4,2,113
01125000031,1463,1048,899,91,43,24,2,0,149
01125000034,957,671,468,33,150,16,4,0,203
01125000030,4781,3880,2333,170,1285,67,42,6,1547
01125000029,2319,1730,532,226,929,40,25,2,1198
01125000023,7894,6044,4879,132,756,84,183,6,1165
01121000011,1082,865,600,11,230,12,2,1,265
01121000003,1669,1324,1121,24,150,24,4,2,203
01009000011,2881,2236,1943,213,15,51,6,2,293
01061000013,2865,2144,1647,158,262,75,7,1,497
01023000045,371,284,276,1,6,2,0,0,8
01023000044,282,226,216,0,7,3,0,0,10
010450007-1,3890,2479,1724,323,241,57,108,35,755
01045000015,2419,1980,1430,60,412,55,21,1,550
01045000016,5026,3920,2405,443,802,126,155,8,1515
01045000003,6060,4795,2907,497,1020,177,248,16,1888
01101000211,1755,1395,32,17,1326,9,25,0,1363
01101000508,809,702,430,10,251,10,7,0,272
01101000504,729,624,392,4,225,5,1,0,232
01101000106,5137,3950,119,54,3760,19,18,1,3831
01101000107,4184,3095,158,77,2837,15,27,5,2937
01125000048,4554,3437,2784,129,435,56,12,0,653
01125000020,5684,4265,2562,431,1118,217,47,14,1703
01125000019,2924,2289,1965,69,193,53,9,3,324
01125000051,570,440,370,23,27,17,0,0,70
010450008-2,3235,2430,1452,140,756,77,21,5,978
010450008-1,391,320,295,3,15,8,0,0,25
01045000001,12631,9815,5794,317,3308,253,159,19,4021
01045000008,1760,1316,848,51,373,26,17,1,468
01045000014,2259,1780,1457,38,232,31,21,3,323
01045000004,1963,1540,1277,35,162,50,16,7,263
01123000102,6350,4928,2440,93,2319,60,22,1,2488
01123001801,2309,1874,1566,29,224,37,18,0,308
01011000003,6361,5118,1039,257,3799,67,12,8,4079
010110002-2,178,143,20,1,120,1,1,0,123
010110008-2,160,128,24,0,104,0,0,0,104
01093000001,4185,3352,2897,72,301,57,12,5,455
01093000019,312,224,206,3,3,12,2,0,18
01093000004,514,406,369,3,26,5,1,0,37
01093000005,851,682,644,9,4,21,1,1,38
01117000040,2035,1704,1537,35,89,35,1,0,167
01027002101,3169,2437,1571,97,716,58,7,3,866
01111000010,6823,5234,3213,77,1841,71,40,3,2021
01111000012,671,513,441,1,58,13,1,0,72
01067000001,6310,4808,3659,49,981,71,32,4,1149
01109000002,1029,790,383,12,370,21,2,1,407
01109000026,670,552,431,18,93,6,1,0,121
010110006-1,192,160,92,1,64,1,0,1,68
01011000005,202,169,42,0,124,1,1,1,127
01123000201,1381,1143,996,15,105,17,5,0,147
01123001001,1328,1162,1066,16,50,19,9,0,96
01123001701,434,359,292,3,59,4,1,0,67
01045000012,1250,970,758,42,130,24,12,3,212
01045000005,348,283,253,10,6,12,1,1,30
01045000002,976,785,669,34,35,29,16,1,116
01109000024,814,617,472,10,112,14,3,3,145
01055000801,3582,2872,2440,43,256,114,17,1,432
01055000104,2912,2315,1325,101,855,73,6,0,990
01055000111,4477,3357,973,299,2006,126,23,0,2384
01027002401,366,286,180,0,104,0,0,0,106
01027001801,222,179,174,0,1,4,0,0,5
01111000001,576,453,381,6,45,21,2,0,72
01111000009,690,528,419,18,75,12,5,0,109
01055001402,4080,3188,2763,138,174,73,22,2,425
01055001301,2338,1844,1611,72,82,68,7,4,233
01055002601,1009,819,755,20,16,22,3,0,64
01055000101,3599,2920,2570,74,179,52,34,1,350
01055001101,729,589,528,22,17,11,10,0,61
01055000102,4039,2999,1941,269,653,140,13,6,1058
01055000103,2533,1808,183,53,1551,30,2,0,1625
01055000105,998,865,354,138,351,21,21,1,511
01055002401,2067,1647,1451,21,90,21,66,0,196
01055000110,2834,2297,2054,32,100,32,70,2,243
01055000008,1076,831,601,33,175,27,1,1,230
01055000107,4070,3201,1560,292,1265,107,22,4,1641
01055000106,2230,1730,1211,105,356,50,9,0,519
01055002301,8940,6919,5514,185,780,177,233,4,1405
01055000109,4891,3913,1430,225,2167,66,75,2,2483
01055000401,5259,4220,3832,51,157,104,52,0,388
01067000002,701,552,466,17,53,10,2,5,86
01067000005,516,412,284,7,108,13,0,0,128
01029000201,3596,2825,2460,30,255,68,13,5,365
01029000102,838,645,625,3,2,11,3,1,20
01119000911,393,319,104,0,215,1,1,0,215
01097000010,3404,2601,2302,56,91,127,9,3,299
01097000036,1133,913,8,8,890,17,2,3,905
01027000801,774,598,561,1,28,9,4,3,37
01027002201,3385,2720,2061,92,497,42,26,1,659
01123000303,1549,1199,1133,14,12,36,2,0,66
01123001501,1399,1112,160,4,936,9,5,1,952
01053000280,280,218,172,4,19,25,0,0,46
01053000120,616,472,294,5,150,17,9,0,178
01089000045,3628,2620,632,176,1784,73,11,3,1988
01089000038,3983,3156,475,130,2500,60,37,7,2681
01089000076,3691,2857,1585,106,992,84,78,10,1272
01089000020,6017,4823,4076,187,155,118,261,6,747
01089000058,5607,4543,3205,126,931,121,147,9,1338
01089000084,8969,6769,4247,329,1705,195,274,20,2522
01089000007,9872,7770,5471,248,1612,285,167,11,2299
01089000073,1429,1125,911,53,47,107,12,1,214
01129000008,752,598,557,2,29,8,0,0,41
01097000038,6457,5330,2259,275,2564,47,194,0,3071
01097000039,3660,2781,2243,93,359,45,35,4,538
01053000040,1173,918,821,20,29,36,9,3,97
01027001201,525,406,382,9,8,7,1,0,24
01123000202,4389,3433,2244,235,797,71,79,1,1189
01053000210,195,148,131,2,4,7,1,1,17
01003000027,1559,1249,1117,35,16,61,10,2,132
01109000027,246,184,132,2,49,1,0,0,52
01079000701,975,772,543,32,101,92,2,2,229
01079003401,2671,2029,1789,36,36,148,10,0,240
01003000017,1921,1503,1228,20,153,70,8,3,275
01079002101,1318,1023,855,6,16,131,7,0,168
01067000011,295,253,149,6,93,5,1,0,104
01111000004,2254,1793,1601,20,93,58,12,2,192
01053000140,1036,764,522,17,183,39,2,0,242
01053000220,1465,1092,996,10,30,51,3,1,96
01053000050,2883,2171,1403,38,664,54,12,1,768
01029000105,1074,844,780,14,24,27,0,3,64
01029000106,273,216,202,2,0,8,0,0,14
01117000043,4260,3118,2597,265,90,114,59,2,521
01129000016,2057,1585,375,9,658,548,3,2,1210
01067000006,722,553,289,21,226,11,3,1,264
01067000012,1926,1670,1386,13,202,45,15,0,284
01029000401,572,456,430,2,1,17,2,0,26
01029000403,316,232,214,11,1,4,0,2,18
01089000083,7114,5271,3737,211,1037,183,103,8,1534
01089000085,4401,3377,2763,93,261,192,51,6,614
01089000064,4456,3290,1709,152,1245,112,81,1,1581
01089000092,7977,6028,3675,230,1825,160,145,10,2353
01089000053,9585,7949,4547,479,2263,216,477,16,3402
01089000060,4967,3745,1680,298,1506,111,197,15,2065
01089000065,6433,4955,3547,155,934,234,48,4,1408
010290001-3,694,521,500,1,3,11,0,0,21
01029000301,1021,776,744,11,1,17,2,0,32
01089000077,3834,3085,2513,81,310,118,40,9,572
01089000006,2425,1909,1360,90,321,66,69,7,549
01089000010,1558,1235,1124,34,17,42,12,4,111
01089000056,6628,5129,4256,122,439,265,60,5,873
01089000051,8947,7683,4491,381,2210,184,439,24,3192
01089000050,8125,6670,1447,313,4623,145,268,17,5223
01089000003,3431,2952,2479,92,207,115,60,5,473
01089000005,3594,3152,2683,102,171,124,73,4,469
01105000007,542,442,339,3,96,4,1,0,103
01105000008,109,96,90,0,6,0,0,0,6
01089000001,3629,3434,146,107,3156,21,18,4,3288
01089000072,5346,3938,2820,131,745,179,56,2,1118
01089000015,7138,5858,4964,150,370,145,203,19,894
01089000078,10196,7990,4997,428,1958,216,371,27,2993
01089000089,7177,5399,3562,267,970,136,470,15,1837
01089000091,6493,4954,3585,194,630,101,423,13,1369
01089000070,3341,2551,1796,94,495,84,93,1,755
01089000062,2502,1980,1693,29,115,127,17,1,287
01089000080,5285,4091,3205,119,464,238,29,7,886
01089000067,4400,3369,2760,110,281,166,27,2,609
01093000007,1610,1266,1205,29,5,22,9,0,61
01093000009,1647,1331,1241,41,5,32,4,1,90
01061000010,4329,3446,2769,81,465,95,31,6,677
01061000012,730,559,510,9,18,19,7,0,49
01087000312,3221,2574,34,11,2526,26,9,1,2540
01087000307,1340,1093,296,24,767,13,3,2,797
01077000113,1222,953,726,99,79,25,20,0,227
01077000110,2344,1717,1049,203,396,61,17,0,668
01077000112,5266,4427,3885,104,263,70,91,3,542
01077000009,3234,2627,2360,50,121,52,30,2,267
01077000013,3534,2779,2610,21,69,61,13,2,169
01077000002,4627,3727,3347,45,218,82,27,4,380
01077000114,3176,2687,2102,101,390,54,45,6,585
01069000191,478,375,172,2,194,10,0,1,203
01069000152,7750,5957,3433,255,2074,137,69,1,2524
01069000291,937,768,683,4,42,27,4,0,85
01077000109,1734,1420,1224,34,92,35,35,3,196
01077000017,817,637,619,3,3,12,1,0,18
01069000221,6087,4495,647,137,3649,68,28,6,3848
01077000016,2352,1818,1740,4,25,44,2,0,78
01077000014,3278,2543,2349,55,83,48,8,0,194
01063000103,502,400,98,6,292,3,2,0,302
01069000241,5645,4367,2478,112,1655,78,52,9,1889
01095000004,2596,1801,1174,501,90,72,19,3,627
01095000014,3310,2725,2510,58,21,100,26,2,215
01069000171,1874,1516,1355,30,74,38,10,1,161
01069000281,1714,1331,1078,40,166,41,8,2,253
01095000005,2021,1498,1134,289,15,72,8,8,364
01069000301,3663,2690,2401,63,123,74,18,12,289
01069000361,3250,2408,2158,68,75,93,13,2,250
01103000304,6835,5400,3211,940,1017,168,72,6,2189
01113000502,6534,4506,1989,382,1895,113,109,56,2517
01103003014,4030,3259,2733,98,298,73,40,0,526
01103000301,1046,956,828,18,52,26,19,2,128
01075001001,289,234,219,0,8,5,0,0,15
01075000401,111,94,90,0,2,1,0,0,4
01113000707,3916,3159,2366,65,616,66,30,1,793
01113000701,1604,1308,794,67,410,19,16,6,514
01103000306,2466,1857,990,315,474,56,13,2,867
01031000018,1659,1276,1010,76,132,42,22,4,266
01031000022,2533,1980,1277,185,440,63,36,3,703
01031000027,5534,3935,1462,462,1889,133,66,7,2473
01085000041,1210,933,25,5,903,8,4,2,908
01071000034,164,128,108,1,0,19,0,0,20
01071000011,2331,1844,1673,19,10,114,8,0,171
0100500010A,527,440,365,10,51,6,7,0,75
01005000003,2765,2434,839,341,1236,22,9,0,1595
01039000013,604,463,429,1,8,25,1,1,34
01039000019,576,436,414,2,7,11,1,0,22
01031000002,686,524,485,6,14,16,1,0,39
01009000018,3299,2573,2291,138,24,95,5,3,282
01009000013,2059,1492,1069,380,16,47,3,1,423
01073002070,3789,3007,137,51,2813,13,4,2,2870
01073002270,1445,1178,42,26,1113,10,0,0,1136
01073001030,6714,4793,611,167,3970,76,23,1,4182
01073001130,4460,3221,545,260,2380,52,19,4,2676
01039000006,634,499,429,9,56,5,0,0,70
01113000705,1201,1012,243,14,749,11,1,1,769
01103000801,2778,2164,1863,162,36,93,14,4,301
01103001801,3715,2848,2582,101,31,110,10,2,266
01103002501,1682,1319,1250,10,12,33,9,0,69
01103002301,953,747,695,1,2,35,3,0,52
01113000601,3965,2741,612,283,1800,49,38,7,2129
01039000020,1084,861,805,16,10,24,5,0,56
01013000006,477,370,242,2,110,13,3,1,128
01039000012,726,564,526,2,28,8,1,0,38
01065000002,895,720,326,2,386,4,4,0,394
01065000004,5188,3943,1012,13,2890,26,21,8,2931
01065000011,313,256,192,3,54,5,2,2,64
01065000012,3409,2603,1603,42,920,39,15,7,1000
01113000001,9560,7429,4640,293,2241,124,145,11,2789
01039000010,655,528,494,1,12,15,4,0,34
01031000024,2911,2284,1500,315,352,109,41,3,784
01031000015,6218,4767,2828,529,1045,164,249,27,1939
01031000000,6,1,0,1,0,0,0,0,1
01031000014,950,747,667,15,17,32,7,0,80
01031000010,578,450,426,3,4,16,1,0,24
01039000011,861,655,621,3,6,17,1,0,34
01041000007,304,227,210,2,9,9,0,0,17
01015000003,1182,899,769,16,68,29,18,4,130
01073002330,1811,1312,29,53,1218,13,9,1,1283
01085000151,776,651,412,10,224,6,1,1,239
01035000113,1650,1207,294,22,883,16,5,3,913
01035000011,182,150,61,1,88,2,0,0,89
01035000021,458,358,262,2,89,5,0,0,96
01041000016,640,491,225,1,251,7,8,0,266
01035000032,228,180,74,0,106,0,0,0,106
01109000030,749,592,407,7,155,11,14,0,185
01109000012,195,158,115,2,33,7,1,0,43
01109000028,329,249,176,5,65,1,0,0,73
01057002201,194,161,159,1,0,0,1,0,2
01065000005,598,462,163,7,295,0,2,1,299
01057001901,272,229,217,4,2,0,4,0,12
01019000011,2172,1777,1658,15,44,43,4,0,119
01021000160,4062,3088,2320,312,375,64,12,1,768
01021000110,1369,1102,1043,20,16,15,2,0,59
01015000006,1863,1470,1391,15,23,31,8,3,79
01073003180,2781,2122,2041,14,6,46,8,0,81
01073002380,1282,1020,36,36,947,9,2,0,984
01115000013,1908,1532,1265,25,173,52,6,0,267
01019000003,376,305,292,0,2,9,2,0,13
010330009-1,1154,939,878,16,11,21,3,0,61
01095000031,1279,976,860,84,6,16,1,1,116
01095000022,2652,1923,1586,249,7,64,3,2,337
01079000401,799,658,351,9,267,35,2,2,307
01079000101,713,601,142,7,428,31,3,1,459
01079000201,785,636,84,1,536,12,1,1,552
01003000016,2400,1812,1436,36,265,72,7,0,376
01003000014,1605,1249,1094,17,51,81,1,0,155
01099000004,2949,2216,1833,27,267,74,12,2,383
01099001404,284,219,165,5,37,16,0,0,54
01003000036,7841,6207,5008,349,575,189,48,10,1199
01079000901,1058,811,652,10,18,118,6,0,159
01043000281,2414,1842,1677,111,4,43,5,1,165
01097000004,880,710,84,3,608,17,1,0,626
01097000083,6653,5050,3655,220,504,110,520,13,1395
01099000002,594,482,229,7,221,24,3,1,253
01099001402,1297,1018,485,8,484,33,8,1,533
01003000037,4208,3362,2820,285,85,106,35,4,542
01043000290,923,712,640,30,0,34,3,1,72
01043000212,1682,1288,1173,54,6,48,5,1,115
01043000021,3107,2281,1956,187,23,75,38,9,325
01043000201,1677,1321,1208,43,10,51,3,2,113
01043000211,1370,1067,954,67,2,35,2,0,113
01043000310,697,533,481,20,0,15,10,0,52
01043000220,3622,2815,2584,74,19,91,15,4,231
01091000305,1496,1176,472,5,694,1,3,1,704
01119000007,4370,3654,1281,77,2184,37,98,6,2373
01025000015,188,147,126,1,16,5,0,0,21
01105000006,162,135,99,2,33,1,0,1,36
01015000011,1892,1459,1347,19,33,57,2,1,112
01097000043,5519,4090,1553,93,2335,72,59,6,2537
01097000042,2759,2099,143,17,1895,14,32,0,1956
01097000059,8562,7012,4761,261,1579,153,231,6,2251
01089000035,5250,3885,623,247,2972,78,33,10,3262
01089000044,1044,751,144,21,571,12,21,2,607
01089000066,2871,2226,1571,92,454,89,32,1,655
01105000011,353,304,141,2,151,7,2,0,163
01045000007,1155,940,851,17,48,21,6,1,89
01003000030,4915,3867,3165,289,281,103,21,8,702
01025000013,960,768,479,4,261,17,9,0,289
01025000008,273,234,142,2,84,5,0,0,92
01025000004,647,514,235,8,259,15,0,0,279
01107003200,1355,1085,1033,17,17,13,5,0,52
01107002200,3420,2651,622,29,1980,27,16,1,2029
01045000011,1123,879,727,14,123,11,5,3,152
01045000010,291,224,190,4,19,10,1,0,34
01045000006,2432,1928,1628,44,189,44,13,4,300
01107005105,3113,2367,1671,36,603,30,19,0,696
01043000230,2040,1559,1374,109,14,57,2,0,185
01047000601,497,430,279,0,145,5,0,0,151
01047000401,1699,1370,226,4,1116,21,1,0,1144
01047000701,139,114,69,1,44,0,0,0,45
01007000005,2288,1762,1430,41,256,30,8,2,332
01007000003,2952,2627,1632,32,925,37,2,1,995
01007000020,4228,3257,2691,102,376,75,12,4,566
01047009352,1442,1063,21,8,1022,2,15,0,1042
01001000005,1192,913,683,14,197,15,6,0,230
01047001501,492,378,122,3,252,1,0,0,256
01047001401,168,136,53,2,80,1,0,1,83
01037001318,311,257,239,4,4,10,0,0,18
01037001117,669,555,515,4,12,22,0,0,40
01051000220,3318,2524,1882,65,509,48,18,2,642
01051000221,7707,5877,4183,267,1154,143,114,2,1694
01051000222,4762,3546,2472,110,803,109,44,2,1074
01051000181,7062,6275,3584,167,2452,60,22,0,2691
01051000161,3052,2286,1615,50,557,41,14,4,671
01051000201,1480,1141,680,27,416,21,8,1,461
01051000151,4670,3443,3056,47,189,100,23,4,387
01051000171,1298,999,426,20,528,23,5,1,573
01051000261,6082,4862,2997,146,1557,85,77,10,1865
01051000029,4846,3873,3059,102,536,126,34,1,814
01051000121,1767,1497,1337,25,85,31,9,1,160
01107004600,2212,2036,581,649,775,21,22,0,1455
01047009342,1712,1215,85,4,1124,6,0,2,1130
01047009530,1809,1311,151,18,1133,13,6,3,1160
01001000010,4766,3734,3063,104,386,99,62,7,671
01125000027,14397,13924,8926,2183,2021,125,596,21,4998
01125000022,5331,4318,3290,125,680,61,143,9,1028
01125000016,7523,5596,4979,228,226,102,71,5,617
01125000039,2310,2127,1454,114,451,34,84,2,673
01125000005,2089,1570,1412,54,49,35,4,0,158
01001000003,1008,784,702,10,56,9,2,0,82
01001000001,795,603,366,8,215,7,0,0,237
01047001101,252,207,59,3,145,0,0,0,148
01037001707,1025,894,492,25,367,12,2,1,402
01107004200,2120,1675,919,107,621,35,5,0,756
01107003100,416,357,317,4,28,8,1,1,40
01079001901,2139,1719,1362,120,93,125,13,2,357
01097000071,2617,2024,963,38,955,34,30,2,1061
01097000072,7748,5772,2428,167,2998,118,50,7,3344
01097000088,1778,1591,1459,31,10,59,15,4,132
01097000050,5684,4491,3199,159,871,85,152,20,1292
01097000040,4889,3904,3113,125,511,56,71,11,791
01097000082,2706,2032,753,52,1094,56,64,0,1279
01097000049,7569,6103,3531,236,1975,134,228,5,2572
01107002100,352,269,84,7,179,0,0,0,185
01107004500,622,533,203,0,324,4,2,0,330
01107004300,242,191,152,0,38,1,1,0,39
01097000084,3780,3133,2656,68,258,91,42,3,477
01047009363,1218,975,15,7,958,7,0,1,960
01001000006,1988,1509,1321,49,75,50,9,3,188
01023000027,505,421,231,3,183,6,0,0,190
01023000025,735,584,549,2,26,5,1,0,35
01023000029,838,659,574,4,68,9,1,0,85
01023000035,397,292,280,1,9,3,0,0,12
01051000061,1860,1400,1088,26,240,35,7,3,312
01051000071,1840,1478,1344,13,70,35,4,2,134
01051000081,2329,1844,1419,33,320,53,14,1,425
01051000051,1421,1239,1147,11,61,11,5,0,92
01101000203,4382,3526,1220,255,1943,61,83,10,2306
01101000402,3821,2817,97,26,2688,20,9,1,2720
01101000305,14368,11599,4075,278,6438,128,679,19,7524
01101000501,10541,8438,3815,207,3234,96,1092,7,4623
01101000412,1595,1334,421,32,865,11,10,2,913
01101000409,2758,2001,438,152,1299,33,92,4,1563
01101000405,4028,2785,687,446,1625,86,12,1,2098
01081000016,2288,1704,1319,51,268,41,18,2,385
01081000020,6982,5196,3912,178,909,155,35,2,1284
01055000501,7356,5859,5511,55,74,161,34,6,348
01023000004,292,241,66,0,174,0,0,0,175
01059000005,3475,2704,2462,106,47,68,16,6,242
01059000006,1116,850,822,11,2,16,1,0,28
01059000020,616,449,300,89,51,23,0,0,149
01051000341,1000,800,593,56,121,24,4,0,207
01051000311,1688,1285,1169,21,48,40,11,0,116
01097000061,6185,4319,1193,235,2630,81,209,8,3126
01097000028,6388,4898,1344,105,3335,85,54,1,3554
01091000401,870,734,298,2,431,7,0,0,436
01091000402,197,159,1,1,158,2,0,0,158
01119000213,292,233,94,2,136,1,0,1,139
01023000031,251,210,78,0,132,0,0,0,132
01023000020,34,28,27,0,1,0,0,0,1
01023000034,118,96,68,0,27,1,0,0,28
010110008-1,298,241,151,0,86,1,0,1,90
01097000065,10119,7386,5402,304,1193,183,292,16,1984
01097000085,4782,3598,2936,44,418,92,72,2,662
01059000017,1015,767,684,54,11,16,2,0,83
01059000007,1393,1075,1002,35,11,25,3,0,73
01101000205,3726,2866,121,79,2651,30,20,0,2745
01101000502,686,570,361,6,195,6,1,2,209
01101000208,1741,1495,997,38,419,18,8,1,498
01101000306,3957,2850,633,68,2060,24,61,1,2217
01101000413,5236,3806,690,89,2922,38,77,3,3116
01059000015,795,629,607,9,3,12,0,0,22
01125000054,1214,920,646,8,265,10,0,0,274
01125000053,2534,2012,1270,22,695,27,1,0,742
01059000003,545,443,413,9,7,12,0,0,30
01059000014,1005,791,743,22,5,14,0,0,48
01061000008,790,588,549,16,5,13,6,0,39
01061000016,762,599,551,16,7,21,3,0,48
01117000031,902,688,595,47,15,36,1,0,93
01059000004,338,264,253,8,1,2,1,0,11
01117000001,823,656,604,15,8,27,3,0,52
01117000026,7867,5767,4350,387,806,129,83,14,1417
01129000001,861,691,558,2,118,7,2,0,133
01129000012,788,590,462,8,21,100,1,3,128
01059000008,533,404,394,4,0,5,0,1,10
01051000101,2636,2059,1435,62,468,68,11,2,624
01097000021,1940,1499,1361,23,48,38,28,0,138
01101000104,4948,3793,656,129,2931,56,49,3,3137
01101000410,4399,3352,346,69,2915,21,25,2,3006
01101000206,2615,2117,165,78,1853,14,17,0,1952
01101000403,4081,3362,691,83,2546,30,33,9,2671
01101000406,1427,1040,115,35,896,6,6,0,925
01097000052,8794,6780,4586,295,1419,204,312,14,2194
01055001401,2925,2286,1599,82,501,87,15,2,687
01055000201,9263,7313,6701,114,206,200,86,6,612
01091000302,610,471,180,6,283,13,0,0,291
01055001603,3248,2435,2137,172,15,79,15,0,298
01055001501,2710,2100,1895,81,22,91,6,2,205
01055001901,2152,1636,1511,39,10,65,6,0,125
01055000016,1393,1076,1010,5,11,35,12,1,66
01009000007,4222,3151,2631,367,31,103,24,3,520
01009000009,885,700,647,22,5,4,2,1,53
01111000008,955,780,535,15,204,16,10,0,245
01051000111,953,757,676,6,46,19,4,0,81
01111000005,1502,1140,1071,11,40,15,1,1,69
01097000080,3711,2869,2501,57,188,63,33,3,368
01009000001,4166,3187,2975,27,43,118,14,0,212
01101000304,6448,4859,2834,435,1366,114,143,10,2025
01111000014,770,602,531,17,41,13,5,0,71
01111000003,1273,1035,927,24,38,32,3,0,108
010110004-1,357,302,89,1,210,1,0,0,213
010110006-2,92,87,70,0,13,4,0,0,17
01067000010,2731,2183,1079,42,1023,25,23,2,1104
01093000010,467,386,356,4,5,24,1,0,30
01093000002,384,298,276,1,10,11,0,0,22
01101000207,1167,862,278,242,335,24,4,0,584
01101000103,6774,5460,1766,166,3251,59,259,13,3694
01061000004,1615,1263,1106,83,35,43,1,1,157
01061000015,868,715,671,13,2,28,0,1,44
01101000503,493,401,276,2,110,11,1,0,125
01051000231,6494,5067,2855,225,1751,106,108,4,2212
01127000003,800,642,602,8,14,12,2,0,40
01127000012,3062,2470,2176,31,189,61,3,0,294
01121000012,827,674,551,0,103,17,2,1,123
01111000006,3402,2811,2263,43,451,42,7,2,548
01053000180,238,194,177,5,1,10,0,0,17
01067000009,448,385,208,2,167,5,1,0,177
01053000010,1045,801,455,33,287,20,9,3,346
01027001102,672,556,529,2,15,9,3,2,27
01089000088,10148,7185,4078,479,1783,154,708,34,3107
01089000071,6113,4444,3092,177,592,140,435,20,1352
01055001701,891,700,626,25,4,28,6,6,74
01081000021,3991,2899,2011,60,734,74,28,2,888
01089000040,883,670,146,19,479,14,13,2,524
01089000055,2519,1955,1613,45,144,129,17,1,342
01045000009,1599,1263,1189,22,34,17,4,3,74
01045000013,518,401,366,7,19,9,0,1,35
01087000101,2363,1987,54,27,1894,37,4,6,1933
01089000037,2706,2089,283,134,1642,51,26,5,1806
01123001203,1677,1280,1039,23,185,35,2,0,241
01123001204,1406,1099,551,21,495,31,6,0,548
01123001201,2324,1785,1536,24,163,43,9,0,249
01027000602,482,397,364,7,12,15,2,1,33
01123001301,208,162,136,1,17,5,0,0,26
01123001101,488,429,360,4,47,12,4,0,69
01027000301,1280,1002,853,37,81,29,2,0,149
01055001601,3999,3134,2907,65,24,109,14,3,227
01053000290,1117,808,305,15,170,322,5,5,503
01051000131,718,578,495,5,65,10,0,0,83
01089000016,1079,618,96,35,474,16,6,2,522
01089000039,4115,3054,619,292,2043,79,73,11,2435
01053000090,218,168,161,1,2,4,0,0,7
01053000080,577,450,357,7,70,16,2,0,93
01051000321,1677,1360,1186,16,87,39,31,2,174
01123001401,485,411,204,21,183,4,3,0,207
01089000036,3789,2824,264,239,2289,65,19,8,2560
01123000101,2220,1621,692,70,812,25,29,1,929
01053000310,2170,1622,116,13,1485,26,3,2,1506
01053000250,1353,1036,711,28,217,76,9,1,325
01111000013,492,383,335,29,6,15,0,0,48
01053000170,519,418,390,0,9,18,0,0,28
01053000160,812,630,596,4,13,14,1,0,34
01061000011,740,572,534,12,6,19,4,1,38
01129000004,794,651,390,3,236,18,6,0,261
01061000017,1120,889,779,14,74,12,4,0,110
01061000014,457,352,308,12,10,18,6,2,44
01133000009,1102,869,833,3,5,20,0,0,36
01063000101,279,242,56,0,185,0,1,0,186
01063000102,162,135,64,1,68,1,0,0,71
01085000011,1428,1130,185,16,936,11,1,0,945
01041000008,370,302,240,1,56,0,0,1,62
01041000017,447,336,289,1,34,8,3,1,47
01041000009,1296,1013,677,20,301,16,6,0,336
01041000005,343,260,234,8,13,4,1,0,26
01041000004,931,717,645,2,64,3,2,0,72
01085000141,572,491,251,5,229,6,1,0,240
01085000061,1271,1028,247,24,751,2,9,0,781
01085000021,668,591,484,3,99,3,4,1,107
01113000603,674,555,388,11,124,26,12,0,167
01113000704,376,301,119,3,177,1,1,0,182
01095000020,2294,1639,1197,382,21,47,6,2,442
01095000017,640,547,507,15,7,12,2,2,40
01095000027,1657,1304,1188,34,5,60,14,1,116
01113000703,2145,1690,1078,38,506,46,21,3,612
01013000015,244,214,198,3,10,3,0,0,16
01085000081,292,231,97,10,126,2,1,0,134
01035000053,458,373,338,0,13,13,2,2,35
010330010-2,1473,1169,1084,19,8,55,1,1,85
01071000035,324,254,242,4,1,8,0,0,12
01075000901,1941,1478,1186,9,265,16,1,3,292
01019000014,340,282,236,0,43,4,0,0,46
01083000701,1429,1176,1115,12,12,23,8,1,61
01103002001,1186,917,809,22,24,55,3,0,108
01013000020,238,181,130,1,43,5,1,0,51
01013000013,495,419,302,4,108,5,0,0,117
01019000002,693,555,540,3,1,9,0,0,15
01071000016,1313,1032,946,17,5,51,6,0,86
01071000023,491,364,331,3,4,27,0,0,33
01071000012,303,271,248,6,5,10,2,0,23
01075000101,1336,1025,867,19,125,13,2,0,158
01013000016,574,454,373,3,72,4,1,0,81
010130014.1,297,240,210,2,22,4,1,0,30
01035000072,179,154,106,1,44,4,1,0,48
01077000101,3007,2812,1788,99,684,89,162,6,1024
01039000008,907,726,689,2,5,24,5,1,37
01073002180,3278,3067,2158,115,627,49,126,1,909
01039000004,940,708,683,4,6,10,6,0,25
01019000013,1027,873,692,11,138,30,6,0,181
01019000005,881,709,684,2,10,10,2,0,25
01075000601,171,128,121,0,5,1,1,0,7
01021000210,999,749,645,29,33,22,4,0,104
01115000022,897,712,653,6,31,10,2,0,59
01115000011,721,563,521,3,27,13,1,0,42
01115000001,2479,1927,1450,53,351,49,13,5,477
01095000009,321,262,240,2,2,15,0,0,22
01073001280,2634,1687,62,45,1570,18,10,2,1625
01073001380,848,744,9,8,722,8,4,1,735
01099000010,684,560,107,6,446,8,1,0,453
01019000007,323,258,237,4,0,12,0,0,21
01099000307,1575,1203,362,21,800,19,9,0,841
01043000150,2517,1862,1729,33,14,76,1,1,133
01043000050,420,324,270,13,4,27,6,0,54
01025000003,2469,1953,640,15,1261,28,10,1,1313
01115000006,557,401,344,16,15,11,6,1,57
01115000027,1163,931,852,37,7,34,4,0,79
01115000029,1208,933,854,34,11,30,1,0,79
01073002360,1973,1541,365,177,969,41,3,0,1176
01073000000,7065,5580,3459,578,1184,153,256,12,2121
01073005200,3487,2645,1878,119,423,45,169,0,767
01115000002,805,655,634,2,4,11,0,0,21
01073002440,1038,700,30,27,626,11,10,0,670
01115000005,2770,2192,1889,45,141,101,19,1,303
01117000019,6211,5056,3734,183,768,79,265,5,1322
01127000024,509,394,379,4,5,5,1,0,15
01127000018,326,275,259,4,3,6,1,0,16
01015000008,2476,1961,1818,16,53,69,8,4,143
01019000004,716,580,549,3,8,15,1,0,31
01067000003,667,528,478,11,28,7,4,1,50
01131002007,279,234,146,0,87,0,0,0,88
01131004001,467,362,28,5,328,3,1,0,334
01131002003,104,96,17,1,77,1,3,0,79
01003000029,1178,1010,900,25,9,42,13,3,110
01123000301,935,739,681,11,22,24,3,0,58
01099000304,1387,1038,232,2,790,7,5,0,806
01079001801,1286,1012,887,11,13,104,2,1,125
01079001601,658,494,417,5,3,62,3,0,77
01025000009,466,357,122,1,225,9,2,0,235
01109000005,51,37,22,0,15,0,0,0,15
01109000016,745,607,464,19,110,12,1,2,143
01109000018,613,461,382,5,57,11,3,0,79
01109000004,482,378,274,11,71,14,4,0,104
01109000031,826,629,360,19,232,17,2,2,269
01109000014,876,707,365,25,289,27,7,1,342
01109000010,413,322,276,5,28,10,4,0,46
01109000015,212,151,122,6,17,4,1,0,29
01109000009,359,277,229,4,30,9,6,1,48
01079001301,1841,1391,1109,19,16,227,12,5,282
01047009544,744,557,64,4,488,1,1,1,493
01047000901,3330,2563,1198,25,1293,29,30,4,1365
01047000201,909,725,561,1,154,10,0,1,164
01129000011,898,710,464,7,207,21,5,4,246
01047009182,913,682,11,4,662,5,2,0,671
01001000008,860,641,351,13,266,11,0,1,290
01131004003,527,384,68,20,311,1,0,0,316
01097000007,4108,2985,2591,37,232,104,16,0,394
01043000240,1448,1145,1062,31,7,31,6,1,83
01119000512,438,364,39,2,324,3,0,0,325
01131006005,217,190,80,1,107,4,0,0,110
01097000076,7110,5445,3965,269,855,211,139,12,1480
01089000093,5935,4397,2276,232,1597,196,103,12,2121
01087000205,454,390,41,2,344,3,0,0,349
01119000413,2942,2253,317,4,1924,13,5,1,1936
01097000008,3330,2518,2176,26,187,120,7,0,342
01081000019,3462,2760,2417,62,186,70,23,2,343
01079001001,832,659,573,4,5,76,3,2,86
01007000007,892,696,606,12,63,17,1,0,90
01109000025,834,670,445,6,188,25,4,2,225
01093000011,331,267,259,5,0,4,0,0,8
01009000005,973,768,689,15,11,41,1,2,79
01009000003,610,496,443,7,18,21,3,0,53
01105000003,1507,1180,119,2,1056,6,0,0,1061
01127000040,775,635,610,4,1,15,1,0,25
01119001101,601,446,40,1,406,4,2,2,406
01127000043,1689,1308,1213,18,29,44,7,0,95
01119000105,170,130,11,0,119,3,0,0,119
01037000420,493,383,282,2,86,11,0,0,101
01131005002,12,8,2,0,6,0,0,0,6
01125000025,1671,1332,1138,67,100,24,1,0,194
01127000016,1955,1557,1381,30,57,78,3,4,176
01127000037,3585,2806,2556,20,104,86,19,1,250
01127000009,1700,1294,1129,12,118,24,1,0,165
01131006002,1242,954,393,5,553,4,0,0,561
01127000028,2162,1700,1538,96,29,31,15,0,162
01009000020,873,675,634,20,8,14,0,0,41
01027000901,330,275,254,0,11,8,2,2,21
01093000006,828,656,620,6,5,17,4,0,36
01109000011,275,191,75,3,104,7,1,0,116
01123000902,2150,1964,1859,23,52,21,8,0,105
01055002201,989,767,735,8,2,16,3,0,32
01051000011,4130,3251,2452,63,647,50,36,4,799
01051000021,549,390,70,9,295,9,6,1,320
01089000018,5479,4545,3735,147,360,144,150,13,810
01067000013,481,399,234,2,153,5,4,1,165
01129000014,747,596,319,8,77,191,0,0,277
01129000015,404,335,138,4,179,13,2,3,197
01129000020,1133,914,656,2,241,15,1,1,258
01003000003,558,456,228,1,219,4,0,1,228
01003000012,753,623,546,8,39,29,2,2,77
01053000070,978,742,695,3,11,24,2,1,47
01029000101,218,196,186,0,1,8,1,0,10
01029000302,1671,1299,1236,11,4,37,4,2,63
01029000104,723,547,527,2,5,15,4,0,20
01029000402,2006,1530,1313,79,100,43,3,0,217
01105000009,212,179,109,2,68,1,0,0,70
01087000413,440,363,11,8,345,1,2,3,352
01133000008,366,304,276,3,5,19,0,0,28
01077000111,4699,3681,2565,141,835,94,49,2,1116
01063000503,152,130,12,1,117,0,0,0,118
01063000402,359,301,41,2,258,0,0,0,260
01057000401,624,496,454,11,17,9,4,0,42
01063000302,671,452,25,3,426,0,2,1,427
01113000402,2647,2064,313,68,1674,9,17,8,1751
010170005-B,330,278,238,3,29,6,1,0,40
010170005-A,506,434,241,2,189,0,1,1,193
01071000037,444,343,304,10,3,23,2,1,39
01071000036,451,377,345,8,3,16,3,2,32
01031000008,290,235,193,3,23,9,4,3,42
01031000001,969,776,722,3,2,35,11,0,54
01013000010,143,97,38,1,58,1,0,0,59
01065000016,584,470,341,4,120,4,2,2,129
01073005110,6121,4674,4318,90,127,51,63,1,356
01035000142,140,107,29,1,75,1,1,0,78
01041000006,698,550,380,1,151,10,5,0,170
01041000002,581,463,426,8,18,12,1,0,37
01095000003,660,464,311,124,8,18,9,0,153
01115000028,385,312,298,3,1,6,2,0,14
01021000180,2135,1566,1228,211,70,55,8,0,338
01043000182,1900,1462,1380,17,0,35,6,5,82
01043000190,2246,1741,1602,55,7,48,6,4,139
01099000009,378,302,43,0,253,6,0,0,259
01043000260,1154,959,918,9,5,18,1,2,41
01043000111,1073,850,804,12,1,29,0,1,46
01105000004,2075,1751,718,31,983,17,29,2,1033
01097000034,2805,2244,7,11,2207,24,3,0,2237
01097000035,3798,3020,22,130,2971,30,4,4,2998
01099001201,34,32,11,0,21,0,0,0,21
01043000320,1384,1121,1043,37,9,31,2,0,78
01025000018,316,237,58,3,175,3,1,1,179
01043000080,561,443,408,8,3,17,1,0,35
01107001200,240,183,163,2,13,5,0,0,20
01129000018,504,380,318,5,41,12,2,0,62
01001000015,2340,1768,1286,43,360,50,25,4,482
01047009372,474,350,7,4,339,5,0,0,343
01081000017,2350,1786,1143,35,542,44,7,2,643
01003000026,2533,1975,1745,96,18,77,17,5,230
01081000018,818,601,348,8,225,15,2,0,253
01059000018,1302,983,885,60,15,29,3,1,98
01051000041,2004,1531,1348,34,103,42,6,1,183
01051000052,981,845,746,14,55,20,1,0,99
01051000331,8813,6641,5147,156,1041,139,120,12,1494
01059000016,1304,922,474,403,39,35,0,0,448
01059000013,1256,940,721,156,40,26,9,1,219
01101000507,735,637,454,11,160,5,3,0,183
01091000504,705,573,414,1,152,6,0,0,159
01117000014,8909,7160,5462,318,896,112,377,6,1698
01055001001,2963,2367,2192,38,23,91,10,2,175
01023000048,149,117,109,0,7,1,0,0,8
010110002-1,141,112,8,3,104,0,0,0,104
010110001-1,837,646,36,1,608,2,3,0,610
01011000009,497,427,149,0,276,2,0,0,278
01011000010,461,370,236,2,126,4,0,0,134
010110004-2,207,143,16,3,120,4,0,0,127
01129000010,698,549,480,6,44,18,1,0,69
01093000013,453,363,353,3,5,1,1,0,10
01093000012,649,525,513,0,1,3,2,0,12
01127000045,844,697,678,2,0,13,3,0,19
01027000201,525,429,398,8,13,9,1,0,31
01123000601,666,525,465,5,54,2,0,0,60
01055000301,1070,865,822,4,21,13,3,0,43
01055002501,1292,1068,977,22,21,31,17,1,91
01101000506,422,363,262,1,87,7,2,1,101
01123000203,2018,1608,1329,36,203,28,1,1,279
01053000230,617,468,413,13,28,13,1,1,55
01111000011,945,745,663,8,47,14,2,0,82
01133000010,824,655,619,13,3,20,1,0,36
01057000601,566,430,392,14,14,8,1,0,38
01069000111,1301,965,778,30,122,22,10,0,187
01085000071,811,657,204,5,439,11,0,0,453
01095000011,522,430,398,5,2,14,4,2,32
01095000023,1568,1197,1120,20,3,24,9,0,77
01071000019,213,189,167,0,0,21,1,0,22
01071000025,536,399,355,4,0,40,0,0,44
01071000005,1159,907,834,10,1,54,6,0,73
01031000007,978,755,671,4,24,46,3,2,84
01031000004,523,440,411,11,9,18,1,1,29
01013000001,837,707,502,4,193,5,0,0,205
01013000019,870,645,506,3,128,10,2,2,139
01031000006,195,140,124,0,7,8,2,2,16
01071000026,215,187,168,1,1,10,5,1,19
01039000005,367,287,275,1,4,5,3,0,12
01057000301,345,283,271,1,8,1,1,0,12
01041000001,679,552,387,7,143,9,5,1,165
01035000121,377,325,103,0,218,2,2,0,222
01057001601,271,217,206,6,5,1,0,0,11
01099000007,536,453,298,8,140,8,1,1,155
01057001801,805,609,586,3,9,11,1,0,23
01065000007,468,386,181,3,197,5,2,0,205
01043000160,1021,837,807,6,2,20,1,0,30
01019000006,462,360,333,6,2,15,3,0,27
01019000016,344,276,242,3,22,8,0,0,34
01047001301,925,747,165,3,574,6,1,1,582
01047000402,206,156,14,0,142,0,0,0,142
01043000172,2579,1913,1771,37,12,80,7,2,142
01131002004,648,523,127,3,391,3,1,0,396
01131001005,74,61,11,0,49,0,0,1,50
01073003330,79,70,7,5,59,0,1,0,63
01073002400,1651,1141,25,21,1101,13,1,0,1116
01073001310,1137,950,2,8,936,4,1,0,948
01119001301,331,275,43,3,228,1,0,1,232
01127000038,693,546,511,15,10,10,2,0,35
01123001601,364,287,232,12,38,7,1,0,55
01123000501,1043,798,714,2,61,18,0,1,84
01027001401,769,599,580,7,2,4,1,0,19
01123000401,865,679,591,5,65,16,0,0,88
01027000802,179,149,67,0,77,5,0,0,82
01093000016,227,177,159,5,0,15,0,0,18
01053000330,1126,842,623,12,108,98,1,2,219
01089000008,2662,2204,1922,53,124,55,43,1,282
01067000008,541,445,317,11,110,1,3,0,128
01129000025,1535,1165,867,20,242,31,3,1,298
01027001001,561,459,411,13,28,10,3,3,48
01029000404,1389,1008,968,17,2,18,5,1,40
01053000100,174,139,126,0,5,7,1,0,13
01103002701,529,417,380,8,0,22,2,0,37
01095000016,2207,1562,1232,275,4,58,2,4,330
01071000017,144,129,117,5,0,7,0,0,12
01031000005,265,194,171,0,9,11,0,0,23
01103001701,1815,1427,1142,185,25,68,5,0,285
01005000002,653,530,367,14,135,6,4,0,163
01013000007,484,399,354,3,37,1,4,0,45
01035000043,393,322,145,9,167,4,1,1,177
01035000511,334,267,245,0,6,12,4,0,22
01035000071,115,89,50,1,36,2,1,1,39
01041000015,358,252,157,1,87,2,4,0,95
01041000013,1249,950,805,12,112,15,2,1,145
01099000011,62,50,32,1,17,1,0,0,18
01043000040,1165,909,849,17,13,28,1,0,60
01105000013,62,53,36,1,15,2,0,0,17
01099000013,518,399,343,1,16,22,2,1,56
01025000019,214,159,120,3,30,0,1,0,39
01107005400,89,79,64,1,10,3,1,0,15
01001000002,4857,3797,3007,115,465,107,88,7,790
01037000108,674,597,522,2,60,16,0,0,75
01047009343,2070,1617,129,10,1479,7,10,4,1488
01001000017,3213,2483,1779,59,555,59,19,6,704
01023000037,122,93,3,1,86,3,1,0,90
01091000511,435,348,195,10,149,2,0,1,153
01059000001,867,691,642,24,2,21,0,0,49
01059000012,540,427,368,22,14,24,0,0,59
01051000141,1642,1218,1151,3,8,32,13,0,67
01117000011,2949,2310,2057,36,99,29,78,0,253
01111000002,1237,919,743,57,88,36,1,0,176
01093000003,89,72,58,0,12,0,0,0,14
01101000408,2776,2031,665,180,1150,34,13,0,1366
01053000150,1190,894,709,23,119,33,1,2,185
01127000029,399,351,334,4,3,8,2,0,17
01123000801,1697,1517,1443,9,30,27,9,0,74
01027000701,200,163,147,1,10,6,0,0,16
01129000013,651,512,471,2,25,15,0,0,41
01129000022,541,429,286,1,127,13,1,0,143
01133000011,1567,1217,1152,12,9,32,9,0,65
01013000011,278,233,164,5,63,2,2,1,69
01075001601,208,173,163,6,2,2,0,0,10
01013000005,289,233,192,2,31,4,3,1,41
01035000052,306,256,222,5,11,18,2,1,34
01035000102,145,125,114,0,5,7,2,2,11
01039000017,883,678,636,6,23,6,3,0,42
01057000701,347,272,201,0,64,6,0,0,71
01075001201,211,169,169,0,0,0,0,0,0
01057002001,363,274,264,0,3,7,1,0,10
01057001301,459,377,353,1,13,8,1,0,24
01057001401,602,476,451,0,14,8,3,0,25
01025000005,192,153,12,0,141,0,0,0,141
01065000010,340,288,149,0,132,0,3,0,139
01117000013,2274,1843,1395,44,285,17,86,0,448
01067000004,443,357,300,3,38,10,2,0,57
01079002601,389,310,67,4,224,13,3,0,243
01079001401,1189,935,786,7,8,129,2,1,149
01047009183,925,571,6,0,564,5,1,0,565
01107004100,310,269,61,4,201,3,2,0,208
01047000502,717,567,108,3,458,0,0,1,459
01131001004,143,123,27,0,94,3,0,0,96
01107005300,457,354,332,13,6,2,1,0,22
01087000204,628,514,21,4,490,5,0,2,493
01127000015,789,606,455,16,123,12,1,0,151
01127000030,584,465,445,1,8,8,2,1,20
01127000041,242,200,194,0,1,4,0,0,6
01131003005,91,85,25,0,59,1,0,0,60
01127000027,461,385,363,4,4,12,2,0,22
01109000017,662,536,428,6,82,18,2,0,108
01109000020,542,408,159,18,223,3,8,1,249
01129000019,460,365,147,1,208,9,1,1,218
01089000031,3190,2657,1006,119,1494,41,26,6,1651
01063000502,314,258,14,0,242,2,0,0,244
01065000001,392,311,202,6,101,3,2,0,109
01057000801,530,417,388,6,10,11,3,0,29
01065000009,472,358,103,3,253,2,0,0,255
01099000401,230,195,45,1,140,5,4,0,150
01043000061,257,218,187,15,15,6,0,0,31
01107001100,515,443,320,3,120,1,0,0,123
01129000003,288,233,121,2,105,5,1,0,112
01127000021,1118,891,691,6,148,44,2,1,200
01127000039,1534,1216,1178,12,8,11,1,0,38
01057000201,310,259,229,3,24,3,0,0,30
01041000010,459,361,275,7,65,9,7,0,86
01085000111,549,452,30,3,421,1,0,0,422
01071000031,521,410,385,1,5,21,1,1,25
01057001201,333,276,267,0,6,2,2,0,9
01075001101,424,337,318,2,14,4,0,0,19
01025000016,208,148,135,3,5,1,1,0,13
01115000018,1561,1181,1070,35,19,43,5,2,111
01133000006,921,797,729,12,4,35,5,2,68
01025000011,575,495,217,0,276,2,1,0,278
01107001400,206,181,133,2,48,1,0,0,48
01119001011,434,333,33,2,298,0,0,0,300
01053000110,83,73,69,1,2,2,0,0,4
01031000021,180,155,144,0,5,6,0,0,11
01031000019,334,258,236,3,1,13,2,1,22
01065000013,30,19,14,5,0,0,0,0,5
01035000022,64,46,36,0,10,0,0,0,10
01043000130,1017,789,707,38,6,33,2,2,82
01043000330,1112,854,789,20,4,40,3,0,65
01099000008,374,277,11,0,262,1,0,0,266
01047009131,499,404,125,5,277,5,0,1,279
01001000009,1705,1282,944,34,258,41,13,2,338
01091000505,281,224,145,0,77,1,0,0,79
01129000005,696,534,494,4,25,6,4,1,40
01039000022,437,359,336,1,9,3,7,0,23
01075001801,398,314,300,2,10,2,0,1,14
01035000073,180,156,48,1,106,1,0,0,108
01131001006,221,175,119,1,54,1,0,2,56
01131002001,121,96,15,2,78,2,0,0,81
01003000011,533,386,343,3,5,34,0,0,43
01127000035,509,418,401,2,1,12,2,0,17
01037000603,420,349,317,2,16,12,0,1,32
01011000007,184,160,85,4,70,0,0,0,75
01053000240,800,603,251,17,314,27,0,0,352
01003000013,1293,999,951,3,2,41,0,1,48
01029000405,665,525,504,4,2,15,1,1,21
01025000012,997,776,268,5,492,9,6,0,508
01043000062,548,446,188,3,249,6,2,0,258
01037000015,312,266,40,1,221,2,0,0,226
01009000015,776,605,577,6,3,13,4,0,28
01057001001,635,489,449,11,23,9,1,0,40
01071000027,197,170,142,1,1,26,0,0,28
01131005005,225,172,16,0,155,0,0,0,156
01031000009,606,454,407,7,12,22,0,0,47
010110001-2,190,150,18,0,132,0,1,0,132
01041000018,535,422,380,0,31,9,1,1,42
01035000161,225,202,88,0,111,3,0,0,114
01079002201,623,476,382,21,21,44,2,0,94
01131003004,122,95,43,1,52,1,0,0,52
01131003002,85,66,22,0,44,1,0,0,44
01131005006,508,374,32,4,341,0,0,1,342
01043000141,903,715,673,20,5,17,1,0,42
01111000007,377,328,297,10,3,13,3,0,31
01043000070,543,431,420,5,3,1,1,0,11
01079003201,239,203,183,2,2,16,0,0,20
01035000092,183,167,140,0,26,1,0,0,27
01051000031,1198,939,661,7,239,18,7,1,278
010330015-1,219,169,156,1,8,2,1,1,13
01027000102,381,303,291,3,4,5,0,0,12
01131005004,505,391,62,2,325,4,0,0,329
01131004002,452,340,7,2,333,0,0,0,333
01075002301,155,114,108,2,0,6,0,0,6
01099001202,48,43,36,0,7,0,0,0,7
01071000033,28,26,25,0,0,1,0,0,1
01107004400,57,48,24,0,23,0,0,0,24
01131006004,208,149,15,0,134,0,0,0,134
