GEOID,TOTAL_POP,TOTAL_VAP,WHITE_VAP,HISPANIC_VAP,BLACK_VAP,NATIVE_VAP,ASIAN_VAP,PACIFIC_VAP,MINORITY_VAP
2400107-002,2147,1701,1589,8,29,22,45,0,112
2400105-004,1735,1377,1214,22,104,21,12,1,163
2400124-000,1764,1493,1437,12,20,14,14,1,56
2400120-000,1896,1557,1493,15,10,24,10,1,64
2400107-001,5068,4669,2153,117,2305,57,27,1,2516
2402102-016,4125,3143,1412,571,855,77,254,11,1731
2402102-006,3901,3054,1936,420,434,55,242,3,1118
2400902-004,4866,3720,2627,99,799,88,90,9,1093
2400903-007,4154,3141,2543,127,272,68,115,4,598
2400903-006,3234,2482,2003,105,211,60,94,10,479
2402117-001,2135,1703,1581,34,20,27,20,3,122
2402118-001,4255,3312,2799,201,156,71,85,6,513
2402118-002,3361,2607,2435,47,53,40,19,4,172
2402121-001,2219,1814,1555,121,52,26,63,1,259
2402121-005,0,0,0,0,0,0,0,0,0
2402121-007,889,730,647,33,18,5,27,0,83
2402121-006,0,0,0,0,0,0,0,0,0
2402121-008,33,23,13,5,0,3,0,0,10
2402109-002,6443,4823,3601,416,336,71,362,1,1222
2402109-001,4370,3115,2641,121,119,40,165,2,474
2402113-002,170,144,112,22,3,3,2,3,32
2402113-003,1017,724,563,46,68,19,37,0,161
2402113-001,6284,4511,3799,243,195,109,139,6,712
2400303-006,12984,9941,5417,672,2958,199,798,32,4524
2400303-007,3117,2343,1915,78,202,59,69,6,428
2400302-007,4375,3446,1942,351,852,97,232,9,1504
2400302-004,3151,2592,1458,126,742,53,200,11,1134
2400307-007,2968,2373,2051,91,105,40,64,8,322
2400304-015,3564,2852,2450,83,144,64,87,15,402
2400303-004,4389,3364,2461,229,409,94,157,8,903
2400307-025,2952,2341,1936,70,212,64,40,2,405
2400302-014,5694,4386,1314,420,2467,93,172,13,3072
2400302-005,4085,3205,1562,459,983,86,159,5,1643
2400302-017,5071,3801,1267,488,1756,81,264,10,2534
2400302-012,2634,2052,1404,273,239,87,76,3,648
2402111-001,3373,2613,2350,92,66,54,43,0,263
2402125-001,5260,4025,3244,248,315,104,96,5,781
2402103-002,4572,3527,3119,132,81,70,109,4,408
2402105-001,7415,6087,5001,269,536,126,159,27,1086
2402107-003,3489,2656,2114,186,116,51,183,1,542
2402107-004,4225,2894,1809,245,268,61,534,3,1085
2402123-001,7704,5922,3708,737,980,87,436,10,2214
2402123-004,0,0,0,0,0,0,0,0,0
2402106-001,2063,1687,1596,18,19,27,15,2,91
2402103-001,2811,2171,1976,83,44,37,31,5,195
2402114-001,4357,3534,3100,147,125,73,92,4,434
2402114-002,624,500,463,5,11,6,8,1,37
2400901-002,4153,3101,2015,130,847,81,42,10,1086
2400901-006,4810,3602,2632,149,570,116,133,5,970
24009ZZZZZZ,13,12,1,3,4,0,4,0,11
2400901-003,3550,2744,2162,110,340,77,57,2,582
2400903-005,4026,3099,2215,93,647,61,71,8,884
2400903-004,3727,2869,2355,108,281,70,61,5,514
2402102-011,4695,3782,2250,489,813,80,180,11,1532
2402107-002,7756,5085,2370,630,675,76,1354,11,2715
2402107-005,154,126,103,6,3,1,15,0,23
2402109-009,2660,1923,1261,173,277,59,172,0,662
2402109-003,786,593,441,52,32,11,52,0,152
2402112-001,4628,3354,2590,240,364,96,95,0,764
2402112-002,6,6,3,3,0,0,0,0,3
2400903-008,5319,3784,2891,143,540,75,123,16,893
2400901-005,4816,3585,2595,188,652,93,57,5,990
2400901-007,4131,3214,2522,89,440,72,70,12,692
2402110-001,2407,1907,1732,61,48,45,26,3,175
2402102-010,6397,4955,2920,747,962,100,279,13,2035
2402102-005,5976,4945,3803,372,514,86,169,22,1142
2402102-018,2745,1951,1176,171,424,44,163,3,775
2402102-015,6077,5033,3645,362,716,65,255,9,1388
2402102-007,5370,4443,3034,497,665,87,201,4,1409
2403321-005,4075,3119,273,1491,1104,143,288,5,2846
2403302-003,3987,3002,690,424,1764,62,121,5,2312
2403306-022,5544,4293,70,191,4014,39,38,1,4223
2403306-021,861,677,32,106,520,13,17,0,645
2403310-009,6636,4886,693,1439,2527,164,229,7,4193
2402102-004,10105,7276,2335,2716,1495,200,701,11,4941
2402102-001,5207,4145,2146,718,948,92,287,4,1999
2402104-001,1240,1017,952,34,6,18,9,1,65
2400901-004,3318,2638,2097,65,338,67,47,7,541
2402124-002,1205,982,803,70,51,20,28,3,179
2402124-004,27,18,4,10,1,7,0,0,14
2402124-005,1503,1131,585,132,285,28,126,0,546
2402124-006,38,34,29,4,1,2,1,0,5
2402109-005,1913,1483,1327,61,34,20,35,1,156
2402109-004,4645,3589,3139,150,84,73,120,3,450
2402108-001,2597,2059,1812,76,67,51,45,0,247
2402116-001,4375,3374,2992,98,96,57,101,7,382
2402102-003,4219,3655,2860,277,359,97,91,7,795
2402109-007,6957,5002,4049,279,236,88,304,11,953
2402109-006,5114,3635,2743,221,313,54,304,14,892
2402107-001,3098,2424,1885,149,165,25,193,5,539
2402107-007,1213,823,506,79,98,14,124,1,317
2400903-001,3183,2519,1921,132,321,74,83,13,598
2402121-002,2629,2019,1417,144,275,28,134,2,602
2402102-008,8732,6569,2818,1717,1430,171,558,1,3751
2402121-003,1664,1338,1052,76,96,14,100,2,286
2402101-002,7339,5282,2801,784,1138,92,493,14,2481
2403304-001,2502,2086,1107,159,727,87,43,2,979
2403320-005,3888,2949,291,1321,1235,130,159,3,2658
2403320-001,5069,3892,384,1478,1924,113,155,2,3508
2403301-004,4511,3468,743,1484,784,108,473,14,2725
2403301-005,4050,3191,949,1238,645,100,362,1,2242
2403301-006,2531,1965,247,487,1080,40,150,4,1718
2403318-002,2707,2078,42,378,1636,30,33,1,2036
2403318-015,168,113,0,27,88,3,3,0,113
2403302-002,2922,2218,223,1046,790,83,184,8,1995
2403306-029,1005,856,34,80,716,26,18,0,822
2403306-028,1121,923,83,117,694,5,18,2,840
2403306-014,614,496,41,35,395,4,31,1,455
2403314-008,3867,2939,280,323,2001,51,350,12,2659
2403314-012,3172,2581,648,175,1431,35,344,4,1933
2403317-002,3576,2793,498,1124,1086,101,97,14,2295
2403314-009,4581,3558,775,349,2176,52,268,5,2783
2403314-013,1615,1213,279,52,773,15,109,2,934
2403314-017,37,30,3,11,14,6,1,0,27
2403314-001,3437,2764,824,258,1515,51,165,1,1940
2403314-014,27,15,3,5,5,0,2,0,12
2403312-015,3718,2984,121,369,2382,47,97,1,2863
2403317-010,9840,7307,184,5107,1884,389,231,12,7123
2403317-013,1973,1377,45,971,305,111,57,3,1332
2403307-009,5285,4167,271,144,3605,45,170,4,3896
2401506-001,5430,4113,3726,153,60,102,50,1,387
2401506-002,3999,3137,2920,68,31,79,29,6,217
2401505-005,6600,4954,4259,172,295,138,84,9,695
2401506-003,1203,923,863,8,13,18,16,1,60
2401509-001,2768,2139,2000,41,19,51,14,4,139
2401505-002,4393,3474,2802,131,333,105,86,10,672
2401505-004,3830,2774,2091,179,371,82,62,8,683
2401507-002,5588,4440,3429,145,658,134,78,8,1011
2401507-004,559,447,389,22,5,11,15,1,58
2401507-003,1466,1182,973,42,109,36,15,2,209
2401507-001,4125,3208,2886,60,119,87,35,0,322
2401504-001,5288,4244,3822,159,78,86,53,1,422
2401504-002,3830,2930,1821,201,707,69,137,2,1109
2401503-006,3109,2408,2112,111,81,75,12,1,296
2402121-004,4795,3418,1938,394,736,45,328,10,1480
2402101-001,3951,3073,2459,186,212,47,142,5,614
2402101-003,2704,2005,1564,196,136,32,50,0,441
2403318-001,4164,3263,66,404,2769,88,26,3,3197
2403320-007,2061,1506,16,339,1151,45,11,1,1490
2403320-018,3765,2523,54,397,1932,35,146,4,2469
2403317-003,15919,11134,185,9537,1200,1366,255,16,10949
2403312-001,3572,2688,184,940,1184,71,374,18,2504
2403312-002,2697,2113,102,560,1372,39,81,9,2011
2403302-005,5119,3630,160,2647,798,222,50,8,3470
2403302-097,0,0,0,0,0,0,0,0,0
2403302-098,36,26,0,22,3,1,1,0,26
2403316-001,1612,1165,149,646,349,42,14,4,1016
2403319-001,7010,5103,1015,2622,1178,254,294,10,4088
2403319-004,4935,3363,136,2362,862,173,59,2,3227
2403313-014,6164,4651,107,229,4159,69,180,3,4544
2403313-020,1020,721,10,96,606,21,11,0,711
2403313-005,4159,3442,539,152,2691,40,97,4,2903
2403313-013,2446,2008,52,80,1847,35,44,4,1956
2403313-012,4144,3343,75,134,3077,35,106,4,3268
2403306-010,4386,3514,123,266,3059,75,108,2,3391
2403318-007,3841,2863,62,356,2446,58,25,4,2801
2400902-008,4767,3582,2690,121,552,98,127,3,892
2400902-005,4083,3151,2571,105,269,81,97,3,580
2400902-002,4361,3289,2211,157,760,70,80,2,1078
2402115-002,4900,3939,3616,114,56,75,58,1,323
2402126-001,5111,3811,3056,265,273,83,129,5,755
2400111-000,1138,916,849,7,21,6,25,4,67
2400123-000,2734,2113,1784,58,194,51,27,1,329
2400106-001,1759,1428,1244,28,102,17,30,0,184
2400106-099,0,0,0,0,0,0,0,0,0
2400122-001,2348,1984,1669,44,198,46,34,1,315
2400122-002,119,100,95,1,0,0,0,0,5
2400104-002,1363,1008,867,16,84,28,2,1,141
2400104-005,1105,884,793,5,41,32,3,0,91
2400303-015,1933,1524,1379,35,26,28,31,3,145
2400304-004,2834,2192,1734,101,175,48,119,5,458
2400306-027,1484,1183,869,185,50,27,43,1,314
2400302-022,3740,3070,2412,179,328,86,61,2,658
2400302-008,3934,3135,2151,362,405,92,117,8,984
2400306-012,3330,2458,1387,225,752,42,76,3,1071
2402701-001,3725,2707,1589,137,490,40,456,12,1118
2402701-013,2121,1586,924,77,276,35,297,2,662
2400301-015,3157,2452,1591,224,467,53,121,10,861
2400301-016,3740,2798,1545,431,612,95,149,3,1253
2400301-013,2001,1459,864,199,330,55,48,2,595
2402701-015,9630,7260,1836,569,3021,103,1796,18,5424
2402701-021,4276,3108,1004,301,1078,69,730,7,2104
2402702-018,2847,2110,1506,79,146,19,338,2,604
2402706-030,2614,1885,481,388,728,50,302,0,1404
2402705-014,1146,934,588,83,161,21,95,5,346
2402702-004,3280,2370,879,143,675,25,659,7,1491
2400305-017,2865,2151,1881,89,76,41,69,10,270
2400301-001,2422,1966,1491,79,169,47,169,10,475
2403708-009,6432,4575,1668,607,1975,145,253,11,2907
2403708-011,4018,3024,1845,286,663,72,182,22,1179
2403708-006,1879,1483,1137,68,136,38,104,2,346
24037ZZZZZZ,0,0,0,0,0,0,0,0,0
2403701-002,2374,1897,1557,62,186,37,52,10,340
2403705-002,4042,3238,2599,85,411,95,46,6,639
2403706-003,4565,3449,2924,105,178,82,135,6,525
2403701-001,4021,3445,2675,158,424,81,119,12,770
2403703-002,3518,2590,1990,70,436,55,40,7,600
2403706-001,2116,1673,1470,29,105,38,25,0,203
2403709-001,265,209,176,3,19,3,7,0,33
2403708-002,2354,1830,1428,95,153,56,83,4,402
2403707-001,3300,2661,2196,33,346,53,23,5,465
2403702-001,3182,2469,2007,93,227,64,71,6,462
2403704-003,3553,2762,2227,51,382,48,32,5,535
2403708-001,5279,4006,1873,418,1417,111,253,4,2133
2403702-002,1957,1589,1315,58,115,14,64,12,274
2403703-004,2276,1834,1582,51,33,20,121,3,252
2402702-006,2883,2058,1008,84,233,23,707,7,1050
2402702-012,4040,3108,2074,142,226,42,637,2,1034
2402706-027,3300,2415,805,176,939,50,495,6,1610
2402702-010,2010,1447,751,23,71,11,567,2,696
2402706-001,3516,2737,1206,420,797,64,270,4,1531
2402701-006,4768,3485,1390,996,473,105,592,1,2095
2400129-002,1968,1609,1495,12,26,29,44,1,114
2400106-003,929,750,652,13,57,21,8,0,98
2400114-000,762,668,548,22,70,21,15,0,120
2400126-000,3909,3345,2454,77,594,37,140,3,891
2400118-000,2054,1623,1538,19,10,41,10,1,85
2402311-001,125,108,107,1,0,0,0,0,1
2400307-027,4121,3133,2490,188,272,34,143,1,643
2400303-022,2236,1810,1390,49,267,34,62,3,420
2400303-020,2254,1828,1610,54,50,32,75,1,218
2400307-023,3711,2864,2468,130,111,36,101,3,396
2400303-017,2602,2081,1881,52,52,43,36,4,200
2400302-013,2480,1948,1395,105,326,46,81,10,553
2400102-000,996,844,810,2,8,16,3,0,34
2400104-004,1887,1564,1413,22,85,19,11,2,151
2402703-005,6756,5050,2602,95,385,33,1950,4,2448
2402706-029,5871,4710,2133,251,1230,85,1057,9,2577
2402706-012,1062,832,451,96,228,35,57,3,381
2402705-016,2856,2382,1131,174,767,38,291,4,1251
2402706-033,2888,2244,958,274,727,68,228,1,1286
2402706-026,3396,2614,1416,144,780,24,249,0,1198
2400301-022,9724,7913,2921,747,2548,139,1721,21,4992
2400301-025,2036,1599,939,185,289,45,145,1,660
2400301-006,3728,3063,1167,280,1155,96,397,7,1896
2400307-017,1902,1439,1036,81,213,23,88,2,403
2400307-015,2853,2124,1705,103,168,23,124,5,419
2400307-026,2832,2075,1629,129,116,31,160,10,446
2400307-018,3133,2235,1570,110,313,33,205,4,665
2400306-004,1347,1104,482,230,332,13,57,0,622
2400306-001,3031,2612,2160,180,160,46,63,7,452
2400306-013,2202,1544,579,412,499,31,46,0,965
2400306-015,3353,2511,1019,929,427,80,112,2,1492
2400103-000,1042,843,807,0,10,16,4,1,36
2402703-004,352,252,161,5,8,3,74,0,91
2402703-006,2618,1965,1359,73,164,25,322,1,606
2402701-007,1606,1206,574,78,211,25,317,1,632
2402706-014,2067,1600,801,133,526,16,130,1,799
2402706-016,4008,2960,1133,420,1020,51,416,7,1827
2402704-003,2353,1853,1586,60,60,34,92,6,267
2402701-016,1236,915,455,128,149,31,172,2,460
2402701-002,856,613,430,24,62,3,96,0,183
2402701-014,2490,1897,1295,65,143,16,378,3,602
2402701-018,596,468,274,40,66,3,85,0,194
2402702-016,4255,3146,1708,109,286,22,1003,5,1438
2402706-004,2721,2116,1547,116,234,46,192,0,569
2402706-009,3181,2296,687,511,864,74,216,7,1609
2401503-003,7120,5411,3915,311,934,135,132,4,1496
2401503-004,980,744,625,36,46,29,6,0,119
2401502-002,2809,2214,2001,63,73,34,13,3,213
24015ZZZZZZ,0,0,0,0,0,0,0,0,0
2401503-005,2144,1725,1154,122,340,34,64,3,571
2401505-001,3806,2948,2530,115,169,94,34,7,418
2401505-006,982,767,638,34,41,18,29,1,129
2403308-001,1909,1584,809,92,633,53,22,6,775
2403313-003,2353,1776,17,248,1494,42,30,2,1759
2403313-008,3122,2132,58,588,1358,43,121,7,2074
2403310-006,6634,5200,735,806,3184,113,527,16,4465
2403310-001,3168,2554,342,463,1552,53,226,7,2212
2403310-014,2454,1640,74,277,1277,30,31,0,1566
2403317-007,7205,5686,245,2015,3410,161,119,13,5441
2403307-010,5267,4175,514,193,3320,52,199,1,3661
2403307-007,4987,3997,875,200,2666,87,255,7,3122
2403311-003,4380,3478,248,162,2971,66,97,7,3230
2403311-005,616,502,62,34,393,8,18,0,440
2403302-001,3903,2899,100,839,1957,63,30,0,2799
2403305-001,7066,5418,632,395,4009,128,380,13,4786
2403312-010,5860,4957,779,602,2994,75,607,13,4178
2403312-006,5506,4319,53,362,3878,80,50,5,4266
2400901-001,3839,3353,2772,92,356,42,81,11,581
2402107-006,8,3,2,0,0,0,1,0,1
2400106-006,1875,1502,1393,17,44,34,20,5,109
2400108-000,3232,2580,2477,27,27,32,13,0,103
2400116-000,3199,2850,1783,132,884,37,26,0,1067
2400129-001,2240,1845,1728,12,36,21,27,4,117
2403318-006,5185,3950,54,188,3710,35,25,4,3896
2403318-009,3146,2554,115,301,2118,31,63,5,2439
2403306-017,5327,4399,127,240,3988,66,62,4,4272
2403306-001,5014,4016,168,425,3403,64,34,9,3848
2403306-011,2924,2361,65,184,2095,40,19,1,2296
2403314-004,2776,2144,1123,240,628,36,122,2,1021
2403306-006,4965,4010,101,287,3593,55,61,3,3909
2403306-016,5668,4149,98,274,3750,79,48,5,4051
2403320-010,1418,1058,108,351,561,37,54,1,950
2403320-021,2430,1781,235,803,621,88,107,2,1546
2403321-009,1489,1339,417,114,482,26,326,0,922
2403312-013,4760,3769,58,251,3431,64,31,4,3711
2403309-010,3230,2585,242,326,1885,55,124,6,2343
2403311-004,7736,5876,756,352,4594,166,168,9,5120
2403311-001,3882,3080,428,228,2341,94,82,8,2652
2403314-011,2139,1950,346,73,1492,12,59,6,1604
2403314-016,585,516,55,23,429,7,15,1,461
2403310-002,6844,5249,1157,1173,2564,109,345,9,4092
2403310-005,4883,3866,2049,506,904,88,391,4,1817
2403310-013,7488,6030,1184,853,3260,98,729,14,4846
2403309-008,7049,5678,301,317,4927,90,170,15,5377
2403321-003,4248,3550,1681,288,1284,65,273,4,1869
2403307-006,3090,2509,594,205,1641,38,71,5,1915
2403306-005,3116,2254,63,172,1999,56,16,6,2191
2403316-004,6815,5136,583,2938,1443,327,189,10,4553
2403321-002,6040,5696,3967,392,494,74,823,4,1729
2403321-095,0,0,0,0,0,0,0,0,0
2403321-094,0,0,0,0,0,0,0,0,0
2403702-004,1082,773,610,24,84,11,44,0,163
2403708-004,5338,4067,2265,307,1067,137,335,14,1802
2401502-001,2842,2300,2083,114,30,35,15,2,217
2401505-003,6052,4776,4305,100,160,92,75,5,471
2401501-001,4787,3823,3367,187,153,81,34,5,456
2401503-002,2309,1823,1630,64,52,51,29,6,193
2401503-007,4377,3236,2147,278,646,93,90,2,1089
2400113-000,2082,1695,1637,5,13,33,6,1,58
2402309-001,1161,947,908,4,4,18,6,2,39
2403314-003,3036,2384,1241,236,744,45,138,7,1143
2403313-010,7183,6052,210,223,5545,96,141,8,5842
2403315-002,6036,4677,283,563,3711,84,119,3,4394
2403313-025,477,375,1,59,290,9,19,0,374
2403313-016,4156,3339,73,228,3014,50,59,4,3266
2403313-007,8624,6618,144,258,6156,88,79,7,6474
2403312-011,5529,4461,224,613,3373,105,263,13,4237
2403321-004,4848,3887,1003,934,1091,101,846,10,2884
2403301-008,1100,900,247,196,310,35,138,0,653
2403320-019,2676,2027,207,527,1214,67,93,1,1820
2403320-008,1443,1169,19,196,938,14,23,1,1150
2403320-014,550,406,21,207,168,9,17,0,385
2403320-002,1904,1492,186,434,828,21,54,0,1306
2403320-097,20,15,0,2,13,0,2,2,15
2403320-015,351,267,8,18,227,6,15,0,259
2403320-012,3710,2749,61,418,2203,55,50,3,2688
2403320-011,4032,2908,77,891,1882,69,69,2,2831
2403320-013,1528,1145,28,151,925,9,56,0,1117
2403316-003,7182,5658,2172,1271,1966,166,232,9,3486
2403319-099,0,0,0,0,0,0,0,0,0
2403307-008,3173,2431,535,164,1571,64,151,2,1896
2403321-006,3153,2601,1651,195,379,55,312,4,950
2403301-002,2775,2262,686,616,731,52,221,5,1576
2403310-012,8079,6544,1053,887,3588,149,1007,15,5491
2403316-002,1237,955,359,221,336,23,41,2,596
2403306-026,2558,2067,60,81,1934,21,7,1,2007
2403306-024,1317,1096,54,63,976,13,15,1,1042
2403306-012,3462,2651,52,102,2473,48,19,5,2599
2403306-009,3455,2730,84,228,2382,40,33,4,2646
2403307-016,2282,1892,546,170,1057,40,118,7,1346
2403507-001,2929,2338,1903,109,258,39,20,0,435
2403501-001,2601,1955,1563,244,106,43,12,6,392
2400301-008,3087,2453,1864,155,239,69,118,3,589
2403502-001,4795,3689,3043,152,355,66,46,4,646
2401901-001,1827,1469,1241,37,145,24,21,5,228
2401901-002,13,5,5,0,0,0,0,0,0
2401915-001,2487,1903,1524,68,262,36,17,3,379
2401915-003,1992,1519,595,54,827,34,17,0,924
2401907-011,57,48,36,1,9,0,3,0,12
2401907-005,307,251,97,7,147,0,0,0,154
2401913-001,242,193,180,6,3,4,2,2,13
2401907-010,364,261,101,1,146,0,13,0,160
2401909-001,637,538,472,17,31,8,9,4,66
2401907-006,3053,2589,2159,143,237,47,45,4,430
2401907-007,751,562,234,27,288,5,10,1,328
2401907-003,697,623,546,16,25,24,11,0,77
2404101-002,7441,6071,4428,698,737,106,135,6,1643
2404103-001,3160,2518,1887,117,434,28,43,2,631
24041ZZZZZZ,1,1,1,0,0,0,0,0,0
2451027-005,3090,2450,1003,59,1296,49,51,7,1447
2451027-018,3705,3329,1233,153,1127,61,815,8,2096
2451027-025,1516,1238,42,21,1159,17,16,1,1196
2451008-001,123,102,59,2,38,2,2,0,43
2400504-007,6651,5250,2476,486,1827,81,459,9,2774
2400504-010,3264,2576,1107,252,934,58,256,5,1469
2400509-019,3532,2816,1472,257,854,52,199,10,1344
2400509-015,3942,3225,1436,156,1201,69,389,3,1789
2400509-017,2239,1687,829,145,592,17,115,1,858
2400502-011,7575,5615,632,267,4523,91,201,11,4983
2400502-030,544,448,264,17,136,4,25,0,184
2400514-010,3421,2782,1426,183,798,55,323,2,1356
2400515-011,4944,3696,2152,326,986,127,119,3,1544
2403109-027,5026,3972,2768,288,255,19,598,5,1204
2403109-013,5175,3810,1901,403,379,44,1076,8,1909
2403106-013,2578,1978,1098,165,145,25,531,6,880
2403104-006,3914,3145,1350,1027,258,101,485,0,1795
2403104-001,6976,5452,1927,1589,992,156,944,10,3525
2403104-005,5602,4392,1632,935,477,85,1310,3,2760
2403109-001,10301,7745,1478,3197,1923,256,1127,19,6267
2403109-020,3490,2789,687,939,535,59,601,9,2102
2403109-032,1525,1038,137,502,283,42,119,6,901
2403113-018,4453,3229,1201,1071,709,136,268,5,2028
2403104-020,5100,3843,2550,203,136,25,864,1,1293
2403104-042,18,14,6,1,1,0,7,0,8
2403104-029,1907,1472,371,49,119,6,913,1,1101
2403104-016,6363,5016,2637,417,528,47,1391,7,2379
2403104-023,364,297,126,11,29,0,126,0,171
2403109-002,10042,7706,1724,3085,1700,193,1192,25,5982
2403109-010,1433,1217,490,186,213,22,315,3,727
2403109-038,481,430,351,31,14,6,24,2,79
2403109-036,3755,2897,803,746,580,75,745,4,2094
2403109-016,8088,5751,733,2212,1242,138,1571,5,5018
2403109-015,5788,4626,1072,1311,1389,144,859,11,3554
2403109-028,1319,1286,1118,53,67,13,49,11,168
2403107-008,6657,5849,3762,530,456,59,1022,3,2087
2403105-003,6863,5383,1334,1464,1830,126,790,5,4049
2403105-013,9854,7003,420,1552,4659,136,447,9,6583
2403105-005,4401,3448,962,636,1494,75,350,6,2486
2403104-036,4,2,0,2,0,0,0,0,2
2403104-034,2412,1914,1221,212,144,30,284,4,693
2403104-041,0,0,0,0,0,0,0,0,0
2403106-015,5978,4418,1218,315,579,55,2267,7,3200
2403106-007,6219,4802,1733,507,917,42,1619,12,3069
2403106-011,124,98,60,4,22,3,13,0,38
2403106-003,3115,2410,1493,206,167,36,510,5,917
2403106-005,4890,3693,2285,222,296,18,844,4,1408
2403106-016,3,3,3,0,0,0,0,0,0
2403109-003,5154,3757,913,1239,756,95,807,9,2844
2403102-003,6629,5111,1526,1079,1673,124,838,12,3585
2403102-001,7554,5847,1679,650,1281,82,2196,20,4168
2403102-008,9447,6929,2361,901,1505,81,2166,6,4568
2403102-005,5187,4155,1942,832,936,70,431,4,2213
2403102-004,8189,6348,2056,1126,1951,122,1171,8,4292
2403113-002,9468,7234,1740,1427,2560,129,1528,15,5494
2403113-030,5916,4536,658,2848,596,192,446,16,3878
2403113-029,5488,4235,972,1931,711,167,642,7,3263
2403113-027,4606,3630,1471,1110,511,65,518,4,2159
2400509-010,9023,7982,4791,415,1913,81,853,12,3191
2400509-026,2218,1761,1136,157,349,41,130,3,625
2400514-008,5013,3755,1019,136,2510,71,65,5,2736
2400514-009,7124,5535,1468,559,2931,76,547,7,4067
2400509-006,3785,3365,1649,214,1279,32,234,5,1716
2400509-005,4581,3757,3066,124,289,42,231,3,691
2400515-018,3629,2839,1777,183,736,77,47,14,1062
2400513-006,1813,1348,839,144,242,33,98,2,509
2400508-013,3609,2805,2173,150,110,34,334,2,632
2400503-007,7063,4428,3546,158,336,28,305,2,882
2400514-012,2774,2261,1764,102,192,72,96,2,497
2400501-004,5738,4608,1147,306,1902,55,1238,3,3461
2400501-003,4645,3801,1190,160,1387,56,1041,3,2611
2400501-010,4202,3247,2364,189,447,52,194,11,883
2451026-024,3068,2446,139,45,2211,24,56,2,2307
2451027-026,1478,1285,238,36,963,6,40,0,1047
2451013-007,1585,1261,59,27,1175,26,11,1,1202
2451015-002,1318,1020,61,21,926,11,9,2,959
2451027-067,3991,2961,797,598,1471,48,58,1,2164
2451011-002,760,723,232,59,314,21,120,1,491
2451012-012,2293,1999,706,127,1060,57,98,1,1293
2451027-013,4573,3505,698,148,2563,56,69,10,2807
2401917-001,206,166,99,15,40,8,5,0,67
2401917-002,45,35,33,0,2,0,0,0,2
2401904-001,208,184,171,1,5,5,2,0,13
2401905-001,263,217,191,0,12,9,5,0,26
2400303-021,3662,2758,2245,101,251,44,90,0,513
2403113-067,2451,1822,949,280,488,38,93,1,873
2403110-005,3212,2415,1470,126,96,12,686,1,945
2403102-002,6818,4889,1674,743,1168,109,1293,5,3215
2403104-017,4835,4227,2698,338,449,23,685,7,1529
2403104-010,4460,3689,2247,416,349,32,576,18,1442
2403108-012,4195,3124,1806,221,492,39,572,5,1318
2403109-025,3313,2615,741,440,493,42,914,3,1874
2403113-003,2840,2258,1731,177,205,38,110,8,527
2400503-001,4595,3791,365,123,3245,74,62,22,3426
2400515-016,4072,3149,2099,249,629,87,94,7,1050
2400501-001,6233,4831,662,426,3478,110,226,6,4169
2400501-005,5880,4683,1020,555,2471,87,609,10,3663
2400511-003,5021,4150,3827,110,61,44,62,12,323
2400515-022,4542,3611,3247,65,110,116,46,4,364
2400513-003,4153,3254,2472,140,326,79,239,4,782
2400515-019,4541,3841,3265,81,369,56,52,2,576
2451027-064,2604,1832,1223,63,400,13,81,0,609
2451027-063,2614,1879,799,52,934,21,60,5,1080
2403113-058,6207,4773,2180,1108,949,132,493,13,2593
2403104-002,4717,3772,2197,317,412,40,809,5,1575
2403104-003,6511,5325,3063,506,594,69,1093,13,2262
2403113-059,2950,2336,1011,402,662,42,260,2,1325
2400301-017,2537,1852,1133,221,385,49,68,6,719
2402307-001,2403,1946,1863,22,16,18,9,3,83
2402314-001,2838,2385,2290,18,25,25,21,10,95
2402306-001,2298,1923,1702,43,112,37,29,6,221
2403107-028,2569,1879,1292,151,73,18,333,2,587
2403110-003,3419,2562,1681,168,138,22,530,5,881
2403107-012,3856,2792,2153,196,74,37,325,4,639
2404707-001,6918,6271,5557,295,163,91,139,2,714
24047ZZZZZZ,0,0,0,0,0,0,0,0,0
2404704-001,3235,2603,2218,62,257,41,28,1,385
2404704-003,588,477,409,23,20,8,11,2,68
2404702-002,1967,1584,680,72,793,20,15,1,904
2404702-005,2961,2138,1171,146,765,26,26,0,967
2404701-001,6053,4663,2720,144,1614,120,94,5,1943
2400301-018,4257,3504,1816,295,1159,80,192,6,1688
2400301-009,2737,2189,1640,128,242,36,137,7,549
2403103-002,3304,2448,1812,226,157,40,189,3,636
2403103-001,3892,2942,2269,229,185,53,171,3,673
2403113-006,3356,2625,1716,214,529,44,122,6,909
2403105-023,8319,6199,817,684,3562,98,1209,14,5382
2403105-018,2398,1934,987,277,293,52,330,8,947
2403113-036,5871,4437,718,2342,528,171,837,16,3719
2403113-025,6694,5085,914,2184,1295,146,660,8,4171
2403113-034,3224,2330,1535,340,215,49,217,7,795
2403107-002,2588,1880,1717,61,28,9,52,3,163
2403107-026,6617,5980,4019,577,419,28,854,5,1961
2403109-031,5470,4760,2378,440,831,71,1050,16,2382
2403111-000,2352,1914,1484,188,132,28,84,2,430
2403112-001,3241,2490,1787,328,179,72,129,7,703
2403105-011,3730,2994,789,621,1073,75,484,5,2205
2403105-008,4314,3388,900,617,1302,59,595,5,2488
2400303-019,2706,2107,1877,52,51,50,50,5,230
2400302-021,4297,3400,2309,191,497,59,339,3,1091
2400302-009,3938,3024,1243,340,1043,84,364,4,1781
2400302-016,2162,1781,1254,195,190,36,116,11,527
2400303-005,4598,3603,2614,168,558,71,176,6,989
2400306-010,2311,2066,1531,148,265,29,90,5,535
2400306-026,3751,3254,2730,119,199,52,123,5,524
2400306-003,2965,2309,516,812,893,59,73,1,1793
2404701-002,1098,906,789,12,80,11,10,1,117
2404702-001,824,569,242,5,286,16,18,0,327
2404706-003,2319,1947,1788,36,51,21,43,1,159
2404704-004,2036,1651,1297,53,240,41,22,1,354
2404706-002,1782,1398,1255,55,47,18,32,0,143
2404104-001,4075,3265,2828,89,239,65,23,7,437
2400307-019,1887,1438,1234,63,37,43,51,0,204
2400307-005,5300,4175,3346,480,131,105,101,4,829
2400303-011,2717,2220,2053,24,22,47,39,2,167
2400303-018,3605,2808,2303,126,192,68,114,2,505
2400303-010,2957,2297,2062,83,51,48,39,4,235
2400306-017,2839,2495,1632,345,413,35,92,6,863
2400306-006,3071,1982,352,823,749,44,61,8,1630
2401305-006,670,601,554,14,18,7,9,1,47
2401311-001,3702,2953,2702,52,82,66,31,2,251
2401309-001,4957,3978,3627,84,100,58,61,3,351
2401306-002,6622,5192,4686,142,135,109,91,12,506
2401302-002,2219,1758,1657,32,15,23,23,0,101
2401307-002,4955,3918,3190,351,169,93,101,7,728
2401309-002,2551,2069,1898,58,28,35,26,7,171
2400512-001,4054,3049,1835,778,266,137,82,4,1214
2400512-003,5598,4318,2870,723,441,134,196,3,1448
2400501-007,3364,2594,1015,114,1090,42,353,6,1579
2401509-002,2333,1803,1660,38,33,40,18,4,143
2400306-024,2115,1752,1209,79,395,12,46,0,543
2400306-023,2036,1606,1393,88,70,15,34,3,213
2401305-004,11042,8643,6888,318,797,116,483,8,1755
2401305-003,3642,2777,2432,54,96,58,120,2,345
2401314-002,7586,6006,5328,223,164,112,143,3,678
2401314-003,1299,1018,901,27,22,22,35,0,117
2401306-001,8004,6207,5697,147,167,75,88,2,510
2404706-001,3976,3474,3237,51,66,27,76,0,237
2401910-001,272,243,229,5,4,6,1,0,14
2401503-001,7023,5357,3608,367,1094,112,203,12,1749
2401508-001,3973,3165,2896,55,38,99,34,4,269
2401916-001,516,402,375,7,13,4,6,2,27
2401907-004,938,759,382,14,347,7,10,1,377
2401918-001,55,52,46,0,2,2,0,1,6
2401906-001,423,361,332,20,3,9,0,1,29
2403504-002,7338,5977,5148,239,320,110,144,10,829
2404101-005,4050,3306,2673,224,292,68,58,2,633
2404101-003,4680,3489,2146,462,718,53,124,8,1343
2403504-003,5608,4387,3942,121,137,64,111,3,445
2403504-001,3599,2777,2494,71,91,49,52,4,283
2400301-020,3073,2530,1035,256,894,53,332,7,1495
2400307-021,3122,2511,2083,87,259,50,36,3,428
2400307-009,4753,3554,2060,680,650,130,56,6,1494
2404702-004,766,657,282,41,320,8,9,0,375
2404703-002,2353,1976,1803,60,50,22,34,1,173
2404703-001,4188,3474,3151,96,96,54,62,1,323
2403505-001,2484,1985,1644,127,140,27,36,2,341
2403504-006,2901,2356,2166,48,35,38,56,2,190
2400301-014,2975,2319,1527,288,374,61,89,6,792
2404304-001,3062,2431,2299,34,22,43,28,4,132
2404306-001,2683,2194,1994,61,32,51,35,0,200
2404306-002,3799,2858,2516,117,104,55,48,0,342
2404319-001,2568,1968,1828,28,33,46,21,3,140
2404308-001,2486,1962,1801,44,30,48,21,1,161
2404325-001,1592,1161,442,108,564,41,18,3,719
2404320-001,2112,1739,1651,28,20,21,14,0,88
2400306-008,2393,2000,1478,253,186,43,37,1,522
2400303-008,4174,3324,2036,317,748,93,158,10,1288
2400307-006,4224,3303,2897,161,92,70,88,2,406
2400307-010,3138,2402,2137,86,56,54,59,4,265
2400304-024,3892,3024,925,288,1600,74,235,8,2099
2400301-026,6724,4510,859,554,2882,101,263,4,3651
2400304-026,1689,1453,707,112,464,21,154,11,746
2400304-007,10286,7062,3241,1005,2278,206,497,55,3821
2400304-012,2857,2248,1391,166,449,48,187,15,857
2400304-020,2837,2271,1466,119,474,34,200,8,805
2404516-003,2127,1649,1210,84,268,37,57,3,439
2404516-004,1474,1133,611,110,370,16,19,0,522
2404516-001,504,410,327,12,58,8,2,0,83
2404517-001,1526,1263,977,17,215,33,20,1,286
2403901-002,2691,2180,1066,79,981,36,23,0,1114
2403901-001,1246,937,485,35,386,30,13,2,452
2403901-003,934,689,226,12,419,12,22,2,463
2404501-003,1212,892,809,15,49,16,6,0,83
2404501-002,1324,1000,814,21,140,9,18,1,186
2402303-002,756,617,592,7,2,6,2,0,25
2402303-001,2691,2170,2104,9,12,18,6,2,66
2403109-037,3389,2637,656,807,609,56,567,9,1981
2403109-039,66,52,10,17,14,1,7,7,42
2403106-010,5624,4346,1274,1080,1272,119,700,4,3072
2403107-004,6665,5690,3934,513,422,43,730,8,1756
2403107-011,4597,3586,2614,329,205,33,372,5,972
2403104-031,4662,3949,2390,391,378,40,725,3,1559
2403113-044,7422,5445,1169,2219,1361,144,734,7,4276
2403113-032,6538,5309,1306,1406,1933,140,669,5,4003
2403107-016,2800,2163,1468,212,252,33,211,5,695
2403107-009,4664,3683,2377,426,328,36,510,18,1306
2403113-039,3079,2363,1525,260,342,18,184,6,838
2403105-022,2047,1674,810,260,355,27,252,2,864
2403107-023,5760,4272,3013,322,188,29,720,4,1259
2403109-024,4549,3278,814,833,788,81,823,6,2464
2403109-029,4099,3168,1034,771,915,96,418,9,2134
2403107-032,1958,1637,1268,80,181,9,89,0,369
2403107-003,4023,3070,2179,206,132,16,496,5,891
2403107-022,3117,2265,1669,166,96,16,279,3,596
2403110-007,3831,2857,1953,172,168,9,532,9,904
2403101-003,6107,4669,1640,1165,1271,81,577,12,3029
2404705-002,4073,3444,3164,82,70,50,45,2,280
24039ZZZZZZ,0,0,0,0,0,0,0,0,0
2403910-002,36,31,31,0,0,0,0,0,0
2403912-001,769,628,539,7,55,23,7,0,89
2403908-001,1697,1383,1175,45,121,29,14,1,208
2403911-001,142,127,112,1,10,4,1,0,15
2403906-001,553,465,362,11,81,9,2,0,103
2404511-004,4255,3215,2015,180,735,79,197,11,1200
2404511-003,465,386,274,18,82,7,7,1,112
2404326-001,4026,3054,2318,402,205,47,59,0,736
2404326-004,3179,2483,2201,81,121,38,46,2,282
2404303-003,2981,2077,1438,167,376,70,32,2,639
2404302-001,5091,3998,3541,100,186,70,91,2,457
2404314-002,1265,995,911,24,27,20,13,0,84
2402305-001,1934,1524,1449,14,12,28,5,0,75
2402304-001,725,587,564,3,7,9,4,0,23
2401307-004,10605,8452,6536,467,977,145,334,17,1916
2401304-001,8180,6472,5757,151,227,120,172,6,715
2401308-002,4784,3641,3282,96,81,90,59,2,359
2401308-001,6278,4942,4454,166,101,80,111,2,488
2401305-002,6531,4931,4300,140,227,73,192,2,631
2403904-001,1051,874,651,16,149,25,34,0,223
2402316-001,3391,2655,2548,27,22,36,17,6,107
2403107-007,2833,2039,1578,162,79,20,194,3,461
2451027-015,2965,2308,284,53,1919,45,27,3,2024
2451027-014,3309,2696,1199,104,1326,64,32,2,1497
2451006-001,2448,1763,175,605,928,57,51,3,1588
2451002-001,1630,1403,735,273,250,31,132,0,668
2451015-016,889,680,6,2,674,2,0,0,674
2451015-011,1798,1416,63,27,1312,15,5,0,1353
2400509-003,5028,3678,2998,195,225,42,241,3,680
2400504-014,8629,6590,1581,1336,3341,154,348,9,5009
2400510-003,1944,1491,1317,60,32,19,55,1,174
2400503-004,2424,1950,694,143,980,50,92,5,1256
2400501-015,4942,3857,2324,172,757,47,560,2,1533
2400513-001,5692,4284,1725,196,899,89,1390,7,2559
2400513-002,2816,2214,1649,46,179,26,294,1,565
2400501-006,5190,4080,470,155,3370,50,76,7,3610
2400508-002,2558,2384,2087,44,65,6,178,0,297
2400508-027,1779,1424,1152,32,63,5,163,2,272
2400511-001,2110,1719,1582,31,33,15,43,3,137
2400511-023,1089,859,775,15,9,5,43,1,84
2400515-004,6491,4718,2115,419,1887,121,230,3,2603
2400515-005,11576,8383,3610,751,3386,225,556,10,4773
2403108-005,3413,2590,2058,200,154,31,145,3,532
2403108-014,72,46,14,16,10,3,3,1,32
2403108-001,4873,3667,2285,375,461,60,479,5,1382
2403108-009,4656,3545,2158,455,460,48,442,6,1387
2403104-004,3695,3126,1827,337,366,37,556,3,1299
2403104-008,6217,5069,3000,447,470,75,1066,6,2069
2403102-011,6392,4285,1136,446,835,54,1859,12,3149
2403102-010,3046,2075,621,245,493,25,740,1,1454
2403102-006,10114,6859,2018,714,1271,72,2834,14,4841
2403107-006,2997,2250,1843,134,48,28,160,5,407
2403107-021,1627,1137,972,47,25,12,65,2,165
2403110-006,3184,2394,1481,137,114,10,636,1,913
2403104-011,1092,966,656,60,86,1,160,0,310
2403113-035,5352,4114,740,2062,535,112,748,4,3374
2403105-002,5855,4555,626,542,2925,65,512,10,3929
2403109-040,4931,4091,1840,450,579,59,1214,1,2251
2403109-033,4721,4133,1874,485,986,64,771,13,2259
2403106-014,2292,1668,536,88,146,6,898,5,1132
2403109-006,6128,4914,2011,864,711,56,1275,13,2903
2403113-043,4315,3294,769,1599,305,144,584,5,2525
2403113-047,7019,6269,2360,674,2623,90,638,5,3909
2403105-009,5033,4071,1475,427,1237,53,899,6,2596
2403107-024,3341,2564,2074,212,59,20,166,0,490
2403104-033,1163,1002,375,187,178,11,240,0,627
2403105-016,4195,3340,1385,365,944,42,610,8,1955
2403113-061,7744,6106,1773,1102,2264,116,964,5,4333
2403113-060,74,43,19,10,4,0,9,0,24
2401701-003,4757,3648,2224,159,1019,89,184,13,1424
2401701-002,3351,2654,1859,99,556,74,72,7,795
2401701-004,3380,2651,1959,123,423,78,87,4,692
2401706-006,4789,3682,1235,404,1857,111,157,16,2447
2401706-019,3332,2563,823,140,1406,54,196,5,1740
2403107-020,3572,2637,1602,301,212,30,477,7,1035
2404301-001,3109,2506,2355,48,20,36,15,5,151
2451026-003,2839,2121,885,854,333,62,43,1,1236
2451027-031,2935,2286,95,52,2101,27,38,1,2191
2401108-001,2030,1624,1415,10,157,21,12,6,209
2401907-001,1339,1122,782,92,194,27,24,1,340
2401907-009,1878,1468,742,123,523,31,59,5,726
2401907-008,80,56,50,1,2,1,2,0,6
2404504-003,2491,1937,1630,92,115,51,40,1,307
2404504-002,858,697,596,31,40,13,14,0,101
2404504-001,380,308,276,0,13,8,6,1,32
2404513-004,3925,3250,1752,344,945,61,166,19,1498
2404513-003,6045,5180,3806,232,845,92,209,10,1374
2402503-010,4416,3641,2903,347,227,80,98,5,738
2402503-013,3881,3044,2789,56,104,36,44,5,255
2402504-001,2572,2051,1884,40,42,46,19,2,167
2402504-007,1517,1159,1098,14,25,3,10,1,61
2402506-006,5849,4659,3183,211,960,84,239,5,1476
2402506-003,3085,2540,1864,106,457,57,42,9,676
2402506-007,498,391,354,13,14,12,1,0,37
2402503-007,4041,3223,2820,81,125,38,144,1,403
2402503-006,4049,3155,2886,71,60,58,63,1,269
2402503-003,4857,3693,3409,70,62,62,65,1,284
2402504-006,2656,2153,2012,38,32,34,26,1,141
2402504-003,3644,2848,2656,42,27,65,25,6,192
2400509-007,2984,2257,1798,76,82,25,277,1,459
2451019-002,3275,2441,669,298,1384,69,58,2,1772
2451019-003,288,248,35,6,207,3,0,0,213
2451026-008,1946,1811,1408,71,125,18,183,1,403
2451026-009,3701,3280,2661,243,155,47,182,5,619
2451027-017,1471,1189,331,35,793,14,29,2,858
2451009-006,2133,1763,108,46,1592,16,20,2,1655
2451009-014,1660,1274,57,21,1183,16,9,1,1217
2451009-007,2048,1585,148,46,1375,29,16,3,1437
2451028-006,3088,2450,60,73,2278,37,16,6,2390
2401710-001,3708,2965,1394,112,1305,107,78,10,1571
24017ZZZZZZ,0,0,0,0,0,0,0,0,0
2401705-001,4275,3343,2568,88,510,79,66,15,775
2401704-001,3673,2729,2202,78,327,64,49,3,527
2401707-001,2146,1704,1108,174,336,55,73,7,596
2401707-002,3881,2855,789,134,1789,114,108,7,2066
2401703-001,3114,2467,1542,62,749,76,35,7,925
2401702-001,1974,1607,1148,50,317,69,26,3,459
2401708-002,2659,2119,963,149,860,103,72,10,1156
2402501-014,5302,4128,3455,179,209,46,216,8,673
2400514-005,1550,1173,337,47,608,20,152,1,836
2400504-009,2473,2027,1685,96,166,39,43,4,342
2400504-011,656,505,410,30,49,5,11,0,95
2400508-014,2041,1607,1310,74,74,24,126,0,297
2400508-016,1427,1094,853,39,98,17,89,0,241
2400509-002,2198,1667,1491,51,53,12,56,2,176
2451027-050,1414,1126,661,47,363,14,39,0,465
2451025-015,2375,1760,564,194,958,53,26,2,1196
2451025-012,2973,2058,770,585,626,71,45,1,1288
2451008-004,504,366,5,1,344,6,4,0,361
2451025-009,1673,1031,11,10,1011,15,6,6,1020
2451027-049,3929,3020,2213,99,467,35,164,1,807
2451027-008,3555,2823,931,97,1693,58,52,4,1892
2402501-001,5692,3855,1303,325,2097,88,108,12,2552
2402503-015,3738,2823,2253,87,290,24,163,6,570
2404509-007,2346,1801,944,109,679,41,61,1,857
2402501-019,4107,3135,1311,157,1511,81,95,8,1824
2400515-001,3457,2506,1296,837,257,104,63,9,1210
2402902-001,1826,1485,1177,130,144,24,3,1,308
2402903-001,1989,1625,1258,46,293,30,9,2,367
2402906-001,1661,1388,1078,24,241,37,8,7,310
2402905-001,2395,2003,1747,37,180,24,15,4,256
2400502-008,3368,2803,224,81,2416,41,88,4,2579
2400502-025,728,713,530,4,169,0,9,0,183
2451025-004,4275,3347,1862,438,841,87,144,5,1485
2451025-003,2905,2376,1521,144,585,48,87,3,855
2451025-018,532,469,155,15,283,5,9,2,314
2451025-017,669,583,209,40,319,13,21,0,374
2451028-002,2754,2328,68,66,2159,56,23,3,2260
2451012-009,2363,2123,1203,170,535,34,178,3,920
2451025-011,1514,1074,366,437,194,26,63,1,708
2451002-002,2439,2142,1448,340,151,51,173,3,694
2451027-065,4681,3472,2210,96,980,21,124,1,1262
2402901-001,1561,1233,901,124,169,27,22,5,332
2401706-014,6378,4783,1159,256,3100,146,261,7,3624
2401706-002,7372,5857,2038,294,3227,151,244,13,3819
2401701-001,4797,3615,1806,148,1410,84,205,9,1809
2401706-018,3893,2864,240,135,2290,52,209,2,2624
2401706-003,3909,2725,405,172,1924,62,245,8,2320
2401706-015,5710,4273,642,321,3034,112,284,6,3631
2400503-002,4360,3452,1028,367,1921,58,137,9,2424
2400502-026,3197,2584,854,110,1439,41,175,1,1730
2400511-022,5885,4564,3160,123,480,46,740,1,1404
2400514-013,4449,3574,1349,278,1568,50,358,2,2225
2400515-007,4891,3836,2534,198,959,101,60,9,1302
2400515-014,1493,1148,833,109,139,31,34,1,315
2400512-002,4835,3534,2369,471,473,134,95,1,1165
2404324-001,1130,980,754,39,154,22,10,4,226
2404303-004,2784,1884,1091,205,520,54,39,4,793
2404325-004,3694,2699,1624,242,655,67,129,4,1075
2451008-006,2809,2179,47,55,2074,31,22,3,2132
2404313-002,2613,1998,1558,116,230,36,64,6,440
2404317-001,7602,5905,4073,506,1059,145,161,10,1832
2404310-005,74,48,31,6,9,1,5,0,17
2404310-001,6894,6113,3379,393,2197,70,85,3,2734
2404312-001,5136,4605,2542,220,1739,66,33,6,2063
2404305-001,3308,2677,2543,15,24,59,30,4,134
2400511-010,4809,3862,2172,161,889,58,573,5,1690
2400511-012,4985,3973,2730,124,642,45,410,5,1243
2402502-011,3576,2959,1854,148,716,70,168,14,1105
2402502-004,277,220,186,7,12,11,4,1,34
2402502-006,0,0,0,0,0,0,0,0,0
2402502-022,138,103,68,13,14,10,5,0,35
2402502-007,293,202,75,9,107,3,9,2,127
2402502-002,4320,3617,3184,81,190,78,71,2,433
2402502-005,834,679,584,31,40,17,3,4,95
2400506-001,2619,2064,1910,37,34,29,26,0,154
2400508-018,1200,939,785,27,23,2,100,0,154
2400508-017,2477,1929,1683,39,81,12,102,1,246
2400508-028,574,414,351,15,12,9,29,1,63
2451028-011,2283,1850,179,45,1617,29,10,0,1671
2451028-012,2050,1708,321,52,1267,30,56,1,1387
2451028-015,2603,2073,621,100,1300,45,42,2,1452
2451026-015,2473,1836,74,52,1690,38,31,2,1762
2451027-045,4974,4533,2471,374,469,32,1241,1,2062
2451023-003,2709,2534,2075,113,175,26,136,2,459
2451021-002,1916,1654,558,104,810,30,176,9,1096
2402502-015,3257,2572,1436,159,814,88,105,12,1136
2402502-003,2639,2084,1387,112,501,64,38,9,697
2402502-001,1533,1136,490,72,456,23,102,12,646
2402502-014,4116,2867,1474,279,1024,80,62,19,1393
2400502-016,2007,1630,191,76,1328,35,52,0,1439
2400508-022,2790,2249,1865,48,48,15,250,4,384
2402506-001,3121,2647,1935,174,415,66,64,4,712
24025ZZZZZZ,0,0,0,0,0,0,0,0,0
2404307-001,3290,2640,2417,89,45,53,22,5,223
2404323-001,5187,4042,3688,124,104,74,34,5,354
2404310-003,2029,1645,1211,135,172,38,78,3,434
2400504-004,5195,3999,2444,189,997,46,321,1,1555
2400511-006,2518,2048,1739,42,85,37,126,1,309
2400511-007,5347,4223,2989,132,475,51,561,3,1234
2400515-020,6302,4913,3763,307,501,201,111,1,1150
2451026-014,2365,1651,644,780,204,38,31,3,1007
2451012-008,2146,1948,998,168,608,42,156,4,950
2451009-004,2381,2048,530,58,1372,34,72,3,1518
2451009-009,1142,860,106,39,690,20,10,2,754
2451026-002,3568,2544,606,983,887,106,56,2,1938
2451010-001,1219,958,18,24,918,9,6,1,940
2451027-062,3039,2337,1061,140,1054,24,38,1,1276
2451027-061,1067,830,140,35,623,12,19,3,690
2400508-003,2188,1789,1457,74,85,11,160,0,332
2400508-026,32,20,14,0,4,0,0,0,6
2400514-003,5178,4028,2025,187,1333,76,409,4,2003
2404315-001,2058,1617,1522,25,18,38,10,1,95
2401307-003,5146,4073,3170,316,395,83,130,5,903
2401307-001,2876,2365,1972,158,125,47,58,5,393
2404322-002,3602,2685,1700,227,617,63,112,6,985
2404318-002,3275,2651,2236,142,183,54,45,5,415
2402315-001,541,434,425,0,0,6,3,2,9
2402301-001,1844,1487,1450,6,6,12,11,2,37
2400515-025,5486,4489,2932,156,1002,90,305,1,1557
2451013-010,1898,1581,274,37,1217,29,53,2,1307
2451025-016,2794,2104,1099,271,648,67,55,1,1005
2451020-001,1791,1393,27,8,1352,13,7,1,1366
2404322-001,3889,2838,1782,254,707,109,44,3,1056
2401307-008,2373,1890,1707,41,73,33,35,2,183
2401105-001,5003,3722,2355,124,1110,79,62,8,1367
2401101-001,3359,2399,1427,818,93,89,31,6,972
2401102-001,5485,4171,3446,239,307,116,44,5,725
2401107-001,3807,2948,2256,160,421,48,42,6,692
2402308-002,882,693,671,3,3,11,2,0,22
2400511-014,3809,2980,2282,88,178,44,378,1,698
2400507-003,3332,2559,2259,64,96,41,66,0,300
2400507-001,4046,3209,2904,78,68,57,72,4,305
2451028-010,2587,2108,214,36,1812,44,31,1,1894
2451025-002,2842,2156,131,61,1938,31,25,2,2025
2451027-021,3199,2593,136,43,2357,33,49,4,2457
2451027-042,2120,1674,1291,51,241,4,75,2,383
2401307-006,3533,2780,2388,100,113,44,118,0,392
2404102-003,1510,1322,1124,55,121,11,11,4,198
2451027-003,804,643,277,25,318,10,16,2,366
2451001-002,2482,2174,1646,210,141,44,152,1,528
2400515-002,4010,3252,2314,319,399,90,122,0,938
2400501-009,4204,3240,1378,319,1020,68,477,13,1862
2400503-013,2709,2183,1833,57,122,34,124,4,350
2400511-008,2587,2077,1573,67,230,37,168,3,504
2400511-018,912,704,539,29,60,10,68,0,165
2400511-015,2199,2150,2037,50,27,8,34,0,113
2400511-017,4597,3555,2396,91,513,53,488,2,1159
2400509-011,3942,3427,2027,215,818,33,340,4,1400
2400509-022,5534,4308,2584,239,1264,63,182,0,1724
2400511-025,6,1,0,0,1,0,0,0,1
2400511-004,4179,2949,1815,120,433,50,550,4,1134
2400511-024,544,444,386,15,24,15,10,0,58
2400511-027,19,15,8,2,5,1,2,0,7
2451015-017,1750,1366,13,9,1338,19,6,0,1353
2451015-025,1004,866,78,34,757,13,5,2,788
2451004-001,2618,2517,1056,182,759,48,500,2,1461
2451004-002,4968,4681,1671,323,1744,59,960,6,3010
2451021-001,1148,1053,610,56,201,10,173,0,443
2451021-005,11,10,6,4,0,0,0,0,4
2451012-011,1387,1136,243,54,801,21,58,0,893
2451013-003,2694,2372,1944,114,139,52,119,0,428
2451018-002,2286,1853,430,118,1207,35,88,3,1423
2451027-047,1785,1544,887,86,320,34,217,2,657
2451027-006,4138,3240,607,116,2461,42,42,6,2633
2402103-003,3211,2300,1923,126,105,43,112,7,377
2403302-008,8990,6562,235,2562,3658,248,176,16,6327
2403307-004,2717,2160,1249,204,576,44,117,0,911
2403305-005,4552,3681,418,351,2645,73,279,2,3263
2403312-005,4470,3566,254,689,2225,74,401,5,3312
2403306-013,3498,2795,240,361,2124,73,73,10,2555
2403305-007,4373,3664,423,382,2503,112,362,5,3241
2403311-002,3866,3061,378,127,2499,46,73,7,2683
2403302-004,3523,2503,242,1305,924,137,46,8,2261
2403306-004,5576,4231,109,294,3789,56,43,7,4122
2403309-003,3002,2162,1008,305,668,83,172,15,1154
2403309-014,16,12,0,0,10,0,2,0,12
2403306-027,2191,1648,203,288,1127,45,33,9,1445
2403319-005,4,4,0,0,1,0,3,0,4
2403312-008,2857,2318,127,439,1683,55,92,4,2191
2400303-012,2796,2262,2034,57,41,60,41,3,228
2400304-013,2356,1856,1440,95,181,45,97,2,416
2400301-011,1542,1198,1002,37,62,18,60,0,196
2400301-007,2329,1844,1438,125,126,52,99,6,406
2400301-002,2512,2014,1584,95,143,52,131,5,430
2400305-004,2874,2168,1805,128,78,42,92,3,363
2400306-009,2129,1748,1516,76,54,17,60,2,232
2400301-012,5805,4175,1456,512,1767,119,377,8,2719
2402705-013,1486,1152,703,144,195,17,107,2,449
2403705-003,3545,2749,2425,48,122,81,41,7,324
2403703-006,2731,1875,1403,90,167,20,193,5,472
2403703-005,3373,2384,1886,102,234,46,103,4,498
2403703-001,4581,3280,2436,150,457,81,159,15,844
2403703-003,2521,1925,1676,72,86,21,53,3,249
2403704-001,4203,3106,2599,82,281,74,48,2,507
2403706-004,3199,2376,1923,52,321,46,36,0,453
2400131-000,1603,1287,1203,13,8,38,8,0,84
2400110-000,1868,1478,1438,11,5,13,0,0,40
2402705-010,4368,3171,1463,86,230,22,1374,5,1708
2402706-035,6111,4448,1428,241,1403,63,1329,6,3020
2400121-000,1121,911,878,4,10,9,5,1,33
2403708-005,3774,2722,2059,175,248,85,160,15,663
2403708-008,1198,1053,812,43,132,13,63,2,241
2404704-002,1102,849,763,20,25,17,17,0,86
2402904-002,2200,1830,1122,129,497,38,46,1,708
2402907-001,1124,1006,791,21,176,12,6,0,215
2402904-001,3783,3376,2555,145,504,44,142,14,821
2402901-002,1992,1655,1448,85,61,26,25,3,207
2451028-008,2096,1658,72,38,1547,26,13,1,1586
2451027-039,1001,784,639,33,73,7,39,0,145
2451027-010,1021,801,442,29,296,13,23,4,359
2451027-059,1165,952,28,35,884,12,9,0,924
2451020-011,2126,1510,374,105,983,50,23,1,1136
2451020-002,916,713,39,26,644,16,2,1,674
2400515-012,2870,2372,1827,148,179,71,127,1,545
2403505-002,6348,4949,4083,226,434,96,87,10,866
2401902-001,1678,1334,1183,41,72,29,7,2,151
2401902-003,148,126,108,5,12,1,0,0,18
2400504-001,5333,4157,1220,305,2289,79,321,4,2937
2400504-012,6858,5358,1980,360,2548,59,455,3,3378
2400504-015,263,205,54,8,92,0,50,0,151
2404513-002,5179,3740,1429,467,1684,113,123,7,2311
2404513-001,1659,1314,550,125,617,32,10,0,764
2404101-001,6019,5002,3809,304,756,53,90,10,1193
2404103-003,1102,1003,923,31,32,9,8,0,80
2400508-015,2162,1713,1344,81,53,26,201,7,369
2400502-010,6294,4863,293,260,4146,66,174,6,4570
2400511-011,5404,4134,2469,120,772,68,701,13,1665
2400508-007,5401,4046,1647,835,799,82,709,12,2399
2400509-013,3311,2351,2070,72,98,15,88,5,281
2400505-001,3651,2908,2673,73,57,58,31,1,235
2400505-002,936,770,718,17,11,4,15,0,52
2400502-006,4540,3632,260,251,3045,59,81,3,3372
2400511-016,3702,2565,1025,147,1058,54,305,7,1540
2404509-001,2726,2133,424,93,1589,29,13,1,1709
2404509-002,2962,2083,116,186,1770,27,17,5,1967
2404509-003,3850,2793,533,152,2081,40,49,1,2260
2404105-001,927,807,703,15,64,19,8,2,104
2400509-001,3335,2696,2383,68,89,31,114,7,313
2400503-006,3443,2707,2365,67,170,19,59,1,342
2400504-008,5298,4074,2606,371,825,65,258,3,1468
2400515-003,3110,2597,2080,98,226,78,98,2,517
2451027-056,1151,919,13,25,889,10,8,2,906
2451015-021,1460,1190,26,18,1141,17,14,2,1164
2451016-002,1561,1284,23,30,1226,7,18,0,1261
2451014-004,3024,2469,441,55,1907,52,54,6,2028
2451014-001,2050,1929,859,144,416,18,507,2,1070
2451014-002,1137,971,398,31,499,8,34,2,573
2451028-005,2128,1692,24,48,1612,19,9,1,1668
2400509-016,1372,1098,757,79,201,17,63,1,341
2400502-017,4471,3462,194,96,3110,51,63,2,3268
2404102-001,2924,2484,2118,54,242,43,20,1,366
2404505-003,2934,2266,1434,123,595,33,98,6,832
2404505-004,4259,3471,2200,192,867,67,143,4,1271
2400305-025,2591,1926,1698,56,34,29,90,5,228
2400305-019,2106,1588,1442,37,23,15,59,2,146
2451025-005,4983,3481,509,1297,1529,126,131,6,2972
2451019-001,1626,1260,49,54,1144,15,11,0,1211
2451027-060,1989,1588,250,53,1267,16,20,2,1338
2400502-019,1551,1332,789,53,414,31,44,1,543
2400512-006,4947,3507,2199,353,763,111,93,9,1308
2400512-008,3465,2754,2098,239,204,87,102,8,656
2400504-006,4874,3640,1550,610,1216,64,255,1,2090
2400515-021,5442,4404,3823,71,316,75,72,2,581
2400302-019,4458,3568,1499,535,1209,92,250,6,2069
2400305-001,2820,2198,1918,95,89,21,52,2,280
2400305-002,3285,2504,1962,201,222,34,70,6,542
2400305-020,2732,2026,1579,90,270,12,68,2,447
2403109-022,6117,4562,1131,1717,986,143,711,4,3431
2400306-021,1175,936,736,47,64,15,78,0,200
2400306-032,2146,1795,1576,55,48,20,85,1,219
2400306-019,3281,3021,2570,131,197,26,86,3,451
2403104-009,2416,1911,843,454,153,30,427,4,1068
2403113-051,4165,3221,1841,608,288,67,445,4,1380
2403104-007,3890,3120,1299,924,256,73,584,6,1821
2403104-038,457,327,47,185,33,6,63,1,280
2403113-040,3374,2631,1541,501,286,69,276,1,1090
2401706-011,2778,2073,416,126,1317,43,196,11,1657
2401707-003,4398,3422,1081,266,1868,144,128,10,2341
2400307-001,3614,2956,2616,81,120,50,63,1,340
2400302-020,3083,2474,1536,149,536,64,208,5,938
2400302-002,2276,1765,1047,119,433,46,145,4,718
2400307-011,1073,794,679,20,48,3,33,1,115
2404703-003,1454,1145,998,39,60,18,27,0,147
2400509-018,3551,2652,1377,190,894,48,163,1,1275
2400512-009,2169,1571,926,274,289,75,30,2,645
2400502-015,7582,5919,968,201,4210,78,580,9,4951
2400508-001,3969,3249,2699,109,175,28,235,2,550
2400501-011,3530,2724,2050,122,221,35,268,4,674
2403102-009,768,576,398,94,24,6,63,0,178
2403105-014,6327,4311,171,2481,979,210,704,3,4140
2403105-006,6263,4901,1095,863,2043,106,874,9,3806
2402501-004,4306,3260,2031,149,910,85,112,3,1229
2402501-023,410,339,245,9,75,3,7,0,94
2402501-045,3365,2850,2282,112,331,64,56,6,568
2402501-041,2632,2033,1180,98,627,53,97,0,853
2402503-011,2633,2062,1771,82,113,23,76,0,291
2402503-019,3602,2667,2315,85,99,49,114,1,352
2403108-007,4858,3860,2469,338,519,68,478,4,1391
2403107-019,6132,4247,3071,320,179,45,605,6,1176
2403107-005,2813,2105,1677,120,135,20,128,4,428
2403113-065,3395,2795,994,421,1009,79,358,4,1801
2403106-008,2570,1985,770,97,69,12,1030,1,1215
2404508-002,3037,2415,2103,62,124,26,99,3,312
2404508-003,488,395,313,8,62,2,3,0,82
2403903-001,1417,1142,844,63,182,28,20,0,298
2402501-007,2772,2258,1856,167,119,66,47,5,402
2402506-002,3341,2605,1867,122,448,43,121,9,738
2402503-012,3474,2718,2247,134,178,43,118,2,471
2451003-002,1283,1056,322,41,604,13,82,2,734
2451027-044,1497,1181,1017,31,63,7,57,3,164
2403113-020,2789,1906,1520,127,124,24,91,0,386
2403105-010,4210,3179,533,460,1986,80,208,3,2646
2403113-022,8623,6242,1008,3547,1337,295,356,11,5234
2403113-046,3155,2465,1300,472,245,50,390,8,1165
2403108-008,4244,3283,1960,300,282,51,711,2,1323
2403113-042,2164,1640,615,540,276,44,199,2,1025
2403113-049,2766,2268,574,459,948,52,299,3,1694
2403107-025,3664,2773,1690,216,280,28,534,8,1083
2400307-012,1617,1295,1112,77,26,24,44,2,183
2400307-022,3036,2295,2026,73,77,29,81,4,269
2400306-002,2411,1905,1630,123,65,33,53,1,275
2404508-001,1793,1431,1234,25,138,17,15,1,197
2404508-004,1730,1466,1113,80,176,30,75,1,353
2403908-002,585,477,402,17,37,13,7,0,75
2403907-001,2521,1886,1183,81,576,29,27,1,703
2404505-009,496,387,335,10,35,7,7,1,52
2404505-008,1615,1324,1065,66,142,18,24,2,259
2404505-007,1762,1423,1204,25,102,36,46,13,219
2404510-002,99,84,71,4,7,2,0,0,13
2404510-003,807,611,559,8,32,6,6,1,52
2400502-013,4652,3764,411,210,3030,61,103,6,3353
2451008-003,2210,1619,58,23,1521,19,18,2,1561
2451021-004,717,628,232,20,345,12,24,0,396
2451025-013,1552,1096,446,227,366,55,31,9,650
2451011-001,2212,2108,1164,170,503,27,261,2,944
2451009-015,2405,1767,27,25,1700,23,13,4,1740
2402314-002,1278,1032,992,7,6,24,3,4,40
2404318-003,4574,3502,2332,222,667,60,225,6,1170
2404309-001,2901,2298,2128,46,54,61,21,7,170
2401708-004,7871,5833,1730,294,3506,160,258,23,4103
2401313-001,10782,8083,6850,528,253,152,265,10,1233
2401305-001,4468,3458,2959,134,200,55,115,7,499
2404515-003,982,785,685,7,75,10,7,0,100
2404515-001,2100,1635,1231,52,286,33,32,2,404
2404515-002,380,280,222,8,42,4,2,0,58
2401302-001,1909,1513,1416,28,17,29,18,0,97
2401310-001,1326,1049,974,23,37,11,7,1,75
2401706-001,2999,2397,1538,109,593,81,99,8,859
2404506-001,954,781,703,10,37,13,22,3,78
2404516-005,2674,1877,886,107,691,43,164,1,991
2404516-006,493,463,391,11,43,7,9,1,72
2404516-002,612,470,367,23,60,10,7,2,103
2404514-002,1674,1284,1110,53,60,22,26,0,174
2404514-001,436,349,305,10,9,11,13,1,44
2404509-005,689,560,356,23,126,7,54,0,204
2404509-006,4452,3454,2634,81,466,62,226,6,820
2404509-091,5,2,2,0,0,0,0,0,0
2451008-010,3594,2807,54,100,2642,39,11,2,2753
2451009-013,658,506,16,23,461,5,3,0,490
2451027-028,1541,1212,30,12,1159,12,10,0,1182
2400504-005,4093,3100,1598,296,920,59,255,9,1502
2404505-006,2296,1845,1221,93,392,32,111,1,624
2404505-005,5746,4639,3043,418,881,80,233,6,1596
2404505-002,1333,1003,567,58,345,29,21,0,436
2401103-001,7660,5766,4417,209,935,120,116,11,1349
2401106-001,2118,1732,1478,43,149,45,17,4,254
2401707-004,4994,3654,748,194,2568,83,138,23,2906
2402502-019,1698,1200,547,151,396,38,86,11,653
2404325-002,5286,3854,2544,269,871,90,112,8,1310
2404313-001,3816,3060,2837,57,81,54,28,5,223
2401104-001,3831,3010,2441,73,418,41,34,1,569
2404303-002,1988,1492,1052,115,258,49,22,3,440
2402504-008,12,5,5,0,0,0,0,0,0
2402504-004,3550,2823,2560,56,66,63,47,0,263
2402505-002,3077,2530,2311,68,42,64,18,4,219
2401704-002,2558,1970,1526,69,240,92,43,3,444
2402505-003,3614,2860,2633,50,46,72,35,3,227
2402505-001,3476,2819,2612,50,69,67,18,0,207
2402502-010,4442,3582,1789,379,1182,85,174,6,1793
2402501-017,731,568,507,13,15,2,20,1,61
2402501-003,3129,2232,1063,275,828,57,49,3,1169
2402501-020,5702,4310,1999,271,1743,90,276,4,2311
2402102-014,3472,2568,1390,326,548,55,276,9,1178
2400902-001,4668,3569,2670,134,607,93,81,6,899
2400902-006,3184,2430,1924,76,307,47,70,6,506
2400902-003,3451,2686,2172,89,246,70,108,3,514
2400304-010,1743,1486,1057,53,278,13,84,1,429
2400304-018,4010,3097,1741,198,860,68,255,10,1356
2400304-023,5009,3583,2247,214,700,70,372,14,1336
2400304-006,5083,4028,705,266,2782,63,279,6,3323
2400304-025,718,476,148,216,82,13,21,0,328
2400304-099,6,3,1,1,0,1,0,0,2
2400302-003,3132,2375,1358,416,397,73,149,16,1017
2400306-030,2221,1861,1587,52,129,20,53,1,274
2400305-022,2961,2188,1814,113,77,49,98,7,374
2400902-007,3064,2311,2018,65,88,39,86,7,293
2402115-001,3967,3217,2953,91,42,63,52,1,264
2402102-002,1978,1694,1182,132,295,35,59,2,512
2403314-005,2279,1778,945,216,507,66,107,10,833
2403321-015,2764,2472,845,394,694,29,575,4,1627
2402122-001,1389,1153,1056,28,12,32,17,0,97
2402122-002,2,0,0,0,0,0,0,0,0
2403313-009,4225,3405,83,166,3112,57,78,6,3322
2403303-001,1562,1278,363,101,788,38,32,2,915
2403318-016,29,24,0,4,21,2,0,0,24
2403317-001,5058,4159,1012,927,2044,112,181,17,3147
2403317-004,6347,4797,213,2047,2556,196,64,11,4584
2403309-001,4875,4017,234,451,3170,74,152,12,3783
2403319-003,2438,1948,1329,205,248,39,146,2,619
2403319-098,0,0,0,0,0,0,0,0,0
2403317-008,2799,2513,426,241,1661,43,205,8,2087
2403317-014,6472,5086,545,1381,2412,199,764,13,4541
2403317-015,427,391,106,41,211,0,33,0,285
2403315-005,10207,8079,380,396,7199,129,171,10,7699
2403317-005,2485,1912,181,1059,617,123,97,16,1731
2403318-013,1371,1042,13,197,817,20,22,1,1029
2403318-003,2072,1572,14,162,1396,6,14,3,1558
2403318-099,16,7,0,3,3,0,3,0,7
2403314-007,3403,2707,450,244,1827,52,199,1,2257
2403315-004,5081,3932,335,111,3427,79,60,3,3597
2403307-012,3396,2717,48,67,2595,34,32,2,2669
2402124-001,2346,1867,1564,141,60,34,63,0,303
2403306-018,3336,2584,180,356,1979,62,82,11,2404
2403302-007,2429,1924,867,239,727,47,81,13,1057
2400301-023,8053,7212,1875,386,4504,64,440,12,5337
2400301-099,0,0,0,0,0,0,0,0,0
2402702-024,1949,1480,911,56,136,14,347,0,569
2400306-014,3905,2699,668,596,1295,35,122,2,2031
2400306-011,2105,1901,1510,107,153,24,113,9,391
2400306-018,2617,2356,1898,210,146,41,71,3,458
2402703-001,2281,1784,1230,60,121,13,347,2,554
2402701-017,1434,1087,374,69,449,30,177,9,713
2402706-020,2884,2239,1122,181,606,39,307,2,1117
2402706-002,4815,3460,833,446,1663,53,466,6,2627
2400307-002,3389,2735,2338,94,211,39,34,0,397
2402706-019,3632,2767,858,262,1234,27,423,3,1909
2402704-004,3351,2546,1950,77,200,28,281,1,596
2402702-002,4251,3239,1743,95,264,41,1090,2,1496
2400305-023,1742,1362,1212,38,28,14,43,2,150
2400306-028,2196,1756,1305,112,227,24,72,5,451
2402705-001,4874,3565,1838,103,332,21,1233,4,1727
2402702-026,2788,2026,931,64,120,20,884,2,1095
2402702-017,538,423,208,9,6,4,187,0,215
2402703-003,2985,2320,1559,59,184,31,466,4,761
2402702-009,6927,5235,1694,340,935,48,2232,9,3541
2403321-001,7973,7288,3275,907,1392,90,1679,13,4013
2403321-096,0,0,0,0,0,0,0,0,0
2403320-006,3527,2677,217,958,1417,53,114,4,2460
2402703-002,4141,3330,2484,87,193,39,503,4,846
2403320-016,585,440,29,50,327,4,34,0,411
2403320-004,2971,2232,157,889,1105,54,108,0,2075
2403320-017,22,18,0,10,7,3,3,1,18
2403303-003,8021,6059,355,203,5373,87,167,20,5704
2403303-005,3362,2730,175,82,2448,46,46,6,2555
2403303-007,669,541,20,8,505,4,9,0,521
2403313-015,4558,3724,274,213,3092,48,174,2,3450
2403313-021,2214,1693,48,59,1521,25,82,1,1645
2402118-003,1972,1521,1298,57,64,38,51,2,223
2400104-008,2091,1635,1464,21,96,37,14,1,171
2400109-000,1247,996,979,4,5,9,0,0,17
2403314-006,1964,1592,904,155,375,33,125,3,688
2403317-006,4465,3211,115,2169,915,122,71,3,3096
2403301-001,6611,5216,810,1211,2205,97,979,12,4406
2403318-011,3130,2408,46,391,1986,53,22,2,2362
2403313-002,4508,3462,82,775,2554,70,60,7,3380
2403313-019,225,166,5,26,123,2,11,1,161
2403319-002,6946,4854,434,2098,1700,169,638,11,4420
2403312-004,6591,5033,105,1190,3657,103,112,5,4928
2403315-006,4221,3379,385,237,2682,80,67,10,2994
2403706-002,3022,2419,2098,57,127,53,79,2,321
2403314-002,7420,5453,311,587,4270,53,333,3,5142
2403320-009,2205,1669,276,283,1088,33,41,1,1393
2403320-020,375,303,9,42,226,6,25,1,294
2403313-018,2310,1730,30,265,1432,32,16,1,1700
2403313-001,874,672,10,148,520,24,6,1,662
2403314-010,2010,1577,344,110,1025,21,105,0,1233
2403314-015,744,598,105,92,369,19,25,1,493
2403307-014,2388,1876,549,201,1039,44,89,4,1327
2403307-015,2139,1750,33,53,1649,12,31,0,1717
2403307-023,2685,1993,47,30,1892,28,41,2,1946
2403307-011,5220,4289,108,96,4021,56,90,1,4181
2403317-011,8119,6140,137,2583,3402,152,120,5,6003
2403307-020,448,341,117,12,187,4,22,0,224
2403307-022,6424,4867,370,205,3975,47,370,4,4497
2403307-021,854,631,213,27,337,12,45,0,418
2403307-024,870,613,124,40,390,28,58,0,489
2403307-019,302,233,13,8,180,11,28,1,220
2403307-018,1449,966,68,20,773,9,106,0,898
2403307-001,1270,984,93,30,837,23,41,3,891
2403302-010,4659,3382,181,1838,1291,125,95,9,3201
2403306-020,4174,3363,76,264,3015,74,37,1,3287
2403306-025,447,353,0,5,348,2,1,0,353
2403312-009,7090,5133,88,1215,3815,103,59,7,5045
2403310-010,2515,1974,384,274,1143,58,187,0,1590
2403305-008,2852,2324,852,203,1117,94,118,2,1472
2403305-012,4009,3204,290,129,2659,59,142,3,2914
2403305-010,1766,1415,171,219,931,12,96,2,1244
2403315-001,4892,3871,432,153,3240,75,61,0,3439
2400301-021,4260,3077,652,227,1890,50,319,7,2425
2401908-001,807,722,701,2,11,7,2,0,21
2401903-001,363,282,229,6,36,10,3,1,53
2401903-002,445,361,179,11,163,0,4,2,182
2451005-001,1728,1228,38,34,1146,24,8,0,1190
2451005-002,213,189,10,3,173,2,5,0,179
2400512-007,5848,4432,3383,291,565,146,98,6,1049
2403101-007,622,488,374,39,56,7,17,0,114
2403101-001,2805,2220,1535,253,209,54,187,3,685
2403113-011,4716,3586,1426,962,744,88,464,1,2160
2403104-018,4915,3775,2390,340,344,22,663,2,1385
2403110-011,3052,2548,1215,391,402,37,514,5,1333
2403104-030,6514,5066,2400,443,493,21,1695,8,2666
2403105-021,8020,5652,433,817,3934,65,526,8,5219
2403105-019,4337,3584,1396,408,916,55,824,14,2188
2403110-010,3771,2838,1926,134,96,12,649,4,912
2403113-037,3878,2941,618,1492,280,110,481,5,2323
2403105-012,7301,5687,1124,923,2597,76,1101,15,4563
2403105-017,5142,4087,991,559,1761,75,778,7,3096
2403105-001,5085,3946,1141,792,1289,73,714,4,2805
2403109-009,8036,6026,1362,2286,1707,150,692,27,4664
2400513-005,4267,3425,2535,153,348,103,260,13,890
2400514-006,4589,3569,2586,152,656,74,93,1,983
2400514-007,3602,2772,1632,147,861,71,78,2,1140
2400512-004,5907,4692,3648,354,400,146,132,10,1044
2400501-002,3401,2528,291,208,1570,41,480,2,2237
2451028-014,889,698,53,20,618,14,5,0,645
2451026-004,2660,1913,706,900,228,32,63,0,1207
2451027-066,3451,2483,1661,119,595,11,65,1,822
2451012-001,4631,4215,2392,191,312,34,1245,3,1823
2451012-002,314,251,158,15,64,0,18,0,93
2451027-011,3228,2604,1225,128,1124,41,75,3,1379
2403104-015,3537,2755,956,866,400,71,522,7,1799
2403104-026,3653,2827,1306,746,253,57,469,4,1521
2403104-040,346,314,119,57,74,8,59,0,195
2403113-004,5355,4383,2249,498,1285,77,345,8,2134
2403109-035,5926,4445,2826,232,229,27,1107,8,1619
2403113-014,3599,2697,1891,256,363,37,162,8,806
2400513-007,4898,3429,1191,984,1046,77,126,1,2238
2400512-005,4529,3378,2574,213,381,156,69,3,804
2400509-023,4300,3565,2180,178,869,42,289,2,1385
2403109-008,7762,5703,1341,1821,1866,132,673,15,4362
2403109-041,4213,3078,792,538,903,56,850,10,2286
2403109-018,5582,4183,841,1353,1225,109,761,10,3342
2403101-002,2966,2389,1555,267,260,29,281,7,834
2402312-001,880,701,677,8,6,7,2,3,24
2403107-010,4801,3695,2450,325,323,41,558,10,1245
2403107-031,1539,1406,942,124,102,11,205,1,464
2403104-014,6443,4836,2191,519,841,74,1207,11,2645
2403113-005,6072,5464,2226,489,2138,75,599,14,3238
2403108-006,5589,4362,2579,349,713,33,667,13,1783
2403108-015,759,598,225,62,115,7,181,2,373
2400305-018,2766,2100,1662,123,171,36,100,7,438
2400305-028,1338,1002,754,53,112,8,59,1,248
2400301-024,2215,1659,710,168,590,50,196,1,949
2403113-007,3266,2590,1590,267,505,32,197,5,1000
2403113-010,3247,2943,1221,349,1134,57,291,3,1722
2403113-071,2186,2139,1605,81,262,20,172,1,534
2403113-054,2757,2728,1876,140,434,11,270,3,852
2400305-034,1677,1187,1035,32,48,22,47,1,152
2400306-022,3588,3145,2224,227,483,34,170,12,921
2400306-029,1399,1142,990,40,73,15,23,3,152
2400304-014,2345,1910,1682,73,77,32,39,1,228
2404102-002,716,621,597,9,8,8,2,0,24
2400301-004,3327,2557,1300,257,812,79,130,3,1257
2400307-003,2393,1947,1524,61,269,49,32,1,423
2401308-003,3649,2803,2512,92,84,40,47,1,291
2400502-024,3684,2908,192,92,2590,42,48,8,2716
2400515-010,4571,3279,1866,208,1087,85,35,1,1413
2402313-001,622,495,476,2,2,15,0,0,19
2401914-001,1586,1271,1102,37,88,28,15,0,169
2401914-003,1075,898,750,63,56,12,14,0,148
2401914-002,99,70,39,0,22,6,3,0,31
2401914-004,0,0,0,0,0,0,0,0,0
2400302-006,2804,2193,1380,261,330,70,148,6,813
2403503-002,8858,6920,5917,191,589,98,90,8,1003
2400303-003,4615,3511,2795,232,234,102,126,6,716
2400307-014,2242,1587,1253,85,134,30,81,4,334
2400307-016,3093,2341,1527,127,528,30,136,5,814
2403113-008,4057,3192,1213,440,1308,63,229,6,1979
2403915-002,2093,1618,346,70,1167,34,36,1,1272
2403915-003,150,117,72,0,36,6,2,0,45
2404502-001,2394,1903,1497,71,245,47,37,1,406
2403112-004,3124,2421,1773,255,176,42,175,10,648
2401706-005,5673,4112,414,316,3213,106,185,2,3698
2403905-001,875,729,590,0,109,14,12,0,139
2403108-002,5354,4036,2752,305,415,50,513,16,1284
2403105-015,4855,3853,1584,512,858,78,857,7,2269
2451015-020,3249,2730,246,71,2133,29,287,3,2484
2451015-018,3196,2406,26,46,2344,26,16,2,2380
2451015-019,90,66,0,5,61,0,2,0,66
2451006-004,1888,1602,720,218,447,45,205,1,882
2451025-014,2271,1429,256,249,888,49,14,0,1173
2451028-007,1473,1191,45,25,1095,15,5,2,1146
2451027-052,3577,2856,86,70,2672,44,25,3,2770
2400509-029,2604,2587,1120,183,1132,8,160,2,1467
2403109-007,9147,6622,1104,2948,1634,253,883,8,5518
2403109-005,4915,3815,1253,1211,763,85,577,13,2562
2403104-025,2276,1773,1179,166,115,14,277,1,594
2403113-050,2885,2255,1342,249,519,42,123,3,913
2403106-009,3765,2981,2003,175,146,43,617,1,978
2403113-068,3671,2716,858,574,1010,79,297,14,1858
2403109-026,5390,3968,736,1302,1277,71,622,8,3232
2403113-015,7857,5892,1459,1867,1845,147,750,8,4433
2403113-023,3552,2532,1908,211,238,41,157,0,624
2403110-001,2111,1717,1039,98,125,15,449,7,678
2401303-001,5460,4387,4084,75,83,88,46,1,303
2403104-021,3491,2623,1690,173,117,31,617,3,933
2404311-001,1110,876,798,18,29,9,11,0,78
2451027-033,2817,2296,506,90,1657,43,44,2,1790
2404318-001,2881,2214,2001,72,64,33,43,4,213
2402503-022,4710,3508,2938,148,181,72,158,1,570
2402503-020,3223,2541,2268,60,96,31,69,1,273
2451026-011,2638,1904,569,973,283,105,55,3,1335
2451027-032,3266,2713,878,126,1601,40,104,2,1835
2451024-002,1153,1054,886,45,45,5,76,0,168
2402506-005,625,431,158,47,199,16,22,2,273
2400512-010,3962,3106,2063,332,556,118,74,5,1043
2400502-001,2007,1652,70,28,1551,26,9,2,1582
2400514-011,3580,2879,1439,271,902,47,195,5,1440
2400512-011,5625,4397,2836,427,955,165,64,10,1561
2451027-055,1048,790,13,11,769,4,5,1,777
2403902-001,487,395,317,7,59,9,3,1,78
2403913-002,3670,3599,1081,117,2355,36,0,3,2518
2451009-011,437,319,7,15,293,2,4,2,312
2451002-003,3394,3142,2386,225,196,36,278,4,756
2400501-008,5871,4414,2933,185,904,92,310,10,1481
2451015-022,1193,893,52,14,817,6,2,4,841
2404310-002,4927,3650,2456,333,553,79,227,15,1194
2451026-007,2865,2244,1121,705,265,80,139,1,1123
2451026-029,5629,4355,394,96,3835,32,15,3,3961
2451016-003,978,782,28,19,721,11,9,1,754
2451013-011,2661,2383,1979,99,104,35,152,3,404
2451013-013,143,125,102,6,7,6,2,0,23
2451025-007,585,436,55,7,360,15,4,0,381
2451027-035,4000,3059,136,85,2837,41,19,6,2923
2451017-002,3916,3035,247,87,2664,45,36,13,2788
2451017-001,267,209,12,6,172,4,15,3,197
2404327-002,4642,3465,2532,294,438,83,154,2,933
2404327-001,3096,2470,2095,88,150,53,85,1,375
2404307-002,2977,2156,1842,126,92,51,44,2,314
2404321-001,4012,2985,2077,198,577,45,97,9,908
2402310-001,1846,1544,1498,8,6,24,5,4,46
2400513-004,3923,3166,2481,108,310,49,209,5,685
2451026-016,1717,1204,26,17,1139,15,19,2,1178
2451010-002,1461,1086,14,12,1059,17,1,0,1072
2451010-003,3339,2965,316,71,2557,6,10,0,2649
2451009-005,1872,1562,344,24,1173,25,16,2,1218
2451027-004,686,553,263,18,246,7,20,1,290
2451001-003,2034,1855,1522,121,72,20,113,0,333
2400502-005,3699,2862,131,129,2527,29,91,2,2731
2404321-003,1679,1305,1011,85,165,37,23,3,294
2400509-021,4459,3533,2590,174,542,57,163,1,943
2451026-019,1814,1401,47,26,1319,17,4,1,1354
2451020-003,2100,1628,59,39,1526,17,9,3,1569
2451018-001,1707,1173,19,14,1130,30,1,1,1154
2451014-005,596,470,4,10,454,4,1,1,466
2451028-013,1982,1554,86,19,1437,16,13,0,1468
2404310-004,1036,920,834,20,49,8,10,1,86
2404505-001,5407,3880,1049,456,2315,96,44,11,2831
2401301-002,4579,3295,2751,124,267,67,68,4,544
2401301-001,5279,4275,3940,79,132,57,38,3,335
2451016-014,3642,2861,52,45,2765,40,13,0,2809
2451027-020,3126,2542,240,69,2164,35,77,3,2302
2451015-015,886,652,20,8,619,8,2,2,632
2451015-006,2071,1613,19,20,1569,23,16,3,1594
2451006-005,3613,2985,1527,467,785,89,175,2,1458
2451003-001,1883,1331,213,168,902,22,51,2,1118
2451016-011,978,765,18,20,729,14,5,1,747
2401312-001,1526,1195,1074,20,68,18,4,0,121
2451009-008,1430,1116,18,27,1058,20,16,0,1098
2451024-005,4888,4295,3569,190,192,39,285,6,726
24510ZZZZZZ,6,4,1,0,3,0,0,0,3
2400509-014,3650,2625,1747,186,435,36,237,2,878
2400512-013,2649,1834,254,127,1392,53,42,3,1580
2400502-014,5330,4287,314,86,3769,56,130,5,3973
2400509-024,4994,3915,2691,152,698,72,281,5,1224
2400514-001,2752,2211,1771,60,227,39,99,0,440
2400506-002,3143,2392,2185,47,54,30,55,1,207
2451025-006,1439,985,42,54,876,18,9,2,943
2400504-003,3849,3286,2593,111,427,26,137,1,693
2400515-009,1533,1324,1147,26,71,31,36,7,177
2400509-009,2150,1693,1459,28,49,11,144,4,234
2402120-001,3174,2579,2333,107,47,64,29,5,246
2402120-002,0,0,0,0,0,0,0,0,0
2402109-008,1677,1305,1028,104,93,18,57,4,277
2400903-002,3628,2745,1993,100,531,70,61,5,752
2403303-008,334,267,141,26,102,0,0,0,126
2403303-002,3771,3032,307,199,2496,69,43,7,2725
2403309-011,5315,4226,327,553,3358,80,147,5,3899
2403309-006,4222,3511,198,290,2937,48,85,3,3313
2403307-013,2843,2282,129,104,1995,32,69,2,2153
2403312-003,3936,3068,83,384,2552,74,46,3,2985
2403312-018,661,536,45,118,342,10,29,2,491
2403312-007,3752,2818,111,282,2388,43,53,0,2707
2403316-005,212,161,39,69,45,5,9,0,122
2403316-098,0,0,0,0,0,0,0,0,0
2403309-013,3121,2537,164,298,2027,60,49,5,2373
2403309-002,1604,1287,86,110,1045,22,54,2,1201
2403312-017,689,560,30,59,465,6,7,1,530
2400302-018,2596,1990,1028,185,618,38,141,2,962
2400105-006,779,635,594,9,10,15,4,0,41
2400305-006,2109,1504,1392,48,17,9,31,3,112
2400306-025,1873,1488,1394,25,27,7,24,1,94
2402702-022,114,76,54,4,3,2,14,0,22
2402705-005,3860,2945,1599,91,317,29,913,3,1346
2402705-022,4313,3221,1776,69,260,30,1053,9,1445
2402706-021,2526,1910,481,386,623,34,415,1,1429
2403704-002,2854,2137,1772,56,210,72,26,3,365
2400513-009,7995,5681,3018,1066,1218,160,267,18,2663
2451015-003,2845,2276,41,58,2172,30,13,7,2235
2400507-002,1481,1142,1063,15,7,21,18,1,79
2400511-019,3999,3046,1964,103,522,36,405,6,1082
2451027-022,2917,2349,92,37,2213,15,23,1,2257
2451003-003,3246,3046,1975,218,284,40,529,2,1071
2403909-001,330,287,243,3,26,11,1,2,44
2400301-005,2640,2050,892,296,546,36,318,5,1158
2451011-006,3450,3311,1473,199,1163,44,468,3,1838
2451026-026,2403,1879,321,66,1465,40,16,0,1558
2400515-013,2287,1859,1554,73,96,46,74,2,305
2400301-010,1732,1389,1213,47,46,21,48,6,176
2403106-004,2865,2233,1258,119,85,14,754,1,975
2403113-001,3951,3210,1065,717,838,60,562,2,2145
2403113-056,6690,4977,1180,1658,1543,114,554,11,3797
2403104-028,2625,2293,1141,276,396,21,452,5,1152
2403105-004,2331,2028,1017,85,728,19,191,4,1011
2401706-010,3578,2616,380,167,1887,50,201,1,2236
2400307-013,2820,2209,1854,86,119,18,106,4,355
2400305-033,2327,1758,1456,46,94,12,134,6,302
2400304-003,2793,2062,1415,158,270,50,189,4,647
2400304-008,2646,2090,1571,110,243,56,114,7,519
2400304-021,4931,3443,2024,241,659,75,467,18,1419
2404705-001,4096,3551,3258,84,98,46,52,3,293
2400504-002,5887,4423,1307,581,1999,101,519,2,3116
2403110-009,3556,2732,1759,171,135,13,634,7,973
2403104-012,4748,3542,1953,274,166,21,1089,10,1589
2403106-002,4668,3622,1690,153,257,26,1484,8,1932
2403107-015,4764,3620,2604,238,128,32,593,11,1016
2404510-001,434,342,132,13,193,3,1,1,210
2402501-016,4416,3442,2192,167,846,78,148,7,1250
2402501-018,2857,2273,1474,113,551,50,91,3,799
2403109-011,4164,3216,1054,949,783,112,416,2,2162
2403108-010,2885,2261,1172,345,399,43,327,8,1089
2404702-003,671,547,470,3,56,6,10,0,77
2400501-014,7291,6702,3964,296,1206,97,1194,19,2738
2451012-005,2255,2093,1122,156,244,24,550,0,971
2451010-004,715,604,17,9,576,5,11,1,587
2402302-001,1881,1518,1428,23,10,35,6,0,90
2404316-001,3796,3142,2754,101,71,62,140,1,388
2401314-001,3849,2950,2662,83,85,40,67,5,288
2403506-001,2413,1775,1585,38,76,39,29,4,190
2401706-004,4454,3227,592,203,2280,61,158,4,2635
2401709-001,3218,2570,1289,101,1093,98,54,7,1281
2404507-001,1740,1405,1108,49,184,40,15,1,297
2451020-006,3354,2636,30,17,2571,27,5,2,2606
2451015-024,2373,1795,25,30,1736,35,4,1,1770
2401706-017,2314,1777,491,101,1109,30,65,4,1286
2402503-008,4244,3184,2818,78,103,49,106,4,366
2402501-010,5588,4359,2400,290,1436,85,155,10,1959
2402505-004,2069,1725,1517,59,79,47,20,2,208
2402502-021,58,47,37,2,7,0,0,0,10
2404321-002,3069,2473,1850,155,351,53,90,3,623
2402501-012,3927,3081,2390,119,318,40,190,1,691
2402501-022,338,245,167,6,43,2,20,0,78
2402501-026,2171,1771,1284,66,292,29,76,3,487
2402501-013,2706,2249,1476,161,430,36,146,4,773
2402501-025,43,37,23,7,1,0,2,2,14
2401706-007,5561,3973,899,299,2589,115,148,15,3074
2400302-023,4068,2992,1776,303,615,92,270,5,1216
2400304-002,4078,3250,1777,248,967,92,194,13,1473
2400303-009,1447,1113,951,37,67,27,27,2,162
2400305-030,1550,1126,822,45,99,15,130,2,304
2400305-012,2236,1604,1275,81,80,29,146,2,329
2402123-002,133,117,91,9,11,8,6,1,26
2400903-003,4438,3299,2326,114,655,81,94,9,973
2403309-012,359,276,29,76,168,3,5,3,247
2403309-005,3745,2982,159,469,2287,43,91,0,2823
2403312-016,3984,2992,127,219,2611,43,45,3,2865
2403302-006,6984,5027,219,2196,2530,145,121,14,4808
2403321-018,4113,3378,425,258,2221,62,487,8,2953
2403318-010,1423,1121,12,119,997,8,1,5,1109
2403302-009,6340,4662,187,1580,2788,121,142,11,4475
2403305-011,2794,2300,147,233,1684,20,252,8,2153
2403303-004,3072,2472,99,107,2241,39,68,1,2373
2403306-002,1531,1252,89,135,990,8,35,0,1163
2400303-002,2042,1660,1496,27,59,26,50,2,164
2402702-001,4070,3041,1246,146,472,34,1150,8,1795
2402705-004,4942,4125,1828,360,1368,93,551,7,2297
2402702-003,3596,2783,1855,84,272,19,565,1,928
2402702-015,2895,2197,1280,62,94,23,743,1,917
2402706-006,1510,1138,738,54,247,18,79,0,400
2402704-005,1958,1556,1306,68,51,35,100,3,250
2402701-011,1695,1144,620,33,136,22,327,3,524
2402701-020,677,525,435,9,36,2,43,1,90
2402701-019,99,67,40,6,12,1,10,0,27
2400306-005,1939,1477,1134,133,129,26,46,0,343
2400303-013,2804,2259,2078,57,35,47,32,2,181
2402701-008,3641,2637,1270,406,471,83,467,6,1367
2403312-012,4199,3353,134,356,2743,66,147,5,3219
2403321-010,3847,3056,1062,1076,487,101,380,9,1994
2403321-008,9694,6908,487,1866,3787,132,842,15,6421
2403321-091,0,0,0,0,0,0,0,0,0
2402701-009,2700,1974,957,132,352,34,511,1,1017
2402706-003,2067,1492,949,91,173,26,231,0,543
2400112-000,2981,2423,2166,23,106,56,58,2,257
2400101-000,820,678,649,7,5,12,4,0,29
2403306-007,5488,4596,305,274,3929,88,100,18,4291
2403306-098,0,0,0,0,0,0,0,0,0
2403307-002,2003,1634,890,184,444,41,88,3,744
2403318-004,3260,2466,49,257,2143,44,39,1,2417
2403306-003,5951,4782,86,413,4235,73,79,7,4696
2403306-019,3622,2790,47,138,2592,42,22,3,2743
2403306-099,3,2,0,0,1,1,0,0,2
2403313-022,1447,1012,11,29,971,8,2,0,1001
2403313-099,0,0,0,0,0,0,0,0,0
2400303-024,3601,2844,2328,137,239,63,71,8,516
2403307-003,2737,2165,1160,231,627,51,114,8,1005
2403310-008,3611,2681,542,582,1483,59,94,2,2139
2403317-012,8495,6318,343,3093,2690,373,289,8,5975
2402702-023,3280,2400,690,168,496,28,1004,2,1710
2404105-002,921,793,759,10,13,11,1,0,34
2403708-003,4998,3691,2112,310,941,89,273,20,1579
2403708-012,656,492,433,11,27,7,12,0,59
2403112-005,5284,3812,1894,825,675,109,368,2,1918
2400511-005,3664,2725,1897,59,250,43,438,7,828
2400514-014,931,745,369,19,320,4,32,0,376
2400508-006,9166,7000,2464,999,2622,155,875,14,4536
2400508-005,1413,1330,1200,23,62,4,44,2,130
2451027-030,1896,1530,42,50,1437,26,11,1,1488
2451028-001,1992,1587,95,190,1286,25,33,1,1492
2451009-003,1582,1307,331,53,905,15,29,3,976
2451014-003,1328,906,44,18,837,16,8,0,862
2400510-002,2077,1616,1442,30,25,27,83,2,174
2400510-004,2709,2080,1891,42,39,17,73,1,189
2400514-002,5724,4589,2194,229,1257,67,852,5,2395
2400502-031,3407,2699,244,181,2216,39,69,6,2455
2400502-003,750,578,50,38,447,10,44,1,528
2400515-026,2261,1965,1825,44,35,25,23,4,140
2403109-030,4222,3292,943,699,803,53,848,2,2349
2403109-034,6558,4827,909,1698,1386,104,830,11,3918
2403108-004,1674,1346,887,112,117,13,201,1,459
2403108-003,3656,2801,2013,221,159,31,363,0,788
2403101-006,2524,1975,862,316,490,52,322,2,1113
2403101-004,3261,2443,766,672,565,58,435,2,1677
2403113-028,3970,3018,531,1759,352,114,366,7,2487
2400304-009,4826,3668,840,281,2065,60,468,5,2828
2400304-017,4630,3265,824,1147,1090,100,159,6,2441
2400304-001,3828,2891,734,750,1235,85,157,8,2157
2400305-007,2246,1589,1396,43,39,22,77,1,193
2401907-002,5626,3964,813,251,2832,62,33,5,3151
2400302-011,2421,1862,1092,345,290,88,82,5,770
2403113-038,5988,4263,3518,260,122,51,295,8,745
2403109-014,4184,3330,1580,448,530,33,750,9,1750
2403109-004,5031,3786,1056,1445,580,108,662,8,2730
2403107-013,4652,3450,2486,286,196,32,426,0,964
2404509-008,1520,1199,715,20,261,9,197,1,484
2401706-013,5913,4444,974,260,2771,126,394,4,3470
2403107-018,3504,2604,2059,183,98,9,189,6,545
2402903-002,667,563,431,15,98,9,4,3,132
2400501-017,7887,5759,605,421,3508,61,1208,8,5154
2403104-013,2780,2059,1615,141,75,11,203,0,444
2403104-032,1831,1367,929,131,59,1,213,1,438
2403113-053,2696,2029,924,599,304,64,189,6,1105
2403104-019,2856,2253,1037,294,264,30,643,1,1216
2403113-013,5072,3862,1150,832,1714,84,197,5,2712
2401706-021,2129,1663,348,109,1054,20,143,0,1315
2402504-002,3378,2651,2447,50,27,36,58,1,204
2402503-026,1127,867,770,37,17,12,29,1,97
2402503-005,4681,3577,3214,90,88,56,87,3,363
2402504-005,4295,3398,3041,59,118,54,95,2,357
2451027-034,1940,1523,97,33,1361,24,26,3,1426
2451009-010,1644,1272,244,95,905,23,33,1,1028
2451007-003,2948,2193,124,176,1857,40,44,2,2069
2451016-007,1635,1238,18,24,1195,21,2,0,1220
2451016-008,979,754,7,11,740,7,2,0,747
2401708-003,2738,2189,875,148,1050,57,62,7,1314
2401706-022,4331,3185,447,344,2275,77,112,5,2738
2451021-003,2566,2030,625,96,1148,48,153,0,1405
2451011-005,2233,1878,729,74,940,40,124,5,1149
2451011-004,126,91,4,7,79,5,0,0,87
2451026-031,1151,863,354,39,426,17,32,3,509
2451016-009,1607,1241,7,13,1216,15,2,1,1234
2451012-006,1560,1472,803,148,250,21,267,6,669
2451020-005,1241,932,27,47,836,23,18,6,905
2451016-004,649,497,10,11,466,12,4,2,487
2451026-028,1355,1084,68,26,972,25,12,2,1016
2401706-009,3860,2911,575,221,2006,102,81,2,2336
2451013-001,2257,2058,1243,65,236,10,488,0,815
2451013-012,1987,1755,1407,50,63,14,185,0,348
2402503-002,3534,2790,2452,90,91,70,77,2,338
2451012-003,1136,1033,519,63,110,6,335,0,514
2451012-013,229,220,41,35,24,14,117,1,179
2451012-004,4408,4225,1670,429,453,44,1637,6,2555
2451026-033,2014,1594,83,16,1486,25,4,1,1511
2451026-018,1419,1098,50,18,1024,19,6,1,1048
2404318-004,916,700,407,44,175,11,65,1,293
2451026-010,4727,3532,1176,1633,566,204,131,0,2356
2451027-007,1862,1456,292,27,1105,36,18,3,1164
2404326-002,2805,2287,1846,190,150,54,62,1,441
2400502-007,3877,2949,159,104,2651,30,67,3,2790
2451015-010,1859,1521,91,32,1372,20,25,2,1430
2451015-023,2345,1907,93,33,1765,27,6,0,1814
2451013-008,2186,1734,208,48,1436,28,28,2,1526
2451008-008,1079,864,454,25,337,23,32,3,410
2451008-009,93,73,12,3,57,0,2,0,61
2451001-004,3152,2913,2344,153,187,37,181,1,569
2404509-004,260,225,114,24,87,2,0,0,111
2400501-013,3783,2834,2519,71,74,29,104,3,315
2451027-058,793,628,15,12,596,4,4,1,613
2451016-010,1071,809,7,12,793,7,3,0,802
2451016-012,2259,1639,25,28,1596,13,12,0,1614
2451026-001,668,505,276,112,95,36,20,2,229
2451027-001,2891,2271,513,89,1623,48,31,1,1758
2451027-057,2654,2219,51,41,2111,28,28,4,2168
2400511-021,1423,1085,720,52,201,13,105,1,365
2400508-023,968,759,632,14,45,10,48,0,127
2400503-005,4246,3722,1911,161,1467,33,182,3,1811
2451023-002,1737,1509,905,55,459,16,82,1,604
2451015-012,370,285,18,5,263,8,0,0,267
2402126-002,4570,3404,2488,355,379,81,100,13,916
2403309-004,2832,2310,210,182,1871,53,54,3,2100
2403310-003,3644,2893,922,731,1056,71,169,5,1971
2403305-002,2196,1870,195,107,1429,28,135,2,1675
2403306-008,2818,2264,54,150,2044,38,27,4,2210
2403305-004,4101,3323,222,199,2824,40,89,6,3101
2403301-003,7514,5473,437,2079,2478,124,504,10,5036
2402702-025,1674,1232,903,40,82,5,199,0,329
2402705-002,1003,797,507,53,163,19,64,0,290
2402701-003,2976,2239,1229,142,418,23,427,5,1010
2402701-012,1472,1095,624,27,135,6,296,0,471
2400502-004,4228,3292,123,120,3011,28,39,0,3169
2451022-001,2022,1964,1282,83,401,13,170,2,682
2451028-003,515,439,10,15,405,10,9,2,429
2451027-046,1110,883,702,32,63,7,65,0,181
2451026-027,1866,1498,215,39,1218,17,17,2,1283
2451023-001,1758,1603,1298,84,108,27,68,5,305
2400510-001,3294,2551,2327,72,32,34,58,1,224
2400510-006,24,21,14,2,4,1,0,0,7
2400510-007,806,620,541,20,15,13,19,1,79
2401902-004,301,257,185,8,55,3,1,0,72
2401902-002,333,247,107,10,119,11,1,2,140
2400502-012,7462,5740,617,146,4849,105,136,9,5123
2451016-001,961,717,24,20,666,2,9,1,693
2451015-001,2022,1655,40,36,1563,21,14,1,1615
2402308-001,710,569,554,6,1,4,0,0,15
2403915-001,2378,1956,500,90,1328,25,35,2,1456
2400303-001,2614,2082,1733,74,154,53,64,0,349
2451026-013,1795,1295,727,437,109,30,18,5,568
2451026-023,1717,1310,104,26,1181,4,1,1,1206
2400502-029,4981,3924,750,117,2659,42,400,1,3174
2400301-019,3404,2596,884,266,1164,65,308,10,1712
2400303-025,3037,2305,1049,253,789,63,171,3,1256
2400305-029,1099,891,805,15,30,9,28,1,86
2400305-014,2646,1983,1684,80,80,23,105,6,299
2400509-028,3125,2396,668,151,1488,54,71,9,1728
2403113-052,3014,2325,1386,398,197,38,289,11,939
2403101-005,3669,2982,1588,307,361,34,686,6,1394
2402503-014,3695,2817,2340,76,154,25,209,9,477
2402503-025,0,0,0,0,0,0,0,0,0
2402503-021,4092,2965,2374,95,190,32,272,4,591
2403110-004,2098,1600,978,99,98,8,400,3,622
2404311-002,657,544,497,11,4,18,2,0,47
2401305-005,3927,2889,2380,100,132,37,221,3,509
2451026-032,2215,1699,102,26,1565,12,3,1,1597
2451026-021,1332,961,41,18,897,17,13,1,920
2451020-007,2712,2137,104,57,1958,28,36,5,2033
2451008-007,1806,1326,40,61,1227,18,5,2,1286
2451012-010,2376,2072,526,165,1337,35,72,4,1546
2402503-009,4283,3390,3026,93,110,36,102,5,364
2402501-002,2798,2255,1614,74,400,54,114,1,641
2402503-004,2225,1778,1588,37,80,34,27,2,190
2402503-018,3562,2692,2047,107,268,63,187,8,645
2402503-027,376,310,303,5,0,0,0,0,7
2400104-003,1781,1334,1151,26,114,41,8,0,183
2400303-023,2205,1754,1534,61,62,47,34,0,220
2402119-001,1829,1472,1343,62,9,38,15,0,129
2403318-012,181,152,11,23,116,5,4,0,141
2403321-007,3345,2569,1094,822,366,86,263,3,1475
2400129-003,1521,1266,1185,9,23,19,29,1,81
2400302-001,2519,2067,1334,136,417,43,160,2,733
2402706-024,3889,2703,974,394,885,63,434,4,1729
2403702-003,1048,867,761,17,52,11,19,0,106
2400134-000,1582,1311,1264,4,18,15,7,0,47
2400305-021,3903,2846,2188,196,222,67,155,14,658
2402706-028,3746,2881,1659,91,350,36,726,3,1222
2402704-006,3111,2332,1711,58,159,19,374,1,621
2402706-018,2398,1761,1004,121,409,29,216,0,757
2403310-007,3425,2541,498,436,1523,61,110,0,2043
2403313-011,3549,2810,55,65,2629,31,69,4,2755
2403313-024,1301,1002,6,16,969,4,18,0,996
2403309-007,4680,3690,158,212,3199,68,129,10,3532
2403303-006,4055,3167,68,86,2985,30,41,0,3099
2403313-006,3453,2821,55,93,2645,52,56,5,2766
2403313-017,3131,2342,38,769,1520,34,35,4,2304
2403307-005,3589,2751,1241,295,1085,58,121,4,1510
2403705-001,4975,3569,2968,114,326,84,71,9,601
2451007-001,1764,1237,95,23,1060,4,65,3,1142
2400503-011,4331,3488,2051,97,1123,35,194,3,1437
2400515-023,7312,5421,1241,276,3785,84,99,4,4180
2451026-022,1064,788,49,28,699,15,15,1,739
2451025-001,4053,3106,368,104,2514,49,98,3,2738
2403112-003,5018,3829,2635,503,313,63,308,6,1194
2403113-031,2578,1979,929,467,359,49,220,3,1050
2400302-024,3025,2240,1407,161,423,55,192,6,833
2401304-003,6454,5138,4577,105,196,98,113,5,561
2400511-009,3929,2986,1794,118,749,44,281,0,1192
2400508-011,2436,1948,1268,154,226,34,262,1,680
2451026-012,1179,853,66,322,410,30,55,1,787
2451028-009,3080,2453,352,90,1955,48,51,4,2101
2400508-012,2951,2296,1879,79,98,15,230,1,417
2403113-019,3044,2323,1389,398,321,59,208,1,934
2403113-021,6594,5009,1396,785,2550,83,283,10,3613
2400511-002,3555,2824,2577,90,36,35,54,3,247
2400511-026,361,300,281,2,8,4,5,0,19
2451025-010,1833,1374,46,58,1239,22,25,1,1328
2400509-020,5135,3928,394,202,3241,46,106,4,3534
2400515-015,3582,2941,2116,249,338,135,100,6,825
2451015-007,1909,1512,40,38,1435,13,10,3,1472
2400509-004,6734,5914,3666,336,1527,56,391,4,2248
2400515-017,5355,3770,1170,289,2168,139,69,0,2600
2451016-005,2020,1633,54,15,1545,6,21,1,1579
2451007-004,3114,2293,103,298,1874,52,30,6,2190
2451015-009,3467,2706,93,48,2537,27,29,3,2613
2451027-041,2457,1888,1361,70,366,19,72,2,527
2401304-002,3162,2509,2325,43,48,33,29,2,184
2401913-002,158,139,69,2,68,2,0,0,70
2400503-012,3755,2965,1029,150,1611,26,171,4,1936
2451020-010,902,666,166,45,423,9,24,1,500
2451016-006,2089,1668,15,28,1631,19,1,3,1653
2451001-005,3575,3228,2733,178,107,41,148,0,495
2402102-013,6012,4609,2060,889,1279,101,359,13,2549
2403312-014,3038,2484,240,365,1533,33,344,11,2244
2403306-015,4892,3851,109,203,3515,54,38,6,3742
2400301-003,3154,2478,1689,262,344,60,121,2,789
2400305-015,1313,954,856,11,10,3,64,2,98
2402705-024,1297,1006,582,35,69,8,302,1,424
2402705-011,1874,1433,1038,51,58,10,265,1,395
2402705-020,2845,2135,1308,82,224,26,480,2,827
2402701-010,2166,1670,989,93,256,10,321,6,681
2402702-011,4114,2889,1506,90,308,10,958,2,1383
2400515-024,1335,1153,777,57,237,40,50,0,376
2451027-037,839,636,429,24,136,8,35,0,207
2400502-018,1618,1340,204,26,1079,30,24,1,1136
2400514-004,600,490,316,15,102,2,57,0,174
2400501-012,4435,3540,3140,87,114,53,109,4,400
2400515-006,3232,2666,2378,57,106,78,31,1,288
2400501-016,3079,2907,2592,65,138,24,86,4,315
2403109-012,4372,3380,1210,895,785,98,474,2,2170
2403112-002,3511,2770,2015,448,153,62,110,2,755
2403113-064,7825,5674,558,2293,2144,156,381,8,5116
2403104-027,1911,1441,311,460,271,23,376,0,1130
2403104-043,0,0,0,0,0,0,0,0,0
2403104-037,471,431,172,72,77,10,106,0,259
2402503-024,3393,2679,2363,81,78,33,93,3,316
2451027-048,1194,1035,204,32,749,16,60,0,831
2401307-007,7915,5919,4932,282,334,113,245,7,987
2451027-012,858,713,388,29,270,12,11,2,325
2404314-001,1171,928,871,12,17,14,13,1,57
2402501-006,5753,3978,1146,351,2375,102,72,8,2832
2402503-017,3153,2428,2156,52,68,26,107,3,272
2400305-003,2957,2186,1770,99,135,36,134,5,416
2402123-003,33,17,5,4,1,0,8,0,12
2403305-006,4416,3635,243,536,2580,74,284,5,3392
2403313-004,2155,1746,69,58,1613,16,35,1,1677
2403313-023,814,639,13,12,604,0,17,0,626
2403320-098,0,0,0,0,0,0,0,0,0
2403320-003,2464,1957,10,163,1738,24,53,0,1947
2403320-099,0,0,0,0,0,0,0,0,0
2400106-005,1361,1137,1014,10,43,11,60,1,123
2400307-024,3375,2427,1742,170,275,48,202,18,685
2402705-006,7157,4988,2571,222,677,58,1428,5,2417
2402702-007,2171,1698,1255,43,84,17,298,2,443
2403321-014,2420,1916,334,873,607,54,166,4,1582
2403708-007,4005,3000,1323,158,1194,88,269,9,1677
2401911-001,92,76,65,1,8,1,1,0,11
2401912-002,496,412,168,8,219,11,7,0,244
2400509-025,3754,2933,1827,116,704,38,238,0,1106
2451015-008,869,702,12,14,671,5,8,0,690
2400503-009,5852,4394,2781,123,947,48,458,6,1613
2451006-003,724,599,64,53,404,13,61,0,535
2403113-016,4898,3385,767,851,1424,81,342,17,2618
2403110-012,4286,3261,1772,286,377,25,782,1,1489
2400306-007,1850,1457,771,343,286,36,59,3,686
2403110-002,3268,2552,1734,147,85,13,551,0,818
2403914-001,375,328,304,3,15,8,1,0,24
2400508-024,1379,1047,912,25,18,3,76,0,135
2403107-027,2448,1765,1483,119,30,17,100,1,282
2402506-004,240,193,169,4,7,11,3,0,24
2451009-002,1261,1050,142,23,888,16,5,2,908
2451011-003,2329,2133,967,124,733,27,299,0,1166
2451026-030,1251,1014,261,38,697,11,11,4,753
2451013-006,837,668,33,12,616,19,2,1,635
2451027-024,639,547,11,10,523,13,1,1,536
2451027-019,960,750,46,6,689,17,6,1,704
2402501-008,5871,4306,3086,220,465,63,497,5,1220
2451027-040,1920,1469,1136,57,179,10,84,1,333
2451006-002,1353,984,172,181,592,18,41,2,812
2400508-008,2619,2061,1742,64,69,8,161,1,319
2451008-002,1840,1385,133,18,1214,15,16,0,1252
2451009-001,903,719,59,7,640,10,11,1,660
2451024-003,2066,1910,1612,72,71,20,142,3,298
2451020-009,1018,788,348,73,335,27,25,7,440
2451020-012,0,0,0,0,0,0,0,0,0
2451004-003,867,635,40,17,544,8,32,1,595
2451027-053,2158,1645,71,32,1542,19,5,1,1574
2451022-002,1827,1627,1263,101,128,14,138,2,364
2400515-008,4034,3114,2052,94,815,70,68,4,1062
2451015-004,1096,885,12,13,850,12,15,1,873
2400305-005,2507,1902,1596,75,134,17,75,4,306
2400304-016,3196,2503,1545,181,562,65,167,3,958
2402706-031,2383,1786,638,280,684,31,171,5,1148
2451008-005,1743,1402,35,28,1340,6,11,5,1367
2400513-008,2842,2269,1656,264,125,56,157,4,613
2400503-003,3166,2544,311,137,2060,39,52,2,2233
2400512-012,3534,2807,2239,194,215,87,73,5,568
2451015-005,1501,1241,37,35,1165,20,9,5,1204
2451027-029,1112,908,30,7,859,12,6,0,878
2404508-005,1881,1502,891,61,395,33,110,1,611
2400307-004,2201,1770,1500,59,155,42,13,3,270
2451027-036,1242,932,47,11,861,19,8,0,885
2400303-014,2337,1843,1599,78,64,52,33,3,244
2402501-005,3642,2782,1399,236,996,82,92,16,1383
2403113-024,3109,2301,1327,294,362,48,280,1,974
2403109-021,3805,2902,982,806,558,58,528,4,1920
2451024-004,3080,2693,2257,136,123,32,125,3,436
2451026-025,2812,2227,107,61,1992,22,78,1,2120
2401708-005,660,539,379,24,97,18,25,0,160
2401708-001,4764,3743,2427,130,991,111,109,8,1316
2402503-016,3212,2577,2121,72,146,40,194,6,456
2402102-017,5056,3603,1000,1176,1162,123,220,3,2603
2403305-003,3587,2906,178,470,2108,53,160,13,2728
2402706-010,2187,1698,1029,140,338,30,173,2,669
2402706-007,2479,1947,826,177,689,31,243,3,1121
2402702-013,1305,964,669,23,73,7,186,3,295
2400305-013,2323,1743,1571,50,37,27,35,2,172
2402705-015,3344,2679,1590,155,592,41,314,6,1089
2402706-005,1999,1576,857,188,380,29,146,6,719
2402706-015,3095,2273,579,374,848,43,441,5,1694
2402706-034,4172,3065,642,603,1395,83,429,11,2423
2403321-017,9137,9104,5279,432,1078,23,2318,2,3825
2403318-005,2194,1708,32,362,1305,42,18,3,1676
2403318-014,313,244,9,39,185,6,5,0,235
2400508-021,755,565,486,11,11,1,49,0,79
2403107-001,2715,2270,1527,197,196,20,327,5,743
2400502-002,5260,4068,125,230,3656,53,55,8,3943
2400305-032,1206,864,543,32,183,9,101,2,321
2400305-008,3038,2234,1844,92,123,34,120,3,390
2400305-010,1293,988,896,24,10,10,36,0,92
2400508-025,2397,1909,1578,39,94,15,158,1,331
2403113-063,3053,2221,516,1129,431,69,151,1,1705
2403113-033,3031,2194,1164,366,474,38,141,2,1030
2403106-001,2757,2128,1516,151,123,22,312,3,612
2451026-006,1999,1444,673,631,89,37,27,0,771
2451027-009,1904,1487,621,69,736,25,23,4,866
2400511-013,1706,1354,784,77,263,11,216,0,570
2400509-012,2592,2132,1728,90,147,17,139,6,404
2400305-011,2362,1829,1550,74,102,23,52,2,279
2400303-016,3045,2348,1911,110,174,66,70,3,437
2402702-020,1385,1141,730,38,157,14,201,1,411
2402705-019,3386,2506,1847,79,180,28,365,2,659
2400509-008,2028,1640,1419,48,41,14,96,2,221
2451027-038,2578,2316,979,178,693,26,471,6,1337
2404511-002,419,312,193,10,80,3,28,0,119
2404511-001,273,216,47,2,162,2,5,0,169
2451026-005,1203,933,385,345,159,18,48,1,548
2451012-007,1762,1469,477,128,800,28,66,1,992
2400304-022,3313,2393,1188,219,682,55,270,7,1205
2400306-020,1459,1439,1356,21,35,6,8,0,83
2403106-006,4104,3137,1098,183,174,27,1653,2,2039
2403113-069,2520,2495,1843,118,316,18,195,5,652
2401706-020,2057,1538,489,107,840,52,95,6,1049
2401709-002,3396,2707,1835,91,645,79,65,3,872
2451026-020,1053,788,39,22,732,12,4,3,749
2451013-004,1552,1298,1023,62,77,27,129,7,275
2403321-011,4566,3409,335,499,2410,45,235,3,3074
2403318-008,2289,1782,21,150,1601,19,20,3,1761
2403310-011,3464,2552,367,235,1762,59,205,3,2185
2400305-009,1619,1179,1094,20,17,12,29,0,85
2400304-011,2748,2020,1063,210,589,34,129,10,957
2402706-013,1975,1577,903,173,341,17,144,4,674
2402704-002,2218,1652,1344,53,58,19,162,0,308
2403708-010,1543,1151,610,77,391,23,66,3,541
2403321-013,4443,3508,392,309,2514,56,316,10,3116
2400305-024,2084,1519,1399,37,23,10,31,4,120
2404326-003,1491,1164,985,61,60,23,43,1,179
2400302-010,3412,2781,2069,207,349,106,75,2,712
2402501-011,3991,2981,2441,110,236,45,139,5,540
2400502-009,4170,3133,153,119,2830,35,47,6,2980
2451015-014,1659,1300,19,10,1270,22,4,1,1281
2404303-001,1357,1205,865,57,231,29,15,1,340
2400503-008,4163,3385,2685,77,327,23,262,3,700
2451027-027,2179,1735,51,12,1663,32,7,0,1684
2400503-010,3766,3022,2626,39,206,17,108,2,396
2451007-002,816,710,159,26,293,15,226,0,551
2402706-032,2049,1651,1148,88,168,22,231,0,503
2403910-001,166,152,144,4,3,2,2,0,8
2400302-015,3391,2542,1248,178,912,42,170,7,1294
2400305-026,4877,3625,2932,175,317,60,135,2,693
2400307-008,2923,2324,1750,135,337,69,26,6,574
2402501-015,4476,3366,2315,183,629,83,169,4,1051
2403110-013,2243,1762,965,71,68,4,629,2,797
2400306-031,1709,1394,1239,48,37,19,38,1,155
2401307-005,1051,919,862,15,19,9,14,0,57
2402501-027,2083,1538,1056,54,183,29,210,1,482
2402702-014,1335,994,653,46,104,9,165,0,341
2402705-007,2259,1868,867,134,598,31,250,1,1001
2402702-005,2020,1568,939,56,70,16,490,3,629
2402124-003,855,708,654,21,10,6,13,1,54
2403309-015,23,12,4,4,3,2,1,0,8
2403309-009,2279,1725,339,372,973,54,26,0,1386
2451028-004,959,784,16,21,744,6,7,2,768
2403108-011,3801,2919,1560,259,541,23,517,4,1359
2400502-023,758,564,150,19,373,11,19,0,414
2451027-016,983,786,324,18,421,18,12,1,462
2403113-045,2789,2239,753,787,263,70,408,2,1486
2403113-070,336,264,66,82,51,9,66,0,198
2451020-008,869,684,77,19,583,12,11,2,607
2402501-021,1332,1003,792,55,102,15,50,4,211
2451025-008,4014,2683,119,128,2408,33,34,4,2564
2451013-005,1131,989,724,46,156,20,33,0,265
2403306-023,2462,1940,89,220,1608,25,19,3,1851
2402706-008,2640,1988,705,262,844,49,171,1,1283
2402705-023,1985,1586,788,83,441,30,265,5,798
2403321-016,2585,2017,202,521,1183,81,145,9,1815
2403305-009,774,624,56,119,428,8,26,0,568
2403113-055,5114,3603,360,1552,1363,61,229,5,3243
2403104-024,4106,3101,1200,166,357,16,1370,2,1901
2403104-035,489,431,248,7,64,5,107,0,183
2400305-027,2574,1992,1664,97,104,28,95,2,328
2401912-001,515,417,312,7,71,12,13,0,105
2451009-012,1814,1389,34,22,1324,27,11,4,1355
2451026-017,1038,732,32,23,678,22,6,2,700
2400508-009,4077,3084,2251,101,69,10,644,1,833
2402706-022,2404,1872,942,171,472,49,249,8,930
2402704-001,2033,1568,1334,93,48,35,53,4,234
2451013-009,1566,1322,126,26,1148,38,14,3,1196
2402503-023,4345,3431,2757,150,242,55,185,11,674
2402702-008,4214,2981,1391,112,269,21,1185,4,1590
2402702-021,490,349,256,12,10,7,59,0,93
2402706-023,951,786,564,54,117,24,47,2,222
2402706-011,2114,1639,784,132,483,26,248,2,855
2402705-008,2632,2115,1039,197,665,38,180,5,1076
2403315-003,3076,2464,157,125,2145,34,57,10,2307
2400511-020,94,80,77,0,2,0,1,1,3
2401706-016,4173,3242,681,211,2149,81,194,3,2561
2403913-003,276,228,154,7,56,6,4,0,74
2451011-007,2024,1962,1178,131,439,26,185,1,784
2400508-004,3086,2458,1966,83,132,28,241,2,492
2451024-001,933,808,679,23,56,4,41,1,129
2400503-014,2650,1939,1244,82,550,20,72,8,695
2400304-005,2176,1563,1009,111,284,33,123,3,554
2400306-016,1864,1433,643,220,536,27,28,0,790
2400502-021,1358,1131,779,30,269,24,20,6,352
2451008-011,654,517,23,26,463,5,2,2,494
2451016-013,1995,1481,17,25,1444,1,0,0,1464
2403113-057,2064,1669,486,201,780,38,196,0,1183
2404501-001,106,76,68,1,5,2,1,0,8
2402501-009,3629,2723,2064,134,349,31,150,6,659
2402706-025,1094,839,566,39,87,10,132,2,273
2403321-092,0,0,0,0,0,0,0,0,0
2403321-097,0,0,0,0,0,0,0,0,0
2401706-012,2214,1639,441,232,910,46,53,1,1198
2403307-017,2129,1728,183,95,1357,30,118,2,1545
2400304-019,3143,2378,617,161,1460,54,145,10,1761
2451013-002,1544,1405,1018,49,212,31,97,0,387
2402701-004,4124,2959,1869,86,343,36,625,5,1090
2403317-009,3553,2785,305,1634,661,227,224,7,2480
2400502-027,3439,2579,287,55,2089,29,150,2,2292
2451027-054,658,507,27,8,470,1,5,2,480
2400305-035,256,181,149,8,17,4,4,1,32
2402705-003,4051,3374,1688,226,1115,69,295,14,1686
2403321-012,1093,929,533,75,106,5,200,0,396
2403321-019,58,50,28,5,5,1,10,0,22
2400508-020,2028,1658,1261,73,93,15,209,3,397
2400508-019,3145,2561,2103,45,42,4,342,1,458
2402502-020,63,56,52,0,0,0,4,0,4
2451027-002,662,538,348,33,141,13,19,1,190
2402705-017,2168,1742,1062,75,332,22,269,0,680
2402501-024,746,580,427,17,104,12,14,2,153
2451015-013,923,720,1,4,714,7,3,1,719
2400502-020,1034,864,225,21,580,10,30,3,639
2403913-001,178,153,127,4,22,1,0,0,26
2401706-008,2888,2139,472,187,1438,72,48,2,1667
2451027-051,389,374,98,4,270,7,3,0,276
2451020-004,236,183,0,0,183,0,1,1,183
2400508-010,3204,2465,2031,61,89,23,253,3,434
2400305-016,1835,1461,1257,68,28,31,75,3,204
2401915-002,159,131,108,2,20,2,0,2,23
2451027-023,656,534,25,5,498,5,6,2,509
2400509-027,43,24,18,0,2,1,3,0,6
2402705-009,3707,2773,753,470,1131,89,399,9,2020
2403310-004,5000,3961,578,600,2542,75,247,11,3383
2402705-012,2573,2016,962,127,687,41,225,8,1054
2402706-017,3464,2620,813,275,1132,51,393,2,1807
2451001-001,1893,1649,1172,174,181,36,102,0,477
2402702-019,2146,1590,1048,57,101,19,372,4,542
2400305-031,805,603,419,16,135,11,25,1,184
2403321-098,0,0,0,0,0,0,0,0,0
2402705-018,1941,1551,655,155,576,33,160,2,896
2402701-005,847,649,438,19,87,5,108,0,211
2402705-021,3173,2503,1159,201,869,37,267,1,1344
2400307-020,2641,1980,1316,127,412,27,108,3,664
2403102-007,106,87,87,0,0,0,0,0,0
2403302-096,0,0,0,0,0,0,0,0,0
2403302-099,0,0,0,0,0,0,0,0,0
2400510-005,416,322,286,6,0,9,18,0,36
2403321-099,0,0,0,0,0,0,0,0,0
2451027-043,897,847,651,40,100,13,54,4,196
2400504-013,844,655,570,21,19,1,35,1,85
2400502-028,475,376,17,20,338,1,7,0,359
2403301-007,2300,2171,1555,120,387,34,98,3,616
2403316-099,0,0,0,0,0,0,0,0,0
2400502-022,53,46,12,0,33,0,1,0,34
