GEOID,TOTAL_POP,TOTAL_VAP,WHITE_VAP,HISPANIC_VAP,BLACK_VAP,NATIVE_VAP,ASIAN_VAP,PACIFIC_VAP,MINORITY_VAP
42035000100,1005,827,787,5,5,12,13,3,40
42099000250,2597,1924,1867,17,12,16,13,2,57
42099000260,1017,694,677,4,4,7,0,0,17
42099000040,5238,4204,3977,52,30,82,32,7,227
42099000150,2652,2112,1916,63,56,51,22,6,196
42099000020,1219,968,924,9,10,13,8,1,44
42003005041,631,464,122,11,331,10,1,0,342
42003000430,400,295,279,0,5,1,2,0,16
42003000411,1297,970,869,22,55,8,9,1,101
42003002571,902,708,655,15,7,12,16,1,53
42007000985,1545,1218,1139,13,27,11,8,0,79
42007000435,1753,1517,1387,15,84,10,14,4,130
42007000975,1597,1301,1196,24,35,24,8,0,105
42007001460,751,610,438,13,145,12,1,2,172
42007001490,940,806,621,15,125,32,5,0,185
42007001040,2248,1875,1751,19,7,55,11,1,124
42007000065,1406,1250,1013,43,145,13,24,1,237
42099000065,1478,1151,1049,23,25,31,18,2,102
42099000240,2263,1882,1800,21,11,24,10,0,82
42099000120,221,166,147,2,4,8,1,0,19
42099000050,2529,2048,1928,32,39,25,6,1,120
42099000270,2295,1808,1745,15,7,21,17,3,63
42099000191,1485,1097,1033,15,27,14,6,2,64
42007000780,2547,2014,1949,9,9,24,2,0,65
42007000510,856,694,640,11,25,13,0,0,54
42007000550,1204,984,903,11,37,6,17,0,81
42007001240,1551,1195,1014,29,95,37,12,6,181
42007000015,1440,1016,167,38,800,19,2,0,849
42007000095,681,566,231,19,300,9,3,2,335
42007000026,386,313,8,8,296,15,0,1,305
42007000036,508,364,162,12,178,15,5,3,202
42007000995,2512,2025,1741,59,103,24,70,1,284
42007000960,1349,1075,976,18,33,23,15,0,99
42007000500,1123,979,866,19,47,16,26,2,113
42007001210,769,603,520,11,51,16,4,0,83
42007000075,1166,986,783,42,130,19,7,1,203
42099000290,396,292,274,8,2,7,0,0,18
42099000330,3203,2577,2460,38,21,40,13,1,117
42099000320,1231,978,924,10,2,19,8,1,54
42099000080,1030,816,790,5,0,11,6,0,26
42099000100,590,381,352,17,3,5,5,1,29
42007001480,964,742,601,14,105,20,3,0,141
42007001560,1316,1066,864,51,123,24,5,1,202
42007000055,2277,1710,879,75,717,27,14,3,831
42007001185,1557,1159,1061,19,49,19,5,2,98
42007001380,639,511,464,18,19,7,5,0,47
42007001055,1838,1486,1352,28,42,38,9,1,134
42007000440,1599,1270,1228,11,10,13,8,3,42
42007001320,610,479,430,11,10,14,3,3,49
42007001175,1252,1032,951,14,29,21,6,0,81
42007001290,1398,1102,1049,12,16,14,6,0,53
42007000405,1852,1559,1478,6,20,24,10,1,81
42007001148,773,634,579,12,22,11,3,0,55
42007000155,1278,1005,624,55,272,42,17,1,381
42007001080,798,665,644,6,3,11,2,0,21
42007000770,1335,1101,1062,8,0,16,7,0,39
42003005880,717,615,309,22,243,2,37,1,306
4200300E010,778,612,536,9,33,3,25,0,76
4200300D980,1053,820,692,19,24,3,71,1,128
4200300E000,679,553,497,13,11,8,22,0,56
4200300E140,1607,1279,1181,23,40,16,14,0,98
42003003360,1081,856,744,22,22,7,63,1,112
42003003700,693,480,190,19,256,7,9,2,290
4200300B030,690,616,492,19,86,10,9,2,124
42003000452,1073,878,807,16,20,8,20,0,71
42003000441,1107,930,844,18,25,9,22,1,86
42003000522,1126,947,890,11,17,3,17,1,57
42003000472,1415,1192,1108,12,25,22,21,1,84
42003001200,538,401,94,8,286,10,4,0,307
42003001740,591,436,130,9,291,14,1,0,306
4200300B130,775,673,501,30,116,12,16,0,172
42067000200,2790,2012,1916,33,13,23,16,3,96
42007001535,1295,1141,1073,12,28,7,15,4,68
42007000265,1436,1185,1094,19,36,22,1,0,91
42007000005,527,419,385,4,26,4,1,2,34
42003005291,818,671,615,5,14,18,10,0,56
42003003000,2511,1842,1659,23,40,9,106,3,183
4200300H091,849,669,75,15,575,14,4,0,594
42003006390,1859,1764,1334,57,145,4,216,1,430
4200300B600,924,779,647,19,69,10,23,0,132
4200300C440,424,313,130,12,158,6,2,1,183
42003009130,1918,1864,1434,144,178,6,98,1,430
42003000770,1183,928,880,9,10,7,19,1,48
42003003570,21,17,6,6,6,0,0,0,11
4200300B660,761,578,369,9,184,15,12,0,209
4200300A350,315,223,51,9,157,2,4,0,172
42003003070,2096,1449,1234,37,37,10,120,1,215
42003000950,589,510,408,12,62,7,17,0,102
42003001451,1125,951,725,24,158,13,28,2,226
4200300B720,343,261,153,2,88,9,3,0,108
42007001095,1509,1206,925,56,177,21,22,0,281
42007001340,1529,1231,1150,16,21,20,4,2,81
42007001350,1820,1525,1427,24,15,27,5,6,98
42007000735,1607,1353,1305,15,11,8,8,1,48
42007001400,1300,1105,974,23,52,22,7,4,131
42007000808,1496,1112,987,14,51,37,7,2,125
4200300B620,88,68,37,2,27,2,2,0,31
4200300B700,820,646,404,13,223,4,4,1,242
42003002920,1280,1011,915,28,20,11,36,1,96
42003002640,2240,1754,1670,18,6,9,37,0,84
42003005370,1616,1408,1296,26,47,12,24,0,112
42003005241,913,704,627,7,15,7,40,1,77
42001000400,2044,1599,1328,212,21,31,14,0,271
42001000425,3273,2571,2271,216,26,34,31,0,300
42001000370,3701,2835,2343,381,26,57,12,3,492
42117000130,48,42,40,1,1,0,0,1,2
42117000280,569,485,449,13,5,12,1,3,36
42117000430,1661,1357,1255,23,10,20,38,1,102
42117000460,1112,890,856,7,9,6,4,0,34
42067000071,636,522,505,2,4,9,0,0,17
42117000320,2169,1732,1634,15,15,38,10,0,98
42117000230,1033,803,771,9,5,6,4,0,32
42117000240,234,169,158,0,0,9,1,0,11
42117000392,946,736,707,3,7,2,4,2,29
42067000030,3340,2643,2539,41,25,29,9,3,104
42067000020,1610,1202,1152,17,8,18,1,0,50
42067000010,768,598,574,4,5,10,3,0,24
42003003021,933,777,704,9,18,8,29,4,73
42003000050,1032,811,733,30,8,11,27,0,78
4200300E685,771,643,569,8,46,6,13,1,74
4200300C860,990,808,645,20,110,9,8,0,163
42003003440,679,485,463,4,4,0,12,0,22
4200300A210,1085,1032,864,40,84,12,37,1,168
42003004940,382,334,275,13,22,8,6,0,59
42003002501,1404,1141,992,43,39,8,56,0,149
4200300A290,778,699,558,35,68,7,20,1,141
4200300B390,582,509,455,15,22,10,9,0,54
4200300D420,937,709,424,21,125,16,126,0,285
4200300D200,918,776,609,21,53,9,86,1,167
4200300F510,1203,971,850,5,53,16,30,0,121
4200300F529,930,745,675,30,15,13,15,0,70
4200300D300,830,665,292,27,319,13,14,4,373
42003006500,352,264,12,6,251,11,1,1,252
42003006920,545,510,433,16,37,3,17,0,77
42003007390,910,845,681,37,44,7,71,1,164
42003007890,788,648,551,14,62,5,15,0,97
4200300B520,1063,909,738,18,51,6,88,0,171
42003003580,373,318,168,4,134,6,6,0,150
4200300E135,2810,2082,1890,8,124,12,32,4,192
42003005400,900,724,88,6,631,11,1,1,636
42003002190,2573,2017,1861,37,54,18,25,3,156
4200300G670,1108,910,822,11,50,22,2,0,88
42003003491,1033,813,444,19,321,24,18,1,369
42003008340,817,663,410,32,191,6,27,0,253
4200300F641,586,480,353,24,88,17,8,1,127
42001000040,2403,1971,1781,70,45,38,30,0,190
42001000120,1417,1171,1090,10,27,21,26,2,81
42001000290,2395,1849,1661,124,11,28,26,3,188
42001000180,2318,1917,1726,95,31,52,14,3,191
42117000210,1614,1282,1221,7,19,21,3,0,61
42055000105,5881,4319,2358,1158,688,153,109,3,1961
42055000213,3133,2558,2283,110,81,52,34,5,275
42055000226,4665,3638,3222,159,127,33,79,8,416
42055000280,452,383,372,8,0,0,1,0,11
42055000229,2396,1900,1630,118,112,37,10,4,270
42055000219,2665,2024,1768,72,141,19,34,2,256
42055000216,2455,2043,1748,166,79,10,47,3,295
42127000070,1221,1037,993,12,4,11,7,0,44
42127000190,4850,4023,3682,169,68,49,50,0,341
42001000432,1901,1496,1361,76,9,26,20,2,135
42001000436,1912,1516,1437,29,6,19,15,3,79
42001000310,2646,2069,1929,69,14,21,16,2,140
42001000410,1868,1389,1152,183,26,18,15,1,237
42001000385,1955,1614,1496,39,23,22,14,2,118
42001000440,2172,1810,1636,85,42,19,17,1,174
42001000390,2622,2131,1981,51,36,34,19,0,150
42001000380,1834,1497,1367,45,25,24,23,1,130
42001000200,2844,2290,2177,35,19,29,14,2,113
42001000460,2268,1788,1578,148,18,24,15,1,210
42001000240,1689,1339,996,186,97,38,34,2,343
42001000078,2129,1698,1580,32,16,30,10,4,118
42001000360,1269,967,850,54,25,15,8,4,117
42001000350,1808,1388,1197,115,36,15,18,1,191
42113000140,314,286,270,2,1,7,0,0,16
42113000010,1065,866,832,8,1,13,3,0,34
42067000120,2055,1614,1561,19,18,11,5,0,53
42065000655,2546,2043,1952,6,9,39,12,3,91
42065000475,2549,1965,1857,26,14,34,5,0,108
42117000045,3565,2793,2649,45,8,45,17,1,144
42055000670,1853,1439,1284,41,49,35,11,2,155
42055000650,1503,1120,1000,37,54,16,19,1,120
42055000725,1279,1035,932,30,32,13,14,2,103
42029000690,2476,1910,1687,146,40,23,23,1,223
42029000340,2934,2285,1918,120,33,15,165,1,367
42067000110,1993,1621,1498,85,12,18,5,0,123
42031000090,2393,2116,1784,66,178,28,62,1,332
42073000555,1406,1135,858,31,231,18,2,0,277
42073000870,1484,1206,1157,2,3,17,6,0,49
42073000880,1429,1143,1079,2,2,32,10,0,64
42073000770,777,628,599,2,5,15,0,0,29
42019000770,1400,1160,1117,9,6,12,5,1,43
42073000864,1150,894,866,8,1,6,4,0,28
42073000862,1406,1170,1094,7,11,24,10,1,76
42073000010,1076,858,823,11,4,5,4,0,35
42073000335,1104,873,775,29,55,10,3,1,98
42073000700,1211,955,907,7,3,11,11,0,48
42073000710,1470,1164,1109,12,3,20,7,2,55
42073000720,1281,1000,958,9,2,14,5,0,42
42117000110,1059,823,797,4,1,12,1,1,26
42117000100,1734,1424,1364,14,4,25,11,2,60
42031000280,1487,1223,1163,7,11,12,19,2,60
42031000020,1833,1433,1384,2,11,21,3,1,49
42031000290,978,759,721,5,12,2,4,0,38
42031000190,534,455,432,4,7,2,6,2,23
42061000330,757,550,387,10,136,15,1,1,163
42061000090,868,702,682,6,0,7,4,0,20
42061000110,1478,1223,1188,6,5,19,1,0,35
42001000270,2300,1891,1786,34,10,40,20,4,105
42055000690,1545,1210,1066,51,58,28,11,1,144
42055000223,3122,2391,2062,114,103,37,62,6,329
42055000620,2220,1743,1600,28,72,19,19,2,143
42055000170,1430,997,952,15,7,14,1,2,45
42061000340,700,548,476,18,36,10,2,1,72
42061000270,611,495,484,4,4,2,3,0,11
42061000500,199,181,178,1,0,0,2,0,3
42011001715,2280,1747,1172,325,208,18,58,2,575
42011000208,2046,1600,1502,62,12,18,5,0,98
42011000212,2084,1691,1538,90,22,27,7,2,153
42011000730,1709,1225,604,501,112,39,19,1,621
42011001370,2126,1620,502,869,276,35,25,6,1118
42011001520,2569,2026,1494,349,147,31,30,0,532
42011001775,2269,1754,1528,96,49,13,63,1,226
42011001795,2593,2067,1678,188,64,6,135,5,389
42001000434,1986,1482,1291,134,10,31,11,1,191
42055000200,2210,1716,1538,40,63,27,43,0,178
42055000462,1532,1212,1159,12,14,23,4,0,53
42055000140,1646,1393,1202,80,88,18,17,2,191
42055000560,1373,1038,957,16,24,28,4,0,81
42055000610,3594,2901,2682,51,56,50,47,1,219
42055000090,2227,1845,1528,147,116,33,33,6,317
42055000050,5202,3834,3548,82,68,62,54,6,286
42065000540,2370,1858,1794,3,7,23,2,1,64
42065000060,2276,1840,1761,8,9,30,9,1,79
42065000690,80,67,62,3,1,1,0,0,5
42065000510,773,568,555,3,0,5,2,1,13
42127000330,1482,1273,1137,49,33,31,15,0,136
42031000340,399,348,342,2,0,3,1,0,6
42065000315,1323,1112,1056,4,27,12,0,0,56
42031000370,776,620,602,2,2,8,2,0,18
42131000230,2687,2203,2072,25,25,23,19,0,131
42131000090,307,256,241,2,0,11,1,0,15
42131000150,1668,1388,1310,17,16,27,1,2,78
42131000120,899,687,651,9,6,13,0,1,36
42131000290,1334,1031,975,19,11,10,4,0,56
42131000030,1435,1221,1151,6,10,19,15,1,70
42127000010,1300,1025,952,24,6,22,11,2,73
42127000100,2167,1769,1653,48,12,22,24,0,116
42127000110,1350,1107,979,52,18,22,29,0,128
42127000290,4115,3446,3142,132,66,44,43,3,304
42127000310,1793,1449,1361,24,4,35,11,0,88
42079001552,2711,2299,2126,74,39,30,13,1,173
42079000920,3025,2244,734,1405,209,35,18,12,1510
42079000165,1312,1076,999,32,11,16,8,2,77
42079002635,1723,1408,1187,108,71,26,13,1,221
42079000105,1909,1625,1543,35,12,14,17,0,82
42079000807,2020,1632,1274,292,42,33,30,10,358
42079002025,1884,1562,1372,66,64,26,30,0,190
42079002404,1242,1044,900,97,26,2,23,3,144
42079001150,1162,965,925,5,5,16,3,1,40
42079002406,1222,1013,939,47,5,10,5,1,74
42079002402,1382,1073,1010,22,7,9,25,0,63
42079000152,1706,1390,1295,36,26,15,19,0,95
42079000825,1610,1333,1130,163,31,12,5,2,203
42079000132,2121,1809,1663,84,22,18,27,1,146
42079000095,291,237,222,10,0,0,0,0,15
42079001615,2212,1798,1536,113,96,32,23,1,262
42079001760,222,180,170,4,1,3,4,0,10
42055000315,4694,3581,3118,223,149,69,39,5,463
42055000546,3153,2375,2232,55,39,30,13,2,143
42055000543,3119,2381,2182,59,73,25,30,1,199
42127000260,3676,3107,2834,149,32,51,32,1,273
42031000010,1119,860,838,2,4,12,1,2,22
42065000160,994,788,757,14,3,11,3,0,31
42079000142,1556,1276,1173,56,17,4,25,2,103
42079001035,3147,2246,765,1428,123,23,9,3,1481
42101004314,649,498,14,66,417,13,7,9,484
42101000205,959,802,530,95,22,25,143,2,272
42101003201,356,259,13,10,230,3,7,0,246
42101001814,1381,1181,640,235,235,12,79,1,541
42101001024,595,491,2,4,483,11,4,0,489
42101001014,977,752,9,13,732,12,3,2,743
42101000311,833,669,22,8,631,19,7,0,647
42101004104,1045,726,324,191,181,18,24,0,402
42101004511,1079,776,172,377,261,20,22,1,604
42101004028,1460,1065,116,24,731,16,199,4,949
42101006316,701,572,463,26,32,10,46,0,109
42101005016,964,791,9,24,764,9,5,0,782
42101003005,854,720,470,39,145,7,56,1,250
42101005210,621,570,112,10,407,8,32,2,458
42101005830,1040,797,513,22,36,2,207,1,284
42031000310,1645,1365,1255,19,56,9,13,1,110
42031000130,1434,1150,1119,1,6,9,5,2,31
42031000440,442,350,333,5,3,8,1,1,17
42031000350,513,422,408,4,0,7,0,0,14
42101002806,539,405,1,13,394,6,2,1,404
42101003629,922,759,319,78,56,6,305,0,440
42101003946,1028,887,732,73,18,15,55,1,155
42101003945,1073,907,741,54,29,17,74,0,166
42101004818,722,624,183,40,101,8,295,6,441
42101006622,1611,1252,813,94,109,14,229,1,439
42101003428,765,607,37,13,547,9,18,1,570
42101003414,1074,891,39,27,823,12,13,3,852
42101003412,960,748,10,9,719,12,15,0,738
42101001517,1300,1169,901,85,38,5,127,0,268
42101001515,671,615,427,74,83,5,31,0,188
42101002107,1220,1147,956,78,54,5,52,0,191
42101001502,1040,905,706,51,80,6,48,0,199
42101000606,510,405,6,7,379,0,11,3,399
42011000090,1649,1274,1190,33,19,11,20,0,84
42011000080,3813,3334,2677,385,200,38,31,2,657
42011001550,2109,1675,1437,116,47,13,68,0,238
42011000770,3040,2217,1237,836,121,36,38,3,980
42101002144,943,759,664,21,43,12,20,3,95
42101002134,1246,1024,768,40,129,18,70,2,256
42101006217,1120,812,203,210,347,19,49,2,609
42101001901,731,529,10,409,141,15,12,4,519
42073000950,1196,1036,967,7,37,9,8,0,69
42073000920,989,868,832,5,15,3,3,0,36
42073000255,1372,1117,1036,10,8,23,2,0,81
42079000975,2739,2016,913,1051,152,31,8,6,1103
42101004308,962,685,19,453,239,11,0,0,666
42101001324,523,393,4,32,363,6,1,0,389
42101000829,1738,1686,1331,54,117,8,172,0,355
42101003417,1003,781,55,26,689,11,12,1,726
42101004012,846,577,54,22,451,1,46,1,523
42101006415,1405,1246,821,110,221,5,75,3,425
42101006407,1009,880,661,53,107,1,43,1,219
42101004702,811,753,247,62,254,9,186,0,506
42101004919,957,697,17,116,564,16,9,0,680
42101004909,2043,1509,37,524,765,23,220,1,1472
42101000201,1193,993,797,69,60,15,62,0,196
42101005821,1061,857,668,59,59,6,68,1,189
42101004512,568,447,251,98,101,6,9,4,196
42079000666,1386,1098,996,59,28,13,6,2,102
42079000596,3833,2887,2255,506,74,52,28,0,632
42079002065,2602,2292,2013,40,106,23,121,0,279
42079000845,1652,1359,1119,188,28,11,17,2,240
42041000350,4713,3975,3379,118,139,54,261,9,596
42041000340,2059,1682,1351,136,116,9,58,6,331
42041000770,1714,1258,1179,20,19,16,20,0,79
42073000485,1560,1201,1006,7,144,22,7,1,195
42073000080,1037,841,780,15,14,10,1,0,61
42073000075,839,688,627,7,18,4,11,0,61
42079002655,1847,1539,1358,80,57,7,39,0,181
42079001245,1982,1763,1634,45,44,22,25,1,129
42079001625,1887,1533,1340,78,89,25,3,1,193
42079000484,2302,1720,1521,57,33,25,73,1,199
42079000482,2401,1905,1732,61,19,8,76,0,173
42079001225,1520,1223,1148,21,19,4,27,0,75
42079000148,1822,1520,1371,44,20,27,55,0,149
42079000750,1341,1010,886,39,63,13,8,2,124
42079003045,1828,1414,827,347,224,32,30,3,587
42079001515,1078,852,818,7,9,10,1,0,34
42079001420,1993,1595,1543,6,6,16,2,1,52
4200300C810,656,522,408,13,85,8,14,0,114
4200300C720,620,473,218,17,217,9,9,0,255
4200300C790,731,624,488,12,103,12,12,1,136
42003009010,283,197,6,4,184,6,2,0,191
42003003225,1474,1097,890,24,15,5,140,0,207
42003003233,1619,1161,925,32,10,6,180,1,236
42003003238,1938,1538,1269,48,34,18,163,0,269
42003000310,1505,1140,1053,25,24,4,25,3,87
4200300A580,567,505,388,35,64,10,13,1,117
4200300A840,102,80,45,6,19,2,5,0,35
4200300E210,599,416,61,14,344,0,5,4,355
42003008030,480,356,31,8,306,5,10,1,325
42003005310,1025,862,805,8,33,6,5,2,57
42003009710,1441,1186,906,49,60,9,155,2,280
42003003051,1426,1128,1063,14,19,18,16,0,65
42061000450,784,627,608,4,6,5,1,1,19
42061000220,1827,1682,1421,68,69,7,112,3,261
42061000480,4618,4374,2249,309,1761,22,23,0,2125
42061000140,495,390,352,24,1,4,3,0,38
42061000360,1012,820,788,5,8,5,4,0,32
42061000380,1077,889,864,1,1,19,0,0,25
42061000560,1871,1452,1403,15,15,12,1,0,49
42003005721,1431,1191,885,10,263,10,14,0,306
42003006715,455,416,359,9,32,5,10,0,57
42003003870,486,369,267,11,82,14,2,0,102
42003005430,507,400,28,11,358,7,0,0,372
42003005420,417,314,17,4,291,12,2,0,297
4200300A720,514,389,40,24,317,7,6,0,349
4200300D280,1214,970,753,12,177,20,14,1,217
42003000624,1712,1368,1250,13,21,16,61,0,118
42003000486,1408,1159,1081,16,15,13,32,0,78
4200300G170,812,581,519,12,4,5,43,0,62
42003009630,688,576,477,15,40,2,36,2,99
4200300F800,804,697,532,24,123,11,15,0,165
42003000930,1589,1384,1163,26,95,25,71,2,221
42003002770,868,643,477,16,104,22,21,0,166
42003005812,1924,1496,1321,29,32,23,84,0,175
42003003010,1230,1005,954,9,13,16,8,0,51
42003003060,553,418,381,11,6,3,10,1,37
4200300A270,580,509,378,14,103,12,8,1,131
4200300F241,1080,890,824,13,8,13,22,0,66
42057000080,1065,846,808,4,1,24,0,3,38
42061000020,434,352,344,1,1,3,1,0,8
42073000160,1339,1124,1064,16,10,22,5,0,60
42073000170,1369,1075,1035,16,13,6,2,0,40
42073000940,1100,894,785,7,67,16,2,1,109
42073000665,1136,847,622,19,181,16,4,2,225
42073000625,1619,1302,1143,20,88,31,4,4,159
42073000990,711,583,552,4,7,13,3,0,31
42029000371,2778,2282,2093,41,40,9,57,0,189
42029001715,2200,1660,1455,51,60,3,60,1,205
42029001705,2191,1727,1223,121,169,22,182,1,504
42029001540,1800,1529,1169,178,171,16,26,0,360
42029001520,1838,1561,1085,250,203,14,30,0,476
42029001510,941,724,308,142,255,12,21,2,416
42029001650,2625,2182,1815,117,120,21,96,0,367
42029000860,781,704,644,9,11,5,24,1,60
42029001316,6788,4567,2410,118,104,17,1899,9,2157
42003004510,1061,765,688,19,15,1,42,0,77
4200300C980,841,689,466,18,178,14,13,1,223
4200300F270,707,555,545,1,5,1,3,0,10
42073000840,797,627,583,7,8,9,10,0,44
42073000690,2092,1838,1679,30,87,8,22,4,159
42053000100,668,538,524,2,0,4,0,0,14
42073001010,1593,1325,1230,16,10,9,12,1,95
42073000760,1189,979,912,4,4,17,15,0,67
42073000820,1492,1208,1120,22,12,14,2,0,88
42073000850,897,730,699,0,0,12,2,0,31
42073000150,1224,982,946,4,5,14,0,0,36
42073001000,876,731,657,16,3,12,9,4,74
42079002300,2726,2242,2149,5,10,47,12,0,93
42079002755,3312,2345,1108,542,706,34,40,10,1237
42079002745,3190,3068,2351,240,360,23,106,4,717
42079001235,781,635,580,20,24,2,7,0,55
42079000310,2459,1939,1798,48,32,21,36,1,141
42079000442,2533,2002,1838,43,69,16,19,3,164
42079001750,1480,1215,1113,26,20,45,5,1,102
42079002445,1954,1619,1549,25,11,10,16,1,70
42079000495,1580,1314,1185,46,24,25,25,6,129
42079001005,3341,2516,1014,1415,167,25,22,6,1502
42003005191,878,677,576,11,16,8,60,0,101
4200300G041,904,696,400,16,256,26,8,0,296
42031000180,477,348,341,1,1,2,0,0,7
42031000250,1157,935,909,7,4,8,6,1,26
42065000130,319,256,244,0,0,5,0,0,12
42065000375,1731,1441,1355,23,11,26,8,2,86
42065000355,2375,1943,1829,22,14,40,12,0,114
42065000395,1663,1314,1216,26,23,26,8,4,98
42065000275,1248,996,956,4,4,14,5,1,40
42031000470,537,445,414,3,7,9,1,1,31
42065000590,844,677,654,2,1,13,2,0,23
42101006103,1305,968,48,194,474,7,283,3,920
42131000240,1287,1053,989,12,16,20,10,2,64
42029000570,1259,973,826,74,52,3,5,4,147
42079002478,2387,1762,614,1070,127,26,14,4,1148
42079002498,2776,2094,982,1047,100,34,11,6,1112
42079002325,2042,1625,1466,96,24,25,18,1,159
42079002315,1985,1668,1575,23,13,33,13,1,93
42079000300,1413,1183,1095,36,25,8,12,1,88
42079000555,1983,1714,1592,58,32,21,10,0,122
42079002620,1166,910,843,47,11,4,10,3,67
42079001200,4631,4185,2699,279,1134,23,38,3,1486
42079002122,1717,1399,1300,48,31,24,4,1,99
42079000229,1631,1293,1237,16,11,2,28,2,56
42079000227,1692,1310,1206,27,6,20,51,0,104
42079000225,1829,1496,1426,19,7,11,23,3,70
42079002425,2097,1793,1686,41,20,14,21,2,107
42079002815,2899,2070,942,639,465,30,63,4,1128
42079002390,1001,789,726,22,26,3,10,1,63
42079002935,1721,1371,898,222,179,15,70,2,473
42031000500,1865,1377,1341,3,4,19,1,0,36
42065000020,465,392,378,1,0,3,4,0,14
42065000035,2010,1618,1556,5,1,30,4,2,62
42065000620,1892,1514,1451,15,5,20,8,0,63
42075000340,3860,3054,2479,317,146,33,102,3,575
42075000130,1280,910,561,281,70,10,13,0,349
42075000240,2117,1567,596,849,167,31,26,1,971
42075000170,2171,1759,1253,374,101,37,29,6,506
42075000160,3041,2392,1443,764,184,43,21,8,949
42075000062,2850,2357,2215,67,28,14,31,1,142
42075000064,1754,1576,1505,18,18,5,16,0,71
42075000070,2658,2119,1959,67,32,28,19,4,160
42075000370,3820,2976,2587,237,54,23,76,8,389
42075000310,1310,998,912,55,16,7,16,3,86
42075000260,2239,1616,888,630,96,26,30,0,728
42075000090,3054,2175,2096,26,21,12,11,0,79
42075000190,1262,986,511,396,92,12,2,2,475
42079000352,2827,2096,1516,217,330,33,14,0,580
42079000366,2102,1660,1324,87,185,28,30,1,336
42079001452,1150,977,916,14,23,10,10,2,61
42079000910,4378,3159,830,2243,244,34,30,16,2329
42009000140,932,757,731,3,4,15,1,2,26
42113000060,451,374,354,3,5,8,3,0,20
42079001786,2496,2049,1902,46,59,28,5,0,147
42061000120,1183,939,907,9,2,6,1,1,32
42061000230,1578,1307,1239,10,19,16,20,0,68
42009000030,1333,1147,1079,16,18,17,13,1,68
42009000010,2972,2446,2261,63,34,47,31,1,185
42009000340,2083,1483,1441,6,9,17,8,1,42
42009000270,2031,1663,1626,20,4,7,0,0,37
42009000390,3082,2528,2428,15,22,48,9,0,100
42009000190,1525,1230,1182,7,3,19,4,0,48
42009000065,1441,1154,1130,6,4,14,0,2,24
42029000630,1853,1383,777,477,105,20,22,0,606
42061000370,449,336,313,4,6,12,0,1,23
42061000180,557,462,424,7,15,8,2,1,38
42061000460,110,90,78,1,8,3,0,0,12
42009000210,1382,1122,1094,11,3,9,0,2,28
42117000060,610,494,466,5,4,18,1,0,28
42117000350,500,384,361,7,3,11,0,1,23
42117000360,1466,1168,1121,11,6,31,3,0,47
42029001300,2560,1922,1645,150,74,31,13,3,277
42029000090,3016,1962,361,442,1179,61,17,0,1601
42029000320,2426,1859,1739,38,27,8,33,1,120
42061000050,367,295,292,0,0,3,0,0,3
42077001210,3929,3074,2486,172,138,23,265,0,588
42105000100,460,363,349,1,0,6,0,0,14
42105000170,286,255,252,0,1,0,0,0,3
42029000250,3246,2415,1927,118,243,27,100,3,488
42029001250,2341,1770,1304,57,126,8,268,0,466
42029001700,819,679,585,61,8,12,8,0,94
42029000740,4817,3491,1865,1368,134,68,91,10,1626
42029000210,4497,3183,2718,102,67,26,245,0,465
42057000110,747,589,562,1,3,12,5,0,27
42041000702,1539,1344,1246,9,18,14,47,1,98
42041000714,4478,3091,1990,86,110,25,869,5,1101
42041000706,2395,1844,1439,33,26,7,328,2,405
42041000704,1873,1402,1146,20,33,6,185,4,256
42041000712,1946,1488,896,69,84,12,424,2,592
42041000630,2546,1883,1780,26,9,36,12,0,103
42029001060,2140,1655,1459,21,42,6,112,2,196
42029000715,2585,1884,1519,236,76,38,10,1,365
42029001720,2764,2133,1747,268,55,46,11,4,386
42029000670,1914,1473,993,354,74,31,29,0,480
42029001500,3023,2640,2259,141,129,9,78,0,381
42029001740,2436,1792,1576,63,79,27,8,4,216
42009000230,1637,1368,1322,3,5,26,3,0,46
42009000020,2133,1823,1725,18,14,31,21,1,98
42009000400,1658,1310,1259,7,5,22,4,0,51
42041000400,1757,1397,1338,16,10,16,5,0,59
42041000807,3518,3365,2433,235,249,39,379,1,932
42041000485,3013,2486,2127,95,131,35,85,9,359
42029001290,4421,3392,2197,134,101,21,925,5,1195
42029001460,3858,2605,2090,84,123,17,277,4,515
42029000100,1875,1373,260,340,741,36,31,2,1113
42029000080,4180,2844,1048,584,1179,65,59,4,1796
42029000510,1218,896,753,8,33,3,97,0,143
42113000130,407,361,347,3,4,6,1,1,14
42079000240,1648,1341,1270,13,11,14,28,0,71
42079001525,1429,1126,1072,5,9,7,16,0,54
42061000240,859,693,665,6,2,6,2,0,28
42101006318,879,702,473,44,30,11,146,0,229
42101004113,1017,734,367,152,214,11,12,0,367
42101004214,1598,1158,69,454,500,9,154,5,1089
42101000849,1154,1069,818,64,77,8,112,1,251
42101000853,1310,1175,740,71,131,4,235,1,435
42101000837,1224,1143,740,65,161,32,154,3,403
42101003010,845,697,462,35,138,6,50,0,235
42077000220,2058,1469,286,946,264,39,37,0,1183
42077001410,2366,1902,1377,298,179,28,50,3,525
42077000350,1740,1304,432,702,201,36,23,2,872
42079001886,1224,1040,930,47,40,14,9,1,110
42079001025,1941,1395,389,972,98,21,15,2,1006
42079002715,2253,1777,967,453,364,33,26,0,810
42079002700,2163,1701,988,446,265,44,20,4,713
42079000470,1210,981,929,13,8,16,6,2,52
42079001995,1918,1616,1529,40,11,11,14,2,87
42079001876,2227,1778,1539,111,85,22,13,2,239
42079000230,1046,817,766,18,7,9,19,0,51
42079002725,4028,3373,1941,717,727,56,37,3,1432
42079000070,901,748,703,26,11,8,1,0,45
42079002460,970,801,760,12,14,8,1,1,41
42079000930,1329,1179,989,146,37,10,20,5,190
42079002565,1646,1319,1231,39,23,5,16,1,88
42079000965,1824,1398,872,480,69,10,29,1,526
42101003808,664,504,3,25,482,0,1,0,501
42101003937,1002,870,707,39,30,5,97,0,163
42101005904,1051,854,81,40,746,35,5,2,773
42101000828,982,808,646,55,24,7,67,0,162
42101004209,1112,771,37,416,256,10,97,3,734
42079000725,2160,1642,1328,97,177,10,26,3,314
42089000370,7037,5502,3483,863,969,104,143,2,2019
42089000297,702,599,463,57,51,24,13,2,136
42089000253,2466,1940,1169,341,374,33,67,2,771
42089000251,753,548,170,194,189,13,13,1,378
42009000260,1393,1091,1054,7,4,18,0,0,37
42105000030,482,371,360,0,1,2,1,0,11
42061000350,851,639,582,7,35,14,1,2,57
42061000530,898,707,676,7,4,10,3,0,31
42061000400,1904,1517,1443,15,15,14,10,0,74
42079002345,632,514,485,6,2,13,3,0,29
42079000215,2628,2370,2041,132,88,7,88,1,329
42079000205,1319,1083,1035,22,6,5,10,0,48
42079001330,1477,1159,982,53,77,17,27,4,177
42079000452,2064,1726,1657,24,11,14,4,2,69
42011000750,2038,1677,1228,293,106,28,42,3,449
42011000510,2476,2005,1796,98,45,26,44,7,209
42035000300,1487,1140,1102,14,1,17,4,1,38
42035000265,334,277,271,1,1,4,1,1,6
42035000360,16,15,15,0,0,0,0,0,0
42035000140,1763,1239,1193,17,5,13,8,1,46
42035000160,2623,1982,1925,18,3,23,5,1,57
42117000160,658,523,510,4,0,8,0,1,13
42117000270,1312,1026,989,5,5,14,5,1,37
42117000090,544,464,440,10,1,11,0,0,24
42117000251,2839,2478,2077,111,210,52,37,5,401
42009000310,726,585,545,9,4,13,2,0,40
42009000150,1889,1519,1474,9,7,17,4,0,45
42035000120,1271,1040,980,16,4,21,17,0,60
42035000070,893,726,704,4,0,6,2,2,22
42035000280,1861,1485,1449,4,5,13,10,1,36
42035000210,2590,2023,1840,45,57,41,28,0,183
42011000810,2074,1681,1594,47,11,18,8,1,87
42011001050,2759,1781,283,1336,275,31,11,12,1498
42117000340,779,626,585,5,2,20,4,0,41
42101003301,1055,799,108,477,88,8,162,1,691
42101000709,667,468,24,355,118,7,3,0,444
42101000502,1115,1000,827,47,55,10,51,0,173
42029000780,1761,1281,1144,37,49,15,29,3,137
42029001320,1502,1107,988,43,29,3,37,0,119
42029000760,5810,4351,3888,214,84,40,79,6,463
42029000421,2210,1540,1204,58,191,28,43,0,336
42029000420,3818,2786,1436,480,123,60,710,2,1350
42029000965,1409,1211,912,136,71,19,62,5,299
42029001015,1926,1605,1301,89,104,13,62,0,304
42089000043,3858,3161,2148,491,420,49,87,2,1013
42089000026,4404,3461,2498,431,396,59,79,5,963
42101001611,462,360,13,25,331,10,3,0,347
42101004215,1504,1148,43,374,519,25,239,3,1105
42101002117,1093,964,807,38,74,8,26,0,157
42101005811,1283,1009,673,88,110,15,136,5,336
42101001016,822,630,13,15,602,8,0,0,617
42101003015,962,807,544,47,154,7,63,0,263
42041000410,1755,1376,1330,6,12,23,3,0,46
42041000622,2059,1682,1562,46,36,21,19,0,120
42041000621,3002,2338,2064,73,117,24,47,6,274
42041000610,2605,2060,1744,70,173,15,62,0,316
42079003050,2475,1892,1258,430,175,19,31,3,634
42079002470,2035,1662,1584,17,12,18,10,0,78
42079001294,2029,1667,1585,18,16,24,6,0,82
42079001288,2403,2022,1934,19,10,8,29,1,88
42079001282,1353,1111,1051,21,6,9,18,1,60
42079001296,1323,1047,995,9,2,15,18,1,52
42079000190,689,582,561,9,4,2,7,2,21
42079001320,1916,1442,1205,72,115,6,44,0,237
42079001310,2062,1625,1294,101,193,15,23,0,331
42079002845,2727,2404,1631,428,260,27,96,7,773
42079000985,2613,1960,921,956,166,28,23,7,1039
42079002480,527,420,403,6,6,0,5,0,17
42079000650,1863,1498,1335,73,50,14,15,1,163
42011001110,1996,1453,350,865,244,52,27,17,1103
42117000190,1881,1510,1437,13,12,27,9,0,73
42019000570,2207,1781,1687,15,11,32,23,0,94
42073000110,1266,1025,976,7,10,7,8,1,49
42075000010,3117,2677,2370,139,82,21,76,3,307
42035000350,1451,1226,1081,51,55,28,18,1,145
42035000290,1555,1242,1191,1,11,11,17,2,51
42011000295,1664,1385,899,288,138,22,67,0,486
42011000120,4059,2934,2725,76,30,40,34,2,209
42011000388,2058,1642,1356,133,107,20,37,0,286
42011000392,2106,1641,1280,151,156,25,35,2,361
42029000530,1370,988,838,22,25,9,93,0,150
42101001082,1403,1329,1006,94,69,9,141,1,323
42101001089,1164,1104,873,52,68,0,101,1,231
42101005828,1086,841,566,63,34,10,169,0,275
42101006610,894,680,518,49,48,11,56,2,162
42101005922,749,642,274,31,311,21,17,2,368
42101005911,746,588,19,25,552,15,2,0,569
42101004808,777,653,175,38,342,3,99,0,478
42101006522,1024,721,341,174,176,8,30,1,380
42101004126,781,556,274,118,135,9,32,2,282
42101005841,1214,962,803,43,35,17,65,1,159
42101003704,718,593,84,67,438,11,29,1,509
42101005714,880,739,639,51,20,12,20,0,100
42101004890,745,545,13,199,339,9,3,1,532
42101004912,1190,888,27,74,740,17,49,6,861
42101002119,879,764,636,41,50,12,19,0,128
42101001701,588,470,16,14,430,9,9,2,454
42101003815,939,846,576,51,138,23,60,7,270
42101003814,787,682,515,48,72,3,47,0,167
42075000520,2325,1839,1712,55,8,22,27,2,127
42075000510,666,560,525,14,2,14,2,1,35
42075000210,1848,1308,487,745,109,17,11,8,821
42075000030,3660,2859,2632,112,47,51,16,3,227
42075000350,4095,3167,2440,569,118,36,50,1,727
42011000940,1674,1181,112,873,274,37,5,0,1069
42011001694,2306,1849,1769,27,16,16,16,0,80
42011001692,2137,1772,1692,17,5,19,20,0,80
42011000070,884,705,672,15,4,5,4,0,33
42011001477,2298,1823,1570,111,85,10,50,5,253
42011001185,2124,1556,401,967,208,65,56,11,1155
42011000790,1220,1037,970,35,6,19,5,2,67
42011001460,2857,2259,1762,314,144,27,52,2,497
42011000260,2373,1843,1556,166,52,15,62,2,287
42011000280,2303,1851,1568,155,72,21,56,4,283
42011001640,1231,856,785,39,8,22,7,1,71
42075000460,3369,2556,2306,103,74,16,36,5,250
42131000210,917,720,684,8,0,13,0,0,36
42101001115,449,346,19,15,309,11,0,0,327
42101004211,1426,1011,54,550,343,12,102,2,957
42101004207,1194,870,33,650,201,32,32,1,837
42101004025,1077,759,35,8,632,5,84,0,724
42101003116,933,781,673,55,27,7,19,0,108
42101000812,1350,1300,985,83,53,12,167,0,315
42101000112,1222,1002,351,299,86,26,250,0,651
42101004901,1052,753,15,450,301,21,24,1,738
42101003433,858,686,66,19,598,6,8,0,620
42101001223,916,723,234,51,415,15,28,8,489
42035000090,973,710,678,4,4,18,1,0,32
42035000250,1479,1199,1124,18,13,23,10,2,75
42041000320,2089,1724,1452,74,81,32,75,3,272
42045000910,1553,1236,933,30,224,15,34,0,303
42045003150,1381,1122,832,47,196,15,40,2,290
42081000410,1878,1462,1357,20,34,19,24,2,105
42081000640,968,767,744,1,6,12,1,0,23
42081000170,1005,769,735,3,7,16,6,1,34
42029000010,1313,957,787,90,61,8,11,0,170
42029000935,1430,1127,894,125,52,23,25,1,233
42029000945,1441,1122,935,79,42,22,28,1,187
42029000917,1501,1330,1038,166,82,19,35,1,292
42029001378,2108,1640,1018,146,419,28,27,0,622
42029001384,1664,1447,1134,73,182,20,36,2,313
42029001382,2124,1626,844,128,588,26,54,6,782
42011000850,1595,1364,1306,14,8,21,3,0,58
42011001140,1529,1089,253,707,163,49,19,12,836
42011000397,1750,1430,1257,92,43,30,28,2,173
42011001610,3603,2951,2634,173,53,34,37,3,317
42011000430,2252,1866,1696,77,47,19,18,2,170
42081000630,2375,1859,1715,30,50,32,13,2,144
42081000620,1103,852,808,5,13,12,9,2,44
42009000355,847,713,690,4,4,12,0,0,23
42029000925,1542,1254,946,190,75,22,19,2,308
42101006633,1128,894,709,54,65,7,63,0,185
42101003710,557,404,3,42,358,4,4,0,401
42063000460,3693,3465,2598,250,553,21,62,5,867
42063000260,607,502,481,3,1,8,1,0,21
42063000580,780,622,603,7,2,3,2,0,19
42063000080,1125,914,833,10,41,15,12,2,81
42063000420,1780,1443,1281,45,55,17,40,2,162
42063000190,2062,1666,1576,23,12,24,7,3,90
42063000180,1093,923,878,10,7,19,0,1,45
42063000130,1681,1355,1252,24,39,19,3,3,103
42063000630,1324,661,645,2,3,8,1,0,16
42011001495,2216,1659,1134,250,170,25,98,2,525
42009000180,898,700,676,4,1,9,2,0,24
42009000410,1179,856,831,9,0,7,6,0,25
42089000173,8352,6585,3193,1327,1837,121,310,12,3392
42089000005,1622,1361,1155,92,63,22,28,3,206
42089000197,2001,1621,1192,183,175,32,40,0,429
42089000053,8977,6450,2013,1879,2606,161,140,21,4437
42089000046,2525,1986,1111,360,468,44,48,9,875
42089000256,1620,1315,853,154,251,27,58,0,462
42041000731,1906,1712,1555,42,42,23,45,1,157
42041000728,1818,1476,1330,51,44,16,33,1,146
42041000724,1805,1402,1293,35,18,14,26,3,109
42041000721,2073,1671,1564,34,11,32,19,1,107
42041000734,1839,1479,1354,28,39,22,21,1,125
42041000290,2452,1745,1685,14,10,13,3,2,60
42063000290,965,745,719,6,10,5,2,1,26
42063000210,1493,1209,1176,4,9,8,4,0,33
42063000055,1117,963,928,8,3,8,11,0,35
42063000170,1236,1000,959,11,4,13,6,2,41
42063000255,1033,850,826,2,0,10,3,0,24
42063000750,458,364,352,0,4,3,0,0,12
42075000360,4126,3394,2980,285,44,32,57,2,414
42075000410,2923,2390,2075,112,60,30,105,0,315
42075000504,2889,2167,1988,89,28,29,14,6,179
42075000502,2172,1671,1531,68,15,19,12,0,140
42075000080,1041,747,732,4,0,9,2,0,15
42075000120,1638,1210,1067,92,15,21,19,2,143
42075000470,2927,2376,2083,184,61,26,28,1,293
42077000010,2596,1958,1626,163,81,33,79,3,332
42077001140,1732,1349,1021,176,101,13,60,0,328
42077000610,1208,951,666,188,85,25,17,1,285
42077001230,3770,2983,2421,123,81,19,325,3,562
42077000540,1330,1056,546,397,89,10,33,3,510
42077001200,1521,1207,985,110,47,15,49,2,222
42077000570,3995,3058,1241,1260,541,45,101,2,1817
42077000880,5872,4596,3841,279,219,40,236,5,755
42077001390,2250,1730,1218,302,157,29,60,3,512
42077000020,2709,1849,307,1229,424,73,19,3,1542
42077001150,3407,2913,2412,200,104,20,174,0,501
42077000330,2144,1620,552,865,235,33,39,1,1068
42077001350,4976,3928,3707,79,32,36,28,3,221
42077000430,2324,1842,698,912,262,33,57,0,1144
42077000080,2329,1716,718,788,262,21,17,4,998
42077001450,2707,2188,1902,149,64,22,52,5,286
42077000410,3094,2453,1248,960,285,35,48,1,1205
42077000840,1178,952,658,208,83,15,14,1,294
42077001040,2839,2262,1733,316,113,44,70,4,529
42077000560,2169,1666,805,606,209,32,83,3,861
42089000023,6104,4692,3439,565,522,83,80,2,1253
42089000130,2596,2208,1999,97,46,36,18,1,209
42089000240,5475,4506,4019,236,124,57,51,1,487
42089000190,2899,2338,1771,272,201,54,44,4,567
42089000350,5556,4550,3067,625,651,69,184,7,1483
42089000360,2759,2268,1940,151,115,30,26,0,328
42089000230,3678,2951,1873,459,515,41,77,1,1078
42089000220,7473,5939,5075,476,239,95,53,1,864
42089000176,7701,6063,3907,1037,938,116,170,11,2156
42089000110,1659,1311,894,217,198,17,27,0,417
42089000164,3442,2814,2070,320,343,65,44,0,744
42089000162,3136,2575,1864,259,348,34,67,1,711
42029000840,2563,1882,1483,152,184,47,21,0,399
42029000414,1643,1322,963,211,70,21,65,1,359
42029000820,3589,2835,1980,553,221,73,49,3,855
42063000040,899,733,707,6,1,13,2,0,26
42029001830,1838,1442,1293,32,39,9,59,0,149
42029001000,4455,3425,2619,161,251,25,348,2,806
42029001140,3084,2232,1133,79,130,7,863,2,1099
42029000037,2568,2021,1720,37,19,4,218,0,301
42029000036,6,0,0,0,0,0,0,0,0
42077001310,5976,4779,3677,328,462,44,250,8,1102
42077000620,2814,2131,1176,682,260,43,51,0,955
42077000095,3496,2475,495,1537,525,66,37,6,1980
42077001080,1118,886,774,47,16,8,30,2,112
42077001130,3167,2527,2020,258,94,36,132,5,507
42077001025,2045,1582,1366,81,55,24,56,0,216
42077001022,2047,1669,1548,51,21,17,24,0,121
42077001011,1798,1480,1336,71,29,16,22,3,144
42077000920,5209,3803,2771,389,339,47,267,3,1032
42077000210,2642,1771,321,1211,324,37,25,2,1450
42133000550,2800,2193,1864,154,114,38,33,6,329
42023000090,914,761,740,3,4,5,5,1,21
42023000080,166,137,132,1,0,3,0,1,5
42057000060,1575,1259,1204,5,3,36,3,0,55
42057000070,1151,878,789,15,37,29,11,2,89
42077000310,1562,1290,710,428,133,18,41,1,580
42077001256,2197,1707,1216,166,118,31,195,0,491
42077001251,2128,1432,863,114,111,21,339,1,569
42077001258,2703,1875,1225,173,104,24,338,4,650
42077001257,3635,2690,1603,418,207,43,428,6,1087
42077001222,3236,2510,1901,173,108,20,288,0,609
42077000810,1782,1377,1222,71,49,11,18,0,155
42077000970,2451,1926,1789,76,11,26,11,1,137
42077001000,3875,3048,2582,255,67,49,92,3,466
42077001255,6143,4749,3384,348,212,31,773,1,1365
42077000190,3450,2369,330,1621,538,61,38,2,2039
42077000120,1825,1282,237,891,212,37,14,2,1045
42063000140,1810,1495,1397,18,45,21,6,0,98
42063000030,2017,1637,1578,10,17,10,7,1,59
42083000120,2800,2461,2098,58,195,36,50,1,363
42083000180,876,700,667,4,3,8,7,0,33
42083000380,737,580,560,0,0,8,5,0,20
42083000190,718,569,541,6,0,12,7,0,28
42083000400,859,629,592,3,1,20,6,0,37
42083000340,1607,1257,1185,7,6,22,2,0,72
42083000430,1621,1354,1311,1,1,16,3,0,43
42045000851,2015,1518,1077,25,36,14,348,0,441
42045000843,1933,1467,1280,26,20,12,130,0,187
42045000828,2494,1943,1340,45,70,15,458,1,603
42045000856,923,873,782,14,12,8,48,0,91
42045002810,114,99,82,3,3,1,10,0,17
42045003088,1494,1260,873,58,236,20,71,1,387
42045003083,1756,1437,1123,45,219,11,35,0,314
42045002924,1569,1314,922,151,181,2,59,1,392
42045002912,1564,1208,1074,22,33,17,53,2,134
42045002916,1221,935,875,4,10,3,33,0,60
42045001380,1373,1039,905,18,50,4,52,1,134
42045002380,1887,1380,1131,52,17,3,163,0,249
42045002410,3098,2333,1640,49,87,10,531,0,693
42045002390,2379,1803,1480,64,58,10,183,3,323
42045001090,1162,847,691,26,101,8,22,2,156
42045001140,1251,970,709,40,206,8,22,0,261
42045002020,1212,907,71,51,189,5,580,3,836
42045003580,1158,877,96,104,117,6,560,1,781
42045001860,1143,961,831,24,10,6,82,0,130
42045001890,1069,863,774,17,21,1,41,3,89
42045001790,1034,859,647,27,89,9,80,0,212
42045000990,1232,907,177,60,590,18,71,0,730
42045003570,1430,1077,130,87,255,21,597,4,947
42045001910,1017,832,693,34,66,4,21,0,139
42045003520,1662,1283,788,75,326,22,70,2,495
42045000900,1941,1553,1325,39,147,7,37,0,228
42045000890,1098,884,786,17,67,1,5,0,98
42045003590,1484,1154,106,128,216,20,702,2,1048
42083000050,1126,852,777,33,13,13,4,0,75
42083000080,693,497,476,4,8,6,0,1,21
42083000390,1276,929,886,5,8,15,2,2,43
42011000380,2832,2313,2026,137,70,30,49,2,287
42011000800,1736,1414,1351,28,17,14,5,1,63
42011000980,2633,2018,493,1244,330,64,17,3,1525
42011001770,2709,2168,1844,122,94,16,96,0,324
42011000860,1672,1303,265,898,207,31,5,3,1038
42011001470,2618,2035,1603,286,103,35,28,1,432
42011000990,2428,1633,174,1338,200,83,32,3,1459
42133001160,728,538,494,24,7,6,5,0,44
42133001180,1210,947,862,36,23,12,7,0,85
42009000120,2908,2331,2249,11,16,32,15,0,82
42009000330,1770,1480,1438,4,12,7,10,0,42
42045003685,1293,964,210,62,659,7,38,0,754
42045000103,1495,1203,1072,19,33,19,70,2,131
42045000091,1896,1387,1067,80,47,8,189,0,320
42045000099,1643,1236,1065,16,25,9,118,3,171
42045000105,1253,894,612,31,14,20,210,0,282
42059000200,401,321,304,1,2,10,0,0,17
42059000340,564,461,449,3,0,2,1,0,12
42059000470,905,701,657,8,12,14,5,0,44
42133001275,4252,3045,1267,972,863,63,34,4,1778
42059000010,429,339,327,3,0,7,1,0,12
42089000218,3547,2851,1963,357,415,45,106,9,888
42089000120,1640,1274,705,271,254,31,45,2,569
42089000310,1145,912,557,148,172,17,21,0,355
42047000080,1747,1410,1359,5,3,16,8,3,51
42047000150,549,433,401,2,5,11,6,1,32
42057000050,1193,943,924,4,3,12,1,1,19
42051001111,3355,2733,2546,70,29,42,20,0,187
42051000536,3276,2600,2321,14,141,54,22,6,279
42051000366,1090,861,719,8,109,14,2,0,142
42051000300,1013,806,772,4,20,4,1,1,34
42119000210,2886,2188,2101,22,11,29,12,1,87
42119000080,1748,1354,1324,14,12,3,3,0,30
42119000160,1751,1258,1208,11,12,13,6,0,50
42033000350,1331,1092,1056,5,5,17,0,0,36
42033000210,1107,861,822,5,3,28,0,0,39
42033000520,739,628,599,5,4,12,4,0,29
42033000260,1225,997,936,8,13,19,9,0,61
42033000300,1366,1048,974,21,16,15,15,0,74
42033000550,1045,831,791,8,8,9,7,1,40
42109000220,1652,1359,1236,45,35,10,22,1,123
42051000692,2338,1948,1838,18,31,18,10,3,110
42089000033,2738,2249,1773,239,153,44,45,0,476
42089000291,2092,1697,1197,188,199,19,117,4,500
42089000090,1011,890,504,168,181,25,52,0,386
42089000180,3089,2472,1304,519,564,57,112,1,1168
42051000751,1921,1540,1360,16,102,30,5,2,180
42051000761,2154,1681,1449,11,162,31,12,1,232
42057000030,1555,1221,1138,24,13,19,14,3,83
42119000140,2250,2159,1687,129,101,28,215,4,472
42119000190,801,616,586,6,3,14,1,0,30
42033000170,1303,1043,973,17,16,21,3,0,70
42045001920,1440,1229,958,37,145,22,63,1,271
42045001900,1498,1247,1116,21,55,8,30,0,131
42045001810,1222,925,815,12,11,3,77,0,110
42045001840,1104,899,780,14,12,3,84,0,119
42045001850,1046,830,740,15,13,5,55,0,90
42045001510,1385,1010,933,8,25,1,38,0,77
42059000350,1396,1144,1091,4,7,36,4,1,53
42059000240,475,401,387,0,10,2,1,0,14
42059000370,775,584,558,12,5,8,1,0,26
42051000320,2323,1818,1750,5,19,19,2,3,68
42051000270,1890,1492,1379,8,47,23,8,7,113
42051000860,5591,4616,4191,40,236,62,40,17,425
42051000570,1811,1458,1370,12,32,24,2,0,88
42051001015,1195,958,756,20,135,20,6,9,202
42027000280,2775,2249,1986,64,47,42,97,1,263
42059000480,569,452,422,3,3,14,2,0,30
42059000380,319,257,251,0,0,6,0,0,6
42059000050,1014,759,697,15,4,21,2,1,62
42051000120,1162,989,951,7,7,15,0,0,38
42129001550,1094,933,898,8,11,9,3,0,35
42063000230,1321,1001,968,6,9,10,3,0,33
42063000480,1602,1296,1164,40,43,10,25,0,132
42063000640,1129,880,832,9,0,19,3,0,48
42059000395,932,774,742,2,6,18,2,0,32
42051000161,1556,1262,1139,13,78,20,5,0,123
42051000221,3849,3161,3027,10,47,48,14,0,134
42051000211,2823,2293,2202,10,21,35,4,2,91
42051000660,3790,3084,2783,35,181,44,14,1,301
42027000605,1747,1376,1285,29,11,22,17,0,91
42027000500,210,166,151,2,1,6,4,0,15
42027000520,416,354,350,1,0,3,0,0,4
42095000608,3385,2624,1847,290,211,37,230,0,777
42095000960,4144,3284,2898,209,104,40,27,4,386
42095000012,2890,2304,1948,136,127,9,68,1,356
42095000390,2789,2197,2010,73,25,16,57,0,187
42095000615,3988,3128,2133,310,412,39,253,4,995
42095001020,5407,4398,3300,349,409,32,331,2,1098
42095000060,2808,2121,1738,201,144,41,16,6,383
42133000790,4060,3289,2907,53,192,50,70,2,382
42133001140,1358,987,873,48,28,25,9,1,114
42059000130,4173,3788,2679,150,885,28,35,1,1109
42059000410,564,462,450,1,2,9,0,1,12
42011000830,2122,1754,1605,68,17,21,24,9,149
42011000767,1401,1187,988,137,38,13,11,2,199
42011000646,2523,1954,1655,178,51,47,33,1,299
42011000058,2204,1679,1445,41,85,23,66,1,234
42011000580,2611,2218,1956,210,12,24,12,3,262
42011000680,1031,839,810,17,12,2,2,0,29
42011000690,634,485,432,23,12,10,8,1,53
42133000210,934,683,639,18,15,4,7,0,44
42045001600,1162,899,217,84,562,32,27,0,682
42045000250,955,722,94,53,580,3,7,1,628
42059000070,945,770,729,9,5,14,7,3,41
42051000850,1917,1520,1426,18,20,31,2,0,94
42051000131,2237,1708,1547,26,89,22,14,0,161
42051000470,1328,1131,1039,3,58,15,9,0,92
42051000420,1761,1459,1390,9,11,27,4,0,69
42051000100,4075,3376,3271,11,10,43,11,1,105
42051000190,2076,1729,1661,6,10,30,3,0,68
42029000660,3179,2452,2207,81,33,53,53,0,245
42029001070,1601,1189,480,160,512,32,17,2,709
42029000895,1052,770,687,12,8,3,55,1,83
42029001835,1404,1043,917,20,32,13,42,1,126
42029001870,1251,1015,887,33,38,6,45,0,128
42095000050,1176,897,791,54,24,14,12,0,106
42095000980,4657,3775,2644,381,379,51,326,3,1131
42095000590,1319,952,429,228,271,20,23,5,523
42029000240,2281,1716,1562,43,41,27,29,1,154
42029001415,3122,2254,1838,87,77,14,212,2,416
42029001360,2023,1527,1269,54,57,20,107,1,258
42029001824,4252,3246,2026,151,240,41,784,3,1220
42029001040,1389,1085,961,36,33,11,39,2,124
42029000850,5644,4583,3753,547,154,98,66,0,830
42029001480,2105,1763,1591,54,61,14,22,2,172
42029001530,2686,2427,1989,126,268,19,35,0,438
42029001190,881,691,507,14,25,2,123,0,184
42033000470,2507,2060,1973,14,17,38,6,0,87
42019000440,3164,2443,2310,33,11,41,25,0,133
42019000520,1167,954,927,2,3,9,2,0,27
42019000379,3282,2518,2255,36,52,14,128,4,263
42019000500,175,148,143,4,2,1,2,2,5
42051000980,1334,951,472,23,409,34,2,6,479
42045003730,861,692,90,73,269,8,260,0,602
42045003820,2312,1824,1547,41,67,12,122,2,277
42045002620,1771,1437,1287,31,38,12,59,2,150
42045001160,1170,867,749,30,12,2,67,0,118
42045003291,1404,1120,760,51,204,18,88,3,360
42045000090,2166,1771,1603,45,61,29,23,0,168
42045000080,2457,1954,1767,51,53,9,58,1,187
42045000010,2416,1917,965,59,774,20,90,0,952
42045000150,1323,1039,932,23,33,21,35,1,107
42045000170,1336,1178,1013,22,95,3,33,3,165
42045000380,665,472,28,22,426,4,3,2,444
42045000370,432,336,6,10,328,5,0,0,330
42045003340,1677,1337,1116,58,122,11,38,2,221
42045000630,1025,688,30,31,631,4,5,1,658
42045000640,387,314,141,10,158,6,1,4,173
42045003130,1413,1145,888,21,191,12,37,0,257
42045002321,3309,2711,2235,94,152,17,198,4,476
42045002357,781,755,610,11,40,3,90,0,145
42045001710,1193,982,842,18,28,0,94,1,140
42045001740,1091,870,759,11,7,0,90,0,111
42045001730,991,798,652,24,32,8,84,1,146
42089000015,2431,2017,1696,120,124,26,34,1,321
42089000140,5293,4434,3583,326,330,60,128,3,851
42019000540,993,826,802,4,4,6,5,0,24
42123000110,1281,955,928,11,2,4,4,2,27
42123000351,2462,1919,1760,21,21,50,22,1,159
42123000300,626,513,492,3,2,6,3,1,21
42059000020,432,360,341,2,7,5,1,1,19
42059000435,1903,1641,1500,43,50,15,26,3,141
42051000880,2860,2362,2229,17,61,17,16,3,133
42051000601,1732,1399,1335,6,10,23,9,0,64
42119000110,1476,1056,1024,10,9,5,0,0,32
42119000200,1515,1221,1156,23,20,14,8,0,65
42109000150,2245,1794,1698,33,17,15,29,2,96
42119000060,4096,3902,1659,600,1641,40,38,0,2243
42133000110,1994,1497,1268,94,98,33,16,1,229
42133000180,1954,1543,1360,68,72,35,22,3,183
42133000560,3462,2754,2598,30,11,72,24,0,156
42029001410,1556,1279,1191,20,9,29,12,10,88
42033000180,1538,1189,1113,7,22,20,16,1,76
42033000460,1654,1424,1362,19,22,11,12,0,62
42109000250,1761,1318,1270,5,11,16,5,0,48
42109000240,1496,1097,1056,3,9,15,3,0,41
42109000040,2413,1805,1735,16,12,22,9,3,70
42019000150,3236,2656,2514,23,27,40,22,2,142
42019000170,1391,1101,999,32,20,26,10,2,102
42019000600,2540,2099,2015,26,10,13,8,1,84
42125001140,696,562,503,4,31,8,5,0,59
42125000630,472,395,378,9,2,3,2,0,17
42133000570,2675,2105,2017,13,19,17,25,2,88
42133000250,3012,2364,2235,36,28,30,11,2,129
42133000880,4481,3514,2977,176,219,53,103,4,537
42133000660,2723,2238,2106,30,24,36,22,3,132
42019000075,3403,2602,2314,72,124,63,19,8,288
42019000530,1458,1241,1186,27,15,7,7,0,55
42019000845,1092,872,838,10,0,6,13,0,34
42019000300,2427,1957,1889,16,7,33,4,0,68
42019000050,3173,2453,2327,13,16,35,33,0,126
42019000650,1426,1197,1166,11,4,3,6,0,31
42019000310,2907,2323,2258,19,13,16,4,0,65
42019000016,5260,4007,3796,52,32,30,69,1,211
42019000014,4897,3575,3334,55,29,28,87,3,241
42051000290,1365,1100,1061,6,5,19,0,1,39
42125000030,1717,1368,1324,8,9,13,6,0,44
42125000715,1126,879,677,15,162,22,6,0,202
42125000745,1163,929,664,16,221,23,4,0,265
42125000490,878,721,615,17,68,7,14,1,106
42125000080,1991,1623,1520,18,10,34,12,1,103
42125001645,1766,1419,1366,20,5,18,3,0,53
42125001300,1471,1154,1070,8,26,25,5,2,84
42125001290,2007,1649,1519,29,44,25,14,6,130
42125001920,1430,1209,988,24,154,18,15,0,221
42125000840,1288,987,955,2,5,20,1,0,32
42125001075,1664,1370,1250,20,71,18,9,1,120
42125001010,741,625,609,2,1,2,0,0,16
42093000090,1004,751,731,5,3,9,2,2,20
42093000130,2159,1733,1638,12,28,19,37,3,95
42025000376,2420,1999,1584,184,186,26,28,6,415
42129001580,585,493,483,1,2,0,1,0,10
42129000620,1553,1315,1203,16,55,20,16,0,112
42129002550,997,813,756,12,7,21,2,0,57
42129002530,1095,917,854,10,12,25,8,1,63
42129002510,853,653,633,5,8,5,0,0,20
42129002540,1243,1070,1032,13,3,6,2,0,38
42129002460,1168,912,858,9,15,14,9,2,54
42051000331,2496,2016,1909,6,31,37,4,1,107
42051000640,3418,2894,2713,38,60,42,16,4,181
42051000970,1448,1117,735,24,322,28,7,6,382
42051000945,1362,1106,990,34,50,9,7,8,116
42051000010,1024,842,762,17,36,17,7,1,80
42051000140,2254,1825,1659,18,85,30,7,0,166
42051000156,984,750,687,7,39,14,0,1,63
42115000230,464,382,361,8,2,3,0,0,21
42115000300,770,631,592,12,9,10,2,0,39
42033000690,3403,3212,1881,221,1087,6,13,0,1331
42033000040,1238,1001,961,12,4,9,3,1,40
42033000240,1438,1201,1162,8,4,22,4,0,39
42033000410,549,441,431,2,0,8,0,0,10
42033000030,687,538,526,4,4,5,1,0,12
42059000180,234,195,181,0,0,13,1,0,14
42059000030,1113,867,837,4,1,9,4,0,30
42059000220,381,300,288,1,2,5,1,0,12
42019000242,2740,2263,2129,30,19,23,42,2,134
42019000320,1409,1156,1100,8,4,31,1,1,56
42019000700,2666,2108,1981,22,50,24,9,0,127
42019000330,4263,3547,3410,25,3,41,19,1,137
42019000020,620,467,440,2,6,11,2,0,27
42027000270,3138,2501,2261,49,96,24,50,0,240
42027000540,1037,860,842,2,0,12,2,0,18
42027000420,2386,1936,1583,70,70,23,165,3,353
42027000236,2218,1625,1160,47,49,21,342,1,465
42027000207,1204,920,724,27,12,11,150,0,196
42111000450,706,575,562,1,2,5,5,1,13
42111000430,1840,1488,1449,2,5,17,0,2,39
42111000590,2087,1669,1617,12,0,9,5,0,52
42111000240,1426,1191,1159,9,4,7,2,1,32
42111000370,305,244,239,0,0,0,0,0,5
42111000410,413,343,334,0,0,2,5,0,9
42111000130,1506,1239,1223,9,4,3,0,0,16
42111000250,1932,1535,1488,8,7,14,3,0,47
42005000180,334,291,280,0,2,5,0,1,11
42037000595,2966,2372,2184,42,35,20,78,1,188
42095000115,3837,3291,1750,810,330,51,292,8,1541
42041000601,4354,3212,2711,104,194,51,142,8,501
42041000602,19,10,7,0,3,0,0,0,3
42041000716,1585,1296,1181,20,10,13,72,3,115
42041000718,1421,1138,1033,28,16,14,35,2,105
42041000245,3346,2457,1824,73,103,14,428,3,633
42041000269,5175,4017,3205,117,92,32,545,11,812
42041000890,1265,1034,813,75,82,23,41,4,221
42041000900,1778,1403,961,84,140,12,188,2,442
42095001210,1508,1261,1041,76,93,17,29,0,220
42095001060,1175,949,865,31,28,16,9,1,84
42095000830,761,633,553,44,13,9,9,0,80
42095000150,1939,1689,1069,431,160,32,40,1,620
42095000560,1111,795,339,222,215,14,17,3,456
42095001320,2870,2186,1370,431,328,56,54,1,816
42095000450,1296,1137,801,165,153,16,23,0,336
42095000601,4626,3646,2748,322,369,34,180,4,898
42025000379,2389,1807,1346,202,190,35,30,1,461
42109000230,1631,1219,1171,11,8,14,7,2,48
42119000040,1821,1412,1270,40,24,13,57,0,142
42119000220,1277,1066,1020,10,6,15,8,1,46
42119000090,3149,2587,2006,206,281,32,55,0,581
42119000180,1530,1194,1129,14,24,21,3,2,65
42033000280,1842,1517,1423,27,11,7,24,1,94
42033000420,476,384,376,2,2,3,0,0,8
42051001072,3894,3186,3005,30,69,52,13,5,181
42051000280,502,383,363,3,6,10,0,1,20
42051000580,1025,824,751,8,43,6,1,0,73
42051000870,2439,2003,1823,14,64,22,44,12,180
42051000995,1379,1111,826,28,208,29,13,4,285
42081000660,1768,1287,1251,4,12,14,4,1,36
42081000550,258,225,222,0,1,0,1,0,3
42081000722,2373,1776,1443,40,203,46,20,3,333
42081000712,3730,3255,2299,188,658,47,68,1,956
42081000300,1512,1235,1147,10,25,9,34,1,88
42129001890,871,713,633,27,26,4,11,0,80
42009000130,1765,1396,1308,30,18,32,6,0,88
42091000440,1670,1312,980,168,106,36,35,2,332
42091002040,1336,1068,879,31,69,5,67,1,189
42091000580,1609,1188,204,49,854,12,80,0,984
42091002460,2485,1920,1509,82,173,30,131,1,411
42091002920,1395,1024,925,33,35,3,37,1,99
42091001850,2031,1537,1291,21,9,9,196,1,246
42091002680,2065,1673,1402,90,119,28,39,3,271
42091001490,1952,1601,889,86,485,19,146,5,712
42091001210,2145,1730,1084,144,168,27,305,3,646
42091000305,1188,903,741,26,92,4,43,1,162
42091000165,1434,1204,848,52,171,6,133,0,356
42091003131,1521,1155,813,31,159,1,142,0,342
42091003136,1605,1207,970,42,116,13,80,1,237
42091003121,1142,961,772,17,37,3,131,1,189
42091001741,1805,1384,937,141,174,12,91,4,447
42091001742,19,18,11,7,0,0,0,0,7
42091003770,1171,902,827,14,22,5,23,0,75
42005000590,1775,1449,1349,10,19,45,10,1,100
42059000102,1284,1032,983,9,9,15,2,1,49
42059000104,893,726,690,5,5,14,8,0,36
42059000320,871,693,666,7,2,6,0,0,27
42059000420,461,357,333,4,2,15,3,1,24
42089000340,1406,1153,874,136,116,18,24,7,279
42089000036,3477,2787,2281,231,118,62,84,0,506
42009000040,1532,1249,1176,12,25,17,18,3,73
42059000160,851,640,610,5,3,14,0,0,30
42059000140,1489,1177,1107,8,3,25,21,3,70
42129000890,1726,1441,1401,12,9,4,7,4,40
42129000830,882,737,709,2,3,14,4,0,28
42129000140,1214,1028,987,6,9,8,0,1,41
42129000930,2820,2332,2253,9,20,25,18,1,79
42129000810,2051,1784,1559,34,94,24,66,3,225
42129000870,1205,1039,957,26,39,6,10,0,82
42129001620,1523,1236,1162,30,16,17,3,0,74
42129000660,3195,2580,2429,22,36,23,29,1,151
42129000880,1631,1397,1331,13,17,20,18,0,66
42129001650,2937,2297,2109,24,32,17,101,4,188
42129000690,2120,1759,1657,21,24,23,16,0,102
42129000900,538,447,417,11,0,3,5,0,30
42129000770,461,376,354,5,4,2,0,0,22
42129000720,2525,2052,1908,47,44,17,28,1,144
42129001640,1428,1121,1048,6,34,9,11,0,73
42045000190,1188,931,219,117,583,33,13,1,712
42095000840,1623,1306,1185,52,9,15,24,3,121
42095000430,2402,2041,1873,96,38,22,11,2,168
42095000870,2507,2063,1936,51,12,30,14,0,127
42095000810,750,601,531,34,11,10,17,0,70
42033000320,568,475,455,1,1,7,2,0,20
42109000140,1901,1559,1439,55,19,14,36,1,120
42115000020,529,424,394,10,2,5,3,1,30
42037000232,1555,1288,1229,19,17,10,11,2,59
42005000360,914,718,679,7,12,10,8,0,39
42047000210,95,86,82,0,0,4,0,0,4
42047000200,1472,1242,1201,2,3,15,9,1,41
42047000220,501,434,423,2,0,5,0,0,11
42015000040,1001,799,760,5,9,17,5,1,39
42015000590,1175,937,909,7,6,11,5,2,28
42015000110,681,551,532,8,0,5,1,0,19
42015000050,2943,2362,2173,17,30,58,67,1,189
42015000140,1735,1320,1250,18,11,15,3,0,70
42015000370,1298,1012,943,11,6,26,5,1,69
42013000510,771,582,562,6,1,5,1,1,20
42013000020,2958,2546,2390,15,47,34,41,3,156
42013000860,2296,1888,1841,5,7,17,4,0,47
42013000261,1807,1527,1437,12,27,26,2,3,90
42013000710,2157,1825,1714,27,8,13,47,3,111
42013000460,1676,1329,1277,5,4,23,12,2,52
42095000160,2938,2580,1916,394,211,48,61,10,664
42095000200,1743,1502,1253,123,70,14,44,0,249
42047000122,1963,1590,1532,6,2,26,7,1,58
42047000140,811,626,589,10,9,13,5,3,37
42071000640,1932,1271,243,723,313,19,29,2,1028
42071001130,4118,2879,2706,85,32,28,7,3,173
42071001610,2862,2346,2195,67,33,11,36,4,151
42071001600,3178,2472,2345,61,20,21,22,2,127
42071000429,2384,1920,1428,236,174,18,87,1,492
42071001770,3349,2413,2081,146,63,14,113,1,332
42071001520,2842,2167,2006,76,39,23,20,2,161
42071001884,2055,1581,1480,35,16,8,25,0,101
42071001882,2351,2208,2070,72,45,7,6,2,138
42021000675,1671,1414,1321,15,42,9,14,2,93
42021001041,1310,987,733,22,196,34,4,0,254
42021000405,1008,800,662,14,93,26,9,5,138
42021001660,831,690,615,17,28,1,11,0,75
42021000440,916,754,739,2,2,5,1,0,15
42021001385,616,482,454,8,5,2,3,0,28
42021001395,920,729,694,7,7,13,2,0,35
42021000636,1536,1184,1132,16,5,13,4,2,52
42021001452,1441,1166,1119,3,11,25,2,0,47
42033000380,1200,969,939,1,11,9,1,0,30
42021001785,1260,1002,973,9,1,9,1,0,29
42021001338,1313,1050,1014,5,6,8,4,0,36
42005000710,1296,935,901,1,4,14,3,0,34
42095000345,1012,844,683,108,39,9,10,2,161
42095000339,1970,1585,1176,254,107,21,45,9,409
42095000344,1875,1496,1135,176,103,14,62,7,361
42095000347,1282,1105,881,115,64,2,43,1,224
42095000900,2150,1755,1481,147,65,32,29,1,274
42095000910,1860,1466,1286,109,30,22,14,0,180
42095000890,2043,1684,1557,60,15,16,16,1,127
42097000240,1042,862,824,13,5,12,9,0,38
42097000850,1605,1317,1261,29,7,6,11,0,56
42097000570,2362,1888,1830,15,8,16,5,1,58
42071001780,2303,1699,1462,111,60,13,62,3,237
42021000235,1051,845,820,4,2,14,0,1,25
42021000080,2815,2479,1855,152,437,26,25,2,624
42085000700,1202,987,933,4,8,17,6,4,54
42085000540,699,518,506,0,1,5,0,0,12
42133001220,3092,2099,348,1061,708,45,39,8,1751
42133000970,4552,3700,3497,62,36,60,20,7,203
42133000120,2201,1654,1450,69,91,35,10,1,204
42033000540,82,66,63,0,1,2,0,0,3
42033000230,2567,2006,1919,18,12,30,5,0,87
42033000570,2298,1854,1793,10,0,35,0,0,61
42021000479,885,744,691,6,21,15,1,0,53
42071001710,5082,3427,3205,113,56,31,23,0,222
42071001700,2957,2112,1883,86,86,25,30,0,229
42019000630,231,199,188,0,4,4,0,0,11
42019000550,2755,2187,2099,23,3,23,20,0,88
42107000105,1752,1479,1419,25,10,3,1,3,60
42107001015,1188,967,850,41,46,18,4,4,117
42107000792,1534,1233,1184,14,3,11,19,0,49
42107000970,1537,1280,1249,8,4,12,4,0,31
42107000980,608,499,469,21,5,4,0,0,30
42097000920,2597,2150,2026,36,22,36,11,5,124
42097000330,1697,1323,1141,86,59,41,4,2,182
42021000457,1082,851,798,13,27,7,0,0,53
42045002680,1853,1505,1387,38,42,17,16,0,118
42045002690,1818,1433,1313,28,33,14,33,1,120
42045001260,1301,954,904,20,12,3,13,0,50
42045003950,1013,813,9,8,797,1,6,0,804
42045001970,1011,758,696,15,11,4,23,0,62
42045001975,2073,1744,1348,63,150,18,146,3,396
42045001940,1295,1005,860,15,32,11,78,0,145
42045001950,1260,987,865,11,25,7,65,1,122
42045002740,1596,1192,293,35,836,26,15,1,899
42045002750,1519,1121,307,35,738,22,40,1,814
42045002730,1350,998,248,36,679,19,38,5,750
42045002000,1054,912,736,80,50,2,48,0,176
42045001995,1199,1058,965,22,18,10,41,0,93
42045002015,1812,1575,1374,20,104,4,62,0,201
42045001830,1112,898,752,16,9,9,113,0,146
42045002630,1677,1378,1160,18,111,15,55,3,218
42045000568,1306,1003,143,126,735,22,6,0,860
42045000578,623,451,25,38,388,13,2,0,426
42045001670,922,703,514,26,150,15,8,0,189
42045003200,1816,1477,733,52,585,13,97,2,744
42045002042,814,582,515,21,20,6,20,1,67
42045002055,556,450,330,14,78,10,20,0,120
42045002045,1303,1022,831,19,83,2,77,0,191
42045002052,1317,976,825,30,25,3,78,2,151
42045002097,1370,1000,809,18,42,10,105,0,191
42027000595,1824,1410,1312,19,24,26,26,1,98
42027000330,1182,879,843,7,5,15,2,0,36
42027000410,4730,4383,2289,245,345,56,1457,9,2094
42091001250,2301,1861,1376,110,129,14,221,8,485
42091003250,1394,1131,1078,16,1,21,8,1,53
42091002740,1296,1015,892,42,44,17,14,0,123
42091002205,4506,3384,2882,124,166,36,149,6,502
42091000340,1176,898,821,22,31,10,12,0,77
42091000150,1716,1330,896,40,339,18,51,1,434
42091001956,2070,1894,1805,22,32,0,35,2,89
42091000927,1296,1177,1121,16,13,7,16,3,56
42091001065,1328,1007,889,57,18,9,25,0,118
42091002580,1991,1501,898,163,386,30,35,0,603
42091002560,2026,1538,801,205,508,42,23,0,737
42091002130,3194,2074,363,998,649,76,58,6,1711
42091000480,1222,979,752,46,110,19,48,1,227
42091000135,2146,1624,1328,69,169,22,30,0,296
42133001210,3341,2594,1222,603,758,38,43,8,1372
42133000675,2200,1605,1028,275,237,37,31,0,577
42133000370,3070,2354,1979,224,69,41,26,1,375
42133000430,5049,3862,3347,173,183,68,56,5,515
42107001565,1419,1113,1067,24,9,9,6,0,46
42107001640,989,809,779,11,6,8,5,0,30
42107000490,861,657,645,2,4,7,0,0,12
42107000015,1417,1145,1079,29,11,18,4,0,66
42097000670,732,540,476,28,22,8,2,0,64
42097000750,1877,1456,1190,161,68,24,15,1,266
42097000760,2165,1623,1387,141,53,24,6,1,236
42097000310,1513,1148,1000,57,56,23,11,4,148
42097000830,1815,1468,1394,31,15,21,9,1,74
42097000320,1218,951,771,96,57,25,6,4,180
42097000840,677,519,493,7,8,7,1,1,26
42097000040,2644,2556,1213,261,1052,7,16,2,1343
42097000010,1174,1012,905,52,53,17,3,1,107
42097000120,879,742,707,5,4,18,6,0,35
42051000811,3037,2496,2431,9,1,22,3,0,65
42051000890,1706,1357,1303,5,4,27,2,0,54
42045000970,1892,1275,159,55,1055,24,13,0,1116
42045001360,1628,1273,1017,39,103,11,82,1,256
42045002345,1150,892,796,21,16,8,42,0,96
42045002430,2242,1693,1385,36,114,6,116,2,308
42045002420,2540,1875,1460,76,41,8,273,0,415
42045000950,2340,1620,147,26,1420,24,9,2,1473
42045002930,2128,1654,1303,80,100,18,142,3,351
42045002910,1665,1263,996,42,75,8,127,3,267
42045003050,1277,1008,398,61,541,22,8,1,610
42045003040,708,517,289,20,193,8,8,0,228
42045002790,1197,914,756,20,58,8,64,3,158
42045002030,2778,2147,1378,57,492,30,176,2,769
42045001720,1257,1010,845,7,23,0,132,1,165
42045001760,1102,895,739,14,15,8,118,0,156
42045003210,2002,1568,736,72,661,26,88,0,832
42045000831,3504,2993,1905,118,838,16,121,0,1088
42045000824,1604,1330,1153,28,47,14,66,3,177
42045000833,714,712,686,6,1,2,15,0,26
42045000834,827,817,799,6,3,0,10,0,18
42045002510,1332,1032,961,12,36,11,15,0,71
42045002490,846,692,620,24,19,13,16,1,72
42045000410,629,470,14,53,413,1,4,0,456
42123000250,427,350,334,6,3,4,4,1,16
42123000255,1609,1232,1162,8,5,13,6,0,70
42091000285,1457,1088,945,45,74,23,15,0,143
42091000540,1457,1164,547,55,485,24,72,2,617
42091000510,1721,1553,448,224,852,22,31,1,1105
42091000520,2505,2154,498,80,1150,26,431,1,1656
42133000140,2635,1976,1781,64,32,24,54,6,195
42133000950,6026,4571,3917,128,339,54,128,5,654
42133001340,1651,1278,647,362,259,21,28,1,631
42133000460,382,294,273,7,2,2,3,1,21
42133001350,1734,1413,891,299,221,26,15,1,522
42133000533,2390,1962,1605,124,150,31,54,1,357
42133000531,2232,1726,1371,151,157,18,34,2,355
42095000460,1538,1247,1011,115,65,26,34,1,236
42095000300,4482,3123,938,1796,462,59,54,5,2185
42095001110,1341,1103,1016,26,18,26,8,0,87
42027000340,1438,913,889,8,8,5,5,0,24
42027000760,969,797,630,62,32,13,67,0,167
42027000320,1815,1496,1456,8,8,14,7,1,40
42091003210,2732,2310,1503,113,139,26,520,1,807
42091003590,5738,4050,3183,117,202,54,483,2,867
42091003540,2022,1600,1418,77,33,6,51,3,182
42091003500,2122,1713,1553,48,46,9,45,0,160
42091002488,1958,1574,1151,44,202,10,168,0,423
42097000590,1297,1002,889,43,36,14,10,1,113
42069000460,2198,1749,1597,61,23,17,18,5,152
42069001420,1106,901,663,45,72,16,123,1,238
42069001315,1801,1399,1140,130,86,20,38,1,259
42069002125,1658,1328,1106,135,76,12,12,3,222
42069002130,2024,1619,1394,112,65,26,42,0,225
42069000745,739,593,542,14,34,1,1,2,51
42069000720,916,731,672,19,17,3,15,3,59
42069000585,1685,1501,1330,59,59,12,39,1,171
42069001605,2823,2346,1478,348,403,41,126,4,868
42069001920,1778,1619,1151,79,273,23,90,1,468
42069001615,1732,1602,769,127,202,18,485,3,833
42069001625,1703,1339,708,133,138,29,345,4,631
42051000630,2868,2351,2135,30,111,58,5,1,216
42051000435,2004,1631,1571,15,20,13,4,1,60
42049000370,1139,924,512,44,296,27,37,2,412
42049000610,2918,2291,1605,117,314,39,196,4,686
42111000610,2147,1686,1648,3,12,14,6,2,38
42041000500,2764,2192,1962,85,38,34,51,1,230
42041000803,1409,1118,1037,14,19,18,27,1,81
42123000181,2604,2144,2030,24,7,25,26,0,114
42041000010,1388,1085,925,52,51,22,39,2,160
42041000100,2699,2200,1799,127,168,32,88,4,401
42041000880,3051,2449,2328,35,23,28,21,2,121
42111000390,1283,1057,1019,9,5,16,3,0,38
42085000620,523,410,406,0,0,0,0,0,4
42085000735,888,679,555,13,88,13,15,0,124
42085001070,2027,1617,1560,8,12,23,1,0,57
42085000640,2267,1678,1582,14,25,17,9,4,96
42085000475,1411,1081,878,13,151,19,8,3,203
42085000160,2843,2611,1895,78,600,28,3,1,716
42069002015,1460,1114,750,217,104,15,48,1,364
42069002090,2389,1718,1060,350,163,25,154,3,658
42069002230,1404,1125,876,93,76,13,82,0,249
42069001110,1013,834,788,26,5,7,5,3,46
42069001100,1729,1404,1307,46,21,7,26,2,97
42069001080,1002,840,775,31,18,3,9,3,65
42069000055,976,798,744,25,12,5,5,0,54
42069000022,1743,1415,1318,24,25,14,23,1,97
42069000595,1423,1233,1123,32,25,7,40,0,110
42069000950,1008,815,722,23,21,26,3,0,93
42069000115,1238,993,914,29,26,11,13,0,79
42069000150,1588,1298,1195,44,33,12,21,0,103
42069000160,2288,1895,1755,41,44,16,29,0,140
42069002320,1465,1201,995,143,37,12,17,0,206
42097000140,626,512,500,6,2,4,0,0,12
42097000060,1653,1316,1227,36,24,14,3,0,89
42097000030,1312,1046,965,35,19,13,3,0,81
42097000360,308,256,249,0,0,4,2,0,7
42097000475,1528,1228,1115,46,26,19,21,2,113
42097000490,1262,1000,890,64,16,14,12,3,110
42097000680,745,561,504,27,11,17,5,1,57
42097000740,1815,1449,1233,116,55,31,12,5,216
42107000060,660,548,527,8,7,7,5,2,21
42037000470,1564,1237,1177,9,10,27,4,0,60
42013000480,1827,1372,1289,10,25,19,13,4,83
42013000450,2669,2120,2026,11,16,22,12,3,94
42013000470,2133,1783,1735,8,8,14,10,0,48
42013000720,1067,879,828,9,15,11,6,0,51
42013000520,1255,1050,980,16,11,11,23,1,70
42013000411,1545,1272,1180,33,22,12,22,2,92
42013000421,1505,1252,1189,15,20,10,11,0,63
42013000390,1059,808,748,17,27,6,7,0,60
42013000960,1233,943,900,10,12,13,5,0,43
42013000230,891,695,634,14,22,22,1,0,61
42013000940,835,671,632,4,8,17,2,0,39
42013000920,586,466,432,12,8,11,3,0,34
42013000630,1266,1120,1015,9,74,12,10,4,105
42013000640,973,772,723,15,7,13,14,0,49
42013000620,675,547,535,4,1,4,0,0,12
42107000270,1845,1507,1405,48,8,18,16,1,102
42107001275,1074,857,836,10,3,4,3,0,21
42107001690,1850,1553,1451,31,19,14,31,2,102
42107001700,1428,1180,1125,14,8,14,16,1,55
42107001535,1444,1068,908,84,47,14,10,0,160
42107001625,609,490,485,1,1,1,2,1,5
42119000010,2480,1907,1788,33,29,19,20,4,119
42041000020,1667,1250,1122,39,23,16,37,2,128
42041000510,1995,1540,1402,50,40,19,14,6,138
42041000823,1941,1544,1416,32,40,21,43,0,128
42041000835,2339,1803,1470,103,94,23,127,1,333
42041000460,1141,933,765,46,46,19,41,5,168
42041000450,1797,1381,1176,53,76,32,43,3,205
42041000490,3466,2834,2661,47,38,34,57,4,173
42033000010,1124,909,879,2,1,13,0,0,30
42033000270,1972,1560,1449,17,16,28,21,2,111
42005000670,1350,1107,1068,6,17,11,1,1,39
42005000580,2112,1725,1664,5,7,27,0,0,61
42013000740,1569,1289,1234,13,6,12,6,0,55
42013000080,1415,1108,1018,17,43,19,8,0,90
42025000258,1749,1475,1385,45,12,21,6,0,90
42025000262,1297,1119,1062,26,6,14,5,0,57
42025000170,1397,1160,1028,65,44,18,16,3,132
42025000360,416,334,313,8,1,8,1,0,21
42025000270,2535,2119,1987,54,13,35,15,0,132
42017001900,3203,2558,2093,49,34,17,341,1,465
42017001950,2775,2206,1999,52,24,22,97,0,207
42017002570,1291,1052,869,64,48,11,47,3,183
42017001920,1172,995,918,30,4,10,17,1,77
42017001890,2193,1824,1549,55,28,11,164,0,275
42017002690,1880,1580,1413,62,11,19,57,3,167
42017000330,1871,1495,1177,160,85,38,48,1,318
42017000340,2628,2047,1188,146,411,27,266,1,859
42017002165,2291,1837,1694,40,29,27,34,3,143
42017002280,1661,1311,1176,60,23,30,18,3,135
42017002050,2290,1891,1721,37,24,10,88,0,170
42017000310,2279,1831,1493,162,86,41,32,4,338
42017000740,569,454,334,37,61,11,8,2,120
42017002270,847,688,649,22,4,9,2,1,39
42017000285,1980,1594,995,117,117,16,359,4,599
42017000130,3131,2506,1864,212,129,42,270,2,642
42051000450,1073,869,825,1,7,16,0,0,44
42051000200,352,260,238,0,6,9,1,1,22
42051001045,1773,1447,1394,3,4,25,1,1,53
42051000260,771,590,543,1,24,12,5,1,47
420510820P1,12,11,10,0,0,0,1,0,1
42051000350,2186,1786,1690,8,35,20,4,0,96
42087000280,2061,1631,1580,18,0,19,3,0,51
42087000050,1991,1583,1485,33,23,20,8,3,98
42087000110,1408,1093,1041,11,5,19,15,0,52
42087000080,2218,1862,1791,35,16,15,12,0,71
42087000090,1631,1381,1342,4,8,15,12,0,39
42129001910,2131,1697,1609,20,19,5,20,0,88
42129001010,598,522,500,1,8,7,4,0,22
42129000940,310,245,239,3,0,0,1,0,6
42129001200,2039,1735,1674,17,6,14,7,0,61
42129001230,426,358,339,0,1,4,0,0,19
42129001630,1294,1073,1010,13,24,12,3,0,63
42129000730,558,458,412,12,19,7,5,0,46
42129000740,890,734,667,10,23,13,7,0,67
42129000760,2313,2107,1846,26,202,18,6,1,261
42129000540,895,722,622,12,51,20,17,1,100
42129000510,470,386,322,6,39,11,8,2,64
42129000610,430,330,280,3,38,4,1,1,50
42017002830,3608,2989,2763,65,50,27,77,1,226
42017001420,1987,1566,1409,59,34,28,46,0,157
42017000300,1234,1044,990,20,14,20,1,0,54
42021000660,692,566,527,5,9,15,7,1,39
42087000100,1955,1607,1544,14,22,10,12,0,63
42097000170,898,710,690,3,3,12,1,0,20
42097000150,676,551,524,5,0,5,4,1,27
42097000730,325,274,268,0,0,3,0,1,6
42097000720,2373,1938,1863,20,7,11,17,2,75
42097000390,943,842,813,10,4,11,2,0,29
42097000900,1373,1091,1034,17,22,16,8,1,57
42097000130,1972,1619,1568,9,16,11,10,0,51
42097000630,1232,948,850,36,31,23,11,0,98
42097000070,1571,1271,1184,39,36,13,3,0,87
42097000110,1452,1102,1058,5,8,15,7,1,44
42097000220,1944,1470,1431,17,5,9,5,0,39
42107001040,570,465,409,19,22,9,5,3,56
42107000840,639,548,538,4,2,1,0,0,10
42107000830,1520,1297,1252,8,9,9,6,2,45
42107001175,1724,1421,1332,41,27,6,20,2,89
42107000780,253,213,199,3,2,5,5,0,14
42017001500,1806,1380,1193,51,55,13,62,1,187
42017001220,982,764,691,12,7,14,29,0,73
42125000160,1654,1319,1089,22,157,21,23,1,230
42125000900,1313,1128,1088,5,18,4,3,0,40
42125000340,1113,962,928,15,7,2,6,2,34
42125000330,1824,1509,1409,46,27,7,10,2,100
42107000330,713,555,543,10,2,0,0,0,12
42107000285,863,740,708,9,3,8,6,1,32
42107000155,1477,1207,1169,10,7,3,9,0,38
42051000560,1262,1044,994,12,8,15,3,1,50
42111000330,832,704,689,0,1,3,3,0,15
42051000900,1026,818,793,7,3,7,0,0,25
42107000175,402,334,312,7,2,6,7,4,22
42107000185,1363,1099,1055,22,10,5,6,2,44
42107001310,1449,1191,1120,25,11,13,9,1,71
42107000940,550,448,414,16,7,4,4,0,34
42107000950,1256,1025,961,26,13,16,7,1,64
42021001851,2415,2048,1899,42,41,18,26,0,149
42021000270,140,103,101,0,0,1,1,0,2
42021000280,1604,1266,1231,8,6,9,5,0,35
42021001770,479,371,363,2,1,1,0,1,8
42021001060,808,590,462,17,93,24,5,2,128
42021000695,1213,947,919,10,2,15,0,0,28
42021000595,278,220,191,5,20,0,0,0,29
42021000290,930,791,741,20,14,13,2,0,50
42049001072,2074,1656,1579,16,13,17,7,0,77
42049001068,2363,1869,1772,14,7,25,9,0,97
42049001330,3488,2751,2576,50,23,42,20,1,175
42049000300,1328,1151,766,65,218,18,68,2,385
42125001510,548,446,418,1,15,3,3,1,28
42125000272,2283,1806,1582,26,117,38,4,1,224
42125001945,1722,1326,930,37,299,48,10,3,396
42125001310,1347,1073,990,4,39,14,10,3,83
42125000960,1247,1060,1008,6,5,17,5,0,52
42125000970,1169,996,945,14,7,14,2,0,51
42125001362,2071,1666,1531,17,57,12,29,3,135
42125001368,1662,1335,1229,21,34,11,34,2,106
42129002420,1707,1524,1450,12,29,15,8,2,74
42129003050,1219,1028,959,5,29,17,6,2,69
42129003060,669,568,529,8,13,7,5,0,39
42103000040,3452,2860,2562,153,27,57,32,2,298
42103000022,3751,2911,2514,233,75,40,36,1,397
42129002970,1397,1222,1161,16,6,22,2,0,61
42129002960,2633,2144,2064,14,24,17,9,0,80
42129002990,1360,1180,1135,5,18,4,4,1,45
42129000210,932,766,730,5,8,9,2,1,36
42129000280,781,631,622,3,0,5,3,1,9
42129000240,440,380,374,0,4,1,0,1,6
42129000250,880,779,756,6,5,6,3,0,23
42125000590,2110,1667,1559,21,35,12,25,3,108
42125001630,1461,1191,1153,4,7,15,2,0,38
42091002880,1609,1176,1013,30,86,15,43,2,163
42091001750,1390,983,829,27,43,2,77,0,154
42091000090,1598,1269,912,45,221,10,65,1,357
42091003193,1369,1068,940,27,41,1,42,0,128
42091003530,1824,1424,1300,54,22,11,18,0,124
42091002025,3827,2826,2604,42,64,29,72,2,222
42091002070,4588,3471,3114,112,132,36,67,1,357
42091001710,1443,1137,1011,48,17,1,52,0,126
42091001400,1129,833,723,15,12,0,67,0,110
42091002910,1159,883,785,39,34,1,25,0,98
42091003670,1506,1302,1033,62,100,14,94,0,269
42091000035,1649,1310,1042,39,44,9,173,0,268
42129000850,313,269,244,6,2,10,3,0,25
42129000710,1911,1601,1539,11,25,4,7,0,62
42129000410,1548,1293,1232,13,26,7,4,0,61
42129000400,728,598,568,7,4,11,7,0,30
42129002095,1762,1453,1392,10,14,15,14,1,61
42129002080,924,776,750,10,9,6,4,0,26
42129000490,490,410,387,2,0,15,1,0,23
42129000950,509,400,371,3,7,8,8,0,29
42041000525,2711,2141,1817,127,114,27,42,1,324
42041000183,3988,3302,2144,444,291,53,439,3,1158
42041000194,1138,899,783,44,51,15,10,0,116
42107000900,2059,1724,1693,9,5,7,4,0,31
42107000565,1024,830,723,60,14,27,8,0,107
42063000695,2371,2089,1862,18,60,36,94,2,227
42013000600,1907,1556,1506,7,4,26,3,0,50
42025000428,1589,1297,1235,25,5,18,4,0,62
42095000290,2558,2107,1470,434,162,51,52,6,637
42095000230,1752,1392,957,211,174,7,42,1,435
42095000800,1905,1544,1398,51,22,12,44,1,146
42095000880,1173,969,921,22,9,11,0,2,48
42095000337,1597,1407,998,136,213,10,34,0,409
42095000358,2530,2155,1500,216,173,22,259,2,655
42095000364,1845,1522,1205,119,75,13,103,0,317
42095000333,1793,1431,889,168,166,19,198,5,542
42095000356,1434,1157,877,103,68,1,112,1,280
42095000368,1549,1280,915,115,102,14,140,4,365
42049000880,1508,1222,1170,14,14,8,6,0,52
42125001540,720,585,556,6,9,10,0,0,29
42125000530,482,393,370,8,8,0,0,0,23
42125001550,822,649,613,9,12,7,0,0,36
42125001770,1315,1103,1060,7,7,7,14,0,43
42125001180,909,747,706,4,3,16,5,0,41
42125001850,640,501,439,3,46,15,2,0,62
42103000110,3206,2784,2546,119,57,40,17,2,238
42103000052,2588,2172,1962,101,42,53,18,2,210
42103000045,2484,2099,1849,115,55,44,33,3,250
42095000470,3107,2993,2412,185,168,17,184,2,581
42095000550,3317,2451,1030,684,641,66,116,3,1421
42095000930,1896,1531,1373,84,35,21,24,1,158
42013000650,852,700,666,2,4,6,13,0,34
42013000660,633,557,528,1,3,0,25,0,29
42049001460,2244,1698,1606,13,12,33,12,2,92
42125001760,404,335,318,3,0,6,1,0,17
42109000260,1130,816,804,1,0,7,1,0,12
42033000480,2190,1729,1678,0,5,15,13,0,51
42013000161,1538,1132,971,12,72,45,11,1,161
42013000760,1018,843,804,5,7,22,6,0,39
42021000615,1273,1037,1010,5,7,10,1,1,27
42013000750,2355,2004,1873,21,36,12,21,1,131
42013000291,2102,1605,1479,20,70,16,13,2,126
42013000301,1402,1187,1090,13,29,21,22,3,97
42071001580,5672,3894,3567,191,69,56,17,2,327
42071001640,2843,2106,1832,169,42,38,29,0,274
42071000210,3361,2588,2434,69,30,34,11,5,154
42049001050,1467,1114,1025,36,30,14,6,0,89
42049000898,1821,1500,1429,10,14,20,7,0,71
42049000902,1840,1413,1341,18,5,31,7,0,72
42049001440,4393,3473,3273,36,27,78,18,1,200
42049001450,1671,1336,1271,13,10,23,9,0,65
42071000350,1194,943,669,198,31,4,38,0,274
42071000330,1049,837,659,60,47,5,68,0,178
42071001850,4044,2905,2787,46,19,22,11,1,118
42071000550,4398,3484,3019,247,101,60,81,8,465
42071000560,2286,1796,1649,87,33,24,8,1,147
42071000540,4210,3203,2754,260,81,61,45,4,449
42071001904,2560,1889,1648,99,45,26,56,1,241
42071001902,3365,2474,2241,95,38,22,73,2,233
42071001890,2635,1910,1746,57,30,10,56,5,164
42071000050,4595,3349,3128,74,44,25,56,4,221
42071000520,5110,3861,3536,157,64,16,79,3,325
42125000140,2114,1877,1633,65,106,21,36,2,244
42125000570,1094,860,773,51,17,9,0,0,87
42109000170,2070,1558,1519,20,2,4,4,2,39
42063000370,1216,992,950,6,2,16,0,1,42
42039000310,1702,1345,1286,10,8,22,5,0,59
42039000050,1439,1149,1107,4,4,11,3,0,42
42039000380,871,753,687,13,33,12,8,0,66
42039000660,2754,2133,2042,10,14,40,7,0,91
42039000630,3165,2441,2285,21,59,27,19,1,156
42039000150,1316,1028,988,5,7,21,4,0,40
42039000130,837,650,623,8,7,4,3,0,27
42121000116,2207,1763,1702,6,5,31,9,0,61
42121000040,1308,1066,1019,9,4,15,5,0,47
42039000370,2758,2379,2282,19,5,33,13,3,97
42039000100,624,527,505,8,6,6,2,0,22
42039000460,1895,1574,1490,21,12,35,7,2,84
42039000330,1718,1311,1259,11,11,12,5,0,52
42039000340,1350,1061,1022,2,1,17,5,0,39
42049000280,885,587,265,54,195,15,79,3,322
42049001320,3041,2430,2260,46,36,42,19,0,170
42049000420,1625,1240,912,81,176,25,15,0,328
42049001290,2299,1912,1775,29,50,14,30,3,137
42049000650,1007,854,773,19,34,2,25,0,81
42049000930,2210,1779,1711,18,6,20,8,4,68
42049001410,1573,1193,1106,15,7,28,10,0,87
42049001400,1541,1233,1196,7,2,15,1,0,37
42049001317,2965,2256,2041,18,9,20,143,1,215
42049001316,3148,2436,1977,52,61,15,319,1,459
42049001325,1792,1514,1290,21,52,14,128,0,224
42043000023,1258,969,898,25,9,10,25,3,71
42043001220,2249,1771,1080,257,385,58,39,9,691
42043001135,2710,2137,1490,140,431,27,61,6,647
42043000300,990,882,250,120,422,5,93,1,632
42043000250,2360,1630,246,658,708,55,58,2,1384
42043001380,614,496,475,7,3,3,6,0,21
42043000766,1797,1394,907,51,265,18,164,0,487
42043000840,1519,1284,1199,12,23,21,18,0,85
42043001280,3391,2684,1344,173,479,33,682,6,1340
42043001250,1907,1534,1044,130,262,20,95,2,490
42099000216,2043,1583,1463,29,22,41,4,1,120
42129001670,2297,1766,1549,22,38,18,122,0,217
42129000230,1715,1432,1401,2,11,7,2,1,31
42129000290,1679,1340,1297,5,12,14,5,0,43
42129002560,430,347,335,2,3,7,0,0,12
42129001000,482,410,376,2,23,3,5,0,34
42129001470,396,310,165,10,123,5,3,1,145
42129002810,1286,1062,1001,12,10,16,11,0,61
42085000445,1233,1025,986,5,4,11,8,0,39
42085000825,1090,801,524,15,218,22,18,2,277
42085000630,1332,1054,1018,5,1,14,4,0,36
42083000010,709,540,505,3,2,16,0,0,35
42107000025,1054,823,778,18,11,14,2,0,45
42107001355,1418,1055,746,276,30,8,8,2,309
42107001345,694,538,385,121,43,8,0,0,153
42107001335,333,289,263,23,1,5,0,0,26
42011001630,2184,1662,1510,82,36,19,12,3,152
42011000600,1855,1469,1179,204,39,27,29,5,290
42011000056,2200,1653,1398,51,106,23,68,2,255
42011000310,1996,1623,1426,27,115,31,13,1,197
42011001438,1994,1634,1567,28,10,14,12,0,67
42071001790,3269,2252,1734,294,109,15,120,5,518
42071001720,4457,3066,2924,63,30,22,20,0,142
42017001490,1282,1029,896,32,50,10,39,2,133
42017000070,3168,2620,2103,148,123,23,219,1,517
42017000680,1313,1046,884,70,60,15,15,0,162
42017001740,3632,2857,2577,84,76,22,74,1,280
42017000370,1457,1212,606,140,406,22,51,0,606
42123000070,1300,1055,991,17,5,36,5,1,64
42123000060,2127,1722,1635,16,20,23,8,1,87
42043000932,2545,2026,1871,44,45,19,24,4,155
42043000900,1335,1078,939,59,37,18,18,2,139
42043001205,2682,2192,1560,72,370,24,152,2,632
42043001145,3001,2530,1765,63,482,24,203,3,765
42043001215,3394,2651,1449,128,656,12,425,5,1202
42043001302,2507,2000,1120,292,371,36,211,2,880
42043000800,1559,1003,985,3,6,7,2,0,18
42043000910,816,573,556,4,9,7,2,3,17
42015000300,1010,795,762,2,1,18,4,0,33
42015000520,1056,812,769,4,4,22,6,0,43
42015000230,478,376,363,0,0,9,3,0,13
42013000171,1769,1361,1226,12,82,21,4,0,135
42013000181,1074,855,787,22,19,4,9,2,68
42013000800,2433,1921,1853,25,1,16,16,0,68
42013000780,1070,873,851,5,2,8,0,0,22
42013000850,1814,1474,1404,6,13,29,6,0,70
42043001368,1311,1040,938,28,41,15,12,0,102
42043001372,1851,1526,1319,55,61,17,63,1,207
42043001352,1437,1102,949,33,32,15,63,0,153
42043001376,1518,1182,1011,20,72,18,55,2,171
42133000320,2775,2172,1846,121,139,37,42,0,326
42133000740,1681,1307,1153,62,45,34,18,5,154
42133000630,4784,3639,3298,122,94,64,51,0,341
42133000220,4077,3253,2904,161,69,36,59,6,349
42133000245,3221,2501,2167,131,93,46,51,2,334
42015000390,1116,884,832,6,1,29,1,0,52
42015000100,989,752,698,9,10,31,5,1,54
42015000060,2241,1763,1640,23,23,30,33,0,123
42015000020,858,711,682,3,3,12,5,0,29
42039000140,1515,1013,990,3,3,5,7,0,23
42039000620,577,434,417,4,2,4,4,0,17
42071000010,1916,1453,1313,49,28,8,41,5,140
42071001930,3165,2345,1788,390,99,38,50,1,557
42071001910,2636,2039,1824,101,45,19,52,1,215
42071001590,4170,3141,2781,137,75,37,89,7,360
42133000980,2573,2115,2039,28,10,25,8,1,76
42133000050,1118,916,849,29,7,17,8,0,67
42133001000,2927,2363,1917,214,160,27,34,4,446
42083000370,779,622,596,0,0,7,0,0,26
42083000160,765,577,549,3,0,13,7,0,28
42071001070,1146,913,816,55,9,10,20,1,97
42071001160,1601,1242,1037,78,30,12,81,2,205
42071001540,2571,1986,1704,173,71,35,16,2,282
42049000030,1277,992,943,8,3,16,4,0,49
42049000340,1044,890,728,52,62,22,12,1,162
42071000710,1691,1343,695,423,179,22,60,3,648
42071000740,1594,1220,536,353,243,22,114,2,684
42071000600,2575,2191,1006,733,430,49,74,1,1185
42071000070,4609,3260,3148,36,24,25,11,5,112
42071000870,1617,1139,372,528,258,23,26,4,767
42083000140,846,681,648,3,0,19,2,0,33
42083000410,145,112,109,0,0,0,1,0,3
42107001505,1884,1386,1214,96,31,25,17,1,172
42107000815,1411,1181,1115,31,11,14,10,1,66
42107000470,1589,1304,1266,10,4,5,4,0,38
42107000460,761,603,588,3,2,8,2,0,15
42129001930,2414,1811,1693,27,21,19,28,0,118
42129002780,4822,3822,3631,38,36,27,51,0,191
42129002830,2428,1960,1865,17,20,16,14,0,95
42011000160,2004,1574,1457,30,34,24,18,0,117
42011000180,2567,2072,1960,36,26,21,13,0,112
42043000360,1117,868,353,148,363,19,32,1,515
42043000765,2439,1965,1661,104,93,28,83,1,304
42043000540,360,293,280,3,3,2,4,1,13
42043000630,2272,1785,1289,128,205,27,144,0,496
42043001230,3564,2923,1240,717,863,69,118,4,1683
42043000071,1096,876,579,215,44,10,28,3,297
42043000610,2018,1596,1068,156,295,21,66,0,528
42043001320,2129,1649,1588,19,11,18,13,0,61
42129001080,956,761,652,12,67,17,7,1,109
42129002800,1212,1016,960,15,6,12,2,1,56
42129002870,2300,1891,1802,17,11,24,10,0,89
42129003030,846,687,653,3,9,9,0,0,34
42093000080,1795,1392,1344,8,9,11,18,1,48
42093000115,1626,1316,1121,32,52,12,88,5,195
42093000150,454,363,342,12,3,4,2,1,21
42047000190,101,66,59,3,2,3,2,0,7
42047000070,1829,1512,1457,11,4,17,5,1,55
42087000230,2145,1717,1614,24,25,28,16,0,103
42071001230,1497,1204,939,112,71,7,82,4,265
42071001320,1731,1378,962,195,134,7,74,1,416
42043001262,3060,2369,1290,158,437,38,474,2,1079
42043001272,3320,2463,1360,270,598,35,251,9,1103
42043000890,1553,1379,922,258,121,23,66,5,457
42043001410,691,534,496,9,15,16,3,1,38
42043000440,1863,1342,253,382,650,27,84,3,1089
42043000810,636,496,453,17,17,12,4,1,43
42043000820,1237,963,901,9,12,25,14,2,62
42043000565,1288,1022,900,66,25,27,7,2,122
42093000105,2933,2403,2006,73,74,20,233,2,397
42033000370,366,308,302,0,2,3,1,0,6
42033000250,3120,2868,1305,1272,313,9,83,0,1563
42071000300,3936,2981,2848,63,31,20,2,10,133
42071000282,2598,1945,1760,81,56,25,22,3,185
42071000288,2692,2045,1807,103,75,28,24,3,238
42043000740,1724,1372,602,148,517,14,119,6,770
42043000775,1679,1361,1211,55,52,34,20,1,150
42043000795,1656,1345,1132,132,58,23,14,1,213
42043000785,3757,3131,1996,293,548,34,275,4,1135
42043000860,1888,1498,1082,143,247,19,33,4,416
42043000850,886,674,452,79,115,20,21,3,222
42043000310,2130,1436,125,373,963,25,15,0,1311
42043000470,1741,1436,747,155,499,32,38,3,689
42043000350,2822,1939,178,528,1258,42,24,6,1761
42043000520,2557,1996,1848,50,35,18,44,0,148
42013000496,1541,1231,1170,5,18,13,14,0,61
42013000492,1526,1200,1143,10,8,7,28,0,57
42013000494,1716,1341,1260,21,9,18,30,0,81
42013000680,1252,973,950,7,5,3,0,1,23
42013000890,1017,801,755,14,12,9,5,1,46
42129002670,751,593,583,1,2,4,2,0,10
42129001880,2339,1877,1747,27,37,19,33,0,130
42129000440,1082,884,829,11,9,11,6,0,55
42129000420,1679,1364,1272,19,12,32,4,0,92
42129001790,715,522,298,13,191,11,10,0,224
42129002852,831,689,650,4,10,14,12,2,39
42129002851,336,262,242,4,5,3,5,0,20
42129002790,1037,828,774,12,17,11,10,0,54
42129000370,1426,1191,1149,9,10,9,9,2,42
42071001840,3412,2434,2279,80,33,12,27,1,155
42039000450,1200,965,921,4,9,18,9,0,44
42121000675,1761,1396,1337,7,7,26,0,0,59
42121000290,1427,1163,1110,14,3,17,3,3,53
42039000300,1272,1106,1076,6,6,13,5,0,30
42039000010,636,508,477,1,1,14,1,0,31
42039000440,775,590,555,4,7,13,3,0,35
42039000030,1862,1476,1376,9,4,46,3,2,100
42039000110,739,568,530,0,1,21,4,1,38
42121000060,439,346,328,1,2,8,4,0,18
42121000136,2486,1939,1855,11,6,36,13,0,84
42121000596,1243,1044,1018,5,4,12,1,0,26
42033000635,5384,4315,4165,16,15,37,64,0,150
42033000630,985,810,744,12,9,19,14,0,66
42033000130,511,392,372,3,1,12,1,0,20
42033000440,597,477,459,3,1,4,1,1,18
42083000240,314,259,249,0,0,4,0,0,10
42083000230,367,309,293,2,0,6,1,1,16
42049000590,2474,2096,1742,57,191,29,65,0,354
42049001370,3076,2426,2288,29,17,39,0,2,138
42049001430,2256,1742,1636,13,20,49,2,0,106
42049001260,2291,1940,1779,46,60,16,28,0,161
42049001110,2738,2288,1974,45,97,41,117,1,314
42049000050,1435,1093,1011,16,12,37,0,0,82
42049000520,2008,1374,574,166,521,31,79,1,800
42049000510,1698,1212,681,145,335,33,32,1,531
42049001300,3614,2861,2383,64,136,42,232,1,478
42049000850,2706,2090,1949,49,24,25,26,1,141
42049000020,985,782,744,0,2,18,3,0,38
42049000960,2200,1787,1719,25,18,10,6,1,68
42129000330,948,774,739,8,2,16,3,0,35
42129002650,1221,1029,1006,11,5,0,6,0,23
42129002770,508,440,419,2,6,3,0,0,21
42129001900,1002,813,738,17,23,16,7,0,75
42129000780,1831,1528,1335,23,92,25,37,3,193
42019000371,5242,4020,3500,119,92,45,232,3,520
42121000405,1264,984,921,8,25,20,6,2,63
42121000640,457,345,324,1,1,11,1,1,21
42039000170,1424,1095,1060,2,5,9,0,0,35
42039000020,788,590,564,0,6,10,1,0,26
42121000395,1956,1509,1381,29,36,41,13,3,128
42121000375,1247,923,835,13,33,29,4,0,88
42025000050,889,734,683,22,5,6,13,0,51
42025000340,2743,2168,1963,129,14,34,9,3,205
42129000040,2690,2072,1943,22,47,40,4,0,129
42011001412,2044,1616,1490,41,24,33,18,1,126
42011001405,1816,1431,1290,73,40,28,10,0,141
42011000652,1959,1561,1371,111,46,19,22,2,190
42011001390,3603,2929,2678,116,54,53,27,2,251
42011001750,2489,2019,1889,50,22,20,23,0,130
42011000480,2369,1803,1628,89,34,25,22,6,175
42081000500,2641,2180,2033,23,46,42,28,1,147
42081000290,613,501,483,3,4,6,1,0,18
42017001510,1540,1220,934,57,24,15,179,2,286
42017001230,955,728,618,24,10,4,63,0,110
42017002400,1362,1162,1101,18,8,18,4,0,61
42017001190,3061,2386,1908,212,107,29,118,1,478
42017002820,1831,1501,1410,25,25,19,12,1,91
42017001300,2930,2391,1845,78,100,15,337,5,546
42017001840,2612,2278,1963,170,31,20,86,0,315
42043000230,2280,1386,111,695,570,17,72,2,1275
42105000230,1099,882,838,13,7,17,5,2,44
42015000320,753,618,526,14,30,14,29,0,92
42015000450,905,716,690,5,2,10,5,0,26
42025000058,1414,1175,1128,17,3,10,7,0,47
42025000371,1396,1201,976,103,87,22,14,1,225
42037000115,2939,2368,2110,117,59,32,39,1,258
42015000550,1150,910,863,5,2,25,2,0,47
42015000430,423,334,308,5,0,11,3,1,26
42021001765,1485,1204,1140,4,6,29,0,0,64
42021000055,1514,1241,1208,8,2,10,0,0,33
42021000260,457,377,356,8,1,7,1,0,21
42011000032,2109,1698,1514,102,19,26,25,6,184
42011000034,1725,1442,1315,70,25,12,20,0,127
42011000530,2560,1927,1158,645,133,25,18,3,769
42005000090,656,553,536,3,0,9,3,0,17
42005000500,1244,1053,1023,3,1,6,3,0,30
42005000350,946,842,784,3,17,14,15,0,58
42005000100,345,287,285,0,0,0,0,0,2
42005000242,1736,1383,1308,17,28,17,1,1,75
42005000192,1465,1155,1068,12,48,11,5,5,87
42005000170,1305,1029,1007,1,1,9,1,0,22
42037000172,2439,1989,1701,109,94,33,46,3,288
42037000310,1120,901,879,6,7,10,0,0,22
42005000570,351,268,262,1,1,4,0,0,6
42005000560,373,295,282,3,1,5,0,0,13
42005000520,367,316,305,5,3,2,0,0,11
42005000720,1701,1381,1337,6,5,12,9,2,44
42037000422,2214,1776,1655,44,17,30,28,1,121
42037000612,2548,2090,1849,48,36,22,113,1,241
42133000728,5946,4728,4345,130,98,46,73,6,383
42051000460,1283,1067,978,10,42,22,3,0,89
42133000820,1742,1319,1065,96,113,10,45,3,254
42019000690,1838,1489,1427,12,4,28,8,1,62
42019000090,1594,1294,1169,29,37,37,14,4,125
42019000680,3081,2707,2221,86,147,41,169,5,486
42019000351,3795,2795,2545,44,55,17,105,2,250
42019000470,819,671,637,5,8,20,2,1,34
42081000450,1178,917,867,13,8,11,0,0,50
42081000600,1953,1587,1458,18,44,23,23,4,129
42081000610,830,657,601,8,26,9,10,2,56
42081000310,2163,1661,1417,26,154,14,30,2,244
42081000260,1966,1528,1469,10,10,25,6,0,59
42011000840,2475,2040,1920,63,16,25,9,0,120
42133000490,1845,1361,1324,7,6,16,7,0,37
42133000010,6853,5181,4835,107,55,41,99,12,346
42133000235,6873,5442,4936,183,104,74,141,2,506
42047000090,196,170,162,3,2,6,2,0,8
42087000210,2354,1790,1606,78,50,37,9,1,184
42125001688,1641,1309,1232,20,19,11,17,3,77
42125001672,1645,1417,1283,34,42,4,33,0,134
42125001682,1565,1199,1118,10,18,8,40,0,81
42125001662,1427,1189,1107,16,36,11,4,1,82
42125001700,1088,934,886,6,22,10,6,2,48
42125000130,741,577,533,5,14,8,3,1,44
42125001570,565,475,427,8,24,16,0,0,48
42125000485,1417,1070,871,24,143,16,13,2,199
42133001290,3320,2403,801,917,734,37,28,4,1602
42017000110,1884,1561,1192,92,121,30,134,3,369
42017002010,2156,1697,1557,18,30,3,80,0,140
42017001610,1655,1301,1137,74,34,6,48,1,164
42017002600,1672,1349,1154,111,27,19,36,0,195
42017001270,2941,2225,1872,67,46,11,206,3,353
42017001905,2848,2171,1684,67,19,7,373,2,487
42087000070,1650,1325,1275,11,12,13,10,0,50
42087000290,3653,2664,2577,22,22,18,8,3,87
42133000860,2372,1792,1568,105,66,31,11,3,224
42133000640,6081,4804,4319,114,231,75,62,2,485
42133000170,4223,3334,3070,72,102,26,39,6,264
42133001300,2075,1453,515,551,380,27,29,5,938
42133000650,3071,2477,2345,55,24,37,14,0,132
42133000360,3180,2515,2031,305,144,60,13,4,484
42005000075,784,637,617,2,0,6,3,0,20
42005000310,966,777,750,3,5,6,0,0,27
42037000095,2282,1758,1540,102,70,24,10,0,218
42005000130,1235,953,917,8,2,9,2,0,36
42005000112,1506,1159,1130,8,1,9,2,1,29
42115000260,1603,1309,1253,21,1,17,7,3,56
42115000320,1789,1466,1407,19,7,20,14,0,59
42115000180,1254,1008,941,8,3,24,9,2,67
42087000130,2925,2398,2290,23,17,40,13,0,108
42019000030,1214,958,892,17,2,28,5,1,66
42019000670,6806,6138,5496,137,250,67,153,3,642
42019000012,4687,3563,3222,67,72,18,155,3,341
42019000353,2538,1829,1682,42,24,18,65,1,147
42019000260,1054,835,793,5,12,12,2,0,42
42019000190,2847,2341,2247,18,20,22,15,0,94
42019000740,335,274,272,0,0,1,1,0,2
42133001427,1889,1491,1303,70,56,22,39,1,188
42133001428,818,679,570,41,54,9,5,0,109
42133001190,1055,788,677,40,45,11,12,0,111
42133001426,1568,1216,1036,80,64,18,25,0,180
42133000610,6870,5390,4929,154,91,107,55,3,461
42133001230,1985,1590,592,543,477,31,27,3,998
42133001054,3297,2384,2072,49,179,15,59,2,312
42133001062,2801,2169,2004,49,58,33,26,1,165
42133001058,2974,2154,1854,74,120,43,53,2,300
42133000890,6891,5781,3929,959,674,97,185,3,1852
42133000760,4025,3049,2677,120,153,61,23,3,372
42133001200,2190,1507,431,623,471,30,15,2,1076
42133000930,2031,1666,1297,126,168,21,57,0,369
42133000780,2589,2121,2002,40,10,29,18,4,119
42133001100,6288,4881,4204,150,338,67,115,1,677
42133001075,3262,2332,1320,530,458,43,34,2,1012
42115000070,2097,1691,1624,17,2,19,17,0,67
42037000375,1881,1495,1453,13,0,18,4,0,42
42037000490,2269,1839,1751,32,5,28,13,11,88
42037000620,1904,1515,1406,43,19,22,23,2,109
42037000020,1323,1085,1059,5,3,11,4,2,26
42109000130,2065,1664,1599,21,10,20,7,1,65
42109000200,1377,1145,1054,32,26,16,24,2,91
42095001160,1203,911,769,56,35,14,30,0,142
42095000780,2276,1797,1522,77,53,17,119,1,275
42095001220,3617,2876,2559,125,60,46,83,2,317
42095000140,1004,853,699,85,54,12,13,0,154
42095000490,2520,1905,887,538,443,53,44,0,1018
42095000331,1302,1078,827,82,68,25,65,0,251
42095000020,1571,1256,1039,124,49,24,15,1,217
42095001000,2599,2137,1685,207,132,30,97,0,452
42095000990,2098,1728,1453,160,100,9,16,0,275
42071000790,1572,987,97,700,230,38,20,5,890
42071000780,1619,1070,157,690,274,27,17,6,913
42071001402,2095,1649,1508,86,15,14,25,4,141
42071001680,3536,2310,2183,39,37,20,19,1,127
42071000220,3792,2907,2598,148,54,37,75,0,309
42081000240,850,661,633,0,7,13,1,0,28
42081000480,3573,2918,2816,21,18,40,9,0,102
42081000460,1201,928,870,16,13,13,7,0,58
42011001310,1936,1732,874,434,377,29,55,22,858
42011000391,765,593,483,76,32,16,5,0,110
42011000393,1593,1217,925,201,84,19,5,0,292
42011000610,2861,2258,1802,305,107,38,19,4,456
42011000654,2671,2026,1721,133,98,18,55,2,305
42103000025,6089,4808,4077,387,158,74,71,4,731
42103000140,2537,2171,1933,115,45,37,40,0,238
42103000080,1352,1070,898,75,28,48,21,2,172
42021000881,1537,1292,1136,32,105,17,13,1,156
42021001016,426,350,289,14,33,10,0,0,61
42021001380,1946,1604,1568,7,2,17,1,0,36
42021001230,1196,1152,972,33,106,4,38,5,180
42021001931,1532,1177,1098,24,34,8,15,0,79
42021001200,383,289,274,2,1,2,2,0,15
42021001190,953,591,417,18,137,11,6,2,174
42115000092,1780,1399,1263,43,18,27,27,0,136
42105000130,1022,808,792,4,0,8,1,1,16
42105000020,397,318,302,7,0,1,2,0,16
42105000270,62,59,55,1,0,3,0,0,4
42105000220,162,133,131,0,0,0,0,0,2
42023000070,182,167,161,0,0,0,0,0,6
42125000095,1425,1131,1026,37,28,17,9,2,105
42125001210,367,310,283,4,16,6,0,1,27
42125001190,2024,1621,1577,4,13,5,7,2,44
42125000420,755,628,591,3,7,14,4,0,37
42125001990,703,592,552,7,14,7,5,1,40
42125000235,1589,1215,977,32,148,25,27,3,238
42125000020,1962,1583,1500,6,15,34,13,0,83
42125000070,617,498,481,4,4,7,1,0,17
42125000185,1153,934,770,38,90,23,4,0,164
42125000050,2352,1868,1746,11,36,29,11,5,122
42125000110,611,515,436,11,46,10,13,0,79
42125000352,1356,1000,928,11,22,16,13,1,72
42125000125,1896,1754,1393,54,219,38,39,6,361
42115000050,787,646,607,15,1,11,1,0,39
42037000372,1523,1243,1177,14,4,34,3,1,66
42005000300,869,736,708,4,5,3,2,2,28
42037000550,479,386,368,6,5,4,2,0,18
42037000630,199,164,158,0,1,2,4,0,6
42037000640,887,733,705,9,1,14,2,0,28
42115000080,1228,980,934,18,12,15,0,0,46
42121000740,375,302,296,0,0,4,2,0,6
42121000102,2320,1907,1849,9,14,16,3,1,58
42121000575,777,604,573,8,1,7,5,0,31
42115000150,1708,1357,1268,31,11,19,10,1,89
42115000140,1012,850,813,11,5,11,5,0,37
42115000040,2636,2138,2042,32,20,23,5,1,96
42069002275,1519,1231,1163,28,1,8,28,0,68
42069000410,1095,873,795,19,16,9,31,0,78
42069000420,1491,1181,1117,18,4,4,29,3,64
42069001035,1257,1080,995,39,12,6,10,0,85
42071001060,5652,3811,3652,89,29,20,14,1,159
42071000960,1506,1304,878,132,138,13,171,0,426
42071000040,3181,2025,1931,39,19,22,10,2,94
42115000380,1467,1141,1068,31,5,15,5,2,73
42069000670,905,755,645,33,20,9,45,0,110
42069000070,660,528,492,20,8,7,3,1,36
42069000080,1869,1471,1351,48,29,30,19,0,120
42069000030,1771,1422,1355,14,18,12,21,0,67
42069000090,278,230,210,0,7,4,4,0,20
42069001810,665,528,430,57,31,5,13,0,98
42069001060,2816,2249,2135,27,19,17,29,1,114
42069000135,1543,1247,1127,45,27,19,19,0,120
42069000925,880,725,683,18,11,6,6,0,42
42069000875,1046,870,802,12,17,18,17,0,68
42069000910,1329,1067,981,36,22,10,16,3,86
42069001280,2273,1722,1642,23,18,13,15,2,80
42125001845,1279,1088,777,31,241,26,12,3,311
42125001890,989,809,661,17,109,10,5,2,148
42125000682,1235,995,969,3,2,9,1,0,26
42125000692,1160,924,882,6,7,15,5,0,42
42005000340,2035,1708,1637,15,12,25,12,0,71
42037000440,622,491,475,4,1,10,6,3,16
42005000265,1945,1633,1559,8,25,16,10,0,74
42005000150,1323,1072,1036,3,4,7,10,0,36
42005000370,1175,865,823,12,5,18,4,1,42
42069001130,1030,812,708,64,17,7,11,1,104
42069002160,961,775,633,85,33,11,15,5,142
42069000830,3765,2980,2857,29,16,40,17,0,123
42069000525,1289,1024,917,50,35,9,16,1,107
42069000480,911,767,681,26,30,4,20,0,86
42105000210,78,68,67,0,0,1,0,0,1
42105000050,177,148,144,3,1,0,2,0,4
42103000120,551,474,416,33,12,3,6,0,58
42091001580,1987,1553,1171,45,75,3,229,0,382
42091003350,2415,1957,1588,65,135,17,151,1,369
42091003561,3339,2652,2335,61,120,30,85,2,317
42091003565,4440,3314,2753,79,149,20,291,4,561
42091002195,4453,3268,2634,129,186,48,258,2,634
42091001917,2342,1832,1560,62,88,11,110,3,272
42091002762,6798,6026,3380,459,2009,35,132,1,2646
42091002420,1203,970,857,31,41,10,30,0,113
42091002160,3340,2547,976,638,875,81,77,6,1571
42125000800,512,394,378,2,0,0,3,0,16
42125002030,925,750,716,6,10,4,0,2,34
42017000990,2788,2206,1890,102,70,65,75,3,316
42017001000,2131,1703,1434,68,103,25,73,3,269
42005000620,826,659,638,6,2,5,5,1,21
42005000380,886,672,635,12,10,12,0,0,37
42069002005,2003,1484,812,405,143,36,99,1,672
42069002070,1846,1430,885,335,154,33,57,0,545
42069001750,1204,940,543,189,100,19,113,1,397
42091003855,2150,1601,1037,61,179,6,297,4,564
42091000015,1211,933,778,42,64,11,40,1,155
42091001360,2544,2081,1787,51,81,5,150,1,294
42069000400,1524,1194,1091,32,4,11,42,0,103
42105000340,117,107,101,0,1,0,0,0,6
42021001951,1754,1377,1305,5,19,16,20,2,72
42021001332,1440,1127,1057,11,10,19,8,7,70
42021001340,849,695,670,6,0,14,1,0,25
42021001220,589,486,469,7,5,3,0,0,17
42021000140,2049,1603,1568,4,1,20,1,0,35
42063000550,561,453,433,1,7,10,0,0,20
42021000540,1338,1049,1005,10,12,10,5,0,44
42021001800,629,511,477,5,1,12,1,0,34
42021001342,807,669,651,3,3,6,2,0,18
42021001146,2044,1445,1058,47,307,27,3,2,387
42021000530,1401,1141,1065,23,23,11,13,0,76
42023000050,181,165,155,0,1,3,2,0,10
42125000378,2344,1750,1647,18,27,22,24,0,103
42125000384,3572,2946,2591,37,68,12,193,1,355
42125000550,2066,1810,1707,16,48,19,16,4,103
42091003700,3798,2953,2381,152,336,65,35,5,572
42091003652,2881,2286,1787,47,78,13,350,0,499
42091001200,1237,925,809,32,49,3,25,1,116
42091002973,2152,1688,1324,55,67,26,224,0,364
42091001026,1824,1489,1045,58,66,21,285,0,444
42091001500,1751,1511,977,98,238,20,159,3,534
42091002170,2855,1965,238,833,892,82,23,3,1727
42091003180,3703,3026,2815,66,50,46,32,1,211
42091000235,1547,1167,825,45,212,13,75,0,342
42091001822,4458,3527,2943,144,296,47,105,6,584
42091002100,2966,2138,717,723,614,88,70,3,1421
42039000180,2775,2278,2177,19,9,31,11,0,101
42039000120,1429,1156,1102,15,11,8,3,0,54
42017001160,1067,780,665,41,28,16,31,0,115
42017002080,3683,2895,2545,60,37,11,214,1,350
42017000470,1454,1088,846,91,74,19,54,2,242
42017000545,2235,1772,1449,122,90,24,70,4,323
42125000190,1980,1659,1476,38,78,30,30,0,183
42125000358,1134,860,769,14,21,12,24,0,91
42125000364,1780,1363,1271,29,16,8,26,1,92
42125000372,1577,1276,1231,10,19,5,9,0,45
42105000245,784,647,625,4,0,9,2,3,22
42121000050,953,670,644,2,8,8,1,0,26
42039000270,1128,885,742,22,78,25,6,1,143
42039000280,364,321,291,3,18,4,4,0,30
42065000180,114,102,102,0,0,0,0,0,0
42065000190,1940,1260,1224,5,8,18,3,2,36
42065000240,1000,826,801,5,0,4,2,0,25
42065000095,1944,1533,1465,14,11,13,16,2,68
42065000085,2051,1624,1547,28,2,20,16,0,77
42039000060,2590,2272,1857,81,274,30,13,2,415
42125000500,1137,930,664,35,178,17,29,0,266
42125000280,1178,901,834,8,29,10,7,0,67
42069001925,2201,1705,891,211,217,57,315,1,814
42069002030,1322,1068,824,125,45,17,71,1,244
42069000895,1265,1036,975,28,9,11,6,0,61
42091002120,3570,2478,536,1146,778,110,35,0,1942
42071001120,2132,1676,1444,102,70,15,36,1,232
42071000425,1612,1205,1056,77,44,13,18,4,149
42071000433,3229,2357,2044,130,74,38,81,2,313
42103000130,2528,2062,1856,120,22,34,24,0,206
42041000380,3408,2762,2452,97,80,25,92,3,310
42041000650,4286,3942,3071,220,276,68,296,1,871
42055000530,1163,922,837,27,37,13,9,0,85
42017001130,1442,1113,983,56,21,16,34,4,130
42017001860,2590,2005,1677,64,47,13,193,2,328
42081000772,2194,1595,954,59,509,39,30,5,641
42081000782,1490,1145,1033,11,61,14,20,0,112
42069001070,706,554,509,13,3,5,15,1,45
42133001393,2027,1571,1410,40,71,21,23,0,161
42011000188,2077,1605,1464,62,26,23,19,0,141
42011000192,2157,1542,1398,33,25,16,48,0,144
42011001530,1890,1489,1150,190,91,20,59,2,339
42011001572,1789,1356,985,230,87,29,20,4,371
42011000320,1674,1400,1340,25,12,10,7,1,60
42011000662,2016,1562,1378,84,66,14,25,1,184
42011001330,2001,1547,810,541,196,29,26,1,737
42011000700,5516,5135,4107,368,507,46,137,1,1028
42011001510,1970,1476,1250,126,66,6,46,0,226
42011001418,1759,1406,1334,12,11,19,18,3,72
42011000040,1542,1238,1121,38,28,21,24,2,117
42071000460,3985,2983,2839,42,13,14,36,1,144
42071000530,2900,2290,1948,181,64,50,46,6,342
42069000760,842,698,661,10,8,5,6,4,37
42081000792,1754,1373,1166,32,132,27,12,1,207
42081000440,1015,791,775,0,0,12,0,0,16
42081000670,534,442,426,3,0,7,0,0,16
42071001923,3378,2567,2254,122,75,31,75,0,313
42041000275,5122,4031,3287,120,136,39,427,8,744
42041000179,1854,1505,1281,63,74,24,72,2,224
42041000310,927,722,603,47,48,19,12,1,119
42065000120,432,363,349,2,0,3,1,1,14
42031000390,699,549,528,3,2,11,5,1,21
42133000870,1840,1544,1195,143,133,11,57,1,349
42133001010,5509,4435,3747,229,291,59,102,0,688
42133000850,2660,2014,1665,118,132,40,60,0,349
42133001110,3366,2701,2523,49,47,49,15,0,178
42133001040,5059,4330,3606,220,318,68,119,2,724
42133000080,5088,3869,3164,219,334,72,69,2,705
42133000155,7468,5726,4935,303,305,115,64,9,791
42103000090,1523,1237,1083,66,22,29,38,0,154
42103000035,6401,4985,4042,477,235,114,104,5,943
42103000010,5415,4552,3826,414,179,64,95,8,726
42103000100,1103,958,844,71,7,11,19,0,114
42103000065,5686,4409,2120,958,1102,90,198,13,2289
42015000090,1041,744,677,10,16,8,14,3,67
42015000380,1457,1165,1070,8,11,33,6,1,95
42015000280,624,485,457,15,3,3,2,0,28
4200300G082,1025,740,602,19,5,6,103,0,138
4200300G081,1518,1060,868,16,6,5,152,0,192
42003007490,756,643,413,49,109,12,55,0,230
42003003551,824,619,388,12,199,7,11,1,231
42003002160,835,729,694,6,4,14,3,0,35
4200300G210,804,612,515,11,70,10,7,0,97
4200300D580,508,363,129,11,212,9,9,0,234
4200300A170,702,548,236,4,280,14,24,2,312
4200300E366,1388,1177,928,35,92,18,98,0,249
42003005091,4318,3223,2825,107,112,54,113,2,398
42123000080,269,241,232,5,1,2,5,1,9
42041000360,5673,5137,3305,408,1265,34,132,9,1832
42041000175,1727,1426,1236,31,19,20,108,2,190
42041000430,1780,1420,1213,79,78,32,17,3,207
42041000215,2837,2111,1454,173,140,30,317,5,657
42133000090,3440,2620,2061,171,276,56,52,7,559
4200300C680,923,662,312,20,317,9,6,0,350
42071000367,1970,1512,1306,110,42,12,35,1,206
42071000240,4441,3068,2899,79,28,27,34,3,169
42071000230,2561,1814,1747,27,15,20,8,0,67
42071001155,1898,1636,1538,28,31,15,27,0,98
42071001346,2696,2411,2208,70,31,16,90,0,203
42123000020,1730,1450,1411,2,5,18,8,1,39
42123000195,1282,1021,978,7,2,18,2,2,43
42121000330,1361,1108,1064,9,3,19,3,0,44
42121000560,903,732,707,5,1,21,0,0,25
42011000880,1489,1049,171,784,140,52,6,4,878
42063000470,1068,917,776,19,48,17,57,2,141
42111000620,1062,864,844,4,1,9,0,1,20
42015000180,737,560,530,11,0,7,5,0,30
42071000320,3180,2247,2104,69,26,16,34,4,143
42071001392,3869,3082,2476,275,154,41,141,2,606
42071001398,2009,1512,1097,192,137,21,78,2,415
42071000272,3511,2560,2430,49,18,11,40,3,130
42071000262,1696,1334,1211,29,22,16,54,0,123
42043001374,1516,1253,1008,59,139,5,34,0,245
42043000160,3058,2365,2030,224,36,20,28,0,335
42133000620,4018,3123,2812,104,75,61,40,0,311
42133000690,3969,3152,2999,48,29,55,13,5,153
42133000960,2129,1672,1512,25,62,26,34,0,160
42111000140,1408,1131,1100,5,5,6,7,1,31
42111000080,2379,1850,1797,11,6,23,5,0,53
42043001185,3012,2347,1367,192,540,39,253,5,980
42043001165,2730,2229,1155,140,734,29,201,8,1074
42043000087,2185,1829,1219,377,109,15,100,3,610
42043000150,2961,2269,2083,63,39,32,43,0,186
42043000147,3164,2309,1647,68,75,31,485,1,662
42043000340,2730,1867,225,728,934,57,14,2,1642
42043000290,1103,975,624,93,240,9,20,1,351
42043000960,850,646,247,99,275,21,27,0,399
42071000470,3871,3097,2652,206,116,63,65,7,445
42081000330,2497,2032,1913,20,40,16,39,1,119
42133001360,2374,1944,1121,429,368,28,50,1,823
42133000390,2605,2157,2002,57,29,41,16,0,155
42083000200,2263,1863,1773,12,8,19,25,0,90
42111000210,752,537,522,3,0,10,1,0,15
42071001340,2473,1911,1713,90,43,20,30,1,198
42071000080,1112,867,775,49,28,19,6,0,92
42133000800,3848,3107,2771,94,117,43,66,1,336
42133000410,5271,4244,3963,56,67,90,31,1,281
42133000175,4467,3537,3027,244,165,68,45,16,510
42133000480,1186,871,829,8,7,11,14,0,42
42011001442,1652,1330,1274,21,11,13,14,0,56
42011000618,2569,1986,1689,148,90,12,31,3,297
42011000358,2165,1744,1498,91,95,38,17,2,246
42011000340,1688,1410,1333,29,18,17,2,1,77
42011000220,3174,2547,2440,47,13,18,17,3,107
42011001560,2347,1842,1267,157,154,189,99,0,575
42071001560,2719,2229,1983,144,61,32,28,2,246
42071001550,3035,2397,2030,208,100,37,40,1,367
42071000860,2065,1528,828,410,244,33,73,10,700
42041000221,2218,1861,1475,65,76,20,218,0,386
42133000810,1672,1282,1064,83,90,29,11,0,218
42091000125,1613,1242,489,78,629,18,41,0,753
42091001965,2804,2221,1550,71,133,19,438,6,671
42083000100,1065,832,770,4,12,22,12,0,62
42083000250,1116,839,788,8,6,17,6,0,51
42083000300,719,570,545,4,3,9,1,0,25
42083000310,717,581,548,3,5,12,5,0,33
42085000020,2107,1708,1656,7,11,22,4,0,52
42085000565,940,750,699,17,5,23,7,0,51
42085000060,953,694,673,0,1,7,3,0,21
42085000600,183,127,125,0,0,2,0,0,2
42107001290,1424,1112,1030,30,17,25,10,1,82
42107001440,2723,2196,2084,43,15,32,12,0,112
42107001682,1655,1332,1257,33,10,13,5,0,75
42107000575,760,541,434,72,26,14,2,0,107
42071000680,1228,1102,705,195,143,24,72,0,397
42071000690,1136,947,548,225,146,13,28,2,399
42041000838,2200,1577,1028,62,413,17,66,2,549
42041000050,1771,1366,992,93,61,17,196,4,374
42041000550,1742,1387,1259,44,30,16,39,0,128
42049000970,1795,1452,1355,20,12,14,19,1,97
42049000320,1308,977,730,42,169,15,18,1,247
42049000790,1400,1161,991,43,51,9,54,2,170
42049001520,1492,1160,1038,43,29,28,15,1,122
42011001170,2366,1661,171,1266,359,102,6,4,1490
42011001780,2332,1903,1365,298,149,20,113,1,538
42011000670,1833,1412,1368,16,9,12,3,6,44
42129001260,1614,1318,1253,19,25,12,7,0,65
42129002160,823,648,607,16,11,12,5,0,41
42129002750,1502,1244,1207,8,4,8,8,1,37
42101005804,980,773,645,42,14,5,60,1,128
42049000245,1763,1279,648,165,392,32,59,3,631
42049000560,1082,892,762,34,58,8,27,0,130
42049001240,1541,1266,1172,26,17,19,14,0,94
42049001510,1730,1312,1128,63,47,24,18,3,184
42083000360,501,403,385,3,2,7,1,0,18
42129002440,764,641,616,11,0,2,3,0,25
42129001430,889,717,612,16,73,11,2,0,105
42129002310,1179,987,931,13,23,4,3,0,56
42129002320,2291,1896,1764,15,27,13,21,0,132
42129002370,172,137,120,2,6,3,0,2,17
42129002190,1868,1506,1412,18,37,12,15,0,94
42129001100,2105,1750,1569,21,111,30,5,2,181
42129001570,969,777,756,9,5,9,0,0,21
42129001560,682,570,547,7,3,4,3,0,23
42101005634,737,578,219,61,225,2,52,1,359
42101004124,985,682,336,142,176,22,32,3,346
42101001706,777,561,4,10,543,7,4,1,557
42101001703,784,612,0,11,607,1,1,0,612
42101001710,884,624,7,5,602,13,5,0,617
42101001815,836,723,334,210,164,21,36,3,389
42101006020,737,544,18,8,513,11,6,2,526
42101003625,928,703,190,40,423,11,46,0,513
42129001030,621,454,361,6,78,10,0,0,93
42129001810,1176,974,873,9,61,14,6,2,101
42101005529,1111,829,406,179,177,7,74,1,423
42105000310,643,511,485,6,1,15,2,0,26
42105000280,131,109,107,0,0,0,1,0,2
42105000110,530,442,425,3,3,2,3,0,17
42047000295,201,179,173,2,2,1,0,0,6
42047000010,216,203,196,0,1,2,1,0,7
42071001525,2753,2169,1884,106,64,25,79,1,285
42011000785,54,27,25,1,0,1,0,0,2
42011000170,2035,1654,1493,56,18,25,51,0,161
42121000300,1253,995,932,8,7,11,6,1,63
42121000020,188,141,129,0,2,2,1,0,12
42039000400,1910,1152,1116,3,0,18,2,3,36
42039000500,1334,1009,950,13,7,22,10,2,59
42039000080,1118,861,818,5,3,26,6,0,43
42071001454,2902,2265,2142,57,23,35,8,3,123
42071001452,2319,1718,1615,45,12,35,5,3,103
42029000480,2125,1595,1318,40,22,9,187,0,277
42029000800,2447,1863,1637,51,95,20,49,5,226
42029000160,2344,1757,1427,125,144,35,37,2,330
42029001010,2768,2073,1663,104,226,40,46,2,410
42121000310,917,755,712,7,3,12,0,3,43
42029000216,3517,2465,1938,55,76,15,349,0,527
42099000210,831,618,590,9,9,6,2,0,28
42007001250,330,275,259,2,4,6,1,0,16
42007000840,2187,1754,1660,18,10,37,3,1,94
42007000850,2019,1634,1565,17,17,14,0,1,69
42007000275,1386,1187,1136,9,19,7,4,0,51
42099000130,1037,806,768,14,11,8,2,0,38
42051000590,513,409,391,11,5,2,0,0,18
42007000620,1171,973,934,5,15,7,5,0,39
42007000610,997,827,741,16,13,20,12,0,86
42007000195,1125,889,684,23,148,19,16,2,205
42007000185,1748,1293,908,62,297,24,8,0,385
42063000710,2085,1700,1486,24,116,40,14,0,214
42099000310,1897,1431,1354,19,16,22,13,3,77
42007000250,1082,959,900,9,25,13,8,0,59
42007000680,184,160,148,1,6,0,2,2,12
42007001360,1587,1294,1176,18,37,17,22,0,118
42007000695,2056,1661,1585,39,23,10,2,0,76
42007000950,1430,1197,1118,16,37,16,8,1,79
42007001280,1611,1285,1231,8,3,17,9,1,54
42007001115,415,317,173,18,108,10,2,1,144
42007000630,1818,1465,1407,7,6,22,3,0,58
42007000640,249,196,180,2,5,10,0,0,16
42063000100,1675,1320,1265,16,5,17,0,1,55
42063000650,1013,841,785,11,5,20,6,0,56
42063000300,1379,1148,1103,7,0,21,7,0,45
42063000670,2945,2400,2216,38,38,38,45,0,184
42007000860,1324,1054,977,14,6,13,6,1,77
42007000300,1617,1351,1243,36,34,12,21,1,108
42007000710,1493,1309,1263,19,8,14,5,1,46
4200300G710,1002,841,754,12,43,15,11,3,87
42003000720,633,476,93,13,364,16,5,0,383
42007001260,3375,2952,2832,27,18,36,19,1,120
42007001300,1596,1291,1222,26,13,22,2,1,69
42007001510,2680,2204,2088,17,42,38,6,3,116
42007001310,1261,1039,984,4,22,14,3,0,55
42007001550,1195,941,872,20,24,15,5,2,69
42051000915,2722,2169,2031,18,18,36,4,0,138
42003002550,1587,1232,1141,18,16,6,45,0,91
4200300F921,934,764,595,28,113,29,8,0,169
4200300F281,674,556,537,7,6,0,6,0,19
42003003300,1187,916,856,11,24,5,16,0,60
4200300F415,1798,1363,1106,34,54,8,146,3,257
4200300B900,666,557,463,7,32,12,33,3,94
42003000281,820,642,555,11,10,4,62,2,87
42003000551,1739,1383,1265,10,23,22,46,2,118
42003000466,1174,907,845,11,8,7,29,1,62
4200300D460,917,784,644,17,93,6,20,1,140
42003001322,953,845,733,31,26,12,40,2,112
4200300F620,322,249,183,11,52,10,3,0,66
42003009960,874,758,614,26,22,6,88,0,144
42003008090,633,521,212,8,254,4,33,0,309
42003000381,1381,1134,954,32,105,12,31,2,180
4200300E342,1993,1727,1552,17,53,24,61,0,175
42003007660,648,592,483,21,50,7,28,0,109
4200300E810,658,563,451,14,32,1,66,0,112
4200300E120,842,681,616,3,36,11,14,0,65
42003003511,815,619,343,8,248,2,14,0,276
4200300B820,1222,923,570,13,303,23,23,2,353
42003006620,521,450,88,10,319,7,29,0,362
42003002510,1427,1226,971,20,42,11,166,1,255
42003001390,664,559,433,38,67,10,10,3,126
42003005870,7025,6954,4350,448,1889,67,227,1,2604
42003001440,837,700,589,16,66,8,14,2,111
4200300A950,533,492,460,4,16,3,8,4,32
42003004241,2368,2158,1658,126,273,43,41,1,500
42003005470,1088,857,274,18,547,12,9,1,583
4200300G852,640,466,424,8,7,10,19,0,42
4200300G856,1213,1067,994,14,9,5,35,1,73
42003001850,635,515,415,10,81,8,1,1,100
42003002371,986,741,656,14,10,4,56,1,85
42003002372,1711,1263,1077,17,20,16,105,4,186
4200300G341,641,502,264,21,196,9,14,0,238
42003005480,723,589,335,4,227,4,7,0,254
42003003080,2793,2257,1968,53,113,17,94,3,289
42003002200,1537,1258,1174,24,23,3,34,0,84
42003000111,705,633,525,25,66,12,11,0,108
4200300C070,933,853,493,34,297,18,15,1,360
4200300G140,1452,1054,960,22,10,7,53,0,94
4200300G171,1733,1389,1179,33,15,21,148,0,210
42055000550,2294,1678,1529,42,41,27,29,0,149
42055000010,2696,2115,1939,61,30,31,32,0,176
42003000061,1490,1253,999,34,161,33,17,1,254
42003009670,1003,804,656,22,26,8,88,0,148
4200300A120,570,415,192,20,181,24,14,0,223
42003005071,3547,2943,2436,86,184,28,176,3,507
4200300H155,1017,791,506,28,244,12,6,0,285
4200300G400,741,587,462,21,109,3,1,0,125
4200300D140,865,729,576,23,80,21,32,3,153
42003003630,637,522,238,18,263,7,0,0,284
4200300F180,1070,888,832,19,9,5,7,0,56
42003004271,3441,2571,2164,52,79,19,232,2,407
42003000980,796,666,527,15,62,15,32,0,139
42003005780,677,634,590,8,17,3,19,1,44
42003004540,1085,786,721,13,6,3,30,5,65
42055000490,2599,2160,2068,30,13,28,12,0,92
4200300D620,584,401,120,18,245,12,15,0,281
42003004281,2801,2388,1762,100,220,37,245,4,626
42003004251,2316,1816,1251,201,227,20,110,1,565
42003009350,766,660,329,39,244,16,41,0,331
42003009820,135,113,90,4,9,2,2,0,23
4200300C080,1251,1103,567,42,232,8,246,3,536
42003000446,1108,876,781,13,62,10,14,1,95
42003000562,1215,973,921,6,5,17,12,2,52
42055000030,2272,1781,1702,21,26,12,12,3,79
4200300D340,929,740,561,32,129,16,11,1,179
42003004741,1049,795,386,43,333,17,31,2,409
4200300F630,1097,721,438,28,244,17,5,1,283
42003001411,1161,961,826,32,70,10,19,0,135
42003001420,834,684,598,8,55,4,10,2,86
42003006860,1788,1659,1342,54,107,10,145,3,317
42003005940,1398,1343,1094,38,42,7,157,1,249
42003008930,226,159,4,1,148,3,2,0,155
42003008830,367,255,4,6,244,2,1,0,251
42003008990,315,241,6,3,221,1,2,0,235
42003003850,934,725,519,23,174,11,3,1,206
42003002025,1067,913,855,8,26,10,7,1,58
4200300G910,929,783,630,25,114,5,9,1,153
42003008360,671,566,136,25,382,8,16,0,430
42003007910,673,560,500,7,30,3,18,0,60
4200300E090,1293,1049,987,16,23,5,11,0,62
4200300A310,699,588,498,17,56,8,8,0,90
42003000301,848,700,609,3,12,4,70,1,91
42053000090,259,229,226,1,0,2,0,0,3
42053000080,3858,3685,2153,283,1222,23,10,4,1532
42127000230,1439,1191,1100,25,18,36,15,0,91
42055000412,2100,1657,1566,22,11,28,11,1,91
42055000402,1882,1446,1398,11,14,4,7,0,48
42127000165,1538,1229,1124,35,26,29,14,3,105
42001000100,4320,3264,3047,73,65,37,31,5,217
42001000090,3555,2928,2706,110,45,42,24,2,222
42055000635,4421,3433,3153,95,95,37,44,0,280
42055000180,407,322,307,4,1,4,2,0,15
42055000472,1665,1261,1194,25,16,22,3,0,67
42055000452,1265,1040,989,6,20,11,0,0,51
42001000060,1758,1334,1201,50,39,21,18,1,133
42001000150,1542,1181,1095,34,21,14,14,0,86
4200300H011,918,699,165,20,494,39,9,3,534
4200300F970,90,76,70,2,4,0,1,0,6
42003002131,1102,878,759,20,63,12,12,3,119
42003000400,621,464,416,11,11,12,11,0,48
4200300G291,1266,1050,997,9,18,16,4,0,53
4200300F950,1070,814,722,12,58,21,4,0,92
42003003860,578,420,286,9,109,10,4,1,134
4200300F530,310,265,254,4,1,2,2,0,11
42003002011,755,619,594,6,14,6,1,0,25
42003000291,1116,938,878,21,16,7,23,0,60
42127000130,1229,995,873,66,18,16,16,1,122
42127000090,1507,1264,1161,36,14,7,15,0,103
42003009730,966,902,595,61,102,16,130,0,307
4200300G790,2406,1864,678,36,463,15,655,0,1186
42003005001,687,538,295,12,223,8,3,2,243
42003004850,1026,849,736,22,55,13,22,1,113
42003001220,519,384,192,9,169,11,5,1,192
42003006665,630,609,513,14,36,6,31,0,96
42003001400,700,579,512,10,39,9,8,1,67
42127000220,785,653,619,14,5,7,8,0,34
42001000260,2714,2114,1983,91,18,13,19,1,131
42001000450,2679,2197,1803,208,106,45,25,2,394
42001000140,1571,1319,1194,33,31,14,49,1,125
42127000030,241,204,196,1,2,1,5,0,8
4200300G645,849,688,638,12,18,5,15,0,50
4200300C050,670,608,463,15,103,6,20,0,145
42001000110,2147,1701,1445,113,76,22,31,0,256
42001000130,1898,1609,1408,80,35,31,49,3,201
42013000130,995,777,691,19,36,20,4,1,86
42013000870,954,638,608,15,4,9,2,0,30
42013000700,2559,2265,1930,52,145,13,69,7,335
42055000520,599,472,460,3,2,9,0,0,12
42055000080,2077,1489,880,388,198,35,9,2,609
42055000060,2682,2043,1458,318,222,27,31,5,585
42065000205,1011,820,789,3,0,17,1,0,31
42019000865,1464,1192,1133,13,11,19,15,1,59
42019000040,423,330,318,2,1,9,0,0,12
42055000580,1560,1196,1133,21,8,26,3,2,63
42101005215,800,706,143,15,529,10,21,4,563
42101005218,843,663,21,11,623,16,5,0,642
42101005007,976,841,16,14,814,15,3,0,825
42101006010,520,428,59,19,338,10,13,1,369
42127000120,1397,1144,1066,15,15,21,14,0,78
42127000300,483,386,356,9,6,12,3,0,30
42065000525,1156,945,911,7,1,23,1,0,34
42031000040,150,122,117,1,1,1,1,0,5
42055000360,555,452,432,4,2,13,1,0,20
42055000370,740,612,590,4,8,6,3,0,22
42055000160,646,466,451,5,1,7,0,0,15
42127000340,807,665,630,9,5,13,2,1,35
42127000350,878,742,679,18,17,6,12,1,63
42101001723,1608,1523,656,217,510,7,138,0,867
42101004714,352,255,10,14,228,9,5,0,245
42101002717,607,498,55,30,391,7,31,3,443
42101003439,946,704,70,15,596,7,31,3,634
42101001616,611,331,0,16,316,1,0,0,331
42101006416,1014,820,543,78,49,7,138,0,277
42101006121,1286,970,73,78,798,31,36,5,897
42101002607,869,716,656,24,5,7,29,0,60
42101003936,838,697,572,24,9,8,80,1,125
42101000835,957,925,651,67,51,18,145,3,274
42101005712,1089,825,583,104,84,4,50,2,242
42101006313,1218,1002,698,85,156,18,53,0,304
42101006312,976,737,491,61,142,11,28,0,246
42101003803,877,694,1,14,686,3,1,1,693
42101003821,720,542,3,16,522,10,2,0,539
42127000240,841,679,648,10,5,10,4,0,31
42127000360,602,499,453,10,6,8,12,0,46
42013000070,1131,859,722,19,73,19,17,0,137
42013000610,629,490,458,4,9,5,5,0,32
42031000380,633,518,490,6,4,10,0,3,28
42031000270,365,315,304,4,0,5,0,1,11
42065000010,234,197,187,0,0,5,2,1,10
42031000400,469,373,363,0,2,6,1,0,10
420310400P1,3,3,3,0,0,0,0,0,0
42131000130,937,703,659,27,5,6,6,2,44
42131000300,733,606,589,4,2,8,2,0,17
42027000850,725,611,588,6,2,8,4,0,23
42027000050,1885,1582,1434,35,47,33,25,1,148
42027000070,6956,6548,3937,457,2079,27,29,3,2611
42055000600,1851,1474,1361,26,23,43,15,0,113
42055000240,4442,3562,3048,213,143,65,91,3,514
42055000285,2629,2096,1798,114,112,28,37,4,298
42055000260,2030,1620,1544,30,16,24,5,1,76
42055000570,2984,2254,2099,45,40,43,17,0,155
42127000270,1000,827,768,31,2,11,4,1,59
42027000380,4120,3804,2687,174,250,38,668,6,1117
42003002940,1428,1099,992,24,13,9,51,2,107
42003001880,415,300,109,16,173,7,5,0,191
4200300G960,729,623,231,13,339,16,21,3,392
4200300A680,495,371,49,17,297,7,3,1,322
42003004110,879,738,655,18,42,7,12,0,83
42003004060,1373,1135,902,15,111,11,89,0,233
42003001870,704,574,442,7,104,6,6,0,132
42003002035,1168,955,909,11,19,3,7,2,46
42003003161,1162,903,749,24,98,10,18,0,154
42003004330,1135,911,769,27,47,9,53,1,142
42003007830,530,467,360,14,72,8,9,2,107
42003001170,538,453,363,10,68,9,2,1,90
4200300H070,798,724,603,38,37,3,41,0,121
42003007100,910,870,565,40,31,5,220,3,305
42003007120,796,771,524,36,90,3,112,2,247
42003004400,1467,1159,1066,14,36,3,29,2,93
42003002821,641,584,298,23,256,6,10,1,286
42003001490,794,651,574,18,38,8,5,0,77
42003004570,452,341,302,8,6,4,16,2,39
42003002680,409,317,286,7,17,7,2,0,31
42003006660,394,338,18,3,306,4,9,0,320
42003009530,880,732,607,22,27,9,70,0,125
42003009940,695,566,466,24,29,6,30,2,100
4200300G680,1223,1025,898,12,75,9,11,4,127
42003003910,638,494,378,26,83,8,3,0,116
42131000010,461,347,329,7,0,11,2,0,18
42131000100,361,263,246,11,0,5,0,0,17
42095000090,3245,2907,1542,558,310,36,389,12,1365
42095001340,3242,2542,1880,301,252,52,88,3,662
42095001030,2149,1713,1504,83,76,14,35,1,209
42095001040,1587,1299,1066,129,39,13,39,1,233
42095001120,1504,1259,1176,36,22,10,12,1,83
42095000740,1711,1423,1298,53,31,15,16,2,125
42095000665,2154,1776,1487,106,53,16,97,5,289
42095000372,1597,1323,996,136,96,14,70,1,327
42131000160,1265,1029,975,12,3,18,1,1,54
42003002521,1147,979,868,24,40,4,32,3,111
42003002491,963,799,762,1,5,2,28,0,37
4200300E145,761,594,554,7,13,12,10,1,40
4200300G190,1096,806,752,20,9,1,21,0,54
4200300C740,899,652,352,17,262,9,12,1,300
4200300E735,1385,1143,962,29,73,16,56,0,181
4200300E705,615,573,490,15,13,6,50,0,83
42003000221,1001,827,743,17,25,7,38,1,84
4200300E356,1302,996,851,36,40,17,53,2,145
42003003820,405,316,214,18,60,20,0,0,102
4200300G011,992,759,458,13,263,13,9,0,301
4200300G931,1032,882,75,11,791,12,5,0,807
42003004371,869,655,598,19,5,11,17,1,57
4200300F760,858,698,363,30,280,28,17,0,335
4200300F810,816,692,478,22,159,7,30,1,214
4200300E376,2661,2299,1900,69,111,15,196,4,399
4200300C140,844,772,563,31,141,11,28,1,209
4200300E320,1427,1088,1010,14,17,5,31,0,78
4200300E330,1628,1230,1162,12,8,6,32,0,68
42003000371,1330,1143,934,20,142,18,18,2,209
4200300B640,863,720,513,14,172,18,6,1,207
42017000020,3625,2768,2554,77,35,17,59,1,214
42017000010,3916,3019,2703,131,39,24,102,1,316
42017002465,2498,2037,1755,34,27,7,198,0,282
42017002800,4299,3482,2999,101,67,30,274,4,483
42017001030,3883,3034,1625,294,737,44,365,0,1409
42017000887,2124,1631,1484,34,34,11,53,1,147
42017000817,2219,1775,1594,45,32,10,88,0,181
42017002530,2330,1959,1818,35,22,13,54,5,141
42001000050,1225,926,741,141,22,26,1,1,185
42101005227,838,681,37,15,631,20,7,1,644
42101000208,875,754,437,113,79,24,122,1,317
42101004408,905,750,148,28,561,15,13,4,602
42101005201,705,495,1,12,474,4,9,0,494
42101001614,424,295,1,19,272,13,2,0,294
42101003214,324,236,3,12,217,8,0,0,233
42101005633,917,722,303,110,114,5,159,1,419
42101001002,1006,767,0,12,761,8,4,1,767
42101003708,497,393,4,37,358,1,5,1,389
42101003007,1499,1356,1060,44,84,13,144,0,296
42101001214,1235,936,34,69,851,13,1,1,902
42101003505,1136,929,476,139,251,22,69,5,453
42003007560,622,572,498,17,26,3,29,0,74
42003008610,300,238,12,0,224,3,0,0,226
4200300C280,816,682,563,28,65,8,26,1,119
4200300E230,792,539,109,9,423,2,1,1,430
4200300A230,1438,1388,1070,51,128,9,118,1,318
4200300A330,589,471,326,16,116,16,8,0,145
42003001700,377,302,52,8,241,4,0,0,250
42003001730,382,282,57,4,216,11,0,0,225
42003004721,1316,1058,904,15,40,9,81,0,154
42003001381,833,694,564,39,70,23,4,3,130
42101004006,885,620,18,13,558,8,31,0,602
42101004018,867,601,41,26,490,13,42,0,560
42101004013,1023,777,51,29,673,7,24,1,726
42101003405,709,536,17,39,478,14,9,0,519
42017002310,805,621,586,19,10,2,3,0,35
42113000040,448,339,227,34,69,8,4,1,112
42001000340,2312,1818,1682,53,31,31,11,1,136
42055000590,328,274,255,5,1,8,2,1,19
42055000422,1758,1388,1319,20,28,16,3,0,69
42055000330,540,420,356,21,21,8,2,0,64
42055000320,1922,1508,1436,22,22,26,9,0,72
42101001906,590,425,13,384,48,14,3,0,412
42101005402,1275,897,101,285,464,19,59,6,796
42101006220,1052,759,175,284,234,15,69,1,584
42101001712,832,657,23,19,616,5,4,2,634
42101003811,948,832,551,73,156,14,59,5,281
42101004316,740,562,6,219,362,5,3,0,556
42101002321,1077,776,55,183,533,17,12,0,721
42101005639,1797,1469,751,112,276,10,320,1,718
42101005708,1155,917,464,70,134,5,236,0,453
42101003632,771,569,144,41,355,22,21,1,425
42101002127,1083,935,662,42,165,14,59,5,273
42101002602,1084,927,867,23,5,1,29,0,60
42101002623,2348,2035,1153,153,499,17,208,1,882
42101003516,1102,766,81,293,380,13,36,2,685
42101001602,726,539,65,30,433,9,14,0,474
42003001921,1166,963,710,23,180,24,34,0,253
4200300B330,768,622,539,21,41,7,9,5,83
4200300A060,600,484,418,11,45,4,9,1,66
42003001091,889,740,677,8,11,10,9,3,63
4200300E332,1504,1201,1118,18,10,10,36,0,83
4200300E333,1463,1157,1083,14,15,15,15,0,74
42003002370,1611,1191,1001,30,21,6,102,2,190
42003002352,1612,1207,1064,15,26,13,82,4,143
42003004200,1730,1400,862,22,392,16,93,3,538
4200300G550,1179,930,831,11,71,12,9,0,99
4200300G500,744,605,517,12,47,8,8,1,88
42101004617,1130,1013,703,68,167,19,73,1,310
42101000120,791,698,540,57,42,5,53,0,158
42101000568,2434,2372,1456,145,247,22,497,0,916
42101000803,1309,1183,946,51,53,13,120,1,237
42101006023,981,854,211,47,508,23,96,0,643
42101006016,782,598,52,19,511,18,21,3,546
42101003118,614,516,419,35,25,8,27,0,97
42101000506,1310,1246,952,89,40,13,146,1,294
42101006125,769,646,42,56,430,13,125,1,604
42101004514,271,202,118,71,27,1,4,0,84
42101002111,946,849,653,42,111,8,28,0,196
42101002712,499,392,54,7,323,9,9,0,338
42101003628,963,722,128,66,483,25,40,1,594
42101003017,2121,1780,1232,61,188,3,284,3,548
42101003630,684,553,140,23,294,9,94,4,413
42101005206,820,713,112,24,543,7,35,0,601
42101002413,596,455,42,23,386,5,21,2,413
42101002133,1217,1030,803,27,142,5,48,1,227
42101005837,1096,898,677,33,42,6,148,0,221
42101000706,1123,834,56,664,166,34,3,0,778
42101006305,824,656,477,73,46,10,37,0,179
42101003225,642,475,2,16,455,4,1,0,473
42101000109,898,728,451,78,19,4,180,0,277
42101005004,880,714,20,11,679,10,2,0,694
42101002217,647,521,170,19,309,7,13,1,351
42055000020,1921,1492,1419,18,16,24,6,1,73
42055000270,1324,1046,970,43,14,25,2,0,76
42017000220,3397,2734,1660,264,264,35,496,3,1074
42017000165,2031,1773,1442,94,129,47,72,0,331
42017000960,1094,937,889,22,3,13,9,2,48
42017002350,1717,1385,1315,22,7,17,14,1,70
42017000840,1470,1225,1159,30,11,1,13,1,66
42001000170,2358,1910,1756,78,26,35,18,1,154
42029000025,1508,1079,961,42,12,14,55,1,118
42029000560,4433,3341,2988,133,70,42,90,0,353
42029001020,1357,1025,796,55,132,17,25,0,229
42029001525,3846,3194,2894,89,134,31,37,4,300
42029001230,1172,849,749,20,14,4,47,0,100
42029000905,837,634,542,32,12,7,37,1,92
42029000350,1832,1450,1346,44,20,7,31,1,104
42029000625,4995,3901,3600,125,73,60,31,0,301
42029001390,2089,1551,1071,144,301,38,17,2,480
42029000206,2056,1604,1428,42,44,27,49,1,176
42101006006,871,651,15,20,602,7,30,0,636
42101006310,1095,907,720,61,74,8,35,0,187
42101002615,595,486,405,17,14,2,49,0,81
42101002606,938,795,731,25,18,5,16,0,64
42101003905,736,619,295,96,115,6,103,3,324
42101003928,1461,1090,272,311,232,33,260,0,818
42101000202,699,576,336,62,92,11,76,0,240
42101005407,1195,891,150,209,196,12,299,2,741
42101001320,680,532,19,17,500,3,0,0,513
42101001313,695,510,8,19,476,9,8,0,502
42101001314,851,631,11,24,584,4,12,1,620
42101001315,657,489,8,21,458,8,6,2,481
42101003512,1512,1135,183,299,540,14,132,2,952
42101006212,1005,728,127,270,349,13,15,4,601
42101000910,1115,925,781,40,49,8,41,0,144
42001000010,1022,744,639,83,5,13,1,1,105
42001000427,2663,2225,2058,101,36,18,12,3,167
42101001618,699,535,3,19,512,8,3,2,532
42101001120,659,508,3,16,491,10,3,0,505
42101005914,643,455,19,26,417,13,3,0,436
42101001205,1618,1316,144,51,1100,22,30,0,1172
42101005627,672,550,326,78,58,3,72,0,224
42101005221,833,633,5,22,611,10,9,2,628
42101001069,937,892,678,56,52,6,99,1,214
42101006215,1094,820,166,282,305,20,63,7,654
42101003711,521,401,11,30,355,4,4,0,390
42079002275,893,730,697,16,13,9,0,1,33
42079001862,1965,1594,1383,125,61,24,19,4,211
42091003300,3199,2542,1704,89,215,28,496,5,838
42091000918,2133,1631,1389,54,48,17,110,0,242
42091000915,19,16,11,0,3,1,0,0,5
42091003710,1819,1445,1240,34,61,9,86,0,205
42079002985,1867,1452,1042,197,197,23,26,0,410
42079002142,2172,1667,1408,87,119,39,12,6,259
42079001430,1456,1188,1095,29,37,15,8,0,93
42079000702,2504,1898,1473,248,135,30,24,3,425
42061000210,1003,784,739,5,18,8,8,2,45
42079001590,1246,967,893,28,20,17,4,0,74
42079001390,1516,1257,1105,54,55,16,29,1,152
42079000806,458,341,207,120,11,10,6,1,134
42107000305,1647,1352,1243,68,19,16,5,0,109
42101006405,1370,1015,610,166,142,23,74,1,405
42101006517,1358,1068,547,194,270,13,42,1,521
42101005831,1420,1128,531,62,129,1,397,0,597
42101006102,928,700,36,68,482,10,115,0,664
42101004524,1159,964,861,42,17,17,31,4,103
42101003016,1111,918,685,33,80,14,103,2,233
42101000304,1222,1058,193,24,806,10,36,0,865
42101003626,621,479,197,16,224,14,37,0,282
42101000412,847,593,6,7,568,9,17,1,587
42101004407,833,614,10,31,572,17,4,1,604
42101005008,928,770,17,14,723,5,6,2,753
42101005006,746,621,11,11,599,3,1,1,610
42101003437,780,610,46,11,537,4,9,0,564
42101004009,940,683,10,56,623,12,14,2,673
42101005521,1056,760,358,142,73,9,173,1,402
42101005527,824,672,365,145,126,8,34,0,307
42101002310,1404,1096,250,318,535,23,51,3,846
42101003524,1096,761,66,200,467,7,42,0,695
42101001406,579,342,5,16,318,7,6,1,337
42107000796,1657,1424,1313,26,32,9,33,0,111
42107000802,868,731,689,15,12,11,5,0,42
42107001365,690,517,330,155,36,5,6,0,187
42107001255,1416,1170,1110,29,5,7,11,0,60
42107001235,461,388,379,4,0,0,4,0,9
42101002518,1019,715,168,321,235,19,15,2,547
42101004917,1086,873,14,45,755,15,60,1,859
42101006320,767,614,477,31,21,1,82,0,137
42029001832,3983,3032,2280,91,97,23,529,2,752
42035000315,1061,829,774,16,12,12,1,2,55
42061000200,1043,876,798,4,38,15,13,0,78
42035000030,2044,1612,1526,15,15,23,18,0,86
42091000806,2313,1796,1605,71,42,20,35,1,191
42091001690,1217,964,873,19,15,11,45,0,91
42091002520,1400,1045,848,34,60,9,96,0,197
42091000470,1633,1314,1001,38,155,14,104,0,313
42091002940,1349,1047,919,23,49,7,44,0,128
42091000992,1104,822,606,68,49,28,85,0,216
42091002748,3874,2946,2574,56,88,22,180,0,372
42091003570,5038,3892,2738,120,174,29,801,4,1154
42091003470,1759,1415,1043,65,178,16,119,3,372
42091003360,1466,1186,642,111,114,25,306,11,544
42091001829,2683,2033,1640,76,210,41,49,3,393
42091003280,2486,1935,1515,77,79,12,233,1,420
42091002860,1949,1506,1133,89,193,17,81,0,373
42091003240,5125,3763,3257,169,143,37,139,3,506
42079003020,1423,1074,650,271,149,19,10,5,424
42079000790,2788,2401,2304,29,5,26,11,1,97
42079003140,1123,930,863,31,28,14,1,0,67
42079000995,3721,2721,676,1945,223,27,27,18,2045
42081000060,422,339,326,3,2,9,0,0,13
42081000370,143,117,113,1,0,0,0,0,4
42081000470,1239,952,876,15,8,29,7,0,76
42081000380,1089,876,855,3,0,10,1,0,21
42105000300,78,72,67,0,0,1,1,0,5
42101002129,1615,1372,975,62,211,27,96,3,397
42101000833,1403,1334,899,79,111,9,225,0,435
42101000839,1287,1240,712,83,120,10,327,0,528
42101004035,864,648,74,27,527,1,19,2,574
42101000207,1221,1048,674,142,82,15,118,0,374
42101004811,686,402,7,26,315,7,53,1,395
42101005609,1072,867,465,143,160,4,80,0,402
42013000554,1421,1178,1134,11,5,5,16,1,44
42013000542,1266,1054,1008,6,3,4,26,3,46
42013000552,1300,1063,1007,7,4,7,26,10,56
42013000950,754,606,576,5,3,15,5,0,30
42073000190,1088,883,826,16,22,8,3,0,57
42073000596,1162,805,345,36,404,28,5,0,460
42035000370,2453,2016,1932,25,12,31,8,1,84
42003004180,1152,970,740,28,121,15,72,4,230
4200300F891,1093,851,708,16,96,25,3,1,143
4200300F010,1291,944,786,30,78,14,30,0,158
42131000175,696,532,501,5,3,13,3,3,31
42041000090,2241,2051,1566,148,143,25,171,3,485
42041000870,2544,2035,1922,28,22,22,21,0,113
42041000130,2805,2294,1761,125,185,37,186,5,533
42073000244,1311,1117,1070,7,16,11,12,1,47
42073000246,1453,1162,1115,7,15,0,16,1,47
42073000130,1030,802,745,10,6,21,0,0,57
42073000140,1290,1068,1037,11,1,9,6,1,31
42073000425,1280,976,778,113,52,17,0,0,198
42003007950,753,613,495,23,84,2,10,0,118
42003009290,837,655,548,24,10,1,67,0,107
42003008690,443,352,13,2,325,0,5,0,339
4200300E331,1235,983,927,6,8,9,18,1,56
4200300E310,1581,1116,1014,25,2,5,60,0,102
4200300E334,1248,1054,1004,9,2,10,14,0,50
4200300E300,1856,1302,1162,30,31,10,60,0,140
42003003221,1106,828,677,23,13,1,112,0,151
4200300E181,1117,874,765,17,53,22,3,5,109
4200300F900,762,606,548,15,20,9,16,1,58
42003000351,1528,1347,1019,41,220,29,37,4,328
42101004807,907,717,265,34,245,5,175,2,452
42101003709,563,428,7,70,358,6,1,1,421
42101003223,619,459,31,12,407,1,5,0,428
42117000170,608,517,503,1,5,8,1,1,14
42003009790,594,518,348,21,12,2,129,0,170
42003006760,469,388,105,5,255,12,22,0,283
42003003600,179,127,12,4,104,6,3,0,115
4200300B370,632,513,436,14,43,6,14,0,77
42003004410,1069,831,740,20,22,1,38,0,91
42041000760,1371,1009,964,6,13,10,4,1,45
42041000850,1319,1025,999,10,3,9,0,0,26
42041000140,4509,3416,2438,210,573,79,133,6,978
42111000530,2440,2026,1926,30,20,22,16,4,100
42111000640,214,170,166,1,1,2,0,0,4
42111000360,128,112,111,0,0,0,0,0,1
42111000060,905,728,708,5,5,10,1,0,20
42111000550,1632,1280,1182,23,28,29,16,1,98
42111000320,2070,1704,1637,3,11,35,5,3,67
42073000565,840,693,615,10,44,4,3,1,78
42073000780,1006,768,751,1,0,5,5,0,17
42101001083,1324,1207,483,85,182,12,451,4,724
42101001087,1272,1199,715,106,152,18,214,2,484
42101000830,2689,2583,1394,214,374,21,542,11,1189
42101001713,908,734,26,16,676,7,13,2,708
42101001720,797,668,6,19,635,10,12,0,662
42101006601,1127,845,561,93,116,21,71,2,284
42101006512,2303,2170,276,361,1513,13,28,5,1894
42101004117,843,649,406,125,106,16,12,3,243
42101003623,695,589,148,41,347,17,58,1,441
42101005010,759,624,17,12,588,10,9,0,607
42101002407,798,608,103,35,418,2,51,5,505
42101003115,902,792,636,55,23,10,68,2,156
42101006315,939,738,461,31,32,1,205,0,277
42101003434,766,602,177,20,387,14,25,1,425
42101003420,1249,943,45,23,858,10,13,0,898
42035000020,1473,1136,1090,5,17,9,5,4,46
42035000190,599,491,457,10,13,7,6,3,34
42035000200,2140,1925,1642,79,151,13,43,0,283
42035000040,972,784,750,2,4,12,4,0,34
42013000220,1452,1098,953,13,63,30,7,2,145
42013000110,1350,1084,954,31,53,34,10,0,130
42013000730,1688,1397,1318,25,11,16,15,0,79
42013000690,968,785,762,4,1,13,0,0,23
42041000440,1902,1495,1344,27,34,15,73,2,151
42041000580,782,603,562,11,14,12,7,1,41
42041000840,2128,1699,1622,26,15,15,10,0,77
42079000060,804,686,635,25,10,6,11,0,51
42041000819,1880,1460,1293,50,34,15,53,0,167
4200300E841,758,610,567,10,11,4,13,0,43
42003008910,322,226,8,5,208,4,3,0,218
42113000110,310,273,260,2,1,3,4,1,13
42009000100,1454,1177,1147,4,3,19,0,0,30
42117000410,228,184,174,0,1,6,0,0,10
42049001140,1088,917,840,23,15,19,5,0,77
42077000510,2002,1745,1087,299,287,13,41,3,658
42077000160,2006,1343,142,1051,232,30,18,3,1201
42077000680,1865,1598,1016,297,201,13,93,0,582
42077000730,2447,1956,1726,96,44,18,49,1,230
42077000550,2826,1989,481,1263,264,37,35,3,1508
42077000470,1256,1048,755,155,90,8,34,0,293
42077000480,1097,948,769,115,39,8,20,0,179
42077000450,3486,2553,897,1351,306,54,67,12,1656
42077001030,2580,2066,1590,346,87,12,40,5,476
42077000600,1206,975,662,205,74,20,30,1,313
42077000580,1537,1304,797,325,152,23,47,2,507
42077000830,1448,1126,678,329,140,23,8,0,448
42011001240,1450,986,373,500,145,30,14,4,613
42101005624,1128,863,373,51,106,3,280,0,490
42101000714,858,636,24,527,108,10,8,3,612
42101006104,1119,849,45,170,443,22,202,1,804
42049000060,1666,1292,1216,18,12,20,5,0,76
42049000890,1208,1004,963,8,12,14,3,0,41
42049000480,1244,841,281,89,371,11,94,2,560
42049000470,1031,719,292,92,299,13,29,0,427
42049000940,1803,1467,1398,15,11,20,7,2,69
42049000075,3109,2366,2191,33,39,52,8,0,175
42049001220,1371,1141,1072,22,18,8,17,1,69
42049000440,1550,1336,1219,27,43,23,23,1,117
42011000590,2956,2428,2278,59,28,47,8,3,150
42011000420,2001,1654,1516,90,26,19,9,0,138
42011000410,1427,1160,1126,18,5,5,0,0,34
42011001285,3098,2274,685,1290,344,78,24,13,1589
42011001480,1360,1099,1007,53,16,24,7,2,92
42011001579,1781,1427,1155,134,82,10,59,1,272
42011001571,2340,1961,1333,182,287,19,169,15,628
42075000230,1154,778,211,506,54,21,21,0,567
42075000488,3882,3000,2575,93,77,32,192,2,425
42075000492,3154,2401,2151,61,38,16,94,3,250
42075000200,1841,1262,540,645,96,17,9,9,722
42075000375,3755,3049,2789,87,41,17,91,6,260
42113000080,549,435,407,6,3,10,8,0,28
42075000391,3245,2497,2255,65,49,21,91,0,242
42077001055,1477,1213,983,120,70,14,17,0,230
42077000770,1887,1485,1260,113,53,21,41,0,225
42077000460,1377,1100,719,242,130,23,23,2,381
42077001380,2853,2113,855,805,434,42,76,7,1258
42077000360,1928,1433,397,778,248,21,57,1,1036
42075000050,2013,1606,1404,104,41,14,25,4,202
42075000530,1992,1717,1602,45,27,16,31,3,115
42075000320,2267,1830,1729,52,16,15,3,4,101
42075000450,4120,3201,2606,378,104,30,83,2,595
42075000150,1478,1100,551,445,113,11,19,0,549
42075000280,4368,3194,2983,90,48,46,23,4,211
42075000300,1784,1398,1285,60,38,10,14,1,113
42011000230,1938,1583,1488,33,13,22,21,2,95
42077001090,1745,1409,1184,84,67,15,66,2,225
42077000710,1946,1520,1122,269,110,23,21,2,398
42077000780,2648,2116,1774,179,83,38,58,0,342
42077001360,3752,2886,1344,762,500,51,319,5,1542
42077001120,1795,1433,1279,88,41,24,8,0,154
42077000900,3097,2430,1805,200,137,19,264,1,625
42077001160,1919,1519,1198,144,87,22,64,5,321
42077000420,2449,1962,972,710,279,43,64,7,990
42077000720,2048,1643,1314,254,51,17,19,1,329
42077000290,2335,1766,641,854,270,40,53,0,1125
42077000790,2155,1813,1533,137,88,16,39,2,280
42077000660,1462,1175,887,163,91,14,35,0,288
42077000630,1665,1339,968,214,123,16,53,4,371
42077000700,2524,1924,1407,322,162,44,21,8,517
42077001270,3601,2841,2659,77,12,19,47,0,182
42077001020,2480,2018,1795,135,38,15,40,4,223
42077000590,1207,975,658,202,107,12,16,0,317
42077000990,3410,2744,2509,122,48,19,39,0,235
42077001190,2502,1957,1568,123,86,9,153,0,389
42077001170,2903,2336,1869,153,96,28,224,0,467
42077001460,2456,1915,1549,199,115,31,38,4,366
42077001100,1467,1094,925,101,35,17,13,0,169
42077001290,2522,1962,1675,118,50,33,82,6,287
42077001425,2933,2519,2111,173,111,15,131,6,408
42077000520,1495,1172,485,531,164,43,23,7,687
42077000800,1032,828,748,34,18,8,16,1,80
42077000130,2642,1875,229,1380,371,57,20,14,1646
42077000390,3579,2548,589,1538,450,71,60,9,1959
42077000070,1461,1030,329,585,134,24,32,2,701
42077000260,1386,1062,592,339,144,22,21,6,470
42077000140,2819,2234,745,1226,320,55,32,8,1489
42077001370,1129,926,676,163,61,22,22,5,250
42077000340,2081,1617,470,849,327,54,28,5,1147
42077000940,2292,1818,1690,49,34,15,24,3,128
42077000280,1359,1099,665,285,127,23,34,0,434
42057000040,732,608,575,8,9,10,2,2,33
42003001580,659,545,474,26,13,8,15,0,71
42003009430,580,425,389,11,6,4,15,2,36
42003004991,618,446,171,7,266,9,3,0,275
42003008590,230,173,6,3,164,2,0,0,167
42003004920,353,302,275,5,12,9,0,0,27
4200300E645,800,630,580,8,20,4,7,2,50
4200300E635,990,781,659,9,60,25,22,1,122
4200300F020,550,442,406,8,12,7,4,0,36
42003002660,1148,1002,933,25,23,3,13,0,69
42003009370,929,778,532,34,134,9,75,3,246
42003005788,2786,1889,1681,46,18,11,106,1,208
42029001200,1704,1373,1169,43,25,12,122,1,204
42029000730,541,368,222,65,79,10,0,0,146
42029001370,3995,3258,2901,66,78,27,139,5,357
42029000334,2130,1724,1597,46,14,8,49,1,127
42029001472,2529,2171,1947,82,104,9,22,2,224
42029001474,2697,2177,1892,142,74,20,36,1,285
42011001760,2892,2225,1916,163,101,24,29,2,309
42029001750,3632,2710,2127,47,41,7,449,1,583
42029000300,3162,2676,2132,149,243,41,109,6,544
42029000790,2293,1811,1579,36,109,32,52,4,232
42029000640,1463,1134,638,400,74,27,15,1,496
42029001180,2535,1874,1521,59,124,11,154,1,353
42077000500,1372,1135,726,291,99,7,31,3,409
42077000820,2206,1763,983,534,220,47,33,0,780
42077000490,3577,2959,2078,259,161,34,439,2,881
42077000640,1943,1644,1165,281,124,21,89,0,479
42131000050,769,687,493,63,124,15,9,1,194
42131000020,1309,1016,954,16,4,19,15,1,62
42063000410,641,529,508,2,6,4,0,1,21
42029001636,1459,1182,1067,18,34,21,33,0,115
42011000020,1660,1377,1323,21,9,16,11,0,54
42011001540,2740,2187,1549,335,189,23,108,4,638
42011001398,1919,1452,1363,20,22,25,9,0,89
42005000695,895,741,724,2,0,9,0,0,17
42005000160,1188,981,966,0,3,8,1,0,15
42037000220,1427,1194,1139,25,6,10,9,1,55
42103000055,5157,4151,2321,864,837,94,104,5,1830
42089000320,927,742,514,101,93,9,32,1,228
42063000620,1649,1304,1256,7,5,14,0,0,48
42087000160,2082,1553,1389,74,39,39,9,0,164
42087000010,1189,955,917,9,3,19,3,0,38
42029001828,2359,1842,1611,68,75,19,62,2,231
42029000720,3419,2801,2353,132,112,38,178,5,448
42029000550,1330,1150,1063,23,27,12,18,2,87
42063000010,102,76,68,2,0,3,0,0,8
42063000310,757,608,592,3,1,7,2,0,16
42105000070,1314,1009,917,19,9,23,17,0,92
42105000060,1067,852,798,20,6,17,6,0,54
42087000120,1704,1395,1329,19,7,19,6,0,66
42029001610,2137,1721,1226,202,161,28,117,6,495
42029000070,6001,4467,3408,151,99,27,744,3,1059
42029000260,4380,3427,2726,154,450,38,53,2,701
42029001385,1236,952,783,42,43,12,72,2,169
42087000030,1191,979,965,3,1,7,0,0,14
42023000040,929,751,720,13,3,7,3,1,31
42087000260,1974,1181,1171,3,2,3,1,1,10
42125001250,1553,1272,1225,0,4,18,4,0,47
42125000540,1670,1371,1193,22,131,19,1,1,178
42045002470,927,747,672,17,21,14,24,1,75
42045002580,2534,1988,1778,43,99,16,43,2,210
42045002460,1288,971,633,62,234,21,28,1,338
42045000315,1029,774,50,166,569,8,2,1,724
42045000290,885,557,83,88,396,15,2,0,474
42045000345,467,333,63,24,243,11,4,0,270
42045003491,1447,1103,232,126,409,7,342,7,871
42045001700,1196,914,777,36,36,9,60,0,137
42045001660,399,260,171,12,55,9,5,0,89
42045001650,326,252,164,18,70,1,8,1,88
42033000090,1936,1446,1400,9,6,12,6,0,46
42033000600,1367,1191,828,333,4,9,5,3,363
42033000620,1631,1339,1247,28,12,22,23,1,92
42017001590,1752,1352,1187,47,41,28,29,1,165
42017002440,1623,1235,1125,27,15,13,35,0,110
42017002640,1933,1561,1431,46,29,14,30,0,130
42017002760,1885,1427,1274,52,25,12,73,0,153
42017001310,1633,1237,1112,46,16,5,44,0,125
42017002290,693,559,504,20,18,6,3,0,55
42017001290,2116,1613,1389,47,30,8,133,0,224
42045002650,1752,1366,1224,26,56,14,33,3,142
42045002640,1846,1467,1271,36,68,5,81,1,196
42045000030,1921,1651,1493,45,41,14,43,2,158
42045000070,2159,1700,1535,49,32,33,34,4,165
42019000135,3404,2688,2402,53,123,80,13,6,286
42019000855,1356,1217,1169,19,13,6,6,0,48
42019000546,2590,2159,2119,8,7,19,5,0,40
42019000547,304,232,217,0,1,7,0,0,15
42019000390,764,597,571,6,3,4,3,1,26
42019000254,2289,1928,1828,26,13,31,10,0,100
42045003380,1448,1123,374,93,463,13,193,4,749
42045000520,679,491,14,16,463,10,2,2,477
42045000530,280,211,11,14,188,2,1,0,200
42045002140,3457,2692,2316,76,54,21,187,0,376
42045003160,1153,922,627,45,171,24,47,2,295
42045001750,1226,986,794,19,28,12,126,0,192
42045000555,1268,938,59,87,802,16,11,0,879
42045002061,2156,1563,1154,59,235,29,83,2,409
42045002900,1549,1264,1146,14,26,8,56,4,118
42045001310,1604,1201,1100,25,34,3,32,0,101
42045003620,1216,815,115,64,578,7,59,0,700
42045002670,1684,1337,1136,31,92,17,56,2,201
42045003430,1442,1110,532,60,373,14,140,1,578
42045003460,1181,937,429,89,240,12,172,5,508
42045001450,1653,1209,1029,35,61,7,77,0,180
42045000174,2047,1589,1132,64,44,19,316,1,457
42045000177,1925,1524,1293,43,50,14,122,0,231
42045001120,2098,1717,1227,55,350,18,52,4,490
42045002210,677,540,417,17,58,21,21,2,123
42045001070,1443,1057,466,21,534,12,25,0,591
42045001050,1419,1113,600,56,398,14,52,3,513
42045001060,1393,959,448,55,430,10,22,2,511
42045000860,1964,1406,32,23,1347,22,12,0,1374
42045003860,2138,1687,1521,44,25,4,73,0,166
42045003840,2230,1782,1520,37,72,6,113,0,262
42045000790,1726,1277,587,47,560,25,59,0,690
42045000260,890,650,72,137,447,16,17,0,578
42045000210,1501,1093,139,91,859,22,9,0,954
42045001300,1440,1064,897,26,37,9,92,0,167
42045001150,1239,947,866,16,13,4,43,1,81
42109000050,1565,1042,1024,9,2,1,3,0,18
42045000545,863,632,91,87,443,18,12,1,541
42063000740,286,227,216,0,3,6,1,0,11
42027000190,2220,1820,1409,59,77,17,242,4,411
42045002560,2012,1540,1384,36,56,15,42,5,156
42045000112,1535,1280,1124,19,24,16,96,1,156
42045000120,1901,1546,1341,35,79,28,51,2,205
42133000520,4061,3247,3036,85,34,60,16,1,211
42043000502,2741,2223,1429,290,430,62,49,5,794
42043001092,1857,1277,449,216,575,44,14,6,828
42043000570,1264,1039,729,77,181,21,38,0,310
42043000560,1902,1557,1469,30,11,23,6,2,88
42043001020,764,587,494,12,48,14,9,2,93
42043000280,1869,1658,984,204,402,40,59,5,674
42043000390,2291,1494,145,316,1050,33,19,4,1349
42043001313,1944,1539,1474,16,27,13,4,4,65
42043000191,1700,1341,1263,23,13,15,18,1,78
42043001400,1067,870,805,26,19,12,2,4,65
42019000610,2450,1963,1883,24,11,14,10,2,80
42019000410,1737,1399,1332,25,5,12,10,0,67
42019000560,4065,3048,2903,42,15,25,46,2,145
42021000390,298,238,227,3,1,2,2,1,11
42025000460,413,336,298,14,16,7,0,0,38
42107001610,1228,1022,974,22,4,10,6,1,48
42107001035,1033,823,729,25,46,4,12,0,94
42033000311,544,397,390,1,2,4,0,0,7
42025000390,822,640,596,20,9,8,4,1,44
42025000420,1443,1165,1080,35,17,18,6,3,85
42025000380,1051,855,794,18,7,18,12,0,61
42025000310,1671,1368,1255,47,34,16,7,0,113
42071000570,3214,2259,2083,83,39,43,14,0,176
42071001776,2949,2478,2188,155,62,20,48,0,290
42071001785,2387,1821,1722,19,16,13,39,0,99
42071001778,1875,1654,1550,40,29,5,28,0,104
42071001765,2100,1585,1528,23,17,5,10,2,57
42071000115,2303,1662,1091,347,213,39,13,7,571
42071001630,3727,2843,2682,74,30,37,2,2,161
42043001420,612,474,434,18,13,10,2,0,40
42043000720,2620,2120,1782,85,144,30,68,1,338
42043000450,1685,1258,298,270,635,16,86,3,960
42021001321,1398,1093,1037,7,15,13,0,0,56
42021001530,1803,1459,1376,20,21,14,18,1,83
42021001481,2238,1879,1782,27,14,11,31,1,97
42021000220,2387,2042,1847,29,129,9,17,0,195
42021001890,832,659,631,3,1,11,3,0,28
42021001210,496,403,387,2,3,9,0,0,16
42071000092,4124,3148,2839,131,46,28,90,5,309
42071001440,1280,1017,906,43,46,17,6,0,111
42071001405,3244,2660,2294,142,124,39,65,7,366
42071001370,3265,2487,1935,319,131,37,66,4,552
42071001470,1740,1373,1141,125,50,20,56,4,232
42043000420,2319,1814,817,163,793,29,41,5,997
42043000764,1579,1235,1049,25,81,11,64,2,186
42043001311,2066,1701,1596,41,29,18,16,1,105
42043000055,1361,1143,1002,40,51,9,34,0,141
42133000920,1864,1382,1091,104,102,18,75,2,291
42133000940,3745,2951,2475,155,183,24,109,2,476
42025000130,1139,912,876,14,7,2,5,1,36
42025000110,965,773,718,22,15,8,12,0,55
42045002450,3083,2516,2020,61,159,5,258,2,496
42045002400,1509,1265,922,93,66,9,166,2,343
42045000720,874,683,436,15,206,8,13,0,247
42045000710,846,565,366,25,157,5,7,1,199
42045000730,2259,1739,1217,75,356,10,82,2,522
42045000020,1828,1499,930,64,413,9,71,1,569
42045000435,950,672,52,51,555,23,9,5,620
42045000980,1659,1186,64,27,1085,22,10,0,1122
42133000590,4877,3726,3373,100,119,69,54,2,353
42133001065,1832,1358,1043,143,136,46,7,3,315
42133000040,1936,1582,1507,20,15,22,8,2,75
42133000400,3318,2748,2570,62,56,19,26,0,178
42019000380,1823,1469,1433,5,2,11,3,1,36
42019000450,2598,2189,2089,16,22,30,6,1,100
42021000210,1984,1612,1533,7,25,17,18,1,79
42021001105,876,683,591,12,59,10,6,0,92
42021000325,1469,1239,1145,14,34,19,15,1,94
42021001405,923,727,691,7,9,3,9,2,36
42021001760,818,628,605,3,1,4,0,0,23
42021002010,206,162,160,1,1,0,0,0,2
42021001471,1161,933,876,8,13,7,20,0,57
42021001505,1068,915,841,13,17,5,19,0,74
42021001510,1949,1807,1489,53,151,4,62,2,318
42025000190,1124,848,690,71,53,31,10,0,158
42133000380,3031,2438,2317,45,15,35,15,2,121
42133001383,2056,1640,1345,86,121,31,81,7,295
42093000030,1103,874,717,64,48,24,33,5,157
42093000050,972,772,673,43,18,23,20,0,99
42085001115,827,672,638,5,3,14,1,0,34
42085000290,1272,959,874,13,22,22,13,2,85
42085001040,818,639,598,6,9,13,4,0,41
42085000425,1600,1326,1232,8,42,9,22,0,94
42085000660,1477,1173,1095,17,15,31,1,0,78
42049001170,2648,2105,1905,55,66,16,54,0,200
42049000490,1573,1128,542,132,389,25,48,2,586
42049001160,1814,1464,1302,51,40,26,29,0,162
42049001020,2935,2248,2101,43,32,42,6,2,147
42049001100,2415,1941,1767,40,43,25,66,1,174
42125001336,1253,963,886,14,21,4,18,0,77
42125001348,1696,1443,1305,30,60,16,19,0,138
42125001332,1796,1400,1254,32,54,11,38,0,146
42125000290,2620,2202,2068,31,41,23,9,1,134
42125000735,1084,870,718,21,98,22,2,0,152
42125001480,2995,2075,1937,46,18,12,55,3,138
42125001385,1319,1121,1071,22,5,15,5,0,50
42125001375,1622,1384,1309,14,11,25,8,0,75
42125000260,2128,1716,1586,25,42,23,5,0,130
42097000860,873,734,708,5,3,1,8,0,26
42133000440,1830,1374,1202,46,70,34,23,3,172
42123000090,584,465,443,1,0,13,0,0,22
42123000420,1726,1338,1261,10,9,24,9,1,77
42085000235,1394,1099,1000,16,22,28,15,4,99
42085000480,1178,942,914,2,2,15,0,1,28
42085000180,710,571,546,8,2,3,0,0,25
42085000690,802,614,593,1,0,13,0,0,21
42021000560,1028,859,833,6,0,7,1,0,26
42097000890,864,658,599,6,11,9,15,1,59
42097000290,881,702,649,25,14,13,5,0,53
42097000445,1914,1539,1443,47,19,21,9,0,96
42097000200,861,733,711,3,6,8,1,1,22
42085000340,1829,1559,1507,5,5,11,23,3,52
42085000792,1847,1379,1011,23,292,37,15,5,368
42085000110,712,567,298,9,246,9,5,0,269
42085000950,1685,1387,1316,4,25,11,12,1,71
42085000960,1837,1498,1406,14,37,17,5,0,92
42037000390,550,444,433,5,0,3,2,0,11
42125001652,1753,1541,1380,24,96,12,20,4,161
42125000010,484,405,382,2,5,8,5,1,23
42125001710,421,351,339,0,2,2,3,0,12
42125001970,1291,1062,1021,7,13,11,5,1,41
42085000395,1300,1122,995,19,66,8,22,2,127
42085000190,1052,849,812,14,2,16,0,0,37
42021000942,1100,857,683,22,141,21,0,0,174
42111000160,554,473,459,0,1,0,3,0,14
42111000310,546,455,438,7,1,4,1,2,17
42123000220,2249,1923,1852,14,7,24,14,1,71
42087000250,344,256,256,0,0,0,0,0,0
42087000042,2773,2061,1991,20,16,27,12,1,70
42087000044,1339,1091,1044,9,6,8,12,0,47
42133000700,4966,3864,3533,56,69,136,32,9,331
42133000510,1900,1521,1435,23,12,27,14,1,86
42115000120,833,695,635,16,0,14,2,1,60
42087000300,2360,1919,1834,26,15,15,10,2,85
42111000030,613,519,500,6,0,13,0,1,19
42013000251,2248,1711,1537,17,87,42,11,2,174
42111000050,2003,1648,1593,22,2,16,4,0,55
42111000510,5569,5240,3202,330,1666,29,16,0,2038
42111000110,998,841,815,1,2,7,4,1,26
42037000055,3677,2901,2564,181,84,59,19,1,337
42095000750,1934,1674,1543,50,23,15,22,2,131
42095000760,987,816,736,26,16,9,15,0,80
42095001170,1824,1569,1402,84,34,28,20,1,167
42095000920,1075,842,677,120,46,6,3,2,165
42095000820,1364,1118,945,82,24,2,53,3,173
42081000802,1903,1460,1220,53,131,30,24,2,240
42081000180,1149,903,850,10,12,9,14,0,53
42005000230,361,306,286,2,4,2,8,0,20
42005000450,1078,920,908,2,2,2,0,0,12
42095000680,1851,1516,1348,78,32,28,32,4,168
42095000670,2052,1611,1363,130,48,18,43,0,248
42041000741,1401,1086,1011,20,10,14,19,1,75
42041000738,1730,1302,1219,18,24,15,22,0,83
42041000640,2874,2227,2150,14,18,19,11,0,77
42041000795,3708,2797,2627,37,55,41,27,0,170
42041000670,2512,1985,1610,142,165,35,33,4,375
42085000150,765,703,496,6,186,6,4,1,207
42111000420,906,758,726,2,4,11,2,0,32
42111000680,874,684,648,10,8,15,2,0,36
42081000752,1708,1317,958,36,260,59,11,2,359
42081000762,1723,1296,907,28,309,50,17,3,389
42081000120,1997,1612,1535,17,12,30,10,2,77
42125001692,1582,1333,1253,12,17,26,7,1,80
42027000830,1802,1409,1354,12,6,23,3,0,55
42027000740,1191,1043,808,69,35,14,112,3,235
42027000390,3386,2420,2079,82,65,27,161,1,341
42027000205,1594,1326,1041,41,31,18,188,3,285
42027000612,13318,13273,10749,632,374,132,1340,198,2524
42133001240,4218,3155,1043,1040,1091,57,37,6,2112
42027000300,687,532,502,2,4,16,3,1,30
42027000200,2837,2430,1296,77,73,18,971,1,1134
42027000214,764,607,483,31,21,3,57,2,124
42027000370,831,676,651,8,1,9,1,1,25
42027000510,1890,1610,1577,9,4,9,7,0,33
42027000440,878,722,681,18,6,8,5,0,41
42027000220,1362,1211,834,79,72,4,218,0,377
42027000250,1649,1182,1150,11,4,6,2,0,32
42095001200,851,701,594,24,32,4,36,1,107
42095001330,2147,1666,1075,272,246,47,67,2,591
42095001010,3820,3056,2257,345,236,19,207,7,799
42095000540,2232,1644,802,482,315,41,39,2,842
42095000650,2853,2284,1761,205,137,17,163,4,523
42095000660,1258,999,836,70,42,6,42,0,163
42115000200,710,612,579,4,6,20,5,0,33
42095000594,4075,3304,2644,199,259,30,161,4,660
42095000530,1916,1347,650,406,278,24,28,1,697
42017002580,2130,1663,905,407,226,48,121,13,758
42017002610,1636,1337,1168,68,34,9,39,2,169
42095001080,688,538,483,31,3,9,11,0,55
42095000320,1247,915,129,654,118,24,31,5,786
42095000620,2875,2151,1123,619,355,42,59,6,1028
42095000351,951,765,612,79,25,8,37,0,153
42095000349,1066,869,590,145,92,10,21,1,279
42095001090,1868,1565,1470,45,22,14,12,1,95
42095000500,976,913,547,198,159,14,13,0,366
42017002630,2304,1845,1580,105,37,29,90,1,265
42017002750,3693,2804,2340,82,53,15,286,2,464
42017000730,814,627,482,93,52,4,4,0,145
42017000630,1280,1016,744,119,89,23,31,0,272
42017000610,1425,1158,939,114,71,21,25,2,219
42017002560,1476,1240,1147,28,12,7,34,3,93
42017000765,4412,3327,2826,92,83,14,278,5,501
42017002420,904,686,638,26,9,5,1,6,48
42017002173,2583,1971,1766,75,32,23,48,1,205
42017002195,3784,2820,2407,153,69,15,141,3,413
42017001050,2904,2302,1644,225,274,57,85,8,658
42017001200,2932,2220,1929,54,46,20,148,3,291
42017001825,2233,1707,1437,53,42,22,149,0,270
42017001652,2412,2073,1850,62,64,14,80,0,223
42017001690,2253,1839,1636,51,50,13,66,1,203
42095000255,1663,1323,1119,94,35,7,72,0,204
42091002410,1153,968,828,33,48,15,39,1,140
42091003200,1711,1326,1147,32,81,11,54,0,179
42091000365,2010,1526,1060,100,285,5,69,6,466
42091003141,2081,1625,1319,31,38,7,234,0,306
42091003077,2053,1579,1352,25,27,7,155,0,227
42091001323,2453,2047,1443,82,132,14,374,1,604
42013000570,2549,2000,1914,15,13,33,1,0,86
42017001810,2112,1586,1418,50,27,11,62,2,168
42017001570,1673,1269,1109,37,43,24,31,1,160
42043000270,1340,1252,740,92,343,12,63,1,512
42043000510,1987,1613,1372,101,62,25,65,1,241
42043001155,3278,2607,1153,195,1049,50,193,0,1454
42043001175,2965,2405,1314,216,539,28,345,4,1091
42043001195,2964,2363,1200,190,780,19,200,3,1163
42043000430,1673,1420,837,144,398,16,44,4,583
42043000845,2056,1665,1567,35,22,28,13,0,98
42095000950,2623,2055,1754,174,81,12,24,1,301
42095000570,1472,1127,605,264,203,31,36,4,522
42095000380,3756,2985,2791,89,21,27,45,0,194
42017000880,2857,2315,2111,57,45,13,61,1,204
42017002850,2605,2201,1932,83,65,33,83,2,269
42017000645,2098,1675,1393,117,62,57,33,0,282
42017002330,2908,2372,2103,70,23,17,136,1,269
42017001700,1750,1499,1379,29,24,2,46,0,120
42017001530,3104,2366,1989,104,128,38,87,5,377
42017000360,1555,1328,935,168,171,14,41,0,393
42017000180,3063,2444,1992,101,100,30,202,8,452
42017000820,4253,3331,2909,102,47,36,211,2,422
42115000330,812,618,590,6,2,12,6,0,28
42017002390,1223,1096,1034,22,6,18,10,1,62
42017002235,4870,3603,3086,183,108,25,158,7,517
42017002255,3281,2561,2240,107,56,29,112,2,321
42017002190,2151,1721,1429,117,84,33,58,6,292
42017002030,2167,1677,1512,45,20,10,79,0,165
42017000420,1567,1264,1021,116,68,14,59,1,243
42017001910,1096,914,859,11,8,2,27,0,55
42017001100,1711,1318,1175,49,27,26,32,0,143
42017001170,2200,1898,1790,28,18,12,18,0,108
42017001755,2090,1626,1129,204,240,29,20,3,497
42017001440,1770,1464,1349,33,17,21,35,0,115
42033000510,2038,1630,1576,8,7,26,0,0,54
42039000590,1540,1249,1152,27,30,20,2,2,97
42039000608,1996,1637,1558,15,13,18,18,0,79
42039000602,1795,1577,1481,20,13,15,43,0,96
42121000660,749,645,619,1,2,4,13,0,26
42039000390,1831,1569,1516,11,3,16,7,0,53
42039000190,529,403,388,1,1,7,4,0,15
42097000620,499,381,341,14,13,3,9,1,40
42097000375,312,254,250,1,1,1,1,0,4
42115000030,1732,1314,1228,41,4,33,1,1,86
42043000767,1666,1370,925,53,190,27,172,3,445
42081000520,895,723,702,3,4,9,1,0,21
42081000682,2250,1783,1491,60,178,32,26,0,292
42081000590,418,333,321,1,1,6,0,0,12
42081000320,2166,1762,1576,21,69,18,66,1,186
42071000340,916,733,611,38,15,6,55,0,122
42017001240,1643,1348,1179,45,79,16,22,1,169
42017002410,1233,1047,980,30,3,8,15,0,67
42017002742,2691,2016,1705,39,40,9,205,0,311
42017002120,2515,2016,1578,151,184,27,81,7,438
42069001090,1164,924,848,39,13,2,19,3,76
42069002025,1034,890,858,5,7,1,15,1,32
42069001775,975,835,758,20,27,8,17,0,77
42069002260,1926,1562,1372,43,31,2,107,3,190
42069000600,1514,1231,1126,37,26,4,44,2,105
42069001230,1086,842,788,7,6,9,18,1,54
42069001240,793,608,525,52,16,7,5,1,83
42069001160,860,690,610,21,27,5,10,0,80
42069001175,954,816,721,44,25,18,3,0,95
42069001209,1044,836,753,40,20,8,3,1,83
42069001205,646,506,442,30,18,12,3,2,64
42039000250,2210,1864,1596,68,142,30,25,3,268
42121000265,2093,1626,1490,14,57,23,18,0,136
42039000610,1405,1091,1054,12,5,9,7,0,37
42129001220,1030,869,843,6,1,10,3,0,26
42129001190,550,476,447,7,6,5,1,0,29
42129000090,953,780,642,6,105,11,0,0,138
42129000100,1278,958,744,8,177,15,6,1,214
42129002360,1336,1028,910,8,89,11,13,0,118
42129002390,1309,1117,1069,5,18,5,9,0,48
42129000260,1280,1040,995,12,9,12,8,0,45
42089000211,2667,2107,1370,288,359,45,96,9,737
42089000150,3304,2725,2242,181,173,52,69,9,483
42089000330,1761,1378,730,282,308,44,54,3,648
42089000273,2795,2232,1450,323,266,30,175,1,782
42091000980,1599,1327,1105,62,82,22,51,0,222
42091001790,1643,1210,799,51,161,18,171,0,411
42091003450,2362,1900,1353,132,252,20,141,0,547
42091000105,1487,1153,768,45,205,8,108,3,385
42039000570,946,748,716,7,9,6,4,0,32
42039000260,1334,933,735,25,138,31,1,2,198
42129002520,1029,837,801,3,6,7,9,0,36
42129002380,669,544,504,16,8,13,6,0,40
42129000790,1382,1141,1055,35,17,18,10,1,86
42129001245,1513,1295,1247,14,0,15,9,3,48
42017001850,1711,1391,1217,31,27,25,89,0,174
42069000990,453,358,344,3,8,2,0,1,14
42071001337,2752,1952,1502,187,110,13,150,2,450
42071001380,1454,1149,1059,45,12,28,6,0,90
42071001810,1747,1443,1374,22,18,11,13,1,69
42071002105,2417,2176,2043,68,38,6,28,0,133
42027000360,1093,869,822,14,12,24,1,1,47
42107000340,241,201,200,1,0,0,0,0,1
42107000765,1054,835,780,17,28,8,0,0,55
42091003600,3172,2525,2357,51,27,18,31,5,168
42091001905,2974,2428,2160,58,81,10,108,5,268
42091001307,2745,2214,2044,51,45,31,24,1,170
42091002775,1427,1092,882,35,80,7,83,0,210
42091001875,3575,3010,1821,214,748,43,212,0,1189
42091003580,5536,4421,3397,114,228,38,592,0,1024
42091003310,2734,2490,1441,131,213,32,674,2,1049
42091003384,2764,2546,1660,144,262,31,428,7,886
42091000933,1773,1359,1039,44,33,10,234,0,320
42091003150,1384,1039,883,12,29,7,92,0,156
42091000560,1176,1038,706,57,225,5,59,0,332
42091002090,2381,1667,532,494,616,56,48,0,1135
42091000420,2147,1609,1056,181,277,19,74,1,553
42091003520,1759,1462,1314,27,43,15,60,4,148
42091001270,1906,1388,571,124,112,24,561,1,817
42091001123,1282,1042,880,24,58,5,77,0,162
42091001036,2017,1639,1144,78,188,21,212,6,495
42091002953,2823,2237,1495,51,139,6,518,2,742
42129002020,2167,1732,1655,15,19,18,16,0,77
42033000340,390,317,303,2,1,3,3,0,14
42033000640,2481,2043,1967,14,8,17,15,0,76
42033000290,1105,830,766,14,17,17,15,0,64
42093000020,944,789,760,8,4,10,8,1,29
42129000380,766,636,609,3,1,13,2,0,27
42129001694,2403,1909,1711,20,33,22,108,2,198
42129001692,2240,1837,1687,9,26,3,97,0,150
42129000350,546,392,373,5,1,5,2,0,19
42129002640,1268,1085,1063,1,2,3,6,0,22
42129001490,378,331,281,2,39,2,5,0,50
42129001480,465,347,227,12,97,5,4,0,120
42129002700,575,481,462,1,3,6,1,0,19
42041000831,3587,2632,2251,81,87,27,190,4,381
42041000748,1818,1441,1325,25,26,16,40,1,116
42041000744,1745,1348,1221,28,24,17,36,0,127
42041000590,594,438,406,8,7,5,12,3,32
42037000140,1759,1455,1252,67,59,21,50,0,203
42037000530,2036,1654,1560,30,21,18,10,1,94
42071000250,2703,2247,2116,69,21,8,33,1,131
42071001090,1459,1164,1029,72,37,6,16,2,135
42027000480,1527,1234,1193,9,3,15,6,0,41
42129001800,1595,1257,1026,38,182,19,7,1,231
42107001660,1506,1121,1087,10,3,11,4,1,34
42107000725,862,684,618,24,17,6,15,0,66
42107001595,1676,1317,1258,9,20,20,1,2,59
42133000539,2089,1573,1401,28,64,20,63,1,172
42133000721,3164,2350,1975,122,104,70,66,1,375
42133001370,2228,1689,772,447,474,29,28,3,917
42025000062,1334,1149,1101,25,2,19,3,2,48
42025000150,1229,1019,946,41,4,21,9,1,73
42015000410,1144,879,838,11,6,18,1,1,41
42015000460,1036,829,790,11,6,22,1,0,39
42015000530,1310,1032,977,14,7,23,3,0,55
42129001840,582,463,303,21,125,12,6,2,160
42107001766,949,809,796,4,0,0,0,0,13
42107000235,1601,1282,1178,41,17,19,19,0,104
42091001263,4595,3354,2842,74,179,16,245,2,512
42091000910,1497,1320,1024,99,79,12,95,1,296
42091002956,2850,2410,1988,51,94,12,254,4,422
42091003660,3477,3084,2091,158,356,29,430,4,993
42091001840,2365,1743,1473,36,20,5,188,1,270
42091002770,2491,1932,1508,194,93,35,110,0,424
42015000240,251,185,172,1,1,7,0,0,13
42015000290,1905,1477,1408,18,6,25,3,0,69
42013000191,1596,1275,1190,13,42,11,15,1,85
42013000380,1262,1010,939,6,22,29,6,0,71
42013000880,922,755,731,6,7,8,3,0,24
42013000400,1064,956,792,26,73,15,35,0,164
42069001665,1952,1474,983,128,151,26,174,3,491
42069002272,1554,1251,1133,19,32,1,51,2,118
42069001020,1237,945,774,93,15,23,44,0,171
42069001010,2039,1710,1505,85,42,8,66,0,205
42069001005,1426,1187,1113,36,21,16,4,0,74
42071001510,3017,2377,1942,196,136,30,80,2,435
42071000427,2458,1966,1351,324,170,19,127,3,615
42069000470,1284,1064,1001,25,9,13,9,1,63
42069001300,2174,1824,1743,32,13,13,10,1,81
42133001399,2713,2135,1845,72,154,25,34,2,290
42133001130,3567,2879,2516,71,189,27,62,1,363
42081000270,1370,1139,1070,3,19,14,17,3,69
42081000220,1021,806,768,3,7,5,17,3,38
42081000350,122,107,106,0,0,1,0,0,1
42081000430,1744,1395,1330,11,12,13,19,1,65
42081000490,661,526,500,5,3,7,6,0,26
42083000020,542,446,399,15,8,14,7,3,47
42015000560,737,644,623,4,6,6,2,0,21
42015000170,899,683,666,5,1,4,3,0,17
42015000570,1131,887,835,6,5,20,6,0,52
42015000270,241,191,186,1,1,1,1,0,5
42011000820,2598,1922,1558,173,100,19,55,0,364
42011000545,1954,1481,1270,109,29,34,30,4,211
42069002110,1462,989,530,308,132,27,38,1,459
42069001675,1780,1530,1162,102,77,25,147,0,368
42069002360,1345,1080,1008,23,18,4,15,0,72
42069002370,1044,879,806,21,10,15,9,0,73
42069002380,753,600,552,24,12,4,8,0,48
42069001325,1417,1093,865,112,91,13,27,1,228
42069001140,1471,1188,1027,56,55,17,41,3,161
42069000175,1530,1223,1081,61,55,12,11,0,142
42069000315,608,492,456,19,4,6,6,1,36
42069000305,815,578,518,34,15,10,3,0,60
42069000180,883,714,645,35,13,14,5,0,69
42069000440,1298,1060,977,41,11,11,22,0,83
42069000430,1223,984,918,23,11,3,16,0,66
42123000050,1604,1288,1214,8,3,24,10,0,74
42123000260,780,636,610,6,3,13,1,0,26
42011001380,1915,1332,230,979,180,40,16,4,1102
42011000450,1731,1313,1174,70,45,10,11,0,139
42027000535,387,319,304,6,3,2,0,1,15
42129002740,1438,1129,1052,30,14,11,22,1,77
42125000650,403,335,322,1,1,7,0,0,13
42125000170,2148,1547,1407,24,65,18,28,0,140
42091002660,2496,1998,1851,64,50,25,8,2,147
42025000280,880,680,648,22,7,4,1,0,32
42115000160,627,504,472,7,5,13,3,0,32
42115000010,426,355,341,1,3,3,2,1,14
42109000190,1831,1490,1300,77,78,5,30,1,190
42109000180,2505,2328,1923,160,168,26,66,3,405
42011001452,2445,2005,1917,30,19,21,8,0,88
42011000406,1980,1569,1406,80,24,29,18,4,163
42129001770,563,498,487,2,6,3,0,0,11
42129001760,864,715,621,16,67,4,3,1,94
42129001530,978,751,714,7,16,8,1,0,37
42091002020,4573,3596,2157,113,208,19,1091,3,1439
42115000220,856,707,689,5,2,5,1,0,18
42081000010,867,711,686,9,0,6,2,0,25
42081000050,93,88,83,1,2,5,1,0,5
42081000580,250,183,180,0,0,3,0,0,3
42091000620,613,486,381,11,69,6,21,0,105
42091003340,3303,2640,1752,117,260,21,496,2,888
42017002360,1819,1484,1372,31,16,19,18,2,112
42111000480,852,699,685,3,2,4,0,1,14
42097000255,1626,1292,1263,5,6,10,1,0,29
42097000425,1272,955,855,35,32,29,7,1,100
42097000190,908,731,693,17,3,11,4,0,38
42111000670,663,508,482,7,2,4,12,0,26
42111000290,544,433,426,2,0,3,1,0,7
42111000260,965,800,776,2,1,17,3,0,24
42071001690,3455,2348,2256,50,7,11,9,0,92
42071001955,1793,1406,1210,96,46,10,38,0,196
42011000500,1266,997,713,214,52,20,20,3,284
42049000260,1832,1223,556,223,381,25,54,2,667
42049001030,896,732,677,6,19,11,5,0,55
42049000750,1432,1094,939,46,66,17,21,1,155
42049001390,3533,2947,2764,32,29,42,35,2,183
42049000620,2314,1882,1326,122,310,26,83,0,556
42049000990,3159,2481,2290,29,49,25,72,6,191
42049000950,2422,1934,1814,29,38,17,21,0,120
42049001125,2387,1864,1722,20,40,4,65,0,142
42129000200,1310,1096,1052,4,4,17,7,1,44
42129000220,733,618,559,6,34,4,9,2,59
42129001540,1140,944,897,11,8,15,6,0,47
42129003000,1269,1065,1012,15,12,19,1,2,53
42129001750,726,587,413,6,140,18,7,0,174
42129001340,1182,981,917,6,36,4,7,0,64
42129001960,2093,1717,1634,25,12,18,15,0,83
42125001635,1102,908,869,10,1,19,1,0,39
42091002500,1909,1393,1174,48,70,13,93,1,219
42091001820,2815,2109,1642,29,18,11,384,1,467
42039000350,1363,1028,977,12,10,20,2,0,51
42121000650,2055,1694,1630,11,11,24,10,1,64
42121000320,498,424,401,2,1,9,2,0,23
42121000690,1190,983,936,2,9,15,1,0,47
42039000490,787,583,547,5,4,11,7,1,36
42123000400,1103,925,890,6,4,9,9,0,35
42123000331,1654,1297,1174,20,43,29,7,1,123
42125001910,1824,1445,1128,65,180,49,22,1,317
42129003010,1019,826,782,10,12,18,0,0,44
42071001250,1371,1043,779,148,79,12,43,0,264
42071001080,1237,1122,1052,26,13,6,22,0,70
42047000335,1626,1324,1272,14,11,12,6,3,52
42097000770,1246,992,854,74,37,21,3,5,138
42097000910,497,395,377,5,4,0,4,0,18
42043000551,1709,1374,1304,20,16,16,5,1,70
42043000600,2205,1771,1568,60,76,19,49,2,203
42043001070,752,610,454,58,103,10,6,0,156
42043000400,840,656,231,74,170,20,180,1,425
42129001370,364,305,299,1,0,4,0,0,6
42129000050,1187,973,908,13,9,16,3,0,65
42129000840,460,380,365,2,3,5,3,0,15
42129000600,678,533,464,6,52,9,5,3,69
42129000390,102,90,88,0,0,2,0,0,2
42129000320,399,355,302,5,40,8,0,0,53
42095000008,2566,2148,1914,120,45,17,45,2,234
42095000940,2333,1807,1627,100,47,18,14,1,180
42095000580,1765,1356,689,291,366,22,24,2,667
42095000220,1947,1637,1274,212,102,32,39,0,363
42095000640,2073,1739,1479,111,38,27,103,2,260
42071001572,1910,1551,1280,129,57,28,48,0,271
42071001938,2606,2048,1903,50,42,12,42,0,145
42043000210,395,346,255,27,38,8,23,1,91
42071001465,1641,1284,1032,96,72,15,81,3,252
42071001040,1592,1373,922,232,88,10,128,2,451
42095000770,4646,3540,2964,187,115,27,225,1,576
42095001140,1581,1270,1139,79,19,21,11,0,131
42095000240,2386,1890,1382,318,150,15,48,1,508
42047000345,825,680,628,5,7,20,6,5,52
42071000088,2733,2051,1966,21,22,11,17,1,85
42071001220,1538,1209,819,171,105,11,120,4,390
42071000265,3417,2505,2300,83,32,37,55,1,205
42095000420,2611,2144,1910,122,55,24,31,4,234
42049001420,1354,1020,948,8,4,26,15,0,72
42049000671,1606,1343,1006,54,221,21,29,2,337
42071001020,2628,2156,1321,549,243,46,70,2,835
42071001870,2733,2161,2030,46,28,19,24,1,131
42071001143,4228,3034,1139,1096,701,64,166,2,1895
42071001000,1948,1478,660,502,300,35,60,2,818
42071001140,1932,1489,1259,55,34,12,126,1,230
42071000420,1997,1583,1146,284,104,7,52,4,437
42081000560,597,513,489,5,9,8,3,0,24
42081000702,2172,1716,1145,50,471,41,21,3,571
42081000850,3105,2421,2283,34,12,39,19,3,138
42023000100,1030,861,807,9,6,17,6,2,54
42011000720,3240,2387,1542,608,221,51,23,5,845
42011000240,2397,1967,1742,129,54,24,30,5,225
42011001360,2700,1795,603,1011,229,17,23,5,1192
42011001260,1424,973,197,715,101,44,7,1,776
42011000460,1119,898,866,10,2,4,9,0,32
42011000301,1331,1135,1075,17,4,7,11,0,60
42011001010,3290,2182,443,1507,316,89,18,13,1739
42043001000,230,194,186,0,1,1,0,0,8
42043001390,545,387,354,16,4,11,2,0,33
42119000130,894,751,604,52,28,20,43,1,147
42121000425,996,782,733,15,10,12,5,1,49
42039000070,178,135,135,0,0,0,0,0,0
42039000210,2569,2185,1854,71,190,33,26,1,331
42095001280,1869,1496,1317,51,54,15,42,0,179
42133000543,3327,2445,2010,74,187,29,140,0,435
42133000160,6208,5095,4652,149,175,81,38,5,443
42133000280,5032,3896,3647,61,53,58,36,2,249
42109000165,2261,1859,1706,47,68,27,9,3,153
42071001945,2564,2142,1960,64,37,18,56,3,182
42071001344,1968,1528,1059,230,100,21,132,2,469
42071001622,1780,1341,1214,57,23,15,23,2,127
42071001624,3694,2875,2489,195,105,27,27,1,386
42091003260,1831,1461,1401,19,6,24,3,2,60
42091001022,1939,1646,1064,95,102,10,371,5,582
42091000870,1648,1329,1005,58,139,13,102,1,324
42091001987,4703,3635,2365,89,257,15,892,5,1270
42091003760,1985,1583,1436,31,47,0,59,1,147
42091001279,3625,2829,2464,85,132,29,97,0,365
42091003841,1314,1005,861,13,34,4,96,0,144
42071001860,1805,1413,1315,38,19,20,18,0,98
42071001760,1357,1024,945,38,21,5,11,2,79
42071000750,1908,1467,444,545,241,47,287,3,1023
42091001113,1332,1090,907,23,60,9,80,0,183
42091000931,1965,1594,1472,14,17,16,65,0,122
42091003861,2016,1540,1077,87,123,5,238,1,463
42091000818,2349,1830,1661,51,37,23,33,0,169
42071000720,1352,1066,643,231,174,20,28,2,423
42025000160,394,356,325,15,2,10,5,0,31
42011000402,2069,1610,1423,99,29,22,28,2,187
42081000190,396,323,310,3,1,7,0,0,13
42081000140,903,723,690,3,4,7,6,0,33
42021001580,630,488,469,7,4,3,3,2,19
42021001700,1008,896,857,13,12,6,6,0,39
42011001580,1892,1467,1178,162,83,17,24,1,289
42041000690,1634,1298,1125,73,55,22,36,1,173
42025000363,2068,1674,1504,89,34,24,16,5,170
42025000040,897,685,588,89,5,4,2,1,97
42025000320,1029,858,837,11,0,2,3,0,21
42085000280,1121,880,809,14,14,22,7,0,71
42085000050,1669,1324,1275,9,9,18,9,1,49
42085000680,753,586,562,1,1,10,4,0,24
42033000500,329,262,250,2,4,3,3,0,12
42033000390,764,618,607,0,1,6,2,0,11
42111000440,843,660,635,0,10,11,4,0,25
42021001995,931,770,725,8,8,19,2,0,45
42021000367,1177,920,895,5,8,6,0,0,25
42021000575,1547,1206,1099,30,50,25,1,0,107
42021001035,973,715,512,33,153,14,7,5,203
42021000335,1525,1243,1159,11,20,17,20,0,84
42111000230,390,351,341,4,1,0,5,1,10
42111000120,1827,1481,1434,14,6,11,6,0,47
42111000600,300,253,245,4,0,1,2,0,8
42017002710,1202,985,893,46,11,12,23,2,92
42017002827,1898,1449,1315,25,17,8,79,1,134
42017002510,1139,905,832,20,13,15,18,0,73
42017000240,2287,1824,1298,175,198,29,126,1,526
42017000790,1799,1407,1248,57,28,5,54,5,159
42017001720,1951,1574,1450,47,26,12,25,8,124
42085001100,718,627,583,5,14,7,5,0,44
42085000912,1774,1396,1282,20,33,28,7,0,114
42085001090,1420,1027,992,5,8,15,4,1,35
42085000490,194,161,157,2,0,0,0,0,4
42041000698,2234,1967,1801,60,23,18,59,0,166
42041000708,2086,1620,1313,63,45,22,176,1,307
42041000780,2082,1511,1351,45,50,17,42,1,160
42085001005,1853,1446,1384,8,5,16,8,0,62
42085000375,1102,787,666,11,76,14,0,1,121
42041000660,1803,1400,1207,68,59,34,28,0,193
42041000811,1736,1357,1264,22,22,12,35,1,93
42017002460,2424,1932,1728,49,29,12,87,3,204
42017001930,1816,1499,1374,40,20,15,13,5,125
42017002070,2291,1742,1488,42,11,13,174,0,254
42017000890,1344,1063,980,30,9,6,27,1,83
42017000200,2180,1765,844,84,490,24,319,1,921
42107000435,1308,1030,969,28,22,11,3,2,61
42017002230,1775,1361,1143,95,63,15,34,0,218
42017001708,1493,1414,1290,12,11,6,89,0,124
42017000655,2001,1656,1372,121,65,40,37,1,284
42017001380,1365,1038,930,38,20,6,50,0,108
42017002780,4406,3472,2534,546,122,54,220,6,938
42017001775,2205,1766,1237,218,231,40,48,3,529
42015000220,1104,884,855,4,3,16,0,0,29
42015000250,1051,859,803,8,7,22,4,0,56
42015000120,144,108,104,1,0,3,1,0,4
42081000075,3720,3084,2548,95,375,46,13,0,536
42015000260,1186,895,875,2,1,5,3,0,20
42015000330,2239,1828,1661,20,35,55,44,3,167
42003004880,1035,851,724,18,86,12,12,0,127
42003002670,460,403,378,7,1,5,2,0,25
4200300E595,1115,971,891,14,40,8,17,0,80
42003002630,2099,1679,1533,16,8,8,103,2,146
42003002730,1419,1178,1105,7,19,8,31,1,73
42003005601,599,503,299,16,178,7,8,1,204
42007001005,1896,1595,1516,26,23,8,13,0,79
42007000345,1489,1133,795,22,281,41,9,2,338
42007001025,1380,1136,1061,22,22,13,8,0,75
42099000300,1313,976,928,8,3,18,8,0,48
42099000110,1537,1205,1149,16,8,17,3,0,56
42007000905,1051,886,802,23,31,16,4,1,84
42007000660,1419,1213,1145,8,38,13,1,2,68
42099000010,229,169,164,2,1,3,0,0,5
42007000355,932,716,464,18,205,20,7,2,252
42007001390,520,441,412,5,2,14,1,1,29
42007000920,104,92,84,4,4,0,2,0,8
42007000830,71,59,53,3,0,1,1,1,6
42007001370,1542,1212,1122,25,37,21,7,1,90
42007000650,1659,1373,1293,8,29,21,4,0,80
4200300H135,764,565,305,19,233,10,5,1,260
4200300E901,836,753,677,6,16,5,45,0,76
4200300A480,219,197,142,8,20,5,21,1,55
42003001021,1147,966,877,26,23,14,32,0,89
42003001011,1535,1347,1001,28,115,5,187,0,346
42067000040,2866,2321,2186,68,17,28,17,1,135
42007000375,1276,988,772,22,136,36,21,2,216
42067000180,896,699,676,1,9,14,2,0,23
42067000190,238,194,186,1,3,5,0,1,8
4200300G840,695,562,524,2,3,3,25,0,38
4200300G810,1208,990,885,17,9,10,72,1,105
42003000542,1943,1680,1479,37,24,16,120,2,201
4200300E780,845,699,591,20,64,18,6,1,108
4200300F464,1560,1226,1160,8,23,14,14,0,66
4200300F462,951,743,712,0,13,5,9,0,31
4200300F526,1173,969,914,6,21,21,6,2,55
4200300C750,875,722,437,19,231,16,16,3,285
42003006680,259,221,11,2,207,0,2,0,210
4200300D180,1240,1022,848,33,73,7,56,1,174
42003001990,1673,1332,1282,4,17,9,8,1,50
42003002022,657,525,478,13,6,17,4,0,47
42003002950,1217,926,819,12,19,13,54,0,107
42007001445,1863,1559,1422,20,83,19,5,0,137
42007000450,1788,1393,1293,29,13,17,19,1,100
42007000165,1501,1152,835,37,246,22,8,3,317
42003005321,1266,1037,979,10,18,1,18,0,58
42003005341,1098,949,889,9,15,9,14,0,60
42003003790,714,546,230,25,294,5,2,0,316
42003007160,902,847,683,22,39,1,97,2,164
4200300F110,1293,1084,1015,25,9,3,18,0,69
42003005920,2775,2689,1919,112,391,22,240,6,770
4200300G260,519,412,349,11,38,11,1,1,63
42003005131,832,756,632,4,98,5,10,0,124
42001000070,2550,2084,1866,145,17,34,13,2,218
42117000070,623,485,467,3,0,2,0,1,18
42067000140,793,617,583,5,9,2,5,0,34
42067000050,534,420,407,2,3,6,3,1,13
42067000150,1204,959,920,3,8,20,0,0,39
42003003780,784,598,342,22,231,15,1,0,256
4200300G390,614,488,212,10,253,15,3,0,276
4200300E585,577,447,399,10,1,8,14,0,48
42003003720,660,483,222,12,237,6,3,0,261
42003001901,841,557,241,12,305,13,5,0,316
42003004020,1050,826,622,23,100,23,53,0,204
42003005821,1339,1021,722,20,253,21,5,6,299
42003004600,1031,816,631,118,22,6,34,1,185
42003001510,1025,822,742,22,27,6,17,0,80
4200300F437,1627,1168,1009,38,49,21,50,0,159
42003001324,1041,882,751,16,22,2,89,0,131
42003001326,1785,1503,1351,20,27,8,78,0,152
42003001282,1779,1374,1182,22,34,19,95,6,192
42003006880,873,795,649,24,56,12,43,0,146
42003006900,673,589,488,13,48,4,16,1,101
42003006600,1359,1254,708,67,179,9,287,0,546
4200300A000,233,197,169,4,16,1,4,0,28
4200300B980,651,565,268,10,272,10,9,1,297
4200300D360,801,650,504,16,88,10,21,0,146
42003005722,705,619,515,8,82,6,7,0,104
42003005700,750,626,571,14,22,7,5,0,55
42003005710,711,589,499,16,60,6,6,1,90
42003000603,1518,1236,1179,5,24,3,16,1,57
4200300A930,479,449,401,19,9,5,10,3,48
42003003940,511,438,365,5,59,3,0,0,73
42003000851,961,842,755,17,36,3,33,1,87
42001000190,825,702,675,6,9,4,7,1,27
42117000080,1032,820,779,7,3,20,3,0,41
42055000705,1738,1357,1182,55,67,27,15,1,175
42127000050,3610,3440,1688,451,1254,32,41,0,1752
42127000060,1913,1550,1451,31,14,16,19,0,99
42127000210,1876,1566,1349,77,50,32,29,0,217
42001000480,3076,2499,2356,36,22,29,30,2,143
42001000320,1376,1107,1052,6,15,16,2,1,55
42001000210,2225,1854,1451,174,141,30,61,2,403
42001000230,3192,2993,2321,261,187,60,171,7,672
42065000225,1137,817,803,3,2,4,0,0,14
42067000170,978,727,703,5,9,10,0,1,24
42031000320,919,751,734,3,0,8,2,0,17
42031000080,546,445,394,10,24,15,3,1,51
42031000070,992,812,728,18,16,17,17,2,84
42073000980,559,480,446,5,7,12,1,0,34
42073000910,647,510,479,3,12,8,2,0,31
42073000315,1611,1218,860,24,292,37,5,0,358
42073000475,1347,1037,810,28,167,25,6,1,227
42117000445,988,816,783,4,0,12,8,1,33
42117000030,371,294,283,1,5,3,5,1,11
42031000220,577,388,377,1,0,6,1,0,11
42117000010,343,274,265,0,0,8,1,0,9
42101003901,942,767,458,140,16,7,152,1,309
42101005603,1004,735,289,107,106,17,206,1,446
42101001805,1047,892,739,51,40,11,50,0,153
42061000540,947,792,769,6,4,6,0,1,23
42061000520,448,348,335,4,2,8,0,0,13
42061000470,141,115,105,5,0,3,0,0,10
42011001660,872,732,684,16,8,10,4,1,48
42011001340,1913,1485,619,649,233,32,30,2,866
42055000630,2811,2077,1880,73,70,13,26,0,197
42055000070,1607,1316,874,289,136,30,15,3,442
42055000130,1766,1293,823,291,144,52,21,0,470
42031000050,1629,1476,1247,46,147,17,22,2,229
42031000230,1871,1461,1417,1,14,12,5,2,44
42031000110,818,665,635,7,0,14,3,0,30
42031000430,896,655,627,4,2,15,1,0,28
42079001355,1572,1249,1136,26,21,13,46,1,113
42079001340,1269,1071,929,23,55,13,52,2,142
42079000535,1337,1104,1028,36,14,8,9,0,76
42079001180,2223,1854,1766,26,17,11,13,0,88
42079000565,1425,1181,1071,74,22,16,9,1,110
42101001325,643,497,8,19,462,10,6,0,489
42101004605,618,464,23,22,429,5,2,0,441
42101003110,785,657,470,60,67,6,58,0,187
42101001207,944,697,67,21,601,16,6,1,630
42101001819,1223,1093,562,290,177,15,70,0,531
42101001818,1341,1214,875,130,93,13,120,1,339
42101001321,542,418,7,12,401,8,2,0,411
42101001912,735,568,84,400,79,39,25,2,484
42101004508,1038,760,316,238,203,12,11,0,444
42101004510,967,680,109,363,212,19,23,0,571
42101004409,607,438,12,7,417,2,3,0,426
42101003108,1395,1229,759,199,127,13,138,0,470
42101005082,861,653,11,26,622,14,0,2,642
42101005095,516,389,7,6,375,1,7,1,382
42101005421,1182,866,271,193,84,8,261,0,595
42101003323,887,632,67,400,174,9,14,0,565
42101003009,1121,970,689,63,101,15,95,2,281
42101000613,602,440,15,14,405,2,5,0,425
42101006303,1325,995,802,84,69,10,41,0,193
42101003101,1016,872,643,94,47,4,68,0,229
42101001006,706,560,2,9,551,8,1,0,558
42101002805,732,554,14,10,532,4,3,0,540
42101004801,905,724,193,40,246,9,245,1,531
42101003615,591,514,120,41,336,6,25,0,394
42101005923,612,491,116,29,343,6,15,1,375
42101005824,1245,1141,928,57,99,11,48,0,213
42101006605,990,834,595,79,103,11,36,3,239
42101006606,783,634,520,34,28,8,36,4,114
42101000115,1037,873,651,68,73,13,72,3,222
42101006640,789,675,538,47,44,12,31,0,137
42101004212,1116,734,24,283,412,8,35,2,710
42101003410,833,666,9,21,627,10,7,0,657
42101003608,784,674,302,45,268,6,51,0,372
42011001430,2035,1611,1379,116,57,27,15,2,232
42101000907,1185,1079,740,80,205,11,21,2,339
42101006201,1392,989,242,356,382,23,42,7,747
42101005321,1182,904,352,173,276,14,103,3,552
42101000707,1083,899,127,525,262,12,13,10,772
42101004517,1242,854,192,404,264,18,24,2,662
42101005818,1814,1421,744,55,153,13,454,3,677
42101003922,1032,766,420,79,52,10,219,4,346
42101004910,1073,778,14,67,651,9,56,3,764
42101002305,1179,924,188,273,470,25,16,3,736
42101000518,1732,1571,1330,70,43,8,118,0,241
42101005825,1155,900,506,66,103,14,206,0,394
42101000231,924,786,622,44,41,12,64,0,164
42101000234,933,788,646,39,41,3,52,0,142
42101000232,970,802,682,53,21,1,38,0,120
42101000573,1285,1170,402,64,211,10,488,2,768
42101000825,2579,2483,1689,143,175,16,433,6,794
42101001402,869,641,26,33,532,14,48,2,615
42101003514,785,572,80,93,394,5,16,1,492
42101004040,1191,1002,131,31,780,19,70,1,871
42101004030,1102,793,71,50,629,16,44,4,722
42101001088,1323,1258,1021,56,70,18,99,0,237
42101001068,1465,1379,1087,67,64,11,154,2,292
42079003126,1947,1506,1375,48,24,15,42,3,131
42079003132,1410,1195,1072,48,17,6,46,2,123
42079003136,1074,868,813,15,11,7,28,1,55
42079003122,1291,1088,1008,14,14,6,38,0,80
42079000250,963,819,780,9,7,13,3,0,39
42079000280,933,790,739,20,18,2,4,2,51
42079001190,2053,1699,1632,26,6,22,3,0,67
42041000475,4008,3224,2902,96,68,56,72,6,322
42073000035,1300,1019,897,17,36,25,5,0,122
42073000930,1304,1009,900,16,48,22,1,0,109
42073000960,1396,1108,974,16,83,22,4,1,134
42079000010,1724,1411,1228,86,64,15,9,0,183
42079000815,2685,2149,1403,680,67,13,29,1,746
4200300C260,351,295,237,7,43,2,3,2,58
42003009650,614,496,469,1,10,0,10,0,27
42003005101,874,742,659,1,62,9,7,0,83
4200300F661,426,362,331,6,18,3,6,0,31
42003002961,1208,986,833,17,92,22,16,0,153
42003007330,1078,1009,680,56,66,10,199,1,329
42003008550,204,169,9,4,147,3,3,0,160
42003003450,396,319,298,4,7,5,1,2,21
42003008970,430,321,10,1,302,4,4,1,311
42061000440,1511,1211,1156,12,16,11,2,1,55
4200300C830,918,758,469,21,253,5,2,2,289
42003005181,1561,1355,1109,45,28,6,145,0,246
4200300G323,2346,1910,1854,19,8,15,6,0,56
4200300E050,1207,1086,1010,26,17,11,16,0,76
4200300B760,927,640,268,10,340,13,10,1,372
42003001500,1463,1168,1049,15,55,13,25,0,119
4200300G780,1030,808,555,19,26,10,192,1,253
4200300D690,382,308,254,6,34,8,4,1,54
4200300A250,1448,1361,1096,57,80,7,116,1,265
42003004840,1061,894,767,13,73,15,19,2,127
4200300D310,904,751,428,32,151,3,138,1,323
42003001160,600,475,368,15,79,12,10,0,107
4200300D160,1322,1044,479,45,138,10,365,1,565
4200300A130,636,465,200,10,236,15,9,1,265
4200300D770,953,773,695,14,37,5,10,1,78
42029001730,4024,3109,2773,82,48,29,145,0,336
42029001450,2548,1877,1680,28,42,19,82,1,197
42029001220,2414,1801,1245,63,45,18,432,1,556
42079001605,1840,1442,1244,96,59,33,12,2,198
4200300B680,879,675,285,21,349,15,12,0,390
4200300E725,1001,820,782,3,8,7,19,1,38
42073001050,1342,990,952,9,13,12,1,2,38
42003003101,1343,1136,1051,21,29,7,15,2,85
4200300G760,934,767,703,3,7,6,33,0,64
42003001831,887,707,649,3,26,13,6,0,58
42031000410,942,691,661,4,1,17,2,1,30
42031000152,1333,1076,1046,4,2,14,6,0,30
42131000075,1692,1367,1294,17,5,21,12,1,73
42079000275,1606,1366,1299,15,32,10,4,2,67
42065000340,295,218,209,2,1,5,0,0,9
42101002706,1740,1557,568,111,295,17,572,2,989
42101003119,649,571,472,53,18,6,20,1,99
42101001911,821,621,26,477,144,14,17,1,595
42101005604,914,714,286,125,185,10,96,1,428
42101006117,760,598,104,42,366,7,83,0,494
42101001905,531,389,4,318,86,7,6,2,385
42101004623,1228,1012,596,67,179,5,165,3,416
42101004618,958,776,446,63,116,9,133,0,330
42101006641,1482,1090,622,140,290,13,40,4,468
42029001631,2101,1576,1382,36,41,23,77,0,194
42079000080,1128,940,894,22,5,10,5,0,46
42079001840,360,300,287,4,3,2,1,2,13
42075000250,1538,1237,959,226,44,22,9,3,278
42075000100,2502,1872,1803,26,13,10,14,0,69
42075000440,3438,2655,2470,68,27,40,41,5,185
42079001410,1451,1217,1113,34,16,11,36,1,104
42079002055,1615,1363,1271,39,27,16,14,1,92
42113000150,304,260,247,5,3,7,1,2,13
42065000580,147,109,99,1,0,2,0,0,10
42061000490,693,551,520,4,2,3,6,1,31
42029000170,1030,808,558,56,148,17,40,2,250
42061000550,1963,1588,1551,3,7,8,7,0,37
42061000510,550,449,434,1,0,13,0,1,15
42029000130,1840,1278,202,318,761,28,10,0,1076
42029000430,1633,1285,1017,54,58,15,128,2,268
42077000980,3257,2618,2211,209,99,9,79,0,407
42029000975,1263,919,743,26,48,20,68,1,176
42029000995,2057,1546,1204,101,122,18,89,1,342
42029000985,1586,1228,781,162,213,25,38,0,447
42029001400,3711,2732,2489,73,50,22,66,4,243
42029000602,1599,1288,1151,31,38,9,46,1,137
42029000680,6883,4825,3693,679,157,66,214,5,1132
42029001570,2374,1952,1266,278,331,30,45,0,686
42029001560,2568,2210,1561,357,227,22,56,6,649
42029001670,1720,1359,1205,41,47,9,47,0,154
42057000020,1361,1085,1035,6,4,24,4,1,50
42029001910,800,639,540,23,16,11,37,1,99
42029000365,4622,3281,2551,518,119,56,42,3,730
42029000361,4360,3266,2781,216,155,53,36,1,485
42029000065,4148,3407,2532,223,451,30,178,1,875
42029001465,2553,1896,1585,105,70,29,91,2,311
42079000835,1735,1470,1273,137,27,6,39,0,197
42079000083,1380,1121,1055,16,17,16,14,0,66
42079000120,379,325,299,6,5,6,4,2,26
42101005021,948,810,33,23,753,12,8,3,777
42101005918,730,667,103,16,543,8,11,0,564
42101003820,636,556,459,27,52,11,21,0,97
42101003813,1304,1173,877,62,120,15,103,4,296
42101002917,500,435,147,20,262,10,5,1,288
42077001070,1221,984,861,60,27,6,27,1,123
42077000270,2152,1705,994,513,199,28,39,0,711
42079000260,2076,1680,1619,21,0,18,6,0,61
42079000180,1825,1514,1394,53,23,9,27,0,120
42079000325,1164,978,918,27,22,6,6,0,60
42079000050,802,671,624,12,11,12,2,0,47
42079001375,1721,1336,1087,96,124,18,25,3,249
42101000718,1142,811,39,618,165,9,23,2,772
42101002417,379,257,19,10,226,3,5,3,238
42101000614,834,610,46,28,537,17,13,1,564
42101002228,685,564,5,14,547,7,0,0,559
42101003224,433,328,13,10,296,13,5,0,315
42101006626,1039,826,687,47,59,5,19,1,139
42101001407,1391,1246,534,227,442,9,64,1,712
42089000060,675,580,450,56,40,5,26,0,130
42061000280,418,304,284,1,5,9,1,0,20
42079001782,1937,1592,1314,83,141,34,14,4,278
42035000150,49,42,37,3,0,0,0,0,5
42101002312,1403,1028,76,518,365,21,110,6,952
42101004504,1130,877,821,19,8,11,9,0,56
42101006302,925,730,621,40,51,5,13,1,109
42029000460,3492,2649,1489,74,105,22,936,0,1160
42029000440,2152,1641,1193,44,26,14,353,0,448
42029000622,2225,1799,1579,91,42,9,56,2,220
42029000752,3749,2786,2001,564,84,38,106,5,785
42089000056,5445,4220,1696,1013,1451,85,124,12,2524
42101003011,911,793,540,31,136,6,80,2,253
42101002901,850,804,408,66,285,4,53,0,396
42101004518,790,581,196,235,136,12,18,4,385
42101001318,877,731,7,36,636,8,53,0,724
42101004513,961,669,235,208,215,16,15,3,434
42101002010,987,685,60,212,413,10,22,3,625
42101001910,956,739,130,495,123,22,26,0,609
42101001215,1079,978,170,35,750,17,20,3,808
42041000470,1676,1317,1168,28,61,14,26,0,149
42073000295,871,716,618,18,59,17,11,1,98
42073000050,998,801,717,14,30,13,9,0,84
42035000220,1423,1098,1018,17,17,17,17,2,80
42011001670,1606,1313,1256,27,11,11,6,2,57
42101001902,1045,747,25,630,101,26,10,0,722
42101000221,720,621,290,23,219,9,92,0,331
42101004904,724,543,11,57,473,11,10,1,532
42101003929,714,578,422,22,14,2,117,0,156
42101003914,474,415,370,8,10,5,28,0,45
42101003941,933,796,653,37,12,7,89,0,143
42101004041,898,658,70,26,534,3,36,1,588
42101004037,1207,920,117,29,706,13,62,1,803
42101002121,962,846,685,63,58,10,25,1,161
42101003520,1077,794,136,187,377,18,111,2,658
42101003805,790,582,6,26,559,13,4,1,576
42101003426,745,588,38,11,536,5,3,1,550
42075000290,193,177,169,2,3,0,4,0,8
42075000220,1555,1105,388,648,88,25,7,7,717
42011000710,2927,2294,1951,198,112,33,16,2,343
42011001700,2776,2247,1975,139,98,26,34,3,272
42011001060,1305,857,127,656,137,38,15,3,730
42011000299,47,42,37,3,0,0,1,0,5
42011001705,2273,1818,1158,458,176,27,49,2,660
42101003227,562,399,17,8,371,6,7,2,382
42101005925,891,768,219,24,507,12,17,0,549
42101003013,976,833,521,49,188,6,67,1,312
42101003809,1447,1294,496,58,672,9,73,3,798
42101003806,830,615,11,10,596,5,2,0,604
42035000050,736,584,556,4,1,15,4,0,28
42045002720,1549,1149,187,53,882,10,31,4,962
42045001560,1229,1021,450,37,488,28,52,2,571
42045001550,1253,1045,470,36,452,16,64,3,575
42045002500,433,329,185,19,110,5,14,3,144
42081000692,2795,2465,1614,195,567,39,60,3,851
42029000540,1698,1300,1170,63,26,9,14,0,130
42029000185,1253,1000,889,30,27,5,50,0,111
42011000365,2825,2302,1952,139,105,32,90,3,350
42081000650,1807,1422,1368,7,5,22,2,2,54
42081000090,935,749,729,7,3,7,0,0,20
42011001578,2229,1782,1625,78,38,17,30,3,157
420111578P1,22,14,12,0,1,2,0,1,2
42101001799,1166,1024,711,113,95,17,113,1,313
42101003207,1451,1289,628,122,397,9,136,7,661
42101004004,1146,679,15,9,650,11,1,1,664
42101004029,997,723,50,11,631,5,33,0,673
42101005128,730,549,9,14,521,11,3,1,540
42063000685,1817,1523,1422,19,45,12,25,0,101
42063000730,944,720,693,2,4,14,1,0,27
42063000220,952,793,760,3,11,6,6,1,33
42009000240,507,434,424,1,1,8,0,0,10
42009000110,1760,1415,1350,13,4,40,6,0,65
42063000520,1331,903,875,3,1,8,0,0,28
42063000510,1430,1134,1078,14,8,15,1,0,56
42063000610,1825,1232,1208,0,7,8,0,0,24
42075000108,3686,2952,2803,64,34,10,26,0,149
42075000112,3160,2361,2214,83,25,15,16,2,147
42075000420,2300,1813,1552,106,45,25,61,5,261
42075000040,1472,1069,995,48,11,14,8,0,74
42075000540,833,651,459,141,35,9,19,1,192
42077000060,2290,1690,452,945,346,29,38,5,1238
42077000850,1689,1364,831,344,138,32,59,1,533
42077001320,1230,993,930,33,7,11,7,0,63
42077001430,2574,2124,1739,228,86,40,49,3,385
42089000267,4945,3672,1434,996,1154,69,153,14,2238
42089000254,3128,2596,1662,424,377,66,109,5,934
42029000050,2629,2135,1201,259,609,23,45,4,934
42029001431,1983,1557,1395,56,22,27,45,0,162
42029000955,1402,1106,882,90,50,26,51,0,224
42029000755,2797,2208,1814,133,83,22,114,0,394
42029001050,3665,2641,2323,67,64,16,163,0,318
42029001646,2703,2010,1796,53,49,21,87,3,214
42029000835,1940,1576,1496,13,22,8,21,3,80
42077001314,1799,1359,1241,31,26,12,49,2,118
42077001312,2031,1577,1342,70,44,8,103,1,235
42077001301,1714,1303,1086,68,42,15,73,1,217
42077000250,3478,3154,1547,618,940,1,30,0,1607
42077000930,3861,3106,2917,67,7,36,40,1,189
42077001110,1021,745,647,60,18,20,2,1,98
42077000440,2546,1873,656,964,243,26,68,13,1217
42077000860,3324,2623,2473,59,31,25,23,2,150
42133000900,4465,3658,2903,244,267,27,209,2,755
42023000060,113,108,102,1,1,2,2,0,6
42077000924,2111,1618,1416,64,38,18,82,0,202
42077000170,1746,1428,689,554,193,26,36,2,739
42077000750,1870,1510,1261,137,78,17,30,3,249
42063000570,2786,2230,2166,10,4,22,7,2,64
42045003053,1102,901,770,35,50,20,22,1,131
42045003068,1749,1428,1069,38,238,12,62,0,359
42045003058,1524,1194,704,40,409,19,18,1,490
42045002270,1528,1206,989,57,93,15,41,1,217
42045003760,780,497,63,38,364,11,33,1,434
42083000110,1270,1042,991,3,9,23,11,0,51
42083000330,583,482,454,12,3,4,1,0,28
42011001160,3794,2615,258,2041,475,140,17,13,2357
42057000100,1612,1254,1183,5,32,20,6,6,71
42057000010,2036,1589,1528,8,20,29,4,0,61
42045000395,713,531,7,14,509,4,2,2,524
42045003770,686,514,74,51,335,12,55,0,440
42045000816,1706,1370,1201,18,21,22,105,2,169
42045000836,1075,771,671,31,12,11,45,0,100
42077000400,2134,1641,883,561,190,47,38,5,758
42059000150,543,446,423,3,1,11,5,2,23
42089000285,2079,1635,1018,297,255,36,65,3,617
42047000110,1366,1115,1068,6,3,21,4,0,47
42063000430,1481,1179,984,44,59,22,58,1,195
42033000060,1662,1375,1314,2,4,36,4,1,61
42045001880,1488,1251,953,60,77,11,149,0,298
42045001180,1769,1351,1157,31,47,15,96,0,194
42059000250,862,696,665,3,6,8,3,1,31
42051000520,246,210,198,1,3,6,0,0,12
42063000345,626,506,490,4,2,2,0,0,16
42027000120,2067,1648,1418,72,50,10,83,1,230
42027000310,1317,1074,1029,9,5,16,6,0,45
42027000710,3665,3333,1896,161,190,20,1051,2,1437
42027000840,2794,2198,2110,19,18,28,25,2,88
42095000710,3087,2587,2454,69,24,27,6,0,133
42059000230,1001,816,771,9,12,20,7,0,45
42059000330,905,741,728,2,3,3,1,1,13
42059000280,569,466,444,3,2,7,2,0,22
42051000780,474,395,356,7,19,9,2,1,39
42051000930,623,506,495,0,3,4,0,0,11
42051000680,37,34,30,1,0,2,1,0,4
42051000740,1156,930,856,13,16,19,6,0,74
42029001418,1995,1508,1247,73,69,12,93,0,261
42029001375,2486,1829,1460,46,43,15,254,1,369
42029001535,5064,3932,3446,121,238,69,45,4,486
42029000195,2731,2144,1980,46,44,16,44,2,164
42033000400,1260,1051,1006,7,1,24,8,0,45
42033000070,1122,889,867,7,1,7,4,0,22
42033000080,1719,1405,1352,10,4,11,4,0,53
42019000510,2745,2236,2164,15,11,19,4,0,72
42051001020,1351,1083,926,20,92,14,13,2,157
42051000490,395,324,307,1,5,3,1,0,17
42045000050,2194,1734,1633,27,26,19,18,2,101
42045000040,3902,3205,2847,90,128,29,95,4,358
42045000650,754,543,115,20,394,0,19,0,428
42045000660,968,697,85,22,581,11,17,0,612
42045000670,946,673,82,30,555,18,14,0,591
42045000130,1277,995,830,41,67,9,38,0,165
42045003000,856,634,398,38,178,9,5,1,236
42045003930,2245,1747,43,45,1662,9,24,1,1704
42045001340,1689,1618,1081,129,122,6,266,4,537
42045003450,1117,854,391,68,253,12,127,2,463
42045003170,1065,834,488,36,240,18,57,1,346
42045002870,904,707,655,16,18,1,16,0,52
42045002160,1677,1350,1198,39,34,11,53,0,152
42045002110,2607,2291,2010,29,59,10,162,1,281
42045001500,1052,773,700,15,19,2,29,1,73
42019000290,2551,2071,1983,19,11,35,4,1,88
42051000955,1915,1587,1193,27,296,44,3,11,394
42033000160,1708,1383,1307,7,12,26,22,1,76
42033000100,422,334,322,6,1,3,2,0,12
42033000150,1413,1170,1089,19,15,19,10,1,81
42019000160,2198,1816,1729,27,18,19,10,1,87
42125001318,1315,1099,1056,6,1,12,14,0,43
42125001324,2633,1952,1806,28,25,17,53,0,146
42125001328,1414,1118,1059,11,24,14,8,0,59
42019000220,2145,1782,1689,26,26,22,8,2,93
42019000460,942,747,719,3,6,5,4,0,28
42019000110,1324,1084,977,23,39,30,6,0,107
42019000580,2769,2264,2193,8,12,24,11,1,71
42125001830,1195,1118,798,56,225,2,32,2,320
42125000215,1220,977,841,19,87,19,5,1,136
42129001150,1158,954,893,8,14,25,5,0,61
42093000040,1168,959,860,19,16,14,44,2,99
42093000060,996,813,672,28,28,18,66,1,141
42059000170,269,199,187,4,0,5,1,0,12
42115000110,1114,891,840,13,4,25,7,1,51
42115000392,1365,1024,913,30,9,36,6,1,111
42115000240,508,407,394,3,1,5,1,0,13
42115000420,254,187,178,1,2,8,0,0,9
42033000330,127,115,111,0,0,0,0,0,4
42033000560,1200,986,953,7,0,12,0,0,33
42027000130,3769,2993,2486,107,131,44,206,0,507
42027000800,848,682,660,4,2,16,2,0,22
42111000520,2450,1992,1911,21,8,27,2,0,81
42111000570,3165,2592,2451,38,14,33,36,1,141
42111000580,603,501,483,2,1,5,3,0,18
42111000170,722,584,561,6,1,9,3,0,23
42111000340,1490,1247,1196,12,6,11,3,2,51
42037000425,1458,1183,1142,18,3,16,2,0,41
42037000070,1429,1128,992,68,36,23,2,1,136
42025000290,846,655,633,6,5,3,4,0,22
42109000110,1325,999,955,13,11,16,1,2,44
42119000250,728,585,511,36,20,7,11,0,74
42033000580,60,53,53,0,0,0,0,0,0
42051000085,819,624,507,9,91,11,2,2,117
42081000100,265,241,235,1,2,3,0,0,6
42081000250,862,711,663,1,3,21,4,0,48
42009000090,1132,908,892,4,3,4,2,0,16
42091003865,1419,1248,985,22,41,12,190,0,263
42091002980,1866,1459,1170,46,81,13,144,0,289
42091001935,2706,2050,1754,54,84,18,126,1,296
42091003001,1809,1436,1251,42,40,12,73,1,185
42091002690,2875,2278,1856,90,224,68,43,4,422
42091003480,2189,1731,1121,93,279,15,225,1,610
42091001240,1841,1388,864,139,124,16,252,3,524
42091001997,3520,2757,2591,52,43,26,14,0,166
42009000160,189,136,132,0,1,2,1,0,4
42009000200,1181,951,930,2,6,9,1,0,21
42129000020,2955,2431,2357,1,18,20,4,0,74
42129000270,1865,1548,1500,5,10,12,8,2,48
42129000570,678,561,452,18,62,5,8,0,109
42045002085,1176,859,656,31,79,8,78,3,203
42045002082,909,668,533,19,65,17,35,0,135
42045002095,1823,1438,1128,22,77,7,202,0,310
42045002099,631,449,357,7,14,4,69,0,92
42045000180,2105,1667,358,151,1143,21,17,0,1309
42045000240,705,563,134,27,395,8,1,0,429
42045001530,1502,1164,362,51,696,18,53,1,802
42051000370,944,791,725,5,36,12,1,2,66
42095000860,3789,3175,2960,85,32,43,26,1,215
42095000720,1270,1027,948,27,16,17,4,1,79
42033000670,297,242,227,1,0,0,1,0,15
42033000680,361,280,262,2,6,4,0,1,18
42005000532,1509,1220,1126,5,57,20,2,1,94
42005000425,1404,1106,1074,4,3,13,7,0,32
42005000605,974,778,754,4,2,10,0,0,24
42047000230,1915,1564,1508,15,9,21,3,0,56
42015000500,1585,1261,1228,15,7,10,3,1,33
42091000500,1272,1071,716,95,192,8,63,0,355
42091000185,2187,1724,1159,77,373,24,103,0,565
42013000370,1789,1408,1325,6,40,17,4,1,83
42019000620,179,143,133,2,0,7,0,0,10
42095001250,3847,3074,2851,99,48,36,26,2,223
42071000910,1722,1243,350,585,278,34,60,1,893
42071000100,3883,2604,2468,52,33,25,9,1,136
42071001280,1191,977,888,44,20,4,24,0,89
42071001290,2027,1634,1413,112,36,16,45,4,221
42071001190,2083,1612,1374,68,26,22,115,2,238
42021001350,879,725,703,8,2,9,2,0,22
42085000710,649,495,465,5,4,13,1,1,30
42085000765,1147,898,782,18,85,5,4,1,116
42085001055,1189,1051,1013,2,3,17,2,3,38
42133000990,301,231,215,4,6,0,2,0,16
42133000707,3987,3299,3063,97,63,33,35,0,236
42033000120,188,169,161,0,2,4,1,0,8
42033000360,361,294,284,2,0,3,2,0,10
42021000520,665,557,517,5,5,13,7,0,40
42019000100,2813,2180,1834,94,180,49,22,2,346
42107000385,1729,1407,1321,44,13,13,19,0,86
42097000160,347,261,248,1,3,5,3,0,13
42097000050,588,509,496,4,3,0,0,0,13
42097000405,1011,799,721,33,17,25,5,2,78
42097000560,2040,1597,1492,26,14,7,42,0,105
42097000580,1199,907,859,23,7,7,4,0,48
42097000300,1300,1049,894,59,39,21,31,1,155
42021001616,954,746,708,8,11,12,5,1,38
42021001125,1071,847,717,19,89,10,10,0,130
42045002100,2251,1843,1628,33,34,7,138,2,215
42045001690,1149,894,775,17,29,2,72,0,119
42045003010,834,603,430,30,126,20,2,0,173
42045001520,955,772,218,45,471,18,38,1,554
42045003790,1356,1025,150,142,371,11,353,1,875
42045003320,1071,786,485,39,222,16,43,0,301
42045001460,1695,1267,1081,19,38,12,105,0,186
42045003078,1768,1492,1247,73,125,19,38,0,245
42045003043,1214,991,804,41,119,18,12,3,187
42109000155,1776,1419,1310,35,16,24,21,0,109
42091000710,1341,1042,530,76,337,10,104,0,512
42091001380,1270,929,800,27,32,2,55,3,129
42091000205,1989,1554,1283,71,142,12,39,0,271
42091002950,2729,2119,1563,253,125,59,120,1,556
42133000714,4390,3480,3159,86,94,67,51,0,321
42097000540,3367,2725,2616,39,12,23,26,2,109
42045000360,483,328,23,19,292,6,0,2,305
42045002850,1076,827,684,22,16,7,96,0,143
42045003455,1297,1022,247,70,381,12,318,2,775
42045001990,1574,1249,1104,39,34,9,49,1,145
42045001980,1440,1339,1203,31,56,1,44,0,136
42045001110,1391,1111,826,29,187,20,52,2,285
42045002600,3011,2385,1921,108,263,23,69,1,464
42123000150,309,268,251,0,0,5,5,1,17
42091003320,1761,1398,845,103,120,14,307,2,553
42091002835,1210,967,754,23,58,8,118,0,213
42133000340,3534,2977,2703,142,46,34,39,4,274
42027000290,875,717,693,4,6,11,3,0,24
42027000100,411,330,324,3,1,3,0,0,6
42027000263,422,329,289,12,7,16,9,1,40
42027000261,863,593,535,10,12,13,22,1,58
42027000264,1500,1167,1121,8,8,7,11,2,46
42027000265,5,5,5,0,0,0,0,0,0
42027000600,1022,841,797,14,13,8,11,1,44
42027000090,1586,1328,1279,8,11,17,9,0,49
42027000400,1028,788,683,36,21,5,35,1,105
42027000140,3147,2591,2144,99,65,27,252,4,447
42091002640,3142,2501,1857,161,380,53,47,12,644
42091000460,1272,1016,907,13,64,15,15,0,109
42069002255,2475,1913,1561,39,34,12,257,0,352
42049001010,2275,1823,1763,8,8,11,16,0,60
42049000430,1458,1217,1174,8,15,7,13,0,43
42085000170,436,359,338,2,2,16,1,0,21
42111000660,1317,1022,950,15,8,32,5,0,72
42111000560,1251,1009,943,9,17,14,17,0,66
42085000974,1218,989,943,6,9,9,10,0,46
42085000972,1435,1176,1115,6,19,23,1,0,61
42085000515,1919,1599,1522,8,9,33,9,1,77
42085000862,1593,1286,1059,7,171,25,13,1,227
42085000072,754,550,179,13,344,10,2,2,371
42069000860,683,567,550,14,0,2,1,0,17
42069000850,887,707,661,18,16,4,6,0,46
42097000650,1340,970,826,58,61,18,12,0,144
42097000871,68,49,45,4,0,0,0,0,4
42097000872,580,437,434,1,0,1,0,0,3
42097000780,1317,1006,852,84,35,23,1,0,154
42097000600,840,614,516,37,41,23,9,0,98
42107000355,889,708,647,21,19,9,16,0,61
42107001710,816,684,636,29,5,10,1,0,48
42005000510,328,243,235,4,0,1,0,0,8
42107000085,811,667,640,9,1,13,0,0,27
42107000850,1430,1149,1085,30,8,14,8,1,64
42033000110,1055,817,793,2,2,13,2,0,24
42119000150,1203,1021,924,33,33,7,23,0,97
42013000210,1923,1288,1112,21,108,24,6,1,176
42013000051,1612,1383,1186,14,145,20,7,4,197
42059000295,911,702,667,3,1,9,6,1,35
42051000035,691,538,407,3,107,7,1,1,131
42025000090,1629,1346,1252,27,11,26,19,0,94
42025000440,1732,1410,1307,36,9,27,16,0,103
42051000055,675,521,448,3,52,3,3,4,73
42017000980,2938,2263,2083,58,34,23,34,7,180
42017001785,3040,2392,1049,296,985,33,83,2,1343
42017002590,3176,2483,1911,313,100,40,127,3,572
42017000805,2799,2163,1949,56,25,23,84,1,214
42017001730,3220,2495,2253,76,53,16,95,3,242
42017001710,1440,1173,1077,34,28,13,17,0,96
42017002670,3052,2357,1986,214,60,34,79,3,371
42017002840,3286,2570,2226,54,59,18,166,1,344
42129001440,250,220,132,7,74,2,0,1,88
42129002950,1082,856,756,6,38,15,4,0,100
42129000060,713,606,575,2,5,12,0,0,31
42129002710,765,622,597,3,0,8,4,0,25
42129000170,435,339,323,4,1,6,1,0,16
42129001110,1981,1628,1516,24,25,25,18,0,112
42017000940,909,801,746,14,12,2,13,0,55
42017002150,3645,2939,2642,105,50,39,86,2,297
42017002198,2390,1813,1610,71,16,5,91,2,203
42017001765,2474,1923,1386,184,266,39,42,3,537
42129000500,930,752,722,7,3,14,4,0,30
42021000767,1176,1136,846,33,234,18,12,1,290
42087000180,1998,1663,1441,101,89,29,16,1,222
42107001145,1456,1182,933,187,43,20,9,4,249
42125001165,1248,1009,898,18,48,7,17,5,111
42125001125,850,700,601,17,49,22,3,0,99
42017001960,1698,1309,1239,24,0,13,23,1,70
42021001651,1214,956,876,14,32,5,17,0,80
42021001941,1696,1427,1299,34,26,15,50,0,128
42021001255,955,865,826,4,22,12,3,0,39
42021001241,1433,1253,1167,16,42,14,5,0,86
42021001540,745,621,591,1,9,6,9,0,30
42021000786,604,493,294,22,157,25,7,0,199
42021000826,1554,1182,763,44,351,22,2,2,419
42049001090,388,295,285,5,0,1,1,0,10
42049000780,1488,1231,1081,39,64,9,25,2,150
42125000520,802,637,529,14,60,9,9,0,108
42129001380,3585,2704,2574,38,21,19,30,0,130
42129000480,626,518,484,4,4,16,1,0,34
42021000025,1480,1175,1128,13,8,14,3,0,47
42125001020,774,600,557,16,4,14,2,0,43
42125002000,346,274,256,3,4,4,0,0,18
42091001981,1476,1424,1326,29,18,7,42,1,98
42091001135,1308,1033,889,28,25,4,83,1,144
42091001450,1033,730,552,24,39,5,111,0,178
42091000430,1715,1317,849,215,160,24,83,3,468
42091003400,966,748,577,76,50,19,29,1,171
42091001845,2634,2014,1658,41,40,10,254,5,356
42091003720,2104,1582,1257,51,111,7,154,0,325
42091002820,1273,1057,651,30,311,11,62,3,406
42129002880,1271,1071,1022,7,16,5,6,0,49
42129001920,286,211,199,3,4,3,1,0,12
42129000630,850,705,633,14,32,12,8,0,72
42041000233,1793,1380,1224,33,19,15,80,7,156
42107001772,1417,1167,1139,13,2,8,5,0,28
42063000400,1089,848,819,4,9,7,0,1,29
42063000020,744,617,578,3,7,11,8,1,39
42093000010,1452,1069,1035,13,9,5,8,4,34
42095000332,1507,1256,1036,101,68,12,30,1,220
42049001380,3809,3037,2839,33,24,20,72,1,198
42125001450,1556,1225,1160,25,5,0,24,0,65
42095000130,3149,2267,525,1396,367,66,79,11,1742
42049001470,1476,1141,1068,19,13,28,3,0,73
42015000150,1167,864,823,7,2,24,4,1,41
42109000090,1587,1160,1107,20,15,13,6,1,53
42013000810,600,456,439,5,2,2,3,0,17
42049000910,2993,2357,2238,20,25,40,18,6,119
42071001410,1408,1103,1050,35,8,4,2,0,53
42071000190,1127,951,735,131,84,19,5,0,216
42071000490,1209,944,844,41,22,9,25,2,100
42071000020,1646,1288,1167,69,27,14,18,1,121
42063000155,1432,1146,1101,3,7,15,11,0,45
42039000320,432,362,352,3,1,4,1,0,10
42049000040,4191,3758,2509,151,1053,28,6,3,1249
42049000820,1880,1442,1114,118,146,24,29,3,328
42049999999,0,0,0,0,0,0,0,0,0
42049001130,2230,1852,1681,70,47,35,14,3,171
42049000410,609,505,424,13,53,8,10,0,81
42043000010,326,272,262,5,1,4,0,1,10
42043001292,2287,1858,1357,82,202,20,196,0,501
42043001304,2372,1796,1153,143,362,25,122,6,643
42043000410,1918,1429,200,251,970,26,17,3,1229
42043000460,1834,1393,280,214,691,16,217,2,1113
42043000021,1694,1342,1266,31,21,8,20,2,76
42129001130,1429,1152,1088,6,19,21,5,1,64
42129002330,2252,1760,1656,27,22,11,24,0,104
42129001520,303,265,253,3,8,0,0,0,12
42085000040,2084,1700,1636,3,8,23,3,0,64
42085000225,1579,1385,1158,40,122,25,32,1,227
42085000245,1394,1075,1017,11,13,14,4,0,58
42107000625,1101,820,586,187,26,16,7,0,234
42107000505,1470,1207,1110,74,9,4,6,0,97
42017000120,1516,1230,1011,95,32,24,62,1,219
42017000720,946,724,502,124,84,7,14,0,222
42123000361,2307,1769,1691,15,13,21,3,2,78
42043000731,2178,1717,922,75,299,15,425,0,795
42107001678,1663,1346,1279,23,2,10,13,2,67
42015000130,1936,1503,1439,17,4,32,7,0,64
42013000560,453,385,370,4,0,3,2,0,15
42133000541,2908,2197,1934,61,60,29,111,1,263
42133000190,2422,1955,1848,32,21,36,11,0,107
42015000420,623,490,459,2,3,17,2,0,31
42071000375,1870,1366,1212,71,25,11,47,1,154
42071000512,3077,2480,2209,132,66,22,54,2,271
42071000518,2199,1641,1410,86,55,19,75,0,231
42071001980,2334,1812,1582,125,47,23,39,2,230
42049000141,1214,1025,633,94,207,22,66,1,392
42049000161,2608,1910,1027,187,600,37,86,3,883
42049000390,1188,1019,662,58,222,36,44,2,357
42071000160,2294,1890,1603,164,108,16,29,0,287
42071001795,2713,2104,2001,36,29,16,12,0,103
42093000070,1096,814,791,1,2,17,1,1,23
42033000700,734,611,590,4,4,4,4,0,21
42109000080,557,440,417,9,7,5,2,0,23
42107000205,1464,1152,1039,63,18,30,3,0,113
42107000375,1242,983,916,35,13,11,12,0,67
42107001465,1108,885,840,18,17,8,7,0,45
42107001200,639,547,536,2,1,2,1,2,11
42107001650,1624,1274,1239,8,4,17,1,0,35
42107000260,408,335,324,7,2,0,1,1,11
42107000880,556,437,406,13,9,8,3,1,31
42107000870,414,329,310,7,2,8,1,1,19
42129000670,899,785,741,11,21,3,4,0,44
42043000039,1847,1443,1212,30,20,15,137,2,231
42043000127,1862,1605,1078,80,235,11,198,5,527
42043001240,3167,2509,1177,301,719,61,309,0,1332
42043000180,743,583,558,8,5,5,8,4,25
42129002005,2945,2394,2266,24,15,7,38,2,128
42129001400,305,255,142,4,98,7,2,0,113
42129001500,700,586,491,5,70,6,7,0,95
42129001420,813,688,620,17,36,5,4,1,68
42071000700,1715,1359,725,349,211,26,82,3,634
42043000950,710,525,248,55,205,19,18,3,277
42013000820,1004,755,727,4,4,11,11,0,28
42071001430,1343,1093,964,57,33,19,8,0,129
42043000079,1538,1326,913,264,90,19,52,1,413
42043000260,1479,1428,617,144,513,23,130,5,811
42119000030,2158,1610,1442,59,50,16,53,2,168
42013000350,889,753,720,14,12,4,4,0,33
42129001040,562,432,340,16,59,13,3,0,92
42129002570,351,280,257,0,4,3,0,1,23
42129000910,1401,1166,1102,18,16,19,3,2,64
42129000820,948,790,767,2,3,7,8,0,23
42129000130,900,750,711,1,4,11,7,0,39
42121000570,634,526,497,3,14,6,1,1,29
42121000680,637,510,484,1,3,12,2,0,26
42043001362,1382,1155,1073,16,26,5,23,0,82
42083000150,283,231,227,1,1,2,1,0,4
42049001492,1540,1233,1162,4,5,23,5,0,71
42129002820,717,604,564,14,7,4,4,0,40
42129001684,2205,1756,1557,35,33,9,113,5,199
42129001682,2122,1747,1571,14,27,8,109,2,176
42129001850,795,632,496,14,112,12,3,1,136
42019000660,2919,2258,2051,54,57,20,68,1,207
42039000560,857,698,666,2,2,19,1,0,32
42049000865,2262,1628,1471,39,19,13,76,0,157
42025000120,801,625,597,12,4,4,3,1,28
42011001487,2028,1728,1462,107,119,12,17,6,266
42011001574,2955,2194,1411,309,308,23,167,1,783
42011000540,1717,1329,918,317,79,24,14,1,411
42017000090,2821,2245,1233,158,223,28,600,2,1012
42017000885,3074,2682,2224,151,226,22,70,0,458
42017001560,1292,1018,899,51,17,17,30,0,119
42017000390,1252,994,720,115,79,21,52,2,274
42105000120,726,558,526,7,2,9,1,0,32
42015000350,1508,1144,1005,26,27,28,50,0,139
42037000275,1536,1190,1118,19,24,23,15,1,72
42005000015,1615,1264,1130,14,50,43,16,3,134
42051000110,1503,1206,1159,4,5,16,4,1,47
42015000580,818,673,618,10,5,17,10,3,55
42021001290,653,529,514,4,0,1,0,0,15
42013000431,1501,1198,1142,3,30,7,4,0,56
42013000321,1204,955,852,11,39,34,8,0,103
42037000130,2062,1754,1521,91,91,14,37,2,233
42037000520,1498,1198,1154,13,4,16,11,0,44
42005000480,1252,1009,958,7,14,15,1,2,51
42133000580,1368,1049,944,48,23,15,4,2,105
42133000910,1741,1384,1134,59,76,23,96,2,250
42019000750,182,139,136,1,1,1,0,0,3
42125000310,1029,880,860,8,6,1,2,2,20
42125001730,1539,1287,1225,18,22,5,7,1,62
42125000995,1172,954,859,15,49,14,13,2,95
42125000040,393,325,313,2,2,3,1,0,12
42133001310,1939,1404,625,430,348,43,20,3,779
42087000020,2829,2141,2058,27,12,19,13,0,83
42133001320,2615,1878,709,613,552,28,47,3,1169
42005000460,1167,992,958,4,8,12,1,0,34
42005000640,489,384,368,3,3,4,2,0,16
42119000170,1955,1530,1457,18,24,16,6,0,73
42133001330,2279,1463,403,651,448,52,8,3,1060
42095000700,2472,2020,1922,31,19,14,25,1,98
42095001150,919,743,657,47,18,5,11,1,86
42071000670,1216,1026,693,176,124,11,51,0,333
42071000970,2125,1879,1570,106,135,5,59,1,309
42071001987,2158,1785,1595,90,41,10,53,3,190
42071001995,3222,2407,2146,108,57,29,55,2,261
42071000840,1529,1070,356,455,232,22,63,1,714
42081000742,1653,1226,1028,25,135,26,4,2,198
42081000200,962,702,643,5,13,24,10,3,59
42081000360,461,361,342,6,0,12,0,0,19
42071000820,1537,1098,256,599,223,41,54,13,842
42071000925,1009,789,638,77,36,12,25,1,151
42103000070,1010,785,675,52,14,16,35,1,110
42103000015,3702,2959,2494,240,90,65,40,6,465
42125001200,639,524,503,6,1,5,2,2,21
42115000370,1513,1284,1228,9,3,16,9,3,56
42115000310,520,428,399,7,6,3,4,0,29
42005000060,817,680,660,7,0,10,3,1,20
42115000360,1133,896,837,27,1,18,4,0,59
42069000240,922,736,634,52,13,12,11,0,102
42069000245,1278,954,875,22,24,19,1,0,79
42069000810,1434,1104,1024,22,9,10,30,1,80
42071001574,2499,1844,1474,189,78,18,85,0,370
42071000930,1505,1351,859,345,175,12,16,0,492
42069001370,1565,1202,896,173,107,20,19,2,306
42069000565,804,673,616,27,10,8,7,0,57
42069000550,1001,826,780,20,13,7,9,0,46
42069000980,768,634,595,12,13,11,7,0,39
42069000970,542,438,412,10,10,3,3,0,26
42069001435,1658,1497,1324,65,52,18,40,2,173
42069002315,1423,1112,954,62,54,18,26,1,158
42037000285,5,4,3,0,0,0,1,0,1
42037000480,1271,1026,962,20,9,21,8,4,64
42005000392,2149,1684,1572,8,42,43,5,4,112
42069001760,965,740,420,133,85,11,115,0,320
42069001865,1606,1213,905,176,92,13,24,5,308
42069000380,296,223,204,8,8,6,1,1,19
42069000390,400,338,324,7,0,2,4,0,14
42091002480,1395,1117,965,28,48,12,56,4,152
42091001720,1348,1008,707,96,96,8,87,1,301
42091001880,3414,2670,2088,103,94,29,343,7,582
42091000115,1919,1420,405,76,872,31,59,1,1015
42091001470,1422,1099,851,44,64,14,130,3,248
42091002140,3049,2171,386,805,935,100,46,8,1785
42091003690,2338,1958,1182,179,466,32,104,10,776
42125001815,1074,878,601,22,209,26,29,2,277
42017002812,2877,2168,1768,57,54,21,257,1,400
42005000320,1392,1145,1093,2,16,23,1,0,52
42069000770,642,530,486,23,11,9,8,0,44
42069000800,227,184,173,5,4,3,1,0,11
42091002110,2621,2140,979,519,579,53,83,34,1161
42091001770,1485,1045,739,26,56,8,193,1,306
42091003640,1927,1626,1239,103,181,23,80,0,387
42091003025,1945,1524,1148,32,136,12,186,1,376
42091002060,908,661,588,21,9,1,42,1,73
42091003382,2347,1883,1622,38,58,7,150,3,261
42091001911,2371,1832,1558,73,69,15,109,0,274
42091001220,2611,2138,1374,157,210,12,371,0,764
42091002730,3035,2330,2143,57,35,35,50,2,187
42069000730,1178,978,745,40,35,5,139,0,233
42069002085,1657,1148,587,362,129,17,79,2,561
42105000010,228,201,196,2,0,0,2,1,5
42115000250,766,637,598,6,1,10,3,2,39
42125000950,20,19,18,1,0,1,0,0,1
42091001002,2243,1826,1332,75,79,31,308,2,494
42091000940,490,408,391,2,4,2,0,0,17
42091001092,212,162,134,2,7,10,4,0,28
42091001091,1029,831,672,26,45,11,71,2,159
42091002670,2638,2106,1887,74,60,7,61,1,219
42091000670,2111,1642,1242,67,249,17,74,0,400
42091000650,1059,850,318,28,400,11,94,0,532
42091000175,1012,765,652,18,64,16,19,1,113
42091000155,1803,1596,1341,41,135,10,77,2,255
42091003440,1765,1380,1010,150,110,18,95,1,370
42091003430,2302,1811,1253,145,175,33,203,2,558
42017001330,1878,1500,1311,43,50,14,68,2,189
42017002340,2234,1819,1674,57,18,15,34,2,145
42125000300,298,254,232,4,14,2,1,0,22
42125001560,832,685,650,7,4,12,4,2,35
42125001610,390,319,295,2,6,8,1,1,24
42123000040,410,326,315,0,0,6,0,0,11
42123000320,1276,1080,1003,14,12,29,11,1,77
42105000150,343,304,288,3,0,4,2,0,16
42065000550,504,368,351,4,0,7,0,0,17
42039000640,1849,1542,1448,19,38,14,4,1,94
42039000220,2070,1751,1624,11,53,18,33,0,127
42125001410,2214,1670,1513,23,19,18,92,0,157
42125000398,1385,1207,1095,19,50,9,23,1,112
42125001150,475,394,357,7,8,17,0,0,37
42125000910,643,528,494,10,17,12,0,0,34
42069001270,441,367,347,6,4,4,4,0,20
42069001250,629,533,514,1,4,3,6,0,19
42069001260,327,260,236,5,2,4,3,0,24
42069001935,3697,3503,2765,372,168,20,156,9,738
42069001725,1677,1244,656,288,168,11,140,0,588
42071000200,3914,3051,2836,89,31,44,32,0,215
42071002095,1986,1912,1847,14,9,13,19,2,65
42071001800,1828,1422,1371,26,4,9,9,0,51
42071001480,1543,1348,1123,92,82,17,42,1,225
42069002280,2748,2180,2027,39,41,43,22,0,153
42133001419,2101,1704,1496,56,80,12,56,0,208
42011000355,1416,1120,1008,52,36,8,16,0,112
42011000570,180,133,127,3,1,1,2,0,6
42069000940,476,386,368,3,7,5,3,0,18
42069000450,1493,1223,1099,70,31,11,12,2,124
42081000732,2009,1506,1240,45,148,39,27,6,266
42065000605,1368,1042,1006,5,2,13,3,0,36
42133000830,2497,1969,1728,88,86,26,37,0,241
42133001423,1984,1592,1404,49,74,10,44,0,188
42069002330,1482,1246,1124,47,28,16,17,0,122
42015000540,1018,772,729,9,3,19,5,1,43
4200300G470,705,578,499,20,45,6,4,2,79
4200300G540,755,641,606,4,17,5,3,0,35
42003003530,1119,899,634,14,218,20,7,0,265
42003004451,720,568,499,14,2,3,47,0,69
42003004100,617,491,356,14,43,9,54,1,135
4200300G940,832,611,22,15,561,11,11,1,589
4200300G110,1513,1135,896,17,13,4,202,0,239
42003000530,1009,822,745,9,11,5,52,0,77
42133001389,3197,2299,1831,72,155,26,196,3,468
4200300F210,961,804,789,6,0,2,4,0,15
42003002100,1369,1151,996,25,55,17,44,1,155
42041000300,1048,845,668,68,79,14,16,0,177
42071001820,2458,1868,1675,111,37,17,30,3,193
42011001305,1522,1170,476,567,150,39,15,7,694
42063000070,943,773,720,4,25,19,7,2,53
42111000200,415,317,304,2,1,5,2,0,13
42111000180,2263,1622,1588,5,2,16,3,1,34
42111000470,654,554,535,0,2,8,1,0,19
42133000420,3699,2909,2649,67,107,46,46,0,260
42133000840,5112,4347,3662,201,294,29,143,4,685
42133001406,1521,1222,1145,14,21,7,29,0,77
42111000150,1465,1262,1212,5,1,29,2,0,50
42111000540,1624,1267,1236,3,1,7,11,0,31
42111000380,469,388,376,2,0,4,1,0,12
42043000030,795,588,531,17,20,9,8,1,57
42043000970,810,585,256,72,235,12,23,1,329
42043000220,2842,1817,218,617,898,42,140,6,1599
42081000420,1128,873,822,8,8,11,12,4,51
42133001409,1624,1349,1221,28,40,26,29,7,128
42133000200,8337,6232,5400,267,382,109,115,9,832
42111000090,56,43,41,0,1,0,1,0,2
42111000270,813,639,625,2,1,8,0,0,14
42111000070,1224,959,919,15,9,7,5,0,40
42091001296,2965,2355,2012,75,128,28,105,1,343
42091001272,2950,2222,1859,45,143,32,138,3,363
42091001143,870,686,599,4,28,6,47,0,87
42091001144,434,270,137,22,22,2,88,0,133
42071000435,1689,1251,967,159,88,9,13,1,284
42041000191,2414,1901,1550,110,96,64,77,4,351
42091002210,2868,2205,790,359,941,66,75,4,1415
42091003011,2731,2284,1835,82,110,10,245,1,449
42083000040,948,734,679,14,16,11,9,1,55
42083000320,1768,1601,879,158,559,7,11,0,722
42085000010,576,472,459,2,5,3,0,1,13
42085000365,1165,968,873,15,55,11,12,1,95
42085001030,947,767,738,2,3,9,8,2,29
42085000822,1821,1296,653,35,547,42,24,1,643
42085000885,1171,939,893,8,23,7,4,0,46
42047000242,1181,937,866,10,9,23,12,0,71
42107000670,362,293,284,5,0,4,0,0,9
42107000585,1328,1019,831,147,25,10,8,3,188
42107000922,826,647,623,9,4,9,4,2,24
42107001210,721,574,554,16,6,1,2,0,20
42083000220,549,462,453,4,1,5,0,0,9
42083000170,1394,1143,1088,2,0,32,5,0,55
42071001530,3108,2393,2149,114,52,46,40,0,244
42071001350,2573,1983,1691,169,61,41,39,0,292
42071001750,1478,1075,977,38,25,10,22,0,98
42041000330,595,479,418,22,15,11,15,0,61
42049001200,1415,1102,975,17,37,20,47,1,127
42049000310,1022,845,605,57,134,30,23,0,240
42049000840,2624,2100,2010,23,15,16,28,0,90
42011001650,3014,2435,2214,60,66,25,40,2,221
42011000640,439,360,340,7,4,5,1,0,20
42011000110,905,700,579,77,20,13,3,1,121
42011000742,2158,1648,1127,402,105,47,25,1,521
42011000782,2541,1958,1247,486,196,18,39,8,711
42129002180,1986,1589,1537,8,8,11,5,0,52
42129000110,1368,1002,711,14,249,8,8,1,291
42129000520,2288,1976,1719,40,151,23,35,0,257
42049000860,1371,1080,991,15,23,11,19,0,89
42049000630,2580,2144,1773,51,136,15,155,0,371
42049001060,1659,1329,1267,8,5,23,5,1,62
42129001390,698,576,475,11,80,13,8,0,101
42101002906,324,211,15,11,189,0,1,0,196
42101006409,960,693,345,114,128,5,107,1,348
42101001310,570,460,5,35,422,12,5,1,455
42101005808,1518,1273,815,61,78,3,299,2,458
42101005823,1327,1087,606,73,52,4,341,4,481
42101006110,1263,959,38,203,458,13,282,0,921
42101006112,1261,938,23,98,813,14,24,0,915
42101003714,800,591,10,236,368,24,10,1,581
42101004505,1115,890,721,73,44,13,46,2,169
42101004520,1030,821,755,19,10,19,20,1,66
42101002903,950,846,487,52,272,17,30,1,359
42101002912,934,843,419,41,343,8,31,4,424
42129001935,1023,818,775,7,8,3,12,0,43
42129001740,592,460,251,23,175,18,2,0,209
42101004401,719,564,20,10,532,4,0,0,544
42101000911,1192,986,827,27,84,17,34,2,159
42101006203,886,645,205,201,236,8,11,4,440
42101005728,646,561,508,17,20,8,7,3,53
42101000203,766,639,353,85,68,9,134,2,286
42101000210,856,726,512,72,29,20,108,1,214
42105000330,401,355,348,3,0,1,1,1,7
42105000040,619,462,443,4,2,5,3,0,19
42011000440,2018,1591,1444,84,22,26,10,2,147
42011000140,2978,2235,2016,87,67,30,31,0,219
42011000384,2613,2035,1698,121,113,12,86,2,337
42011000520,1686,1429,1255,88,57,20,10,3,174
42039000410,281,225,208,1,1,5,0,0,17
42071000434,2584,1942,1185,315,292,39,144,1,757
42099000230,3098,2515,2354,49,20,46,30,1,161
42007000720,1874,1585,1461,23,34,25,11,0,124
42007000175,1320,1046,834,45,142,9,16,1,212
42051000730,1705,1390,1324,11,10,14,11,0,66
42051000840,831,657,631,1,3,13,1,0,26
42007001270,2197,1776,1695,20,9,24,4,2,81
42007000530,2127,1617,1433,39,68,24,32,0,184
42063000120,226,178,173,2,1,1,0,0,5
42063000600,56,42,37,0,0,3,2,0,5
42007001470,817,630,459,13,131,17,4,1,171
42007000705,2068,1757,1646,39,15,30,3,2,111
42007000570,2151,1744,1662,21,19,19,14,1,82
4200300G150,1208,894,770,26,3,5,78,0,124
42007000465,2245,1737,1665,13,17,22,11,0,72
42007000540,1547,1220,1087,28,63,16,20,0,133
42051001060,419,338,316,2,9,8,4,0,22
42003005460,795,628,145,12,467,8,8,0,483
42003007060,1324,1266,819,53,160,7,229,2,447
42003008120,581,506,165,16,294,11,22,2,341
42003000261,878,707,643,5,17,9,16,1,64
42003000171,1199,987,859,21,58,21,25,3,128
42003007700,768,711,596,23,54,6,35,0,115
4200300A100,362,268,101,5,148,7,11,0,167
4200300F585,1540,1338,1263,21,25,18,15,1,75
4200300E032,696,540,499,6,10,3,16,0,41
42003005600,652,554,373,13,164,2,9,0,181
4200300G580,984,799,679,8,56,8,44,0,120
42003009470,682,564,492,19,16,11,18,3,72
42003006210,2502,2447,1806,84,286,44,164,1,641
4200300E791,1045,853,745,20,44,29,16,0,108
42055000190,2041,1631,1494,32,60,23,29,0,137
4200300C240,584,485,411,16,39,13,6,0,74
4200300G420,1288,1078,987,11,59,13,8,1,91
42003002280,927,765,715,9,18,14,3,3,50
42003003236,1641,1111,629,58,25,8,394,0,482
42003003950,755,623,544,17,41,11,10,0,79
4200300E260,710,586,561,9,2,10,6,1,25
4200300F409,1487,1044,831,32,41,23,119,1,213
4200300F412,78,54,46,1,5,0,1,0,8
4200300E100,1394,1153,1058,11,55,6,15,1,95
4200300F580,798,678,630,7,21,15,2,3,48
4200300F190,604,498,474,2,9,5,1,0,24
42003001890,671,508,189,16,296,4,5,0,319
4200300B050,856,789,677,20,71,8,13,1,112
42003001471,1348,1068,935,29,76,18,16,1,133
42003004590,1049,798,674,30,25,10,47,1,124
42029000650,2620,1980,821,1025,84,80,35,1,1159
42067000160,631,505,483,7,7,8,3,1,22
4200300D500,711,550,404,10,90,8,45,0,146
4200300B410,730,671,618,11,28,7,10,1,53
42003004690,861,688,608,24,6,7,40,0,80
4200300E515,836,655,595,13,19,5,8,1,60
4200300F395,1560,1164,1073,7,11,17,52,0,91
4200300B190,875,701,478,90,114,17,11,0,223
4200300D600,482,345,63,27,244,13,12,0,282
42003004751,1164,897,460,45,355,19,35,0,437
4200300G370,606,531,524,2,3,0,2,0,7
42003000670,1096,884,767,8,71,21,12,2,117
42003000461,920,721,666,13,14,8,14,0,55
4200300F528,864,700,586,18,22,8,52,1,114
4200300F490,775,625,499,18,90,11,6,0,126
42003008790,309,245,7,3,235,0,0,0,238
4200300G850,803,638,528,7,19,1,77,0,110
4200300B450,720,594,533,12,29,5,10,1,61
4200300A700,423,336,41,18,272,9,5,0,295
42053000060,194,123,114,1,5,2,3,0,9
42003002170,1375,1150,1114,6,4,7,8,0,36
4200300E475,1284,1002,896,28,11,16,41,2,106
42003002881,648,504,183,6,282,7,29,0,321
42003001660,414,358,343,4,6,2,0,0,15
4200300G250,713,593,476,12,89,7,1,1,117
42003003840,690,549,377,28,124,12,2,0,172
42003007870,715,606,522,9,49,7,16,1,84
4200300D660,993,737,396,30,271,15,31,0,341
42003000540,950,765,682,11,29,6,31,0,83
42003004311,1773,1385,1262,38,38,10,31,1,123
4200300B780,1337,1055,481,22,379,21,151,2,574
42003000295,1272,1055,945,18,48,2,17,0,110
4200300G490,1653,1272,983,43,183,23,35,0,289
42003001240,476,377,74,3,289,11,8,1,303
42003001250,433,336,116,3,210,8,3,0,220
4200300A970,642,612,546,18,28,11,12,0,66
4200300A870,658,610,555,8,20,3,21,0,55
42003004010,936,757,619,13,105,11,15,0,138
42003006685,913,798,686,20,45,6,33,0,112
4200300A600,552,509,416,25,52,8,16,0,93
4200300A620,529,522,443,21,29,8,18,2,79
4200300G100,822,609,550,24,13,5,17,0,59
42127000080,819,635,609,13,1,4,5,0,26
42003000631,1454,1255,1046,16,74,13,94,1,209
42013000580,205,168,167,1,0,1,0,0,1
42055000120,2013,1514,844,424,231,33,13,1,670
42031000480,982,781,742,3,1,21,2,0,39
42019000590,573,481,462,7,0,6,2,0,19
42101000610,603,450,46,16,372,14,20,1,404
42101004049,900,729,156,10,409,5,160,0,573
42101004042,923,753,53,31,654,8,23,0,700
42101004001,755,562,65,20,362,6,122,3,497
42003004255,1050,825,751,5,36,8,13,0,74
42003002180,2262,1648,1442,55,64,17,45,0,206
42003001302,1667,1372,1312,5,13,6,32,0,60
42127000200,678,573,545,7,0,11,0,0,28
42065000145,1271,1037,1001,5,1,24,5,0,36
42055000380,473,335,321,3,0,2,3,0,14
42101001816,1130,964,586,235,77,5,65,2,378
42101003610,661,558,241,34,274,11,22,0,317
42101004515,1159,966,853,64,24,13,17,3,113
42101001411,461,382,37,40,301,6,8,0,345
42101004414,673,546,23,36,491,14,12,0,523
42101001615,601,337,3,10,317,10,4,0,334
42101003507,1365,1048,354,225,411,3,75,4,694
42101003802,787,633,10,19,603,11,8,4,623
42101003804,751,597,7,20,570,11,5,0,590
42127000370,1297,1023,960,16,5,22,7,0,63
42127000020,1178,970,924,25,3,9,9,0,46
42013000840,1530,1219,1168,9,5,22,8,0,51
42117000291,547,420,389,3,3,20,0,0,31
4200300E200,699,624,592,5,11,7,3,2,32
42053000050,413,342,325,0,0,10,0,0,17
42027000790,2358,2175,1766,111,95,18,186,8,409
42027000020,1170,999,944,12,18,12,10,1,55
42027000582,1915,1572,1482,22,26,10,14,2,90
42127000280,237,192,183,3,0,0,1,0,9
42003004130,1275,1077,961,6,85,6,18,0,116
4200300F331,865,742,593,17,97,13,18,4,149
4200300H111,1101,1006,510,18,429,19,40,1,496
42003008260,706,611,446,20,85,8,50,2,165
42003002870,330,256,39,2,206,4,5,0,217
4200300F398,3394,2166,1379,31,36,10,703,1,787
4200300F399,121,77,68,3,3,0,0,0,9
42003000565,1199,948,880,30,10,8,21,2,68
42003000493,1346,1104,1045,10,14,4,14,1,59
42003001292,1710,1377,1296,15,37,10,10,1,81
42003005610,754,623,467,15,125,19,1,0,156
4200300E525,948,759,682,15,19,21,16,1,77
42003002150,1012,862,782,15,23,14,19,0,80
42003005490,1070,950,708,16,206,7,14,0,242
42003002221,761,673,577,6,70,0,7,2,96
4200300G621,1006,808,749,12,20,15,17,4,59
4200300E020,756,654,556,2,71,0,19,0,98
42131000140,326,244,219,21,2,2,0,1,25
42053000030,468,411,393,7,1,8,3,1,18
42095001180,1156,946,890,25,10,7,6,0,56
42095001190,1100,876,817,16,5,18,15,0,59
42113000020,416,328,317,0,1,7,0,0,11
42113000050,549,473,460,3,0,7,0,0,13
42131000190,232,185,166,4,0,6,0,0,19
42003001341,727,622,458,41,101,18,2,0,164
42003002211,665,579,503,19,38,2,13,0,76
4200300F220,783,618,594,5,11,2,7,0,24
4200300H051,1140,998,411,24,555,17,15,0,587
4200300E695,2279,2056,1717,51,106,24,143,0,339
42003001561,1361,1181,1042,38,52,19,32,0,139
42003001780,246,166,43,0,120,1,0,0,123
42003000750,1093,919,501,26,387,7,6,0,418
42003002268,1027,834,518,22,257,14,19,3,316
42003002350,1928,1454,1097,24,27,9,282,3,357
42003002351,2200,1666,1161,20,14,7,447,1,505
42003002360,1896,1294,829,11,6,10,428,2,465
42003004680,697,509,465,12,4,4,20,1,44
42003008430,955,840,381,44,362,16,47,3,459
42003005110,876,714,586,15,87,18,6,0,128
4200300E425,1053,804,749,12,6,10,30,0,55
4200300E435,698,604,565,2,14,8,14,0,39
42003001790,725,562,266,12,273,18,5,0,296
42003003471,871,617,287,9,310,9,5,1,330
4200300D930,833,667,609,21,18,7,6,0,58
42003001998,2138,1718,1582,19,58,21,17,6,136
42003004140,907,743,625,23,39,16,36,0,118
42003002631,1034,812,777,13,4,3,11,0,35
42131000200,1406,1164,1105,7,2,15,1,1,59
42003007680,773,698,603,14,50,2,25,0,95
4200300G080,1024,786,684,9,14,3,73,0,102
42017001680,2125,1715,1461,58,54,15,99,0,254
42017000535,2311,1833,1520,151,87,32,43,5,313
42101005617,1235,931,479,101,155,10,121,2,452
42101003605,617,530,210,21,270,12,28,0,320
42101000802,883,771,665,33,30,8,34,0,106
42101001301,892,662,28,30,592,15,13,2,634
42101003810,739,580,51,12,506,9,16,1,529
42101003944,1072,842,448,71,20,5,299,2,394
42003002560,1594,1288,1172,22,30,3,50,3,116
42003009450,789,661,568,28,27,8,21,3,93
4200300D010,857,662,343,13,265,32,20,3,319
42003000821,1107,880,704,23,100,13,40,0,176
4200300D520,853,657,532,21,87,16,6,0,125
4200300D090,655,558,240,6,298,11,5,0,318
42101003436,606,437,2,4,429,9,4,0,435
42017001790,2883,2305,2093,48,45,21,88,2,212
42017002090,2140,1650,1495,40,5,13,87,1,155
42001000280,997,809,759,11,5,15,10,0,50
42003003540,820,610,346,17,222,13,4,0,264
42003004420,1466,1054,962,32,8,4,35,0,92
42101003429,919,709,66,13,616,13,18,0,643
42101001118,613,472,5,18,445,9,9,1,467
42101004810,790,624,255,43,181,16,151,2,369
42101005030,742,594,8,17,568,8,7,0,586
42101001029,693,579,0,17,565,7,8,5,579
42101004523,1019,801,741,21,20,5,5,0,60
42101002113,860,770,679,33,44,4,14,1,91
42101004210,1157,840,34,454,271,10,124,7,806
42101000230,785,696,534,52,58,12,50,0,162
42101003702,813,680,168,54,386,18,72,1,512
42101004506,1130,914,762,65,44,24,20,7,152
42003000031,810,620,502,11,28,3,73,0,118
4200300A080,628,437,148,7,260,8,16,0,289
42003009170,936,719,578,22,22,6,85,2,141
42003009860,873,746,575,41,50,5,70,0,171
42003002421,979,737,600,18,91,28,0,0,137
42003005386,3096,2153,1889,42,72,20,96,5,264
4200300F417,1013,768,688,10,25,4,35,0,80
4200300G440,1010,834,733,8,75,5,7,1,101
42003001641,770,645,514,8,82,15,1,2,131
42101002723,1105,977,664,47,79,5,160,0,313
42101000402,1087,773,9,16,748,7,6,0,764
42101002123,1960,1854,995,122,536,47,184,8,859
42101002124,1118,936,569,46,263,7,49,1,367
42101003915,947,778,712,31,17,9,12,0,66
42101000836,1164,1027,641,133,149,16,76,0,386
42101000838,1048,995,640,59,157,6,131,2,355
42101002120,864,735,584,33,76,1,37,3,151
42101002132,726,610,472,26,75,6,33,0,138
42101002140,1222,1026,745,30,174,4,66,0,281
42101002122,1458,1233,980,40,118,11,71,1,253
42101003213,399,285,8,17,248,4,14,0,277
42101003117,649,540,449,36,31,5,26,0,91
42101002301,807,563,131,207,226,19,8,5,432
42101004020,884,613,20,45,456,6,93,1,593
42101002137,905,755,616,30,87,4,26,5,139
42101002401,1228,1141,720,84,153,13,170,0,421
42055000310,2616,1913,1717,68,74,32,26,0,196
42055000305,4064,3056,2569,253,154,53,35,1,487
42017002783,2889,2192,1797,41,46,10,273,3,395
42017002825,3259,2585,2325,54,23,18,149,0,260
42029000520,896,635,541,21,17,1,47,0,94
42029001860,1614,1303,1200,30,22,6,34,1,103
42107001515,1972,1509,1351,103,24,22,11,1,158
42107001165,1386,1126,1027,44,32,8,13,2,99
42029001710,2251,1797,1655,61,32,15,24,1,142
42029000610,3333,2500,1664,599,149,37,63,2,836
42029001270,1268,943,708,31,27,5,117,0,235
42101002101,1088,965,769,58,70,15,62,1,196
42101000107,900,675,220,211,68,11,163,5,455
42101000116,824,694,375,103,71,20,149,1,319
42101004502,1119,824,429,241,124,28,21,3,395
42101005203,678,636,258,25,167,12,168,8,378
42091001650,1489,1319,1060,35,84,7,107,3,259
42101006211,1295,936,136,303,508,8,3,0,800
42101003012,859,734,435,42,162,8,84,0,299
42101004106,1122,823,296,265,237,26,29,1,527
42101001202,789,542,15,17,502,12,1,1,527
42101002109,1008,927,786,35,54,14,29,0,141
42101002408,1660,1525,563,111,490,28,355,7,962
42101002323,785,601,149,219,263,6,8,1,452
42101004114,958,709,363,124,190,7,28,0,346
42101006401,1116,863,517,134,189,17,29,0,346
42101002306,1644,1192,219,299,651,16,54,7,973
42091003800,2146,1668,1468,40,73,14,77,0,200
42091001108,1976,1536,1196,123,121,28,86,2,340
42011001448,1553,1287,1234,20,12,4,9,0,53
42001000160,526,429,410,7,6,7,2,0,19
42079002292,2082,1548,1337,49,15,26,126,0,211
42079002294,1550,1237,1093,28,23,3,82,0,144
42061000150,922,754,732,3,3,8,0,2,22
42061000250,437,395,383,3,3,3,0,1,12
42061000390,419,307,282,1,9,10,1,0,25
42079002805,2536,2098,1169,597,288,33,71,2,929
42079001645,1789,1441,1253,99,76,29,5,0,188
42079001740,1081,867,833,7,6,17,2,3,34
42101005507,1203,881,405,230,220,7,31,0,476
42101001507,1689,1520,844,97,431,31,133,5,676
42101002505,862,695,609,36,22,10,25,1,86
42101004310,530,397,11,20,351,9,7,0,386
42101004309,753,589,50,63,428,9,54,0,539
42101003817,1176,1021,322,50,558,6,107,3,699
42101000413,1076,778,9,23,744,15,4,0,769
42101005118,780,579,7,11,558,4,5,0,572
42101005011,605,483,17,9,461,1,3,0,466
42101004521,854,599,189,237,164,12,11,0,410
42101002007,956,861,490,38,320,7,28,1,371
42101000117,984,812,615,56,53,6,85,2,197
42101001410,1069,877,357,57,389,16,77,2,520
42101005419,914,700,176,175,63,5,272,0,524
42101001212,821,622,18,36,579,6,4,2,604
42107000250,670,509,491,8,1,6,4,0,18
42107000535,3192,3045,1486,333,1199,3,21,1,1559
42107001300,1172,932,860,26,22,3,18,1,72
42101004224,1274,969,63,284,479,19,173,2,906
42101000906,968,788,684,23,51,1,21,0,104
42101003924,1313,1012,443,112,131,21,315,6,569
42101003918,801,573,181,192,47,13,159,0,392
42101001810,1095,981,799,68,41,12,49,1,182
42029000770,1358,1086,993,24,14,17,26,0,93
42029001420,1034,817,764,25,3,11,10,3,53
42035000110,7,7,6,1,0,1,0,0,1
42091001280,2255,1755,1243,157,123,24,199,8,512
42091001460,1832,1345,1060,60,45,9,157,0,285
42091001012,3243,2600,1489,335,224,28,521,5,1111
42091001725,1386,970,799,34,50,1,78,0,171
42091002810,1903,1450,1332,28,42,7,40,2,118
42079003015,1655,1250,643,351,258,32,15,3,607
42079001165,1329,1116,1048,20,20,11,14,0,68
42101000405,920,652,9,14,631,3,5,2,643
42101005607,1219,898,574,114,147,3,44,0,324
42101006621,1530,1195,916,108,84,13,72,0,279
42101005317,1048,778,262,179,163,16,160,3,516
42013000240,1673,1364,1121,30,156,26,14,0,243
42035000180,1356,965,875,17,15,28,15,0,90
42035000230,878,587,573,1,3,4,2,1,14
4200300F570,845,700,655,11,5,10,1,0,45
42003002090,1156,884,762,22,63,21,18,0,122
42003005170,1001,719,229,17,456,13,11,0,490
4200300G690,1084,964,857,9,83,10,4,2,107
4200300F000,853,650,302,8,15,0,324,0,348
4200300F070,689,532,484,8,15,1,18,0,48
4200300D030,767,580,254,3,307,6,9,1,326
4200300C580,545,419,147,18,248,5,3,0,272
4200300B920,684,502,135,11,345,6,15,0,367
42003001110,761,677,529,11,106,16,17,1,148
42003001140,799,667,528,5,100,8,24,2,139
42003001120,851,735,532,22,148,11,24,0,203
42003002305,674,567,535,8,9,9,2,0,32
42003002291,894,732,686,5,15,11,3,0,46
42101003712,482,367,6,34,325,8,8,0,361
42117000150,1827,1406,1321,17,21,34,2,1,85
42131000040,625,534,509,6,0,11,0,1,25
4200300F790,504,423,179,20,205,12,11,3,244
42003000576,1747,1451,1290,42,24,9,72,0,161
42003004730,630,523,441,20,18,4,35,1,82
42111000630,247,201,195,0,0,1,2,2,6
42073000900,18,15,14,1,0,0,0,0,1
42073000020,1082,910,836,14,14,16,6,0,74
42101005718,1060,874,677,66,90,6,26,3,197
42101001404,1005,761,80,35,601,13,37,1,681
42101003927,1040,858,544,129,27,7,150,0,314
42101006008,697,574,150,33,363,7,22,2,424
42101000219,870,707,459,32,146,4,61,1,248
42101000404,779,558,3,23,550,2,0,2,555
42101000711,1229,847,52,669,149,18,14,0,795
42101003114,725,617,525,37,29,10,21,0,92
42101003113,673,561,478,41,19,6,22,0,83
42101005611,1131,844,495,91,90,11,113,0,349
42101004819,750,597,184,21,84,0,310,0,413
42101004706,903,818,364,58,315,1,83,0,454
42035000340,411,330,319,5,4,2,1,1,11
42041000110,2220,1836,1690,48,45,22,38,1,146
42041000170,1576,1286,1207,33,13,17,8,1,79
42041000160,3718,3028,2828,59,41,43,36,0,200
42075000430,1496,1192,1107,43,13,21,6,4,85
42075000270,3013,2211,1351,770,105,33,14,8,860
42003007620,711,650,547,33,24,6,37,0,103
42003005440,181,161,4,3,154,1,0,0,157
42009000380,286,239,228,2,0,7,0,0,11
42113000090,374,312,307,0,1,2,1,0,5
42077000650,1780,1438,1111,214,63,9,35,0,327
42077000690,1855,1705,1324,203,108,22,45,4,381
42077000870,3853,3008,2378,284,154,38,180,0,630
42011000051,2333,1766,1536,61,77,26,60,0,230
42011000490,1735,1350,975,269,92,15,30,2,375
42011000910,2682,1941,390,1223,387,63,43,6,1551
42101000504,1431,1233,968,38,62,7,129,1,265
42101000229,926,728,610,27,32,10,49,1,118
42049000540,1842,1372,881,89,259,26,101,3,491
42049000010,1528,1151,1089,16,4,25,6,0,62
42011001502,2070,1626,1223,249,117,20,35,6,403
42011000399,2159,1762,1472,142,98,18,37,0,290
42075000332,2860,2027,1290,494,160,13,92,2,737
42075000334,1769,1426,1285,64,27,11,40,0,141
42075000400,2607,2045,1761,114,58,33,64,0,284
42075000020,1642,1329,1165,101,27,21,16,2,164
42077000370,1441,1096,374,560,177,40,29,2,722
42077000240,1858,1345,449,685,297,32,5,0,896
42077000040,2561,1930,407,1139,474,50,25,6,1523
42075000180,1125,803,255,487,68,12,18,3,548
42077001240,2565,2030,1704,108,44,18,147,1,326
42077000960,746,577,534,20,8,7,4,0,43
42077000740,1478,1199,983,124,66,12,24,1,216
42077000928,3010,2351,1941,138,120,28,145,1,410
42077001330,4115,3456,3236,110,38,39,12,2,220
42077000200,2452,1681,245,1222,264,43,32,9,1436
42077001440,1884,1581,1270,155,118,24,30,4,311
42077000760,2148,1694,1354,205,79,24,40,0,340
42077000922,2614,1955,1494,112,101,21,217,0,461
42077000180,3832,2927,676,1700,652,69,54,13,2251
42077000892,2893,2230,1889,107,84,10,143,0,341
42077001340,1206,1004,918,38,13,21,7,0,86
4200300G090,1199,914,753,13,20,7,115,0,161
4200300G120,1414,1057,959,18,14,14,42,2,98
42003008870,334,252,8,3,238,7,1,0,244
42003007240,1143,1107,419,39,49,0,598,1,688
42003008200,987,856,501,34,257,10,39,1,355
42003002740,841,720,689,4,16,3,5,0,31
42003005730,673,581,516,15,44,7,2,0,65
4200300E625,1395,1215,1060,11,57,8,66,0,155
42003002381,1161,950,898,10,13,25,8,1,52
4200300G240,763,673,580,10,68,7,5,0,93
42029000490,1582,1304,1092,55,71,4,87,0,212
42029000222,3141,2300,1484,132,134,23,513,1,816
42029000225,2243,1807,1274,54,152,9,292,2,533
42131000110,1136,928,893,7,6,8,7,0,35
42011000150,2260,1817,1702,56,30,11,16,0,115
42011000470,1843,1508,1400,54,22,20,9,1,108
42005000730,1192,987,951,6,8,10,5,0,36
42029001818,1275,970,784,49,81,15,44,2,186
42029001880,1136,926,817,30,24,10,32,0,109
42029001600,2459,1845,1604,177,26,33,14,1,241
42063000110,999,772,753,5,0,7,2,0,19
42063000450,3168,2978,2386,141,343,18,105,1,592
42029001850,906,701,644,14,9,5,23,0,57
42081000530,1047,814,778,5,11,20,1,0,36
42063000330,256,194,185,1,4,2,0,0,9
42125000700,516,408,357,4,39,5,1,0,51
42045002710,782,600,540,3,18,6,27,0,60
42045001870,1044,917,816,7,11,7,69,0,101
42045001000,1482,1159,221,72,763,12,105,0,938
42045000829,1500,1087,904,28,17,6,129,0,183
42045002780,1179,899,777,17,33,7,62,0,122
42045003240,848,657,544,16,64,6,26,1,113
42045003260,2469,1997,1134,36,532,15,283,3,863
42045002530,1958,1551,1372,36,76,16,46,1,179
42045002570,1833,1458,1205,40,160,23,28,1,253
42017001280,2951,2211,1810,54,42,8,279,0,401
42017001040,1745,1379,1187,63,50,11,65,0,192
42017002130,2842,2224,2049,63,34,22,33,4,175
42045000280,466,330,16,39,277,5,2,0,314
42045000270,2058,1916,1265,125,468,12,57,2,651
42045000200,770,616,225,35,347,9,14,2,391
42045000485,522,360,13,42,312,5,0,1,347
42045000495,643,450,7,8,436,0,0,0,443
42045000510,746,574,16,26,521,5,4,0,558
42045000572,1417,997,74,292,633,13,5,0,923
42045000562,895,625,36,157,438,14,14,3,589
42045000060,1992,1617,1495,23,51,6,26,0,122
42045000960,1262,922,31,25,865,4,3,0,891
42045000930,1379,1071,267,117,677,14,34,3,804
42045001330,982,754,686,9,32,0,21,1,68
42045002660,1831,1492,1282,45,92,22,45,1,210
42045003880,767,622,26,23,564,18,6,1,596
42045003940,899,741,64,16,656,15,10,2,677
42045003900,1252,988,40,21,918,12,8,2,948
42045003850,1785,1370,1175,42,73,12,64,2,195
42045001290,1580,1170,969,32,71,11,91,0,201
42045001200,1010,754,614,27,58,12,33,1,140
42033000220,494,434,423,4,1,4,3,0,11
42027000450,1066,899,797,27,22,32,13,0,102
42027000080,1119,923,885,8,4,10,7,0,38
42089000204,2669,2211,1593,226,282,46,73,2,618
42095001100,1550,1291,1190,44,17,13,13,0,101
42095000520,1987,1439,568,464,384,28,47,0,871
42043001082,2603,1798,731,303,758,30,19,4,1067
42043000940,1648,1314,840,147,242,20,80,3,474
42107000135,2524,2248,1280,236,740,5,11,0,968
42107001115,1504,1131,971,52,85,29,7,0,160
42025000015,1164,943,840,79,18,8,5,0,103
42025000240,1642,1371,1235,64,24,21,16,0,136
42025000230,1998,1498,1358,66,23,26,10,1,140
42071001490,2979,2822,2218,176,352,21,73,4,604
42071000630,1352,1047,299,502,240,29,30,4,748
42043000063,1562,1203,926,96,95,27,70,0,277
42021001840,613,508,472,6,18,7,5,0,36
42021001555,1239,1080,961,15,38,11,40,1,119
42071000890,1894,1480,707,527,205,27,90,4,773
42071000900,1876,1469,489,645,303,37,70,2,980
42043000660,1774,1397,478,158,504,12,269,1,919
42043000320,1982,1370,150,283,951,38,19,2,1220
42043000651,1040,855,690,37,68,18,43,3,165
42045001390,1459,1104,934,20,63,8,70,2,170
42045002310,1504,1182,1014,34,60,13,55,0,168
42045003073,2882,2450,1980,56,269,23,129,1,470
42045001015,1925,1578,1474,20,34,6,42,3,104
42045001005,2358,1931,1696,49,40,13,122,3,235
42133001260,2645,1873,643,663,610,68,13,2,1230
42021001880,412,312,299,3,0,4,0,0,13
42021001155,965,745,611,24,93,16,0,1,134
42133000470,1426,1050,922,39,55,15,14,0,128
42133000330,3517,2808,2367,245,96,56,36,0,441
42019000180,1037,852,801,8,11,12,12,0,51
42085000500,582,485,471,1,1,6,2,0,14
42085000550,1405,1122,1065,21,3,13,5,5,57
42085000650,2539,2053,1914,23,27,44,26,0,139
42085001020,945,761,743,4,1,2,1,0,18
42049000580,2661,2475,2174,102,123,24,60,1,301
42125001240,957,791,752,6,9,14,3,1,39
42125002010,467,361,350,1,1,10,0,0,11
42125000830,579,468,425,0,19,17,0,0,43
42133000770,480,381,343,8,3,8,3,1,38
42049000660,815,623,329,86,170,14,26,0,294
42049000600,1028,809,707,11,52,10,29,2,102
42085000895,1310,1026,944,14,32,12,6,1,82
42005000270,466,408,389,1,5,13,0,0,19
42043000380,2532,1933,647,340,939,51,57,3,1286
42043000580,2698,2082,1026,277,580,42,199,6,1056
42097000355,937,786,757,12,8,7,2,0,29
42097000180,783,612,595,3,1,5,2,0,17
42021000720,576,480,460,4,0,5,0,0,20
42021000730,252,210,206,0,0,3,1,0,4
42021001301,1113,888,859,8,6,6,2,0,29
42021000710,3408,2816,2729,19,21,32,5,0,87
42005000410,824,673,654,4,1,7,0,0,19
42125000392,1461,1239,1135,20,37,16,17,0,104
42133000350,3128,2558,2112,253,94,55,36,5,446
42123000310,276,220,209,1,0,4,4,0,11
42125000790,371,322,301,5,10,4,1,0,21
42013000770,806,640,610,9,2,11,1,1,30
42115000170,1174,915,857,16,7,26,9,1,58
42037000260,902,766,741,7,2,5,5,2,25
42085000300,1107,847,804,5,8,12,15,0,43
42005000440,1934,1574,1505,12,14,24,9,0,69
42037000030,823,606,567,15,6,12,6,0,39
42095000730,2234,1794,1719,33,11,16,5,2,75
42027000240,2261,1806,1741,15,1,25,16,1,65
42027000550,584,467,450,4,1,9,2,0,17
42027000150,1779,1611,1252,90,70,8,142,7,359
42027000460,845,663,618,12,5,12,6,0,45
42027000560,670,540,523,4,1,11,0,0,17
42095000310,3119,2480,1336,684,244,33,250,7,1144
42095000170,1069,828,510,207,87,23,16,2,318
42095000280,1920,1573,1105,325,106,15,39,5,468
42095000440,1124,849,764,46,18,9,11,0,85
42017001940,1563,1313,1263,20,7,17,3,2,50
42017002520,1169,993,929,36,10,4,11,0,64
42017001430,1990,1576,1363,74,41,13,79,0,213
42033000190,425,333,313,5,2,11,0,0,20
42095000190,2210,1739,1088,443,176,26,33,2,651
42091000950,1297,1010,887,59,40,16,24,1,123
42091002050,2248,1694,1454,50,70,16,98,2,240
42091000265,1036,793,653,30,65,16,39,1,140
42017001320,1453,1090,1002,28,7,4,35,0,88
42125000930,1103,923,871,13,8,15,6,0,52
42043000670,2177,1709,1003,115,347,19,238,1,706
42071000480,3481,3015,2620,151,109,48,70,6,395
42095000850,1853,1520,1411,57,17,19,7,1,109
42095001350,2820,2320,2111,87,55,35,30,0,209
42017002245,2725,2206,1957,111,33,42,48,2,249
42017002237,2961,2345,2131,86,41,28,50,1,214
42017002370,1639,1431,1317,31,34,23,18,1,114
42017001990,2628,2016,1843,34,11,9,99,1,173
42017002450,2312,1850,1678,38,6,16,89,0,172
42017000040,3032,2452,1605,194,247,38,392,3,847
42017000445,2217,1592,586,192,770,25,35,0,1006
42017002000,2689,2110,1958,41,17,12,59,1,152
42017001187,2543,1905,1668,74,59,17,61,1,237
42017001970,1752,1430,1319,29,18,9,47,2,111
42017001470,2183,1659,1352,71,64,25,143,5,307
42017002380,2199,1832,1517,125,66,17,127,1,315
42017001180,2193,1826,1694,42,13,15,27,0,132
42017002323,1762,1478,1294,43,39,12,78,0,184
42109000060,2213,1739,1679,12,11,26,4,0,60
42119000120,811,685,587,23,28,14,31,3,98
42097000270,560,455,442,6,1,4,0,0,13
42097000530,2274,1868,1766,46,36,17,3,0,102
42097000510,1229,965,879,52,5,17,6,3,86
42069001875,1274,983,669,225,74,15,18,4,314
42069001575,1087,858,551,173,94,23,34,2,307
42043000170,1357,1102,1012,32,20,20,26,0,90
42043000240,1891,1280,188,490,592,46,28,3,1092
42071000390,2067,1734,1411,161,52,17,92,1,323
42071000310,3519,2636,2459,81,54,16,37,1,177
42017000250,2088,1736,1263,157,172,21,140,3,473
42017000320,1506,1182,977,99,46,20,36,2,205
42017001210,2960,2384,2184,58,39,12,55,2,200
42069002252,2058,1586,1343,58,51,9,103,0,243
42069002140,2419,1978,1775,93,47,19,40,1,203
42069001535,1806,1368,937,292,124,24,12,10,431
42069001525,1772,1324,921,218,159,31,11,2,403
42121000030,937,792,755,3,10,12,0,1,37
42039000360,1991,1217,1182,7,2,7,1,2,35
42129000430,883,748,712,4,6,2,14,0,36
42091001989,5277,4233,2551,130,337,19,1167,1,1682
42091002220,2457,2005,1078,223,632,35,66,2,927
42129000340,681,513,479,4,12,12,1,0,34
42129000150,384,336,323,0,7,5,0,0,13
42129001180,1290,1079,1049,10,0,11,2,0,30
42129001210,721,627,606,7,5,4,1,1,21
42107001075,1741,1398,1184,83,92,21,20,0,214
42091001295,3113,2265,2014,61,55,14,109,3,251
42091002570,1492,1068,507,97,422,33,34,4,561
42091002590,1797,1246,750,125,355,20,21,4,496
42091003780,2384,2032,1680,70,115,32,121,0,352
42091000800,913,754,715,21,8,0,8,1,39
42091000810,2113,1779,1717,29,9,13,14,0,62
42091000630,1180,928,502,52,266,23,97,0,426
42091000410,2369,1827,1341,136,266,13,73,0,486
42091002620,3048,2401,1869,148,327,33,28,3,532
42091001680,1752,1442,1057,84,191,23,98,0,385
42091000390,1826,1369,922,91,254,24,89,3,447
42129000120,255,227,221,2,1,1,4,0,6
42129002050,1980,1671,1613,15,7,17,9,0,58
42033000660,886,749,719,6,2,16,3,0,30
42129002430,674,560,540,6,7,5,0,0,20
42129002450,700,578,547,1,6,12,3,0,31
42129000650,672,550,505,9,23,7,6,0,45
42129001450,293,230,116,8,98,1,1,0,114
42017001060,1867,1420,1167,115,53,34,53,0,253
42017000930,1080,952,878,22,12,10,23,2,74
42017002770,3136,2620,2126,173,106,39,193,1,494
42017001640,5209,4146,2622,313,698,48,489,5,1524
42005000630,1006,830,802,0,3,9,1,1,28
42037000535,1011,819,784,5,3,10,4,0,35
42071000950,1216,1018,776,115,78,19,44,1,242
42129002290,1729,1441,1370,12,11,16,12,2,71
42129002500,411,337,327,1,3,5,0,0,10
42129001730,671,514,490,1,5,15,2,0,24
42107001320,1191,975,920,9,15,13,13,0,55
42107001225,1540,1301,1258,18,5,2,6,0,43
42015000610,1573,1264,1177,20,11,31,7,1,87
42129000960,519,431,399,7,14,5,4,1,32
42107000480,1748,1392,1346,13,6,11,9,0,46
42091001287,3210,2587,2089,61,143,15,270,3,498
42091000780,1156,975,866,40,35,13,23,0,109
42091003658,1858,1521,1381,20,27,7,73,1,140
42091000230,1722,1359,1109,63,104,26,55,2,250
42091000075,1584,1186,974,54,37,14,104,0,212
42091000400,2291,1859,1289,258,185,27,103,3,570
42091003100,1073,778,644,17,54,8,48,1,134
42129002110,917,753,689,13,13,25,10,0,64
42129002600,694,566,557,1,2,4,0,0,9
42013000590,1676,1226,1184,10,4,14,6,0,42
42069000820,2260,1814,1755,21,7,10,8,1,59
42069000790,625,483,455,10,4,5,3,0,28
42069000780,844,649,574,39,10,19,5,1,75
42069000010,1856,1422,1275,27,6,7,85,1,147
42083000420,1436,1132,1087,7,3,9,7,0,45
42027000690,866,752,662,33,23,4,30,0,90
42027000810,1367,1114,1074,12,2,15,3,0,40
42129002125,1023,846,809,3,13,12,3,1,37
42041000239,2874,2137,1323,64,72,18,652,1,814
42125000765,680,555,440,18,75,9,0,2,115
42083000290,1289,1062,1022,10,6,7,6,0,40
42091000310,1300,977,843,31,58,5,31,0,134
42025000180,1857,1420,1241,83,49,34,4,3,179
42115000340,488,397,359,18,2,5,2,1,38
42109000270,1086,817,803,6,0,1,2,1,14
42011001558,1712,1550,1345,79,50,7,73,0,205
42129002350,740,593,556,8,18,5,0,0,37
42091000095,2322,1921,1483,85,180,14,144,4,438
42091001923,2390,1938,1685,62,78,6,97,1,253
42081000210,1075,813,778,8,11,7,7,2,35
42081000540,643,501,466,13,2,12,5,0,35
42111000010,931,762,736,9,0,9,4,1,26
42097000500,1420,1137,1025,57,17,24,9,1,112
42097000210,989,759,722,11,5,7,10,0,37
42071000327,2029,1551,1348,72,37,16,82,0,203
42049001250,2047,1617,1484,34,39,25,36,0,133
42049001180,1352,1091,1009,21,26,19,11,0,82
42129000560,2549,2054,1864,22,92,29,39,3,190
42129001590,2004,1656,1538,19,31,21,16,0,118
42129001060,1760,1379,1208,15,112,31,6,4,171
42129001280,1367,1147,1082,9,24,14,16,1,65
42125001780,692,593,572,2,4,5,2,0,21
42039000470,818,624,554,12,22,22,0,0,70
42039000240,1556,1273,1054,40,116,35,22,5,219
42123000165,1296,1064,1023,2,4,10,5,0,41
42125000600,733,566,549,0,2,13,1,0,17
42125002045,622,518,447,1,53,10,0,0,71
42125000810,831,613,561,5,23,8,1,0,52
42129002250,2671,2187,2076,21,15,23,27,1,111
42071000500,1787,1416,1312,26,26,10,31,1,104
42097000880,753,558,542,4,4,3,3,0,16
42043000990,292,240,215,15,4,6,0,0,25
42043000768,1746,1386,1093,46,125,7,93,0,293
42043000870,1633,1311,1076,72,104,22,37,7,235
42043000144,1858,1487,1071,73,76,8,243,0,416
42043001330,1266,1006,967,12,8,9,6,1,39
42043000980,904,666,324,71,209,10,54,2,342
42087000060,1318,1021,991,7,2,7,4,1,30
42121000126,1649,1304,1234,9,8,23,13,0,70
42129002680,1453,1151,1042,14,49,28,3,0,109
42129002690,766,628,571,14,25,7,7,2,57
42129002470,1430,1148,1106,4,9,7,4,0,42
42071001332,1606,1236,917,157,94,8,78,1,319
42071001260,1102,834,732,45,30,4,20,0,102
42047000355,1315,1075,1042,3,2,9,6,4,33
42047000385,2079,1709,1663,11,2,7,7,3,46
42071000323,1066,865,606,141,66,8,53,0,259
42071001050,1278,1063,908,55,44,12,36,2,155
42039000550,1054,837,796,6,4,18,0,1,41
42011000250,1972,1635,1465,69,29,25,46,3,170
42011000930,1049,768,142,516,144,33,6,2,626
42043000200,796,631,597,12,7,9,1,0,34
42039000040,344,280,267,3,2,4,3,0,13
42121000465,935,749,694,14,16,15,8,1,55
42121000225,2262,1827,1671,20,58,42,21,0,156
42109000030,1004,748,722,4,5,11,1,0,26
42071000380,1544,1169,1057,46,31,10,31,1,112
42091002850,1692,1222,1114,33,32,8,26,1,108
42091000900,2455,2161,1536,96,350,19,166,1,625
42091002652,1257,1035,861,65,79,14,19,0,174
42091003550,5870,4510,3679,186,451,62,120,4,831
42091000025,1482,1155,948,58,56,6,76,4,207
42091000045,1777,1563,1220,44,140,7,143,0,343
42091001032,1474,1201,1042,43,31,9,64,6,159
42091002200,3892,2886,814,920,921,59,246,1,2072
42071001635,3268,2530,2381,73,33,33,9,2,149
42071001310,2320,1716,955,270,181,28,299,7,761
42071001200,1052,952,799,53,48,4,48,0,153
42071000060,2962,2184,2081,38,13,11,29,2,103
42011001230,2350,1667,559,827,340,46,17,7,1108
42011000395,3184,2465,2132,96,93,29,115,6,333
42081000390,582,468,449,0,0,10,0,0,19
42081000510,2334,1955,1776,23,69,41,37,3,179
42025000210,228,187,177,1,1,5,3,0,10
42085000215,1173,920,846,12,12,25,6,1,74
42085000355,1348,1122,1043,9,29,3,17,3,79
42041000080,2010,1588,1213,113,181,18,62,0,375
42041000198,1874,1468,1294,35,37,10,89,0,174
42119000020,1113,798,772,2,7,14,0,1,26
42017002620,1643,1398,1240,37,46,16,60,1,158
42017002500,1398,1141,1083,24,11,5,15,1,58
42017000515,2215,1749,1245,184,209,53,53,2,504
42015000400,1070,857,806,10,5,8,13,1,51
42015000200,635,486,474,2,0,6,2,0,12
42099000160,962,766,730,9,8,18,0,1,36
42003003650,472,354,172,11,160,19,3,0,182
42003005140,744,613,512,9,79,11,3,0,101
4200300G600,1144,887,793,15,42,21,15,0,94
42007000325,1881,1484,991,27,410,46,10,2,493
42007000335,1633,1229,803,21,383,20,4,0,426
42007000875,1532,1295,1141,17,88,25,25,0,154
42007000365,1794,1518,1197,32,192,30,47,1,321
42007001420,1348,1116,1073,4,12,17,6,0,43
42007000670,565,459,394,8,40,6,4,0,65
42003003181,1202,1001,929,9,34,11,7,0,72
4200300E130,1330,1058,969,8,35,20,22,0,89
4200300A500,1131,1055,943,29,44,7,35,0,112
4200300D560,913,689,487,31,130,7,32,0,202
42003000940,1066,941,834,23,67,11,4,0,107
42067000090,530,397,317,70,12,4,0,0,80
42003000861,818,676,544,15,20,5,89,0,132
42003009840,1020,906,707,22,74,12,87,1,199
4200300G410,638,392,90,5,295,1,1,1,302
42003009150,1222,1029,793,41,62,4,128,4,236
4200300G720,965,856,782,19,25,13,5,0,74
4200300D480,886,694,466,18,144,16,55,0,228
42003001351,1174,1010,762,65,153,19,10,1,248
42003005060,3437,2767,2552,42,69,43,31,1,215
42117000180,531,389,368,7,2,13,0,0,21
42003001180,115,95,22,0,70,3,0,0,73
4200300D910,773,628,565,11,31,6,21,1,63
42003002111,1323,1076,967,34,46,23,5,0,109
42003003370,1869,1602,1394,22,39,7,135,0,208
42003003380,1404,1159,1045,27,16,11,44,4,114
4200300D950,641,545,470,11,47,4,8,0,75
4200300D830,712,615,541,23,28,3,21,0,74
42003006520,208,189,13,1,171,4,2,0,176
4200300A150,16,9,3,0,5,1,1,0,6
4200300G130,1088,826,703,18,20,12,76,0,123
4200300F351,1185,968,731,32,153,16,27,2,237
42003002780,1255,1052,963,11,36,19,19,2,89
42003009880,853,698,548,27,64,2,51,0,150
42003000791,1215,949,793,31,64,21,39,0,156
42003007080,792,728,532,44,16,7,125,0,196
42117000370,938,762,720,2,5,16,5,0,42
42117000380,606,464,449,1,2,5,2,0,15
42127000040,506,434,406,7,2,7,8,0,28
42001000082,1811,1456,1363,30,6,27,19,0,93
42031000460,336,275,264,1,1,2,1,0,11
42073000970,126,98,97,0,0,1,0,0,1
42073000800,857,690,662,5,3,11,3,0,28
42073001040,1321,970,918,20,4,8,10,1,52
42031000450,681,519,500,2,1,10,1,0,19
42101003940,1455,1099,161,235,102,38,599,0,938
42101005610,866,652,328,110,65,16,140,1,324
42101006204,1381,927,144,287,536,24,8,1,783
42061000070,1018,829,803,7,5,10,0,0,26
42061000030,89,76,68,2,1,0,0,0,8
42117000020,1533,1174,1078,29,2,41,9,1,96
42011000760,3086,2393,1325,822,233,34,58,3,1068
42031000200,996,799,774,0,6,8,2,0,25
42079002555,1949,1588,1440,41,57,13,14,2,148
42079000420,2051,1735,1704,4,8,19,1,0,31
42079000580,1716,1391,1315,23,7,27,9,0,76
42055000340,2207,1617,1573,12,7,16,11,0,44
42101006017,976,733,29,38,662,19,20,3,704
42101002621,720,617,532,28,26,5,25,0,85
42101003925,994,826,724,35,10,8,49,7,102
42101004302,1136,842,28,489,338,14,38,2,814
42101000574,2077,1750,311,56,64,12,1301,4,1439
42101000575,2056,1998,788,223,657,5,355,8,1210
42101002307,1272,967,186,159,623,44,20,3,781
42101002005,350,257,27,46,179,19,6,4,230
42101006207,1233,886,130,286,466,9,18,4,756
42101001102,624,492,7,3,479,1,0,0,485
42101001319,774,651,40,26,587,21,6,0,611
42101002009,1053,935,523,48,245,21,121,3,412
42101001808,350,250,27,140,78,12,11,0,223
42101005810,1140,927,628,57,32,1,192,0,299
42101004804,851,650,83,49,483,15,33,1,567
42101001017,701,571,2,5,549,4,6,0,569
42101000576,1465,1434,760,81,111,16,447,0,674
42101000572,792,743,613,40,33,4,57,0,130
42101000417,792,600,3,22,581,12,3,1,597
42101003318,790,580,72,320,191,8,20,3,508
42101003107,1174,1004,804,65,52,7,76,7,200
42101002409,566,461,27,27,409,10,4,4,434
42101004611,746,609,90,18,482,18,18,0,519
42101005913,1137,888,48,26,805,15,1,3,840
42101002108,1090,992,765,45,99,8,78,1,227
42101002620,571,371,206,10,23,1,131,0,165
42101001220,691,501,24,20,463,9,5,0,477
42101006615,1385,1077,715,79,184,5,86,1,362
42101006502,991,818,673,39,35,5,53,3,145
42101001403,733,565,35,42,443,6,48,1,530
42101005515,1152,828,319,193,78,6,226,0,509
42101000708,914,687,34,469,218,17,7,6,653
42101004812,926,740,279,52,218,1,189,1,461
42101004410,761,573,32,16,521,3,10,0,541
42101004011,808,611,29,31,525,5,38,0,582
42011000623,1232,995,898,17,9,8,51,1,97
42101002139,1572,1337,855,105,306,30,55,1,482
42101004008,595,447,2,29,418,12,5,0,445
42101002807,383,304,4,15,281,10,1,3,300
42101004895,941,685,16,73,605,6,10,3,669
42101000717,834,626,22,527,88,21,16,1,604
42101003515,824,571,79,133,327,6,33,6,492
42101002313,1167,843,205,217,385,42,53,3,638
42101005819,1730,1512,1107,120,57,6,219,0,405
42105000090,909,758,723,5,2,7,15,0,35
42073000090,877,726,660,12,13,4,7,0,66
42079003095,1483,1285,1012,71,98,16,102,1,273
42003002650,1525,1371,1271,6,23,12,44,2,100
42003005160,873,716,619,13,60,2,7,1,97
42003002470,699,568,513,5,29,7,5,0,55
42003004830,507,429,211,23,182,9,9,1,218
42003005805,2751,2004,1628,70,38,6,229,6,376
4200300F041,1412,1158,1016,28,68,11,32,2,142
4200300D070,747,596,307,13,267,16,8,2,289
42003005030,513,402,79,6,318,10,1,1,323
42003000871,1148,963,884,11,36,10,21,0,79
42003009570,574,437,364,6,24,4,36,0,73
42003009610,918,692,601,21,8,6,47,0,91
42003003091,1851,1568,1486,10,31,12,24,0,82
4200300B880,585,509,438,19,11,7,29,0,71
42057000130,494,395,387,0,1,7,0,0,8
42061000040,1034,764,750,2,4,2,5,0,14
42029000325,2578,2099,1998,29,20,9,43,0,101
42073000830,1391,1158,1104,6,19,17,4,0,54
42073000812,951,774,761,1,2,7,1,1,13
42073000814,1225,967,936,14,4,10,2,0,31
42079000515,1322,1065,966,45,20,12,14,0,99
4200300B250,757,664,546,44,51,9,13,2,118
42003001230,591,426,233,16,164,12,5,0,193
42003005271,1031,758,645,25,9,5,54,0,113
42003002801,1288,1075,975,21,48,15,17,1,100
42003001061,847,728,670,6,17,13,25,2,58
42131000220,1424,1175,1121,14,4,15,5,2,54
42053000020,376,338,331,2,0,0,1,1,7
42031000060,2016,1640,1553,21,36,17,3,0,87
42101002207,989,832,321,38,454,23,23,0,511
42101004813,1199,999,387,70,177,12,358,2,612
42029001955,1412,1218,1082,17,18,11,80,0,136
42079003150,778,648,589,20,27,8,2,0,59
42079001510,558,501,478,0,5,11,0,2,23
42065000170,673,540,518,6,4,6,3,0,22
42101005713,961,738,642,22,20,16,32,0,96
42101001401,1744,1568,727,184,297,19,342,5,841
42029001080,2796,2125,1953,42,37,26,37,2,172
42061000190,819,647,593,12,9,21,4,1,54
42061000060,318,257,251,3,1,2,2,1,6
42061000580,612,479,460,3,3,11,2,0,19
42077000320,1386,1179,758,300,85,16,38,7,421
42041000211,1310,1096,944,46,30,31,52,2,152
42029001260,3579,2778,1946,71,86,2,632,1,832
42009000250,316,221,207,4,0,8,0,0,14
42029000060,6017,4729,3510,316,578,57,276,5,1219
42029001136,1791,1431,1150,56,61,17,153,0,281
42029000705,2835,2504,1095,243,1006,13,109,0,1409
42101004802,815,652,212,51,306,13,82,2,440
42101003609,700,595,285,48,203,9,55,1,310
42101004109,937,671,216,201,236,11,30,0,455
42101003103,906,812,627,57,43,9,69,0,185
42101003942,722,639,500,42,14,13,62,4,139
42101004222,1377,949,63,655,269,23,42,9,886
42101002128,844,684,581,26,46,18,23,3,103
42079002380,1054,893,875,0,0,10,0,0,18
42079001830,666,537,511,8,1,8,6,0,26
42101000704,963,699,21,622,91,19,6,4,678
42101003419,1127,905,46,18,819,7,11,1,859
42079002595,1727,1436,1375,25,7,13,18,0,61
42035000130,391,315,306,0,2,2,3,0,9
42101005601,1344,1080,495,131,144,9,268,0,585
42029001170,1292,901,785,30,14,2,62,0,116
42029001025,1283,1039,816,50,61,4,32,0,223
42029001005,1074,891,685,70,83,21,21,1,206
42101006323,1562,1300,976,63,155,0,110,0,324
42101006311,1164,976,778,46,67,5,80,1,198
42101006314,1008,812,603,104,56,10,37,0,209
42101003907,1030,856,749,45,23,11,29,3,107
42101004914,827,626,8,114,499,8,10,1,618
42101005202,736,697,171,54,416,5,64,0,526
42101003906,680,539,486,29,7,4,12,1,53
42101003932,905,732,360,169,65,18,138,5,372
42079000138,2280,1827,1578,159,43,19,18,7,249
42011001040,2274,1532,174,1204,204,91,21,0,1358
42101006404,962,677,509,77,51,4,29,2,168
42101005635,1234,965,470,94,255,12,141,1,495
42101005727,2059,1519,472,219,736,19,65,0,1047
42101005829,1468,1165,976,58,47,4,60,2,189
42101005024,1026,787,20,30,725,7,11,1,767
42101003212,944,742,221,38,446,6,42,0,521
42101006107,1254,933,105,128,600,7,105,0,828
42101004313,739,537,11,223,317,10,3,1,526
42073000220,1284,1021,959,4,5,20,18,0,62
42073000240,1284,1046,982,11,13,4,15,0,64
42075000494,1740,1420,1349,30,11,9,14,2,71
42101000577,1177,1120,760,95,159,10,95,1,360
42101000571,890,863,752,22,40,2,44,0,111
42101005418,1354,958,212,299,228,18,178,0,746
42101002513,1007,668,157,307,203,24,23,4,511
42101000308,775,602,6,21,566,6,13,4,596
42101001610,435,315,3,12,285,8,12,0,312
42035000080,196,153,144,0,0,9,0,0,9
42045002990,951,780,665,44,33,21,28,1,115
42045002970,645,514,450,4,17,12,18,0,64
42029000428,2076,1540,1360,49,18,12,85,2,180
42011001145,2047,1443,191,1051,231,52,28,8,1252
42011000100,1244,1049,821,170,44,21,13,1,228
42101005017,892,770,15,29,730,16,6,1,755
42101005002,821,694,11,6,667,11,12,0,683
42101005220,791,657,119,27,483,15,28,1,538
42101003425,1948,1612,973,74,432,13,142,2,639
42101006222,1108,763,262,237,229,12,40,3,501
42101006209,1070,739,103,204,391,22,46,8,636
42063000240,420,356,330,4,1,9,5,0,26
42009000170,863,698,665,7,3,19,2,1,33
42063000660,3056,2731,1931,104,650,15,16,1,800
42089000100,1455,1175,741,179,171,29,52,2,434
42029001133,1386,1068,941,21,44,13,45,0,127
42029001760,3036,2346,1971,62,39,8,246,2,375
42077000050,2075,1485,348,906,310,29,10,3,1137
42133001120,4632,3591,3085,111,259,48,51,1,506
42077000300,2854,2039,568,1166,387,46,47,0,1471
42077000670,1230,1027,818,135,57,8,18,0,209
42077000110,1259,927,175,624,180,22,6,8,752
42063000380,626,505,489,1,4,7,0,0,16
42045001430,1223,905,840,11,17,3,34,0,65
42045003800,1077,776,88,146,293,25,246,0,688
42045002800,1263,967,864,16,34,4,45,0,103
42045000160,1339,1121,978,23,60,12,28,0,143
42011001680,1856,1443,1336,53,10,23,18,0,107
42009000050,1041,811,775,12,5,3,1,0,36
42045002280,1391,1114,921,26,87,25,45,1,193
42045003870,1793,1370,65,22,1261,8,15,0,1305
42059000080,2127,1702,1627,21,9,25,9,1,75
42051000770,530,458,431,2,5,15,0,1,27
42047000160,574,463,439,11,1,5,5,0,24
42119000240,1034,844,802,11,8,19,4,0,42
42045002770,1080,821,746,12,16,5,37,2,75
42045002760,1114,822,761,8,13,7,23,1,61
42045002130,1073,812,718,24,23,6,30,0,94
42045002180,602,475,415,6,30,10,16,2,60
42027000212,3513,3242,1693,121,238,26,1122,1,1549
42027000670,1103,1048,782,99,46,17,97,3,266
42057000090,1029,842,822,1,4,9,0,0,20
42059000060,2297,1820,1693,17,20,51,18,2,127
42059000310,559,446,413,11,10,1,0,0,33
42059000270,253,205,188,4,4,7,2,1,17
42029001240,1632,1227,1048,30,14,14,111,0,179
42019000400,307,236,231,0,0,5,0,0,5
42045002370,4806,4370,3545,92,210,19,491,7,825
42045002350,2261,1976,1606,39,118,14,194,3,370
42045003020,286,205,74,17,112,2,2,0,131
42045001955,1202,977,858,25,48,11,33,2,119
42045003780,2303,1694,147,99,1188,12,271,1,1547
42123000370,602,488,459,5,3,13,6,1,29
42089000070,1635,1280,603,325,344,20,50,4,677
42029001350,1604,1250,825,57,57,11,297,0,425
42033000200,1487,1219,1189,1,2,21,2,0,30
42125001420,1601,1262,1168,32,1,19,27,0,94
42133001150,608,506,480,0,9,10,3,0,26
42133001396,1556,1222,1098,52,23,17,19,1,124
42129001160,908,743,696,9,12,10,4,0,47
42025000250,1608,1252,1158,53,20,10,7,0,94
42129002910,865,640,554,4,71,5,5,0,86
42059000360,425,346,322,0,4,10,0,0,24
42033000450,1149,889,857,12,6,9,1,0,32
42019000480,4883,3865,3602,49,40,47,66,0,263
42027000490,2054,1667,1565,19,15,30,8,1,102
42027000110,1268,967,939,4,7,11,3,1,28
42095000065,1766,1324,520,547,250,44,36,4,804
42095000825,1100,845,776,35,9,5,18,1,69
42025000080,1314,1051,1003,21,2,13,5,0,48
42081000160,2578,2121,2001,17,24,25,35,1,120
42091003460,1357,1169,741,87,188,14,145,0,428
42091001485,1985,1633,1330,54,107,6,127,1,303
42091001610,1270,933,785,28,28,5,69,0,148
42091001016,2383,1951,1342,66,58,18,464,1,609
42129001300,857,674,656,8,4,3,1,0,18
42129002590,1054,883,832,14,7,11,12,0,51
42129002580,1081,908,851,13,30,13,7,0,57
42129002980,1493,1237,1194,8,18,4,3,0,43
42129000680,3626,2979,2830,44,37,22,31,2,149
42045001010,1332,947,626,37,227,24,37,1,321
42005000290,74,71,68,0,1,1,0,0,3
42005000680,656,535,523,0,4,5,0,0,12
42015000160,620,477,467,2,0,6,1,0,10
42091000345,1315,1059,470,72,462,17,51,1,589
42091003110,1553,1164,705,23,378,11,44,0,459
42013000340,690,549,515,3,8,10,5,0,34
42095000510,2299,1817,827,551,425,38,33,4,990
42071000610,1556,1240,375,600,291,21,22,3,865
42095000668,1317,1097,891,58,55,2,93,0,206
42123000125,1211,894,849,7,2,20,4,2,45
42021001900,1146,910,890,2,0,11,1,0,20
42133000240,3280,2710,2555,65,29,33,20,7,155
42019000210,2231,1919,1809,34,19,22,23,2,110
42107001055,462,384,366,3,5,3,1,0,18
42045001230,1374,1047,892,8,41,15,84,1,155
42045000800,847,675,346,22,272,10,34,0,329
42045000740,1401,988,230,28,693,13,26,0,758
42045000750,1135,822,254,40,500,19,22,1,568
42045000760,1555,1137,377,51,661,25,45,0,760
42045001770,1182,960,809,18,19,1,115,0,151
42045003510,1097,882,264,31,502,9,93,0,618
42045001320,1563,1273,960,79,128,17,89,5,313
42109000010,895,675,654,9,7,3,3,2,21
42027000060,2008,1664,1584,11,17,18,20,1,80
42027000180,1760,1359,1238,23,32,17,48,0,121
42091003845,1112,878,729,31,46,5,66,0,149
42091003750,2172,1681,1526,27,45,9,63,0,155
42091001370,1770,1446,1173,42,117,14,91,0,273
42045001370,1035,774,654,32,43,6,38,1,120
42045000440,1138,763,29,29,702,16,2,0,734
42045000475,894,595,1,32,573,2,5,0,594
42045000420,648,503,13,25,470,3,0,0,490
42045002540,1730,1425,1160,46,134,9,64,3,265
42045002550,2360,1896,1263,41,269,20,295,0,633
42045001400,1107,829,762,27,22,2,14,0,67
42045002825,1200,865,806,14,11,1,33,0,59
42045002920,2750,2337,1480,175,193,14,466,2,857
42091001800,2167,1795,1549,36,57,11,133,2,246
42091001128,1297,1036,823,46,59,11,97,0,213
42095000030,1170,852,709,85,21,27,9,0,143
42095000352,1305,1046,831,104,72,4,33,2,215
42095000480,1272,1067,849,76,89,16,38,0,218
42027000430,1203,819,787,5,8,10,0,1,32
42027000040,1455,1090,1018,22,33,6,4,2,72
42027000170,417,363,356,0,1,3,3,1,7
42025000367,1653,1366,1250,44,27,24,16,3,116
42091003510,1581,1252,1052,52,71,13,62,2,200
42097000230,425,314,300,3,1,5,4,2,14
42051000670,614,484,461,12,0,7,6,0,23
42049000770,1920,1599,1408,45,73,10,61,1,191
42049001150,2765,2212,2082,38,32,32,13,1,130
42085000575,1042,802,745,8,7,26,12,1,57
42085000320,764,633,614,2,4,6,5,0,19
42069002300,1186,935,759,132,31,24,3,1,176
42097000935,1802,1420,1341,19,10,20,14,2,79
42097000550,819,670,650,5,1,3,10,5,20
42041000390,2560,2219,1921,78,80,29,108,6,298
42025000300,1665,1400,1288,51,38,15,5,3,112
42025000350,1222,940,862,46,5,13,11,0,78
42017000435,1907,1488,1083,122,255,13,35,1,405
42017001706,2339,1897,1500,58,70,13,251,1,397
42017002805,2518,1931,1792,35,25,10,69,0,139
42017001360,653,520,477,13,8,7,18,0,43
42017000280,2737,2255,1500,133,173,27,443,1,755
42087000150,291,230,217,4,6,2,0,0,13
42129002930,636,480,441,4,17,7,2,1,39
42129001020,666,538,519,2,3,8,6,0,19
42017000710,580,431,334,69,23,3,2,0,97
42129002300,435,320,305,3,6,5,0,0,15
42021000478,1537,1279,1223,15,17,13,3,0,56
42017002060,1981,1611,1478,31,5,14,52,3,133
42017000050,3285,2527,1140,230,262,25,872,4,1387
42017001580,1821,1412,1158,58,78,22,79,0,254
42107000695,955,716,668,25,20,7,5,0,48
42021000154,1876,1536,1496,8,7,15,1,0,40
42125001030,1119,920,860,17,3,21,8,0,60
42125001440,2584,1870,1692,51,11,12,64,0,178
42129002210,2718,2158,2032,50,22,15,22,2,126
42129000180,1896,1634,1585,12,8,16,3,0,49
42091001910,2630,2062,1633,133,61,22,213,1,429
42091002900,850,613,530,21,26,6,28,0,83
42091001510,981,660,565,24,23,0,38,1,95
42129002075,609,479,466,0,9,3,2,0,13
42129002100,748,592,550,12,13,10,4,0,42
42049000100,1549,1274,1144,32,55,17,15,1,130
42095000354,1253,995,736,113,83,9,77,0,259
42095001270,1237,979,770,118,77,8,14,2,209
42013000790,230,179,172,0,2,3,1,0,7
42015000440,215,168,163,0,0,1,0,0,5
42015000510,1249,966,903,21,9,12,16,0,63
42049001340,2150,1636,1505,25,45,18,11,1,131
42049000690,1054,797,658,27,89,7,14,0,139
42049000920,2268,1857,1788,22,10,14,7,0,69
42071001420,3152,2483,1748,389,171,46,186,1,735
42125000620,629,489,466,2,9,7,0,0,23
42049001040,1457,1076,1006,12,22,20,13,1,70
42011001350,2478,2192,1143,524,468,27,65,41,1049
42017000985,2881,2314,2137,51,40,33,29,2,177
42017001450,971,803,679,37,25,12,49,0,124
42043000751,1900,1541,1279,26,143,12,79,0,262
42015000030,210,141,134,0,0,4,0,0,7
42133000500,1558,1257,1185,29,11,18,4,0,72
42071000445,1579,1223,1061,89,44,15,19,1,162
42081000340,1491,1223,1156,13,16,24,5,2,67
42049000130,1786,1396,1350,5,5,25,2,1,46
42107000520,138,113,105,4,0,1,0,0,8
42129002400,490,417,390,5,3,7,8,0,27
42087000270,196,158,158,0,0,0,0,0,0
42093000120,232,189,180,0,3,4,3,0,9
42013000010,1928,1572,1506,14,16,28,6,1,66
42119000230,1365,1102,1042,19,18,13,2,0,60
42071000650,1097,959,693,153,116,10,17,1,266
42043000112,1244,965,853,24,29,14,37,0,112
42129000300,764,645,636,1,1,5,0,0,9
42129000160,482,399,378,1,6,4,2,0,21
42129002860,1121,959,914,10,10,8,7,0,45
42129002760,2403,2173,1915,98,115,34,20,1,258
42129000360,464,366,348,4,6,9,1,0,18
42043000194,1649,1352,1285,12,22,12,12,1,67
42043000047,1354,1032,915,34,36,4,38,4,117
42049000360,1188,849,527,98,190,17,13,0,322
42121000580,448,401,382,1,2,12,3,0,19
42121000540,1328,1040,1005,3,2,13,5,1,35
42105000160,438,343,327,4,1,5,4,0,16
42005000140,549,407,398,2,2,1,2,0,9
42013000330,788,648,608,8,10,10,1,1,40
42013000830,780,612,593,5,8,5,2,2,19
42037000150,4635,4249,3668,170,197,47,158,3,581
42037000160,1816,1814,1649,76,31,6,52,0,165
42037000010,876,721,697,1,5,12,4,0,24
42081000570,1528,1235,1202,11,3,9,6,1,33
42081000110,1200,949,891,10,6,19,5,0,58
42133001030,2207,1786,1568,99,85,25,22,0,218
42125001860,1271,1116,917,35,124,20,16,7,199
42017000860,1349,1033,968,24,2,12,12,0,65
42017000832,1990,1580,1452,38,21,5,59,0,128
42019000730,1288,1027,985,7,4,13,9,0,42
42019000377,3436,2768,2409,117,66,48,113,5,359
42115000270,1130,910,852,13,4,17,1,1,58
42071001170,1721,1322,1105,86,31,15,90,1,217
42081000230,1108,851,831,2,1,10,1,0,20
42021001720,800,673,604,14,48,6,3,0,69
42021001730,484,411,383,9,14,5,0,0,28
42069001290,2455,1991,1906,23,13,12,11,1,85
42071000580,749,648,408,144,104,12,8,3,240
42069002295,738,589,495,43,30,10,11,0,94
42069001845,1180,877,564,157,120,16,25,0,313
42091003610,1493,1279,1064,40,89,10,49,1,215
42091001938,2363,1747,814,48,78,8,783,2,933
42091001350,1517,1122,913,35,39,13,118,1,209
42091000770,1643,1381,1251,35,60,9,29,1,130
42091002470,1008,736,616,14,34,5,58,1,120
42091002890,1865,1479,1079,59,255,20,70,1,400
42021001361,1486,1192,1163,3,3,11,2,0,29
42021000862,798,692,586,27,65,9,19,2,106
42021000175,696,572,551,7,7,4,3,2,21
42125001620,1120,894,854,6,6,14,4,0,40
42091001326,1574,1224,809,33,297,4,76,0,415
42091002035,4558,3254,2852,107,117,38,99,1,402
42091001340,2218,1877,1503,43,73,18,222,1,374
42091000812,3810,2773,2513,72,63,43,64,0,260
42091000245,1184,931,722,38,77,4,87,0,209
42091000450,1630,1269,885,213,130,36,34,3,384
42039000420,1402,1107,1064,7,4,16,1,0,43
42017000380,1819,1467,1008,185,201,21,64,0,459
42125000645,496,395,356,3,14,8,1,0,39
42125001050,399,311,259,8,21,12,3,0,52
42123000140,2042,1727,1650,18,8,25,11,0,77
42105000260,1103,816,775,19,5,18,1,0,41
42021001595,744,599,576,11,2,7,0,0,23
42021000190,904,709,683,3,4,8,4,1,26
42039000200,962,769,729,15,6,10,0,1,40
42069000960,2469,1983,1896,26,11,17,4,0,87
42091003835,1540,1216,974,24,41,5,159,2,242
42065000700,1711,1420,1374,4,1,14,4,0,46
42041000370,1686,1329,1138,81,65,18,27,0,191
42071001300,2881,2191,1837,99,75,18,157,1,354
42011000060,1228,939,849,23,31,6,7,0,90
42011001576,1976,1515,1310,98,64,20,37,3,205
4200300G480,1131,967,820,18,84,16,10,2,147
42003004960,864,700,422,26,226,24,10,0,278
42003003970,636,553,476,23,29,20,9,2,77
42003003680,388,268,29,12,225,9,0,1,239
4200300C700,384,324,253,4,57,3,5,0,71
4200300C840,325,245,200,8,21,4,4,0,45
42003005690,794,683,527,14,119,13,6,3,156
42133000536,4010,2899,2177,153,363,60,152,1,722
4200300C320,694,586,484,18,67,6,9,0,102
42071000290,3394,2654,2363,119,93,18,35,0,291
42123000231,1844,1478,1421,5,2,37,2,3,57
42121000445,1400,1112,1032,15,29,24,4,1,80
42063000560,255,186,185,0,1,0,0,0,1
42071000030,2506,2012,1738,119,66,43,41,5,274
42043000681,1259,994,830,23,77,16,51,0,164
42081000280,1240,987,877,28,31,9,32,0,110
42083000065,1061,776,706,9,5,39,10,0,70
42085000590,778,624,588,4,4,16,0,0,36
42091001290,2194,1646,1390,66,91,16,83,3,256
42011001485,3337,2603,2192,175,153,25,65,4,411
42071000388,1993,1603,1278,81,74,16,156,1,325
42071000386,3467,3004,1943,533,371,27,165,0,1061
42071000395,2029,1574,1407,63,34,13,67,0,167
42085000310,1416,1139,1064,17,12,16,18,0,75
42085000835,1102,846,736,12,80,9,9,0,110
42107001455,716,621,598,16,6,4,3,0,23
42107001260,2589,2366,1465,189,694,4,6,1,901
42047000365,1650,1335,1296,3,12,12,5,0,39
42083000030,1320,963,882,11,14,35,4,2,81
42015000010,133,110,109,1,1,0,0,0,1
42011000920,1857,1352,239,935,222,42,14,2,1113
42129000460,602,504,468,6,20,1,2,0,36
42129001700,2191,1784,1572,27,18,33,131,0,212
42049000640,1135,918,843,17,31,4,19,0,75
42101001020,1012,765,12,14,747,1,3,0,753
42101001086,1301,1234,789,78,109,11,238,3,445
42101001085,1188,1107,837,87,77,11,90,1,270
42101001081,1237,1141,855,78,81,10,122,0,286
42101001822,1042,952,770,52,33,8,88,0,182
42101004046,909,727,62,15,561,7,85,1,665
42101004050,865,738,79,6,596,6,60,0,659
42101006509,1253,987,640,119,162,8,61,3,347
42101005843,727,603,417,31,37,5,118,1,186
42101003701,320,245,4,41,192,12,13,1,241
42101005303,1244,869,109,246,429,5,89,2,760
42101004703,2514,2209,1009,84,650,8,450,8,1200
42101003230,472,396,15,10,364,3,8,0,381
42129001830,612,546,518,4,11,4,5,1,28
42101000618,871,714,36,24,645,13,7,0,678
42101006501,1368,1108,960,38,55,8,38,4,148
42101004507,830,655,541,58,36,15,7,2,114
42101006631,948,748,573,60,53,7,54,3,175
42011000771,2395,1920,1398,324,145,17,63,2,522
42121000355,1815,1441,1364,11,11,27,2,0,77
42039000090,1332,1047,1005,9,8,14,2,0,42
42029000230,4787,3680,3112,282,130,52,92,4,568
42121000730,184,147,132,2,6,5,1,0,15
42099000140,960,756,687,19,14,11,13,0,69
42007001165,1155,979,864,35,44,18,7,0,115
42007001200,1716,1287,945,27,227,64,5,0,342
42007000760,116,91,87,2,1,1,0,0,4
42007001070,712,583,544,4,15,10,2,1,39
42063000320,417,311,294,5,2,8,0,0,17
42063000440,1252,1002,910,24,36,13,15,0,92
42007000310,1424,1148,1062,19,10,20,19,3,86
42007000590,2287,1874,1785,18,37,13,10,3,89
4200300E371,1715,1384,1271,13,41,8,33,0,113
42007000290,1397,1129,1036,18,27,15,22,0,93
42007001230,961,772,646,5,83,27,4,1,126
42051000250,1013,796,755,6,7,13,7,1,41
42003000961,946,771,629,26,72,17,14,0,142
42003003460,438,229,31,7,193,10,2,0,198
42003000501,1643,1303,1217,10,13,14,46,0,86
42003000831,1063,863,607,51,103,21,85,2,256
42003004640,1106,863,796,16,11,9,32,0,67
42003008410,727,656,295,27,283,5,50,2,361
42003003260,1793,1480,1154,57,76,7,180,3,326
42003007270,419,384,338,8,14,5,16,0,46
42003007370,503,462,370,26,34,8,30,1,92
4200300A660,764,635,563,8,54,0,12,0,72
4200300B490,725,612,538,19,43,2,10,0,74
42003003640,462,386,217,16,155,8,1,1,169
42003000841,1124,910,750,17,51,7,78,0,160
42003001080,748,630,492,17,105,2,10,0,138
4200300E040,2387,1903,1765,17,84,13,17,4,138
4200300C120,1391,1342,939,23,292,16,71,6,403
42003000091,562,506,428,6,57,6,16,0,78
42003000650,931,747,638,19,78,9,2,1,109
4200300G271,2180,1721,1650,26,6,13,17,0,71
4200300B940,442,362,108,3,248,8,3,0,254
42055000150,2004,1629,1254,206,117,35,38,1,375
42003000660,1213,1011,923,16,48,3,12,0,88
42003001970,886,648,589,28,5,5,12,0,59
42003000721,460,351,88,12,251,15,2,0,263
4200300F102,848,730,672,10,8,4,31,0,58
4200300E125,1033,835,727,10,83,12,4,0,108
42003003232,1061,829,689,23,22,4,80,1,140
4200300C040,781,710,503,37,134,11,20,2,207
42003005561,790,644,372,9,231,12,15,1,272
42003002071,1398,1101,980,17,71,23,5,3,121
42003001541,1192,1017,899,36,47,9,23,3,118
42055000500,786,662,602,18,20,12,9,0,60
42055000390,1580,1252,1134,33,41,24,9,2,118
4200300E870,992,807,749,11,17,10,21,0,58
42003008770,345,272,7,8,251,8,2,1,265
42003001130,746,620,474,10,101,7,28,0,146
42003007810,641,539,384,8,119,8,17,1,155
42003004800,757,643,467,18,117,9,29,0,176
4200300E665,801,668,586,4,42,6,22,2,82
4200300E655,808,656,610,8,16,7,7,0,46
4200300E770,441,359,341,3,0,5,5,0,18
42003001680,629,523,285,18,209,6,4,2,238
42003005378,1711,1353,1262,20,10,3,44,1,91
42003003310,1394,1048,1001,1,8,4,27,2,47
42003006350,1885,1849,1414,54,125,2,240,1,435
42003005980,454,342,17,2,314,6,6,0,325
42003004361,894,667,594,19,18,1,28,0,73
42003002240,920,760,596,5,136,7,12,0,164
42003000801,954,749,648,24,29,3,39,0,101
42127000145,1542,1247,1094,60,17,36,15,0,153
42055000250,3750,3216,2992,79,74,35,19,4,224
42055000040,3687,2771,2502,90,65,57,25,1,269
42003009780,687,565,377,11,20,1,149,1,188
42003005602,971,799,512,10,245,8,22,0,287
4200300B500,639,524,429,24,41,6,25,0,95
42053000010,309,284,276,2,1,4,1,1,8
42003001260,687,590,444,17,115,7,2,0,146
4200300H080,724,668,521,17,93,13,21,0,147
4200300A860,835,640,422,23,183,15,8,3,218
4200300E495,877,700,655,2,22,6,14,0,45
42019000420,1940,1603,1553,10,3,19,7,0,50
42019000065,2375,1851,1784,19,3,9,24,0,67
42101002225,560,478,62,14,405,9,3,0,416
42101005123,613,482,16,7,458,3,1,0,466
42101002105,1649,1468,1102,50,189,16,109,0,366
42127000320,169,140,136,3,0,1,1,0,4
42031000210,1093,869,833,6,10,11,5,0,36
42055000510,1334,995,960,14,4,7,5,1,35
42127000250,1251,1014,940,33,6,13,12,0,74
42101002709,1256,1175,671,88,96,20,303,3,504
42101002711,2148,2028,713,109,278,7,933,4,1315
42101000903,1126,940,489,56,361,16,27,2,451
42101003203,423,335,8,17,303,5,9,0,327
42101005710,1330,1043,548,121,150,14,212,1,495
42101001909,721,535,19,459,86,10,4,8,516
42101001104,332,284,20,12,214,5,34,0,264
42101000310,752,580,11,20,549,15,4,1,569
42101002803,581,443,11,18,419,6,0,0,432
42027000660,2912,2708,2062,210,100,11,289,0,646
4200300E891,836,728,678,6,13,6,14,0,50
4200300E815,858,686,642,5,3,9,27,0,44
4200300G311,1491,1204,1131,32,7,23,8,0,73
4200300G320,1052,851,822,6,3,14,2,0,29
42003001190,428,298,56,20,224,3,3,0,242
4200300H021,615,450,67,6,370,9,3,0,383
42003007250,933,791,380,25,49,1,335,3,411
4200300F200,839,677,648,10,7,2,6,0,29
42003003670,558,427,118,8,298,5,2,0,309
42003001051,1007,823,723,24,35,8,34,0,100
4200300D220,974,765,579,12,155,8,15,0,186
42003005081,1642,1371,1257,18,33,31,24,5,114
42003004210,1078,889,479,22,334,23,35,4,410
42003004160,1325,1167,848,40,168,16,94,3,319
42003000021,1074,824,743,17,20,7,35,0,81
42003002310,962,728,659,22,8,0,36,1,69
4200300B290,644,536,404,27,71,10,29,1,132
4200300F100,812,660,615,9,15,12,6,0,45
42131000280,476,397,384,4,0,4,5,0,13
42003001550,696,585,501,18,29,12,26,0,84
42003008450,388,354,138,8,201,7,0,0,216
42003000920,817,682,591,25,40,9,15,0,91
4200300F840,777,647,562,26,28,4,28,0,85
42003001941,943,808,713,15,40,9,27,1,95
42003005351,823,671,624,24,9,8,5,0,47
42003005150,980,786,476,24,271,13,10,0,310
42003004670,734,587,491,33,27,11,25,0,96
42003004440,812,590,521,22,11,6,20,0,69
42003007510,548,492,301,20,102,6,70,1,191
4200300E980,1324,1173,1070,21,35,12,29,0,103
42003003941,752,635,587,9,33,3,0,0,48
42003008010,646,537,203,18,308,6,9,0,334
42001000330,2470,1875,1683,53,57,58,14,1,192
42101003314,1111,737,132,445,170,9,19,3,605
42101002608,885,729,659,21,17,9,26,2,70
42101006515,906,588,235,115,222,9,31,1,353
42101006123,974,814,114,57,620,14,30,0,700
4200300G330,403,320,299,8,7,8,1,0,21
42003009190,886,696,527,29,14,6,116,0,169
4200300G220,867,678,572,26,67,9,7,0,106
4200300E045,902,753,724,7,5,8,7,0,29
42003002369,1976,1425,1192,28,22,18,158,0,233
42017002327,1805,1458,1308,31,9,12,80,0,150
42003007580,734,682,586,27,43,6,22,1,96
42101004525,883,701,653,24,5,7,7,2,48
42101005405,1049,735,116,204,246,7,153,1,619
42101001714,911,720,2,21,698,5,6,1,718
42101001727,587,482,7,20,450,6,7,2,475
42101001117,418,340,7,25,307,4,1,1,333
42101001108,776,603,11,18,574,12,7,1,592
42101003432,754,591,46,5,530,3,10,0,545
42101001603,646,479,6,15,460,1,2,0,473
4200300B960,642,572,148,22,396,3,13,0,424
4200300C900,734,597,435,22,120,13,13,0,162
42003003620,382,347,125,16,202,4,1,1,222
42003001960,783,584,546,9,11,2,6,0,38
42003004780,713,559,321,14,170,20,46,2,238
42101005110,566,430,53,12,367,5,2,0,377
42101000317,787,610,14,5,587,10,0,1,596
42101005511,1054,755,313,153,90,14,173,2,442
42101003403,659,487,11,10,467,8,3,2,476
42101006004,829,639,13,13,576,25,30,3,626
42101006014,1031,752,48,22,636,18,43,6,704
42101003001,1503,1314,816,68,290,13,123,0,498
42101002801,550,420,20,13,384,5,4,1,400
42101003219,519,404,8,13,374,15,5,0,396
42101000408,1015,771,17,17,738,8,8,0,754
42017000290,2154,1768,1381,138,140,26,86,1,387
42107001525,1616,1280,1176,57,18,5,9,1,104
42107000070,916,734,713,4,5,3,8,1,21
42029000450,732,579,476,28,12,6,52,0,103
42029001800,2499,2001,1751,58,78,15,95,0,250
42101000715,622,430,21,368,64,5,5,1,409
42101004708,757,505,101,33,338,5,34,0,404
42101005903,831,642,21,24,597,6,13,2,621
42101004031,933,673,67,33,545,5,36,1,606
42101002322,1053,711,149,297,271,13,12,4,562
42101000204,994,842,501,115,43,17,171,1,341
42101000110,1054,864,501,123,17,15,209,2,363
42091001983,2636,2118,1595,58,104,8,352,0,523
42091002000,1846,1533,1219,56,88,13,143,1,314
42079000955,1905,1382,563,767,115,28,23,1,819
42101005411,1159,792,125,232,144,30,232,1,667
42101001904,726,576,32,479,68,3,9,1,544
42101005126,542,407,5,8,393,2,1,0,402
42101000403,1014,728,14,18,703,10,4,0,714
42101002406,2874,2749,1180,122,684,14,743,3,1569
42101000118,805,674,605,13,15,0,34,0,69
42101005640,926,711,217,84,85,4,274,0,494
42101003316,912,631,120,330,164,17,51,1,511
42101003320,832,602,74,341,187,14,25,2,528
42101000721,980,727,39,567,162,10,13,1,688
42101005812,1205,949,665,45,28,2,203,1,284
42107000400,418,318,307,4,1,7,0,0,11
42107000860,1570,1275,1186,20,14,10,38,0,89
42101005835,1451,1254,1036,53,35,3,123,1,218
42101005836,1279,976,519,33,50,2,369,1,457
42101005519,1016,743,351,110,43,4,207,6,392
42101005524,1238,921,470,169,88,9,180,2,451
42061000260,321,249,243,0,0,6,0,0,6
42061000160,331,283,270,3,0,6,1,0,13
42101004922,1292,945,31,97,822,14,5,1,914
42101004916,896,682,18,23,612,3,31,0,664
42091000790,1151,956,852,38,33,13,26,0,104
42091003390,957,734,511,70,86,23,58,1,223
42079002156,1949,1529,1254,116,124,34,4,3,275
42079002166,1642,1239,1050,61,100,9,14,8,189
42079001445,1619,1343,1223,38,58,14,16,0,120
42081000400,1568,1122,1017,28,21,37,14,1,105
42081000130,2834,2234,2112,26,9,37,23,2,122
42101004621,598,455,8,20,422,0,5,0,447
42101003102,855,645,90,278,148,24,149,2,555
42101001820,755,662,516,49,44,3,48,1,146
42003004170,1120,932,777,23,94,14,19,0,155
4200300C160,491,426,294,27,79,4,21,0,132
42073000285,900,709,453,21,206,32,5,0,256
42073000790,1239,1016,982,3,6,12,5,0,34
42003008240,555,503,362,27,77,4,27,1,141
42003008300,779,628,386,43,143,20,46,2,242
42003008100,523,424,114,13,288,5,7,0,310
4200300F427,1348,1094,972,9,14,6,93,0,122
42003004190,1658,1458,911,43,341,9,149,2,547
42003004220,906,733,496,35,138,16,49,4,237
42003002851,549,458,140,17,293,14,5,0,318
4200300E280,717,590,551,6,17,6,8,0,39
42003009250,804,635,445,20,12,1,151,0,190
4200300E290,1103,944,886,3,23,12,6,1,58
42003002321,1139,831,732,13,4,2,79,1,99
42003006370,1207,1137,864,40,68,7,155,0,273
42101002520,1054,706,83,360,239,8,48,1,623
42073000495,1569,1247,1058,21,118,24,1,0,189
42101002315,1119,804,203,322,275,15,31,1,601
42101000401,806,563,14,16,540,6,3,1,549
42101005209,1046,882,176,32,640,14,41,0,706
42003006870,663,602,499,12,42,8,28,0,103
4200300F524,1116,909,851,6,13,16,17,0,58
42003005450,928,743,132,13,584,15,8,1,611
42003000181,1042,864,795,11,29,3,14,0,69
42009000300,141,96,94,2,0,0,0,0,2
42101005623,1282,992,588,113,68,8,152,1,404
42049000181,2223,1599,839,166,540,27,36,2,760
42049000830,2175,1670,1584,13,11,22,19,0,86
42049000570,939,771,629,33,49,12,36,0,142
42049000530,1858,1370,919,93,267,16,66,1,451
42049000800,2585,2024,1684,71,160,21,88,1,340
42075000380,1911,1582,1496,25,13,11,18,1,86
42113000030,167,133,120,0,1,8,2,1,13
42077000950,1035,823,792,17,3,8,5,0,31
42077000230,2319,1652,272,1098,325,39,38,2,1380
42011000292,2662,2118,1586,283,190,26,60,2,532
42077000380,3411,2525,852,1337,348,39,52,7,1673
42077000030,2066,1529,368,871,331,40,36,1,1161
42003008490,207,127,4,3,118,3,0,0,123
4200300A375,648,496,306,21,162,11,1,0,190
4200300E675,936,780,742,5,22,5,9,1,38
42003005840,978,774,685,15,54,9,7,2,89
42029001840,1389,1028,977,25,10,5,13,1,51
42029000919,688,645,543,49,36,5,20,0,102
42029000140,2449,1911,1438,148,231,29,66,1,473
42029000203,4299,3648,2921,122,498,21,76,2,727
42011001020,3121,2182,286,1753,320,80,26,4,1896
42037000580,556,456,442,4,2,0,2,0,14
42005000660,1423,1124,1094,4,1,16,1,0,30
42083000280,843,632,584,4,12,21,1,0,48
42089000261,4768,3654,1924,578,1005,60,159,5,1730
42029000295,1942,1644,1371,58,55,6,145,1,273
42029000347,1533,1243,1015,56,69,9,90,3,228
42045003140,1005,726,504,37,138,11,47,2,222
42017001800,2859,2343,1989,81,77,7,168,3,354
42017002220,2359,1847,1612,91,54,40,36,0,235
42045000810,1352,1009,111,23,860,10,23,1,898
42045002860,1464,1129,965,13,20,3,119,0,164
42063000530,832,658,649,1,0,3,1,0,9
42045003330,1183,921,652,38,165,13,62,1,269
42045002091,224,162,130,5,7,0,19,0,32
42045000230,952,745,146,81,511,21,9,0,599
42063000365,1572,1227,1188,10,4,22,1,0,39
42133001250,2862,2012,576,852,629,38,16,8,1436
42095000040,1270,950,809,82,31,18,1,4,141
42107001105,1523,1240,1025,85,104,26,7,1,215
42107000912,1223,951,906,29,8,10,5,1,45
42107001580,283,242,236,2,1,3,0,0,6
42045002960,629,535,474,7,27,8,16,1,61
42045002980,795,658,559,22,22,13,27,0,99
42043000530,1827,1484,1451,2,5,9,8,1,33
42021000430,509,429,412,6,0,8,0,1,17
42025000070,247,200,182,3,4,3,5,1,18
42025000400,1016,753,699,24,15,7,2,0,54
42071001950,2121,1665,1479,85,40,22,27,1,186
42071001830,1741,1401,1271,60,22,10,23,0,130
42043000763,1817,1454,1101,37,171,12,115,1,353
42021001280,660,550,535,2,4,2,0,0,15
42021000010,860,704,658,12,7,15,2,2,46
42021000350,1130,897,859,13,2,16,1,0,38
42071001920,2901,2186,1928,139,73,30,29,1,258
42045000680,2897,2273,1940,44,86,33,168,0,333
42045001040,1079,834,336,40,412,19,31,0,498
42021000060,1389,1102,1074,3,2,5,4,2,28
42125001980,274,214,203,4,2,1,1,0,11
42125001875,1083,897,562,19,280,16,17,4,335
42097000280,293,242,237,2,2,1,1,1,5
42049001190,1564,1267,1180,33,17,16,17,0,87
42005000050,1098,938,912,3,8,9,6,0,26
42037000510,1263,1023,971,15,7,12,8,3,52
42085000775,890,715,673,2,19,6,12,1,42
42085001080,585,512,414,8,82,4,1,0,98
42005000490,1455,1213,1161,10,6,19,1,1,52
42125001390,1279,1054,1004,13,9,4,21,1,50
42085000140,857,710,374,2,319,6,3,0,336
42095001260,1301,1092,997,32,14,23,22,0,95
42123000410,230,206,195,0,0,4,1,0,11
42111000100,104,83,78,1,1,4,0,0,5
42081000150,778,624,603,2,8,11,1,0,21
42027000820,267,208,195,5,0,3,0,0,13
42027000700,3402,3198,2597,183,122,25,272,15,601
42027000350,560,378,365,4,3,5,1,1,13
42095001050,638,500,446,36,12,3,0,0,54
42017002550,1257,1119,1028,19,15,4,47,1,91
42017001305,3084,2646,2100,106,133,8,274,2,546
42095001240,2067,1646,1497,74,27,22,13,4,149
42095000075,1996,1438,423,787,284,33,21,1,1015
42017001260,2339,1849,1615,52,23,16,131,1,234
42017001340,3669,2857,2309,61,94,14,376,1,548
42125000670,754,617,571,4,8,24,0,2,46
42091002400,1070,838,678,33,79,11,30,0,160
42091000960,3442,2751,2297,145,181,46,79,1,454
42091002648,2106,1517,640,169,658,54,37,4,877
42013000040,1005,774,717,5,26,8,3,2,57
420130040P1,108,100,91,1,2,3,0,0,9
42013000930,740,525,503,3,1,10,2,3,22
42017000030,2699,2173,1460,113,184,38,379,0,713
42125001270,1303,1044,915,20,64,19,8,5,129
42071002000,2642,2079,1895,94,31,24,31,2,184
42095000970,1295,1011,853,82,45,16,16,1,158
42017000920,2310,2032,1792,91,37,8,83,3,240
42017000780,3065,2274,1938,84,35,15,181,1,336
42017001480,1865,1421,1218,51,53,9,85,2,203
42017001350,1665,1261,1071,51,28,14,90,0,190
42017000850,1934,1504,1404,34,16,4,36,0,100
42121000195,1722,1352,1223,25,38,28,23,1,129
42097000520,1558,1292,1227,26,11,18,6,0,65
42097000790,1299,953,745,132,46,22,3,1,208
42071001360,1353,1055,796,124,39,13,87,1,259
42071000155,1721,1361,992,203,160,17,8,2,369
42017001370,2005,1564,1392,43,43,10,64,0,172
42017000620,1615,1263,974,94,131,20,40,0,289
42069001455,1638,1252,872,207,147,26,18,0,380
42069002195,1556,1213,958,130,106,24,13,3,255
42129002220,2124,1654,1538,17,10,34,31,1,116
42107000995,759,585,458,29,67,16,14,2,127
42091000005,1592,1233,1031,61,64,8,56,0,202
42091000850,1672,1500,1085,65,212,10,124,2,415
42091000355,2408,1807,1291,105,341,24,63,6,516
42091001950,3252,2496,1963,46,86,10,388,0,533
42091001900,2214,1802,1440,46,94,9,204,0,362
42091003070,953,709,636,3,10,6,43,1,73
42091003410,2062,1615,1288,89,133,26,84,1,327
42091003730,1928,1477,1326,34,29,7,75,1,151
42091001006,1750,1376,747,58,116,22,448,0,629
42091003290,1686,1350,890,45,114,8,291,3,460
42129000070,602,449,267,4,155,14,6,1,182
42129000470,894,719,669,6,13,7,16,0,50
42071000440,1305,1042,899,60,51,9,26,0,143
42071000335,2289,1801,1509,89,65,16,123,0,292
42129001600,1044,882,834,3,6,14,4,0,48
42129001610,1320,1100,1081,1,0,2,0,0,19
42129002170,788,675,633,6,11,10,3,0,42
42129001090,1496,1259,1170,11,48,15,8,0,89
42133000300,2121,1570,1416,45,49,37,11,0,154
42015000210,1273,1035,976,6,10,25,2,1,59
42129002480,1023,765,728,4,11,8,1,4,37
42091003810,1739,1308,1028,78,103,9,88,0,280
42091002630,3233,2495,1755,214,452,20,38,11,740
42091001540,1484,1078,901,31,31,6,104,0,177
42013000140,1119,862,764,16,63,11,1,1,98
42069002170,1281,1000,841,84,58,11,12,2,159
42071000830,1455,1027,343,449,257,23,29,3,684
42129000920,2051,1647,1593,12,17,4,9,0,54
42129000450,1801,1487,1434,9,9,14,8,0,53
42091002430,3889,2901,2486,121,124,50,103,3,415
42049001350,1956,1459,1334,36,14,46,3,1,125
42049000730,1394,957,635,91,173,29,29,1,322
42049001280,2195,1737,1552,27,36,12,92,1,185
42129000190,2596,2148,1998,29,44,24,39,2,150
42129002920,875,643,583,4,39,15,3,0,60
42125001105,890,719,659,16,24,14,2,0,60
42121000530,753,629,609,5,0,10,2,0,20
42123000030,174,149,142,4,1,3,1,0,7
42125001230,1092,915,864,13,11,12,3,2,51
42129002940,1031,789,705,16,35,13,1,0,84
42129002720,561,455,436,3,1,9,4,0,19
42095001310,1008,820,741,32,23,14,17,1,79
42049000810,1449,1237,1106,23,47,20,33,0,131
42043000330,1444,1141,320,335,483,28,17,0,821
42033000020,650,528,483,13,19,3,3,0,45
42091000055,948,729,588,22,24,7,82,1,141
42081000860,2046,1701,1596,28,21,43,10,0,105
42081000020,686,535,521,2,6,4,0,0,14
42021001525,1456,1199,1108,8,17,12,50,0,91
42041000150,201,169,165,1,0,1,1,0,4
42085000455,1213,1002,903,10,47,18,10,6,99
42085000330,1142,940,887,16,4,7,15,5,53
42033000140,821,636,603,12,8,13,4,1,33
42041000187,1741,1447,1209,45,45,12,144,0,238
42041000560,1213,961,871,43,16,15,21,0,90
42021000315,1370,1140,1097,6,7,14,12,1,43
42017001540,1371,1075,972,26,24,8,33,0,103
42017000670,1408,1160,998,93,46,16,8,0,162
42085000610,497,401,390,3,2,8,0,2,11
42085000530,2471,1868,1784,22,14,25,7,0,84
42085000270,2955,2766,2580,41,49,17,62,4,186
42017002140,2633,2064,1913,56,34,22,27,2,151
42017000210,1624,1356,965,124,142,11,113,0,391
42107000890,1957,1553,1488,8,6,27,9,3,65
42015000600,613,474,435,7,1,23,4,0,39
42015000490,1102,833,749,21,14,29,6,3,84
4200300D050,950,704,305,25,367,10,5,1,399
4200300G570,455,396,380,2,14,0,0,0,16
42003001750,653,464,224,15,215,13,1,0,240
42003001710,380,277,110,17,141,7,5,0,167
4200300G660,404,336,259,13,59,10,0,0,77
42003004520,963,702,630,28,15,6,28,0,72
42007000560,1075,894,775,25,44,18,29,0,119
42003003880,483,374,296,10,56,12,2,0,78
4200300E960,918,782,720,14,33,5,16,0,62
4200300G650,775,627,498,14,89,22,10,0,129
42003001590,451,390,366,5,3,5,8,0,24
42003002910,1299,1035,936,18,32,11,23,1,99
42003002591,1229,924,860,10,19,10,21,0,64
42003005210,1046,851,744,23,13,4,58,0,107
42003001811,603,469,406,6,34,12,6,0,63
42003003770,444,371,277,14,71,7,1,0,94
42003003400,1381,1079,943,13,20,7,84,0,136
4200300E931,1070,854,756,12,47,13,31,0,98
4200300D850,932,792,663,15,76,7,25,2,129
42003001000,1701,1310,873,32,141,18,246,1,437
42003006170,1244,1180,850,76,78,6,173,1,330
42003003900,682,548,435,12,84,15,1,0,113
4200300D870,673,555,489,7,32,5,11,0,66
42003003410,2404,1886,1606,35,46,9,183,1,280
4200300E745,1102,899,818,16,25,12,27,1,81
42073000120,301,224,207,1,2,6,1,0,17
42101003939,772,658,530,22,22,3,82,1,128
42101005406,1216,908,165,237,275,12,194,2,743
42101005404,1169,812,122,188,367,17,138,2,690
42117000420,1808,1423,1331,15,9,29,29,1,92
42011000200,314,247,230,13,0,4,0,0,17
42011001030,1330,844,183,606,105,22,7,1,661
42011001620,2041,1614,1497,70,31,16,6,0,117
42011000779,1940,1559,1087,245,126,15,94,4,472
42101003930,916,794,618,75,33,14,65,0,176
42101000314,803,652,6,9,619,8,3,1,646
42101002314,1218,916,527,258,109,11,31,2,389
42101000511,1874,1789,1121,100,284,23,279,0,668
42101000917,744,642,174,27,380,3,58,0,468
42101004610,642,567,215,25,306,14,24,1,352
42101005641,1635,1280,606,99,388,22,178,7,674
42101003306,1138,794,49,565,161,11,50,8,745
42101000611,1109,822,43,22,749,12,10,0,779
42101003631,969,773,211,56,207,8,298,2,562
42101002610,656,564,421,28,26,7,85,2,143
42101003616,624,523,114,46,317,12,51,2,409
42101002202,915,772,470,37,219,10,35,0,302
42101002001,1625,1423,519,258,449,26,226,2,904
42101001516,935,807,609,57,75,8,51,3,198
42101004318,1169,839,25,626,166,22,65,10,814
42101001405,858,723,150,95,348,29,136,0,573
42101005516,1137,789,321,112,109,3,213,3,468
42101006202,1237,835,136,338,374,32,8,2,699
42101004101,892,661,165,254,217,17,33,1,496
42101004519,965,694,105,375,224,28,9,5,589
42101002215,842,674,45,23,600,13,6,3,629
42101003302,1127,823,91,571,128,29,104,1,732
42079001852,2175,1640,1430,85,98,22,11,1,210
42079001635,1654,1322,1208,55,41,13,11,1,114
42041000030,2272,1751,1579,42,49,10,58,0,172
42073000215,1384,1122,1078,10,7,9,14,0,44
42079003170,638,531,500,4,11,3,7,0,31
42105000290,867,688,636,5,5,18,14,0,52
4200300D790,806,654,597,3,40,11,1,0,57
42003004810,590,465,232,11,210,9,6,0,233
4200300D240,734,612,489,9,88,12,13,0,123
4200300E565,996,824,769,6,12,1,36,0,55
42003005683,1111,898,647,14,196,9,21,5,251
4200300B210,663,555,361,69,103,22,12,0,194
42003004710,860,671,570,27,12,3,49,0,101
42003000781,776,603,515,12,20,7,47,0,88
42003001150,581,464,336,17,100,9,6,0,128
42003003031,882,762,671,19,26,1,30,0,91
4200300F170,749,609,576,6,8,7,10,0,33
42073000325,1418,1063,854,31,141,20,16,1,209
4200300B270,1033,829,638,56,97,23,19,1,191
42003006700,353,297,18,1,278,2,0,0,279
42101005115,849,669,35,20,610,8,3,0,634
42101005313,1356,1000,178,318,310,8,158,14,822
42101002609,900,728,679,11,8,1,25,1,49
42101006118,1233,993,44,89,567,11,305,2,949
42101001613,463,352,4,7,338,2,1,0,348
42131000250,331,273,244,15,9,5,2,1,29
42061000010,384,259,241,5,2,3,2,0,18
42117000200,680,516,476,6,5,11,2,3,40
42009000080,126,95,92,1,1,2,0,0,3
42029000381,2597,2104,1847,56,52,15,50,2,257
42077001470,3173,2457,1381,489,342,27,268,1,1076
42029000270,2037,1571,1469,31,15,6,34,4,102
42101005523,967,718,297,166,107,9,149,0,421
42101000852,1911,1820,1052,130,292,13,326,2,768
42101005525,1143,859,367,210,251,15,50,0,492
42101005403,1153,829,144,212,325,7,141,0,685
42101002816,467,347,0,22,329,1,2,0,347
42101002604,757,639,590,19,5,5,21,0,49
42101005814,808,645,469,25,20,4,114,0,176
42101005510,960,667,212,158,221,5,74,1,455
42101004005,1055,863,10,17,814,6,34,0,853
42035000170,155,135,129,0,0,6,0,0,6
42101004503,1465,1141,1063,32,19,14,7,1,78
42101005842,987,768,518,56,63,6,121,0,250
42101002319,841,627,72,149,408,13,22,0,555
42029001280,1264,975,819,17,36,11,83,1,156
42029000375,2885,2227,1863,74,77,29,142,2,364
42029001838,2760,2218,1264,64,129,25,718,0,954
42101002512,824,648,510,84,44,11,9,1,138
42101000710,1097,788,101,533,144,35,51,0,687
42101002104,1138,1042,831,61,80,3,63,2,211
42101001114,518,397,2,10,384,8,3,1,395
42041000227,1845,1530,1260,74,72,31,83,1,270
42079002005,1268,1040,1009,14,2,3,0,2,31
42035000060,1107,921,886,8,7,15,6,0,35
42101003713,605,418,6,205,226,21,1,0,412
42101003719,589,461,10,363,114,14,9,0,451
42101004320,923,670,6,486,188,24,20,3,664
42101004107,812,610,244,172,176,16,26,2,366
42101005504,1020,752,333,219,177,11,34,1,419
42101002316,1068,789,97,265,391,18,33,1,692
42101005807,835,699,463,76,32,12,120,0,236
42101003703,448,353,30,41,281,7,10,3,323
42101004710,377,320,88,22,191,5,17,3,232
42011001790,1211,1050,855,163,15,5,16,0,195
42101004816,926,723,185,40,318,12,187,4,538
42101002317,898,646,34,212,401,24,7,4,612
42101002416,437,330,25,10,288,5,11,0,305
42101000809,1476,1313,1039,68,56,15,118,0,274
42101003903,1099,879,692,51,24,7,114,0,187
42101003908,814,672,564,49,13,5,41,1,108
42101002219,742,626,63,23,530,14,12,1,563
42101000716,1015,658,42,466,160,9,15,0,616
42101000410,854,618,6,9,602,2,4,0,612
42101001119,750,547,1,16,533,1,5,0,546
42101000218,762,639,523,30,37,1,49,1,116
42101004026,978,674,40,46,523,9,82,2,634
42041000040,1032,809,684,45,42,8,28,0,125
42041000263,1964,1538,1372,36,20,6,92,0,166
42029001030,1586,1221,1071,51,29,19,46,0,150
42011000776,1607,1327,1026,183,74,26,47,4,301
42101003423,789,652,339,31,259,16,19,2,313
42089000279,2453,1930,1399,219,213,50,75,2,531
42077001260,4176,3422,3173,100,42,31,50,5,249
42089000080,2269,2117,1369,427,261,10,103,4,748
42029001812,2694,2153,1680,90,125,22,232,1,473
42077001052,1209,986,856,59,27,7,40,2,130
42045002170,1633,1301,1196,18,14,4,57,0,105
42045003600,752,550,61,47,432,10,13,1,489
42045000305,1472,1372,523,246,612,4,3,0,849
42009000220,390,317,310,1,4,1,2,1,7
42119000051,1713,1350,1200,43,24,13,51,3,150
42095001130,494,403,366,20,6,2,8,1,37
42095001070,1009,762,657,44,20,21,21,1,105
42045003740,1659,1216,153,143,720,24,207,0,1063
42029001120,899,726,645,20,31,13,17,4,81
42029000615,3279,2314,2105,60,48,51,32,1,209
42029001245,1245,878,721,9,19,4,113,0,157
42033000050,382,322,305,1,1,7,0,0,17
42019000362,3977,2959,2684,62,68,23,91,0,275
42019000363,40,25,16,4,2,3,2,0,9
42045001610,838,694,274,17,369,11,31,1,420
42045002885,1350,1025,882,30,26,11,74,0,143
42045001420,1815,1335,1275,12,9,7,22,0,60
42045002866,835,615,550,15,14,1,23,0,65
42059000190,182,152,149,0,0,3,0,0,3
42133001020,3504,2966,2617,109,129,29,74,4,349
42125000920,1040,831,793,2,32,3,0,0,38
42133000020,2888,2257,2115,22,43,46,27,3,142
42019000720,866,667,641,2,7,13,0,0,26
42019000556,1321,1088,1034,17,11,7,4,0,54
42019000557,997,814,788,8,6,7,0,0,26
42019000340,668,544,518,3,2,8,4,0,26
42019000248,2870,2382,2277,32,18,16,23,0,105
42095000100,1574,1454,695,367,129,15,213,1,759
42051000310,1527,1230,1191,5,5,21,3,0,39
42091003490,1400,1092,926,41,53,15,44,0,166
42091001670,1389,1144,881,43,63,10,145,1,263
42091001660,973,804,712,22,24,7,38,0,92
42129001330,1238,1028,945,17,29,20,1,0,83
42129001290,977,806,772,8,5,6,7,0,34
42129001780,1004,801,674,19,83,12,9,3,127
42129001870,984,813,745,9,29,8,5,0,68
42045000220,890,656,75,73,504,12,17,0,581
42045003751,291,212,70,18,117,5,13,1,142
42015000190,292,216,191,17,3,4,2,0,25
42027000750,1296,1084,894,61,50,15,62,4,190
42071001535,2018,1571,1509,23,16,6,15,0,62
42019000280,916,741,709,5,2,17,2,0,32
42021000420,328,286,273,2,1,8,0,0,13
42071000170,1439,1174,1011,110,46,4,6,0,163
42071000402,2041,1556,1328,101,37,21,68,4,228
42045002340,1259,933,767,36,21,4,95,1,166
42045001440,1673,1224,1067,24,35,6,73,1,157
42045001630,1755,1320,1019,43,213,24,22,2,301
42045003920,1049,854,47,19,781,9,12,1,807
42045003910,1161,900,71,26,813,13,7,1,829
42045001570,1121,852,347,31,456,15,21,0,505
42045002330,1179,932,778,38,27,7,80,0,154
42091003030,4002,3093,2536,105,166,46,237,2,557
42091003860,1619,1259,1082,33,37,7,91,0,177
42091002790,2234,1701,1202,277,67,22,127,1,499
42091000924,1535,1180,1088,32,16,6,32,0,92
42045003410,1381,1020,350,117,391,17,159,4,670
42045002260,2321,1692,1225,82,305,17,62,1,467
42045002520,1752,1430,1260,37,64,12,45,2,170
42045001270,1337,980,885,22,32,4,32,1,95
42045003063,1633,1374,1041,50,182,18,78,4,333
42091001810,1917,1463,1222,24,24,6,177,3,241
42091001890,1722,1402,1202,66,42,25,62,2,200
42027000470,578,445,411,8,12,12,0,0,34
42091003821,1387,1070,847,41,87,4,86,0,223
42059000455,1198,939,856,26,29,21,6,1,83
42049000350,952,692,324,138,175,12,53,0,368
42049001360,442,365,351,2,1,9,1,0,14
42013000100,1071,833,754,20,33,17,1,1,79
42013000970,1437,1137,1093,26,4,7,5,0,44
42013000532,1669,1325,1267,10,10,12,18,1,58
42013000556,1743,1396,1335,17,7,12,22,1,61
42059000260,13,9,9,0,0,0,0,0,0
42025000330,1628,1300,1202,53,6,12,15,0,98
42017000080,2091,1691,1209,182,72,23,204,1,482
42017002650,1896,1538,1369,56,36,8,46,4,169
42017000400,2869,2270,1483,334,299,50,132,1,787
42017001020,1538,1194,1028,42,51,22,45,0,166
42097000020,1197,993,927,34,20,6,4,0,66
42125000440,907,733,695,11,12,11,2,0,38
42017002470,1594,1284,1186,37,30,10,24,2,98
42049000740,1121,857,628,55,131,16,19,1,229
42091000720,1643,1261,267,101,666,18,223,0,994
42091002530,2923,2326,1671,105,258,13,272,1,655
42091003665,3110,2409,1990,84,75,17,239,6,419
42091001944,1751,1372,1148,71,62,22,69,1,224
42091003040,1210,909,744,21,61,5,82,0,165
42129002230,1613,1285,1228,14,9,16,15,0,57
42071000450,2239,1462,1410,25,5,21,4,0,52
42049000760,913,754,673,27,20,11,17,0,81
42049000450,957,597,124,68,371,3,30,7,473
42049000380,1920,1806,1366,87,265,30,54,1,440
42107000415,579,488,450,23,7,12,0,0,38
42043000880,2238,1775,1172,166,241,40,175,3,603
42043000640,2554,1964,752,219,545,22,462,0,1212
42043000370,1429,1142,209,202,710,18,38,1,933
42071000778,1489,1065,76,833,238,23,8,2,989
42071000810,1398,1109,365,471,235,18,55,2,744
42011000054,2784,2113,1847,69,112,29,53,1,266
42071000660,998,835,562,165,74,11,32,2,273
42047000170,470,367,347,7,2,4,0,1,20
42039000580,212,162,145,0,1,4,3,0,17
42039000540,326,233,217,2,1,7,0,0,16
42049000120,204,154,150,0,1,2,0,0,4
42129002490,809,652,624,1,9,14,0,0,28
42039000230,1428,1112,1008,9,41,20,9,0,104
42121000170,611,490,468,3,3,9,2,0,22
42017001184,2595,1944,1754,37,45,23,67,0,190
42017001550,1177,893,801,27,23,12,23,0,92
42005000740,594,504,488,0,3,3,3,0,16
42037000500,976,791,754,11,3,12,3,3,37
42021001055,1719,1053,638,46,358,20,9,4,415
42013000120,1000,825,775,11,12,7,11,0,50
42005000650,1286,1053,1028,5,4,9,2,0,25
42133001430,686,485,400,34,20,38,2,0,85
42133000060,1434,1133,1063,22,18,29,0,6,70
42019000060,2352,1834,1756,16,8,22,18,1,78
42125001040,421,357,344,5,2,6,0,0,13
42125000880,267,218,205,3,1,5,0,1,13
42017001980,2673,2016,1725,66,33,17,162,3,291
42017001520,3236,2632,2316,73,83,45,101,2,316
42017001390,2498,2125,1725,70,79,39,195,3,400
42047000250,1341,1048,1010,5,4,13,9,1,38
42047000262,1517,1185,1150,5,11,8,5,1,35
42037000540,1161,936,898,9,2,14,6,0,38
42071000850,1378,958,391,347,194,23,40,2,567
42005000550,963,825,794,1,10,13,1,0,31
42115000210,311,235,227,1,1,3,0,0,8
42069000700,852,715,585,16,32,4,78,2,130
42069000275,1176,896,788,55,37,4,6,1,108
42069001805,1620,1301,961,166,139,25,40,0,340
42069000665,1221,1013,910,51,36,6,13,0,103
42069000840,580,476,432,14,9,19,1,3,44
42069000620,1286,1060,946,28,41,12,28,1,114
42125001590,481,400,369,9,9,5,1,0,31
42069001120,1088,938,842,41,14,15,19,0,96
42017000810,2911,2278,2015,89,25,22,78,0,263
42091002895,1194,992,727,25,84,3,151,0,265
42091001780,1357,954,705,28,65,7,152,1,249
42091003223,4019,3457,2597,92,208,22,509,3,860
42105000200,325,276,263,6,0,4,4,2,13
42115000290,284,243,235,1,3,2,1,0,8
42115000410,438,353,331,11,3,4,0,0,22
42091000890,1608,1383,909,68,254,8,140,1,474
42091001985,2547,2010,1630,54,81,17,213,2,380
42091003646,2468,1882,1367,34,126,23,326,0,515
42091002795,1574,1230,955,22,51,14,179,0,275
42091001170,1318,1018,834,43,93,9,36,2,184
42017001110,1331,1006,850,58,42,18,33,2,156
42017000585,2154,1785,1454,88,112,29,101,1,331
42017001250,1496,1304,1086,38,90,9,74,0,218
42039000520,752,613,595,4,6,3,0,0,18
42003004610,731,557,519,12,6,0,17,0,38
42015000340,603,459,415,5,12,16,3,1,44
42015000470,724,541,493,8,6,25,10,0,48
42003003430,1255,989,907,10,12,7,40,1,82
4200300D970,999,801,728,30,36,5,3,0,73
4200300A540,1011,979,791,45,53,11,58,5,188
42003000891,1154,955,894,14,25,8,8,0,61
4200300F171,889,732,693,17,7,4,10,0,39
42121000010,284,223,210,1,1,10,0,0,13
42043000761,2622,2080,1712,63,150,20,140,4,368
42133001413,1725,1491,1056,172,163,13,104,1,435
42091002755,3717,2786,2440,70,88,32,155,0,346
42071000431,1471,1236,904,116,57,17,142,0,332
42085000755,1075,879,796,21,38,14,12,3,83
42049000200,1795,1143,574,140,312,24,102,1,569
42049000980,3167,2783,2323,126,302,57,31,5,460
42101003435,589,422,0,20,407,6,1,3,422
42129000080,571,435,249,6,161,4,6,4,186
42101002716,672,575,150,22,339,18,60,3,425
42101000233,1120,939,692,62,77,14,91,0,247
42101006511,1103,878,416,132,280,9,56,2,462
42101006516,1010,758,402,157,183,10,31,2,356
42101000316,922,734,14,27,697,9,5,0,720
42101004003,1090,804,12,51,737,25,14,4,792
42101006219,956,720,255,277,169,17,25,1,465
42101004115,1070,791,352,170,256,25,29,1,439
42047000395,1105,905,867,7,1,8,11,0,38
42011000130,2128,1647,1458,81,50,33,7,1,189
42117000120,189,160,149,0,0,7,1,0,11
42051000020,534,453,403,6,31,13,0,0,50
42007000420,745,620,527,9,46,13,15,1,93
42099000090,379,322,296,9,8,7,0,0,26
42099000280,73,64,59,3,0,0,2,0,5
42007000490,1326,1084,973,29,41,27,8,1,111
42007000520,2390,1863,1684,25,94,31,17,0,179
42007001500,160,121,118,0,0,3,0,0,3
42007001330,1240,969,934,10,8,5,4,0,35
42003005120,247,181,109,2,64,2,7,0,72
42003004090,1242,1045,862,25,76,8,79,1,183
42003001073,675,574,528,0,20,10,15,1,46
42003004301,3437,2621,2072,82,185,34,231,3,549
4200300A390,905,756,554,27,150,21,10,0,202
42003006000,826,749,320,30,205,7,200,2,429
4200300B150,878,698,534,46,100,9,4,0,164
42003000130,971,806,763,5,22,3,13,3,43
42003001371,724,635,530,17,81,12,0,0,105
4200300C560,506,418,69,17,334,4,0,0,349
42003002274,847,732,620,20,60,16,18,0,112
4200300A740,1240,1112,878,46,165,15,12,2,234
42003002440,693,564,520,11,23,3,4,1,44
42003005680,895,769,595,11,135,16,2,0,174
42003005560,818,654,342,10,279,9,14,1,312
42003005785,2324,1510,1253,55,36,16,125,1,257
42003005521,613,449,205,9,234,12,2,0,244
42003001331,737,584,385,50,124,4,8,0,199
42003008530,147,121,13,0,91,0,16,0,108
4200300D730,757,635,575,9,26,12,13,2,60
42003006675,780,719,586,29,66,13,24,0,133
42003008630,457,362,8,6,347,6,0,0,354
42003008950,534,325,3,3,317,4,1,0,322
4200300G858,900,724,671,5,13,2,28,0,53
42055000350,1507,1139,991,42,68,17,13,0,148
4200300G590,990,805,710,28,37,15,18,1,95
42003006110,907,855,505,46,202,11,100,0,350
42003002930,2030,1530,1269,19,43,19,173,2,261
42003000361,1468,1239,956,42,182,29,26,2,283
42003000711,628,458,112,8,338,9,3,0,346
4200300E381,3166,2683,2311,75,73,13,185,0,372
42003002710,1101,848,726,12,75,21,6,0,122
42003005382,2371,1956,1804,26,58,9,52,3,152
42101005225,939,742,8,26,708,3,11,1,734
42101004027,740,530,25,34,468,4,11,0,505
42101000220,740,657,400,29,125,9,99,2,257
42101000608,515,404,37,9,336,3,21,1,367
42101001216,985,796,207,38,544,4,13,1,589
42101005909,720,506,20,10,470,6,11,0,486
42101003308,1121,795,91,506,186,11,54,6,704
42101004301,626,480,17,53,409,17,1,1,463
42101004905,1093,817,11,86,726,8,11,3,806
42101003413,911,722,33,24,679,4,2,1,689
42101000915,791,632,433,44,121,11,30,0,199
42101006304,1228,942,594,113,83,8,146,0,348
42101005631,1462,1177,742,60,99,16,238,1,435
42101005706,1930,1648,955,174,355,12,180,3,693
42027000720,1703,1511,1241,63,39,16,147,3,270
4200300G881,977,845,622,20,176,18,19,0,223
4200300G891,838,721,569,3,124,4,13,0,152
4200300G901,588,555,313,7,170,2,62,0,242
42003005641,927,764,366,22,348,9,12,4,398
4200300A800,463,324,148,20,142,4,5,3,176
42003004890,764,645,626,7,5,1,1,0,19
42003000081,1009,821,650,14,136,3,13,1,171
42095000180,1280,1020,609,264,129,21,19,0,411
42131000060,396,299,282,4,3,3,6,2,17
4200300F060,857,659,595,6,12,3,29,1,64
4200300E065,1593,1270,1176,20,32,16,19,0,94
42003000305,1476,1169,888,7,36,13,221,1,281
4200300A890,918,838,729,26,44,7,22,0,109
42003003800,708,568,472,4,85,5,2,0,96
42003002411,760,576,430,28,101,13,4,1,146
4200300E220,505,391,68,14,306,7,3,0,323
42003007970,674,558,205,24,324,5,5,0,353
4200300E055,1168,921,825,19,47,23,14,0,96
42003007200,1581,1499,1006,93,67,4,316,1,493
4200300E151,1084,832,722,11,61,18,9,1,110
42101001510,1425,1145,565,82,414,21,87,1,580
42101006001,881,786,184,60,409,17,131,4,602
42101002405,1105,1050,635,70,174,6,177,0,415
42101000209,864,751,417,66,189,8,72,0,334
42101005709,756,605,340,60,109,0,84,0,265
42101001218,831,608,64,15,511,18,3,1,544
42101001221,641,521,37,23,466,14,4,1,484
42101001306,898,630,12,23,595,10,1,0,618
42003009330,841,764,453,21,234,5,44,0,311
42003008710,304,235,1,3,232,1,1,0,234
42003009070,841,594,24,2,568,3,1,0,570
42101001719,524,410,3,12,398,8,2,1,407
42101003440,721,563,50,17,487,1,10,2,513
42101005213,908,752,78,20,637,8,28,0,674
42101003634,848,753,388,82,205,13,72,0,365
42101003304,921,693,119,403,116,30,81,2,574
42003004910,698,587,566,1,14,7,1,0,21
42101002102,1243,1119,909,52,75,13,73,2,210
42101005113,798,605,18,17,567,12,9,0,587
42101005102,612,483,61,16,385,3,11,0,422
42101000905,985,835,575,46,171,9,41,2,260
42101000908,597,489,420,13,22,5,25,0,69
42101003812,1049,983,630,79,222,7,64,1,353
42101002212,746,592,59,14,499,15,8,0,533
42101002226,778,633,42,14,577,4,9,0,591
42101006005,980,792,54,22,678,32,26,0,738
42101003211,1016,830,273,63,471,12,26,1,557
42101001806,1033,907,758,42,15,10,74,0,149
42101004021,981,701,32,62,389,5,229,0,669
42101003620,673,540,204,22,288,10,25,2,336
42101002224,722,578,181,20,369,16,15,4,397
42101004404,678,489,16,15,462,4,5,0,473
42029001641,3133,2402,2054,105,70,13,156,1,348
42029001550,3441,3293,2617,186,362,25,120,3,676
42029000345,897,893,881,0,4,0,8,0,12
42101005114,922,793,262,59,456,15,39,0,531
42101004201,1815,1261,137,811,344,45,40,9,1124
42101004205,1566,1163,98,688,362,16,77,4,1065
42101003109,940,823,510,151,87,7,65,3,313
42101004707,807,677,228,35,390,6,27,0,449
42101001702,611,485,6,11,471,5,0,0,479
42091001640,1909,1468,1182,52,90,11,129,1,286
42091002780,2466,1904,1494,181,84,19,122,0,410
42101002311,1361,1019,58,568,332,16,119,4,961
42101003943,653,563,479,31,4,1,43,1,84
42101000101,809,670,413,110,25,8,122,0,257
42101002414,676,512,9,17,493,4,3,0,503
42101002415,401,293,19,8,264,2,5,1,274
42101006109,1221,889,60,127,575,14,145,0,829
42107001375,826,596,399,163,28,12,4,0,197
42107000750,347,293,283,4,3,3,0,0,10
42101002509,806,565,183,240,138,15,16,3,382
42101005822,830,674,472,46,23,6,127,1,202
42101005826,946,751,521,42,11,7,170,0,230
42091003831,1336,1109,916,15,43,8,115,3,193
42091002190,2555,2039,779,335,843,31,69,4,1260
42079002885,2197,1674,786,472,401,53,43,9,888
42101002115,1109,929,760,32,91,10,33,0,169
42101005805,2206,1845,1262,90,208,5,275,0,583
42101005319,1100,848,246,140,232,9,212,1,602
42003009030,337,259,10,12,240,9,0,0,249
42003000010,1825,1610,1510,24,27,6,19,0,100
42003003730,495,360,99,9,251,10,1,0,261
42003006420,344,326,178,30,41,1,75,0,148
42003008110,723,583,390,22,128,9,26,0,193
42003006410,1317,1270,647,28,212,9,366,2,623
42003008570,327,253,6,14,225,3,0,0,247
42003004900,1226,1012,921,19,42,16,4,0,91
4200300F230,601,511,479,6,10,6,15,0,32
42101003910,1294,1007,261,225,226,15,304,1,746
42101001725,671,520,4,28,484,2,11,0,516
42003009920,649,562,418,21,43,6,67,2,144
42003006090,523,492,316,29,120,6,13,1,176
4200300F740,1069,840,323,14,476,17,18,2,517
42003001610,929,751,633,37,38,12,28,3,118
42111000400,1345,1101,1082,5,2,5,3,0,19
42101006608,1969,1532,856,207,421,24,52,0,676
42101005711,983,768,566,101,72,6,33,1,202
42013000090,1172,889,745,12,88,26,9,1,144
42041000827,1371,1223,1167,19,13,7,15,0,56
42003001210,675,553,357,16,167,13,2,1,196
42113000100,111,96,91,2,1,2,0,0,5
42101006322,1062,874,615,23,99,3,132,1,259
42101005638,973,774,346,75,181,1,157,0,428
42049000550,993,807,725,24,34,11,9,1,82
42049000250,1024,882,438,92,304,9,36,0,444
42049000110,3415,2932,2537,91,227,53,39,2,395
42077000530,3113,2249,497,1436,334,44,73,3,1752
42077001060,1432,1212,1051,70,44,9,33,1,161
42003003237,1241,936,767,14,11,1,140,0,169
4200300E455,1149,877,758,30,17,14,55,0,119
42029000110,1342,943,276,234,414,33,9,4,667
42029000020,1274,894,295,509,71,17,13,5,599
42063000702,1866,1508,1204,36,120,18,113,0,304
42029001890,828,684,524,17,62,2,74,0,160
42017002100,1705,1313,1172,36,25,2,69,0,141
42045001930,1946,1764,1453,59,128,11,80,1,311
42045001410,1328,998,907,23,22,8,25,1,91
42045002072,1224,899,769,23,27,3,59,0,130
42045002075,1022,845,710,14,70,3,29,1,135
42017002183,2973,2280,1925,195,33,24,83,1,355
42045002290,1287,1029,739,104,130,34,42,1,290
42045000140,1124,890,740,28,79,14,28,0,150
42045001350,1170,898,784,25,29,2,41,2,114
42045001250,1091,839,754,20,19,2,40,1,85
42045003440,912,702,381,39,136,13,138,1,321
42045002830,1023,795,721,16,21,7,29,0,74
42045002820,938,738,590,23,66,8,49,2,148
42019000359,3296,2684,2390,72,50,10,138,2,294
42019000358,309,238,164,21,25,10,21,1,74
42019000354,685,539,466,12,22,6,29,1,73
42019000200,2145,1826,1716,27,24,26,21,1,110
42071000140,1323,1011,742,162,90,17,15,0,269
42043000590,2383,1872,1546,82,132,34,83,0,326
42045001020,1127,812,559,38,163,34,15,0,253
42045003500,710,558,284,30,205,7,39,3,274
42045003540,891,682,405,43,187,5,49,3,277
42045002921,1712,1291,1086,16,13,5,152,0,205
42045002928,838,656,543,10,49,22,29,1,113
42045002010,1296,986,874,27,21,2,54,1,112
42019000120,964,749,681,14,14,15,7,6,68
42019000640,1123,901,863,10,4,8,8,1,38
42025000200,1160,873,717,72,46,18,14,4,156
42085000670,1641,1271,1177,18,25,31,6,1,94
42049000710,1275,1009,802,49,93,20,27,0,207
42125000580,1210,948,871,23,25,11,3,0,77
42125000430,316,235,216,2,14,1,3,0,19
42123000100,481,412,395,0,0,4,4,0,17
42125000860,1853,1560,1311,65,123,27,24,1,249
42125000980,852,702,660,11,4,10,6,0,42
42085000415,784,653,584,7,32,7,19,0,69
42111000300,1457,1201,1159,8,3,17,3,0,42
42027000030,964,811,725,23,37,14,11,0,86
42017001915,3961,3144,2640,101,40,18,322,1,504
42017002720,1742,1345,803,229,189,18,89,2,542
42119000100,845,636,544,46,19,7,12,0,92
42095000400,1937,1488,1378,47,22,28,15,0,110
42091000830,3166,2362,2083,121,70,43,55,0,279
42091000225,1241,920,810,21,46,5,37,0,110
42017000598,1813,1563,1224,97,129,17,89,0,339
42043000711,3182,2513,1626,131,371,33,353,0,887
42017002430,2282,1822,1564,88,101,30,43,1,258
42017001410,1804,1417,1249,63,27,25,62,2,168
42109000100,889,691,662,5,3,11,4,1,29
42069002240,694,601,501,45,13,5,39,0,100
42043000480,1200,857,136,199,540,17,16,4,721
42043001040,1403,1125,1033,23,33,12,25,1,92
42071000980,772,622,550,21,15,7,24,1,72
42017000410,2449,1966,1094,169,459,23,229,0,872
42017000910,1315,1128,980,54,26,6,54,0,148
42069002390,923,714,649,22,18,17,10,0,65
42121000695,1187,967,929,7,3,16,3,0,38
42129002060,1389,1089,1028,10,12,8,16,0,61
42069000635,1433,1205,1118,47,18,9,8,0,87
42071001270,2080,1599,1366,43,23,11,136,0,233
42091003790,2898,2275,1879,81,118,20,168,0,396
42091002990,1819,1520,1298,26,58,8,120,1,222
42129002150,789,647,616,10,0,3,8,0,31
42129000530,461,372,305,14,39,8,6,0,67
42017000350,1111,878,633,114,61,27,50,1,245
42041000281,3141,2240,1768,57,21,9,373,1,472
42129000550,1235,1035,958,14,40,8,15,1,77
42129000990,486,397,355,4,14,11,10,0,42
42129002730,1789,1387,1245,14,75,17,15,2,142
42129002340,2754,2217,2117,20,26,19,24,0,100
42129000980,581,461,415,8,23,4,9,2,46
42129000970,570,432,392,5,15,8,11,0,40
42091001390,2056,1490,1254,54,38,8,123,0,236
42091003050,1285,1067,894,42,44,4,69,0,173
42069001365,1410,1083,880,97,72,11,21,1,203
42071001030,1411,1151,877,131,107,15,38,5,274
42071000275,2143,1733,1591,47,24,22,41,1,142
42071001735,1639,1328,1197,71,17,12,22,1,131
42015000480,972,733,656,29,17,20,4,0,77
42069001650,1344,1067,732,99,79,6,141,1,335
42109000020,501,403,394,4,0,5,0,0,9
42129001120,973,783,736,5,22,6,8,1,47
42091001440,1323,1165,1010,12,43,2,94,0,155
42111000650,1087,870,820,11,10,14,0,0,50
42111000190,100,89,87,0,0,1,0,0,2
42049001305,3148,2530,2306,51,65,17,80,0,224
42129001820,1236,1068,953,15,67,11,17,1,115
42043000620,2313,1851,987,174,456,32,228,1,864
42095000690,2229,1800,1587,105,32,30,39,2,213
42095000667,2128,1748,1343,108,83,18,208,0,405
42071001960,2624,1914,1735,85,48,19,26,2,179
42071001935,1776,1341,989,153,85,19,97,3,352
42091001430,1207,878,752,15,20,2,84,0,126
42091001040,3496,2713,1593,235,183,46,682,3,1120
42091002800,1960,1697,1361,62,193,9,57,1,336
42041000202,1980,1579,1343,32,63,15,106,1,236
42041000251,1275,998,923,28,16,8,22,1,75
42111000490,949,820,778,6,0,24,5,1,42
42017002680,1764,1579,1460,43,20,13,40,0,119
42085000030,458,385,361,3,7,10,0,0,24
42017002730,1382,1109,981,49,15,11,39,4,128
42003002750,1013,843,782,12,11,15,9,1,61
42003003140,773,625,599,1,4,5,10,0,26
42007001410,1445,1211,1160,11,5,20,6,1,51
42099000170,691,531,490,14,10,9,9,0,41
42007001430,848,731,633,10,50,21,6,0,98
42007000820,208,146,140,2,0,2,0,0,6
42003007290,755,686,604,20,33,3,24,4,82
42003004490,1333,1156,998,11,12,9,123,0,158
4200300F940,493,388,334,8,36,8,4,0,54
42003008650,525,381,18,1,358,6,0,0,363
42003000231,1106,906,714,5,39,10,141,0,192
4200300F780,953,842,518,36,264,9,21,0,324
4200300F610,676,512,347,9,135,10,9,0,165
42003005815,1382,1011,871,15,25,6,74,0,140
42003003930,482,381,333,6,29,2,4,1,48
42003000990,630,540,503,8,11,3,11,0,37
4200300D440,890,728,519,21,124,12,53,0,209
4200300A020,720,596,550,14,7,7,16,1,46
42003007350,783,721,548,51,48,6,65,0,173
42003005760,807,675,599,8,58,3,1,0,76
42073000415,1352,1078,862,79,134,33,2,2,216
42061000080,135,103,100,1,0,0,0,0,3
42011000270,2248,2000,1765,91,75,13,53,2,235
42031000170,181,148,147,0,0,1,0,0,1
42067000100,840,639,470,153,7,8,2,0,169
42101002004,985,772,120,137,499,8,35,0,652
42101000617,762,593,41,7,545,5,4,1,552
42101004609,712,608,340,43,175,9,37,0,268
42101004622,1424,1212,532,68,474,11,134,1,680
42101006635,1120,913,759,64,46,7,40,0,154
42101003637,885,806,312,105,287,16,105,0,494
42101003529,1293,933,56,368,226,17,310,1,877
42101001107,659,499,2,13,483,7,1,0,497
42101002504,820,702,594,45,31,7,16,5,108
42101003111,1096,905,464,135,68,14,217,1,441
42101000206,863,732,540,49,31,7,109,2,192
42101004048,916,724,106,20,548,4,42,1,618
42101002612,806,670,534,52,47,11,31,2,136
42101005719,737,576,475,46,41,8,10,0,101
42101002309,873,661,182,137,342,19,18,6,479
42101004303,979,728,25,519,206,13,13,3,703
42101000418,831,646,5,17,624,10,6,2,641
42101001022,604,489,4,11,477,13,3,1,485
42101002302,1022,697,177,245,262,20,19,10,520
42101004312,810,588,11,478,125,20,7,0,577
42101001204,726,550,36,13,497,3,3,0,514
42101002704,593,436,9,24,395,10,10,1,427
42101005410,1263,921,148,174,165,7,408,0,773
42079000088,246,208,189,10,7,2,0,2,19
42079000025,872,712,633,39,25,13,4,0,79
4200300C990,727,618,410,12,160,8,15,0,208
4200300C220,513,445,354,6,72,11,6,0,91
42003005301,657,545,506,7,19,6,5,0,39
42003005620,864,664,313,11,324,13,12,0,351
4200300G860,1111,894,641,16,198,10,33,0,253
42003006460,490,367,22,2,343,2,0,0,345
42003009800,962,775,522,24,34,14,172,2,253
42073000750,664,535,514,5,8,0,4,1,21
42101004014,1190,838,59,26,626,7,130,0,779
42101005509,908,637,222,213,108,9,89,1,415
42101005501,1012,747,278,223,220,15,39,2,469
42101001807,878,732,634,38,16,8,32,2,98
42101003409,666,502,8,19,478,12,2,0,494
42101002810,562,415,6,17,394,12,2,2,409
42061000290,200,164,148,0,9,5,0,0,16
42029001965,1937,1624,1390,17,59,8,145,2,234
42079002765,1476,1139,550,325,269,31,24,3,589
42105000320,599,456,436,4,3,5,1,1,20
42101005506,1023,714,309,205,180,14,39,1,405
42101006644,792,628,547,27,14,2,37,1,81
42101002006,829,723,83,45,526,5,83,2,640
42101002141,1080,898,601,75,177,5,45,1,297
42079002035,1805,1522,1351,65,85,20,25,1,171
42079002540,1057,858,778,32,23,7,6,0,80
42101000806,1015,977,817,42,27,6,90,1,160
42101001004,753,630,11,13,603,12,5,0,619
42101003525,859,639,119,143,320,16,65,7,520
42101000519,1914,1780,1565,54,45,4,108,0,215
42101004704,434,363,114,36,185,10,35,0,249
42113000120,227,180,167,2,1,6,1,0,13
42079003075,1730,1441,1200,93,88,18,57,5,241
42035000010,229,178,175,0,1,1,1,0,3
42101003517,1052,714,66,218,423,10,21,1,648
42117000330,178,139,133,2,2,4,0,0,6
42029000870,1206,874,758,18,8,2,63,6,116
42101000415,982,718,4,22,688,26,7,1,714
42101000804,1284,1182,969,66,25,6,115,1,213
42101004501,1077,794,718,32,12,13,13,2,76
42101003916,876,676,271,136,67,9,189,2,405
42101002713,1526,1323,490,97,276,5,461,1,833
42101004608,1154,1054,542,96,356,11,66,1,512
42101004918,947,788,42,32,713,11,14,0,746
42101001224,938,704,55,50,595,9,6,1,649
42101002703,1294,1270,438,99,105,9,629,2,832
42101000319,904,667,7,10,632,35,12,1,660
42101003228,640,485,2,20,463,5,4,0,483
42101000901,682,584,261,14,303,7,11,0,323
42101001519,869,730,622,40,24,7,37,1,108
42101004920,928,753,20,33,691,14,12,0,733
42101004217,1011,746,36,315,328,12,94,2,710
42101001210,981,611,14,12,577,11,8,0,597
42101003209,1263,1048,331,68,586,22,58,0,717
42045000940,2183,1425,143,42,1253,20,5,3,1282
42011000970,2890,2185,481,1395,418,75,13,5,1704
42101005018,797,649,7,11,620,8,10,0,642
42101003231,584,478,64,8,408,15,2,0,414
42063000200,268,214,207,2,0,4,2,1,7
42063000590,102,74,69,0,0,1,1,0,5
42029001416,1198,896,821,19,16,3,34,0,75
42077000150,1472,1036,174,746,149,17,34,3,862
42045002120,1006,794,745,7,9,8,20,2,49
42133000030,1112,856,819,12,5,5,7,1,37
42045001820,1361,1064,929,16,9,9,93,2,135
42045001280,1574,1415,1309,15,17,0,72,1,106
42045001590,681,505,130,25,334,5,17,0,375
42051000381,449,338,308,3,13,6,0,0,30
42027000530,765,608,603,4,1,2,0,0,5
42011000052,2333,1850,1579,80,118,19,42,0,271
42029000291,1911,1554,1334,23,56,11,125,0,220
42045003890,1875,1532,175,57,1252,10,47,1,1357
42123000290,564,438,415,1,9,7,1,0,23
42019000710,537,491,476,8,0,2,3,0,15
42111000460,14,14,14,0,0,0,0,0,0
42095001290,1533,1278,1183,33,27,12,20,0,95
42091001230,1329,1075,749,71,100,16,133,0,326
42129001270,2187,1769,1682,19,33,20,11,0,87
42115000060,679,557,543,4,2,6,3,2,14
42091003060,1245,971,851,18,36,6,45,1,120
42013000910,753,590,549,8,13,11,8,0,41
42045003531,1166,847,92,79,564,14,106,1,755
42045001800,1098,887,731,20,22,5,104,1,156
42045002775,1110,858,801,12,20,2,16,6,57
42045001130,598,453,376,5,44,6,16,1,77
42045001210,1379,1044,887,22,65,3,58,1,157
42085000125,1170,818,286,4,508,12,6,5,532
42133000270,501,394,375,4,4,12,0,0,19
42095001230,4510,3494,2965,218,114,24,170,2,529
42027000010,631,542,501,10,6,11,1,3,41
42027000730,1470,1404,810,78,75,8,439,0,594
42069002205,1368,1045,955,42,29,5,16,2,90
42107001672,1895,1522,1451,23,12,15,18,0,71
42025000100,1413,1145,1092,18,9,5,6,0,53
42129000590,950,756,629,16,68,16,9,3,127
42087000140,564,403,376,3,8,6,7,0,27
42125000890,945,751,683,1,37,20,0,0,68
42129001510,1072,955,911,7,27,5,3,0,44
42091002830,1115,881,628,25,174,12,34,1,253
42129002840,1103,885,831,7,10,11,14,0,54
42095000210,2297,2024,1712,144,74,18,77,1,312
42015000080,629,509,480,3,4,6,11,0,29
42049000700,1482,1134,912,66,118,20,14,0,222
42049001270,1203,934,815,31,27,7,45,0,119
42071000940,704,559,238,206,91,18,24,0,321
42049001230,1212,974,892,36,14,11,12,1,82
42129001860,726,608,533,15,37,16,7,0,75
42107000645,1370,1036,753,230,32,19,13,0,283
42043001340,1682,1384,1292,36,21,23,10,0,92
42129000750,374,310,285,8,5,7,6,0,25
42043000690,1745,1346,1047,67,139,12,70,2,299
42071001926,1270,1003,955,10,10,11,15,0,48
42129001660,1864,1445,1328,13,26,7,69,1,117
42129003020,800,651,610,4,22,3,2,0,41
42129002620,591,498,478,0,7,4,1,0,20
42039000160,1011,787,759,4,1,9,6,0,28
42017002025,1917,1568,1433,49,14,5,45,2,135
42017002115,1892,1491,1344,40,7,10,80,0,147
42051000480,2580,2457,1266,130,1043,15,3,0,1191
42013000900,795,660,630,11,4,8,1,0,30
42005000330,1378,1148,1068,7,15,32,3,0,80
42017002300,2213,1722,1495,89,81,24,39,3,227
42115000190,508,413,394,6,0,3,3,0,19
42125001530,616,528,505,9,5,1,7,0,23
42071000605,1291,999,889,45,17,7,32,2,110
42069000355,515,383,320,28,22,7,6,0,63
42069000495,1253,1063,941,51,37,6,20,1,122
42091001085,2068,1649,1375,38,75,22,136,1,274
42091000732,1052,795,657,25,20,0,81,2,138
42125001900,669,547,434,11,75,9,13,0,113
42017002787,2655,2059,1751,73,45,13,160,1,308
42091003650,1350,1159,880,80,148,16,44,0,279
42021000200,539,426,408,5,2,5,2,0,18
42021001920,729,647,599,14,8,14,1,0,48
42065000330,284,218,212,1,2,1,0,1,6
42015000070,608,450,409,9,6,11,9,1,41
42003002830,344,261,33,8,216,5,1,1,228
42003003191,1153,942,902,13,10,14,1,0,40
42071000800,1470,1034,112,719,272,41,14,3,922
42121000550,846,655,615,5,9,8,7,0,40
42063000540,467,363,349,4,0,3,0,0,14
42071001240,1692,1384,1193,77,64,17,29,0,191
42071001180,2719,2217,1640,140,128,26,295,0,577
42133001386,2059,1590,1022,265,256,14,49,3,568
42083000350,858,667,629,3,5,23,2,1,38
42133000750,806,562,522,8,13,11,4,0,40
42091001785,1258,929,753,22,16,10,125,1,176
42107001762,2004,1665,1592,28,10,14,13,1,73
42047000375,1451,1166,1091,17,7,17,17,1,75
42083000130,723,602,574,1,6,10,2,1,28
42049000090,570,415,403,2,1,7,3,0,12
42011000885,2869,2070,347,1538,291,63,17,4,1723
42101001021,1080,802,12,42,758,8,4,0,790
42101004121,953,651,281,151,188,8,44,1,370
42101004125,1135,795,372,173,192,12,56,3,423
42101006639,878,721,547,55,76,3,41,0,174
42101004122,839,584,261,127,138,16,50,1,323
42121000070,399,309,302,3,0,5,0,0,7
42063000720,1196,1012,921,10,22,12,46,2,91
42003002690,763,624,607,1,4,4,3,0,17
42003002043,1994,1621,1519,9,49,24,8,0,102
4200300G460,1179,920,730,29,138,15,10,0,190
42003009310,904,696,601,16,16,7,41,0,95
4200300F960,466,380,357,8,3,1,10,2,23
42003000161,1365,1090,1010,9,23,3,44,2,80
42003004470,819,629,573,8,10,8,22,0,56
4200300G180,1685,1266,1050,19,11,7,158,0,216
4200300F090,720,596,566,5,11,2,5,0,30
42003003250,1376,1229,977,32,132,17,56,2,252
4200300H031,868,709,214,23,461,22,12,1,495
4200300F371,1137,959,809,33,75,18,21,3,150
4200300F141,514,438,411,7,12,1,4,1,27
42003005750,1120,905,660,19,191,24,9,1,245
42003005681,906,754,476,11,240,15,18,0,278
42003003690,463,330,134,14,179,8,0,2,196
4200300D890,402,346,271,12,48,3,14,0,75
42003000602,581,456,408,21,7,7,12,0,48
42003003210,932,823,786,5,1,12,0,1,37
42003002400,873,709,653,11,32,9,3,1,56
42003005410,980,806,96,10,695,14,7,0,710
42003009050,265,220,4,3,209,5,8,0,216
42003002251,818,705,561,14,110,5,12,0,144
4200300G380,1037,830,714,9,91,9,8,1,116
42003001670,428,382,365,1,12,2,0,0,17
42003008280,631,522,461,14,9,0,32,1,61
42003003990,713,618,545,23,26,18,3,0,73
42003008320,829,651,491,25,91,10,33,0,160
42003004820,630,460,248,10,187,9,7,0,212
4200300G000,602,463,279,5,153,14,14,1,184
42003002344,1037,750,682,8,11,1,43,1,68
42001000030,736,519,333,163,7,11,0,2,186
42101002125,1001,828,640,51,99,7,43,4,188
42101004017,845,604,36,28,478,9,66,0,568
42101005012,819,663,18,10,633,18,3,1,645
42101005005,773,643,8,8,623,8,8,1,635
42101004603,811,688,265,48,364,11,15,1,423
42127000155,1378,1089,974,43,31,18,12,1,115
42101001001,733,572,0,5,570,6,1,0,572
42101001026,808,635,4,9,616,5,1,1,631
42101001811,956,803,683,48,30,9,36,0,120
42003000331,1245,1041,820,20,143,14,21,3,221
42003004971,720,539,299,5,221,12,9,0,240
42003007430,1095,1071,683,37,84,8,259,3,388
4200300F392,708,570,543,3,7,5,12,0,27
42003001980,737,606,581,2,10,5,1,0,25
42003000211,1178,961,838,5,15,11,79,7,123
42003000901,1288,1103,988,23,60,9,21,1,115
4200300F680,495,446,415,5,16,6,2,0,31
42003007310,1050,995,670,41,57,18,197,0,325
4200300G611,869,685,579,24,44,12,20,0,106
42003006330,1231,1210,919,70,113,9,89,1,291
42131000260,605,483,455,7,8,10,6,1,28
42131000270,355,282,247,11,4,3,17,1,35
42017001660,2333,1864,1665,54,43,26,68,0,199
42017001820,2240,1701,1428,42,34,11,159,1,273
42101001305,937,721,91,22,597,14,11,1,630
42101004907,1061,854,28,51,780,5,17,2,826
42003000225,2364,1809,872,28,288,15,599,0,937
42003002981,1386,1105,939,18,89,25,23,0,166
4200300G951,512,378,24,11,344,8,6,1,354
42003008750,398,280,10,3,260,9,4,0,270
42101003441,1093,866,78,22,749,2,24,4,788
42101005216,1046,904,156,27,649,4,89,2,748
42101006218,977,689,229,240,223,16,19,0,460
42101004709,502,369,31,22,314,14,4,1,338
42101000801,840,762,602,46,30,7,80,0,160
42101005401,932,680,112,184,345,20,43,4,568
42101006214,1144,861,132,251,444,17,52,2,729
42101006617,780,623,494,40,51,15,19,1,129
42101000223,999,814,621,53,32,2,105,0,193
42101006108,1083,791,43,120,476,14,170,3,748
42003009550,854,634,511,28,10,3,72,0,123
42003002480,212,164,153,1,4,0,3,0,11
42003000321,1359,1157,922,21,162,15,28,2,235
42101004711,382,302,18,17,265,8,7,0,284
42101005124,881,674,18,27,641,10,8,1,656
42101005109,647,466,4,16,442,3,4,2,462
42101001203,738,517,14,16,482,3,7,0,503
42101002916,551,475,59,24,361,3,29,0,416
4200300B580,239,207,172,9,22,0,0,0,35
42101001508,843,732,591,34,36,5,59,2,141
42101000615,879,725,48,29,638,10,12,4,677
42029001308,2182,1634,1436,41,20,12,93,1,198
42029001160,1053,770,666,17,6,2,68,3,104
42029001620,2771,2175,1492,192,120,34,353,3,683
42101005090,556,410,16,23,373,6,5,1,394
42101005081,905,650,22,17,600,9,8,3,628
42101002818,622,463,6,17,437,6,2,0,457
42101003208,1205,1049,606,44,338,17,47,1,443
42101005907,765,543,30,15,504,12,1,0,513
42101006411,1013,687,361,113,96,11,110,3,326
42101005222,892,712,36,16,666,10,0,1,676
42101006206,1280,938,204,227,476,23,43,1,734
42101005522,943,644,297,120,87,2,143,0,347
42101004119,914,672,315,154,146,4,45,3,357
42107000715,1121,865,759,43,37,14,7,0,106
42101004103,879,647,161,208,266,14,25,4,486
42101005308,1091,742,116,223,300,16,90,0,626
42101000909,1010,897,766,38,42,3,46,0,131
42101002719,3251,3084,1189,219,437,19,1207,6,1895
42101005615,796,637,273,91,82,3,157,1,364
42101005602,938,747,304,97,66,11,219,1,443
42101005422,1154,825,144,237,130,11,253,1,681
42029000810,2147,1435,591,610,203,53,11,4,844
42091001150,1954,1686,1182,45,161,4,272,3,504
42091003825,1348,1031,809,36,129,5,49,0,222
42101005224,836,668,1,13,656,11,0,0,667
42101000841,1033,967,763,39,48,3,91,0,204
42101000840,1033,1001,655,52,70,7,215,1,346
42101000834,1094,1039,812,62,30,4,128,2,227
42101000831,1245,1163,777,75,95,21,212,1,386
42101004202,1082,761,59,487,175,16,74,3,702
42003002620,1805,1401,1322,20,13,14,25,0,79
4200300C920,960,782,494,42,232,14,11,1,288
42041000815,3202,2686,2089,249,151,27,120,7,597
4200300H121,508,398,33,5,361,8,5,0,365
4200300E545,1431,1156,952,23,48,7,114,0,204
42003007000,811,769,431,36,38,7,259,2,338
42003008050,446,267,18,7,236,5,1,0,249
4200300F600,718,578,537,11,10,13,2,1,41
42003000582,957,771,733,10,18,2,1,0,38
4200300B540,710,608,531,31,21,14,15,1,77
42111000220,628,496,466,1,1,8,0,0,30
42101006623,1209,944,649,88,56,12,130,0,295
42101005702,1225,986,643,121,173,12,36,0,343
42101005910,1265,901,29,19,838,24,14,2,872
42101005619,1694,1262,679,122,137,14,300,3,583
42079002685,1475,1105,825,163,109,8,5,0,280
42113000070,148,141,137,2,1,0,0,0,4
42101005625,1058,819,412,100,144,8,140,0,407
42101000705,1433,1074,49,834,234,19,8,2,1025
42011001095,2343,1598,266,1206,224,31,19,13,1332
4200300D540,964,754,561,28,109,12,47,1,193
42003008070,544,459,164,16,250,8,22,1,295
42003002338,1372,1027,836,27,29,1,128,2,191
4200300E615,731,586,513,20,24,6,15,0,73
4200300F300,1048,865,834,1,6,6,10,2,31
42003004080,854,692,582,14,53,11,26,1,110
42029000213,1724,1274,1144,31,19,21,51,0,130
42029001820,2967,2186,1918,61,84,27,89,0,268
42011001000,1816,1230,282,812,178,73,9,2,948
42029000580,1892,1383,1214,61,38,39,27,0,169
42029001440,3374,2438,2110,61,82,27,144,5,328
42063000500,405,299,292,0,0,7,0,0,7
42029001312,3305,2503,2250,40,37,18,133,2,253
42045001220,1858,1366,1210,32,38,6,68,5,156
42045003350,1144,897,678,25,136,12,41,0,219
42045001640,1670,1137,756,44,283,37,15,0,381
42017000140,1757,1431,688,220,219,24,298,6,743
42017000100,1303,1057,777,38,41,4,182,0,280
42045000101,1752,1296,1127,27,21,13,109,0,169
42045002240,876,700,635,18,39,9,6,0,65
42045002220,672,547,449,18,41,10,31,2,98
42045001780,1106,869,729,11,10,3,114,0,140
42063000280,288,234,220,0,2,9,0,0,14
42107000120,570,469,449,3,5,3,4,0,20
42107000225,962,723,655,35,13,21,4,1,68
42043000760,1637,1280,1025,46,90,14,101,1,255
42071000772,1976,1416,141,973,366,33,18,4,1275
42025000220,425,373,334,8,2,13,5,0,39
42045003830,2387,1873,1544,71,97,21,133,1,329
42045001240,1510,1101,986,30,28,10,28,0,115
42045003365,531,369,245,15,87,6,27,0,124
42045003255,892,660,482,45,102,2,35,1,178
42019000760,3361,2789,2683,23,10,29,12,1,106
42019000375,3355,2531,2275,62,79,21,80,5,256
42049000400,1523,1204,819,80,230,24,39,0,385
42125000410,593,503,468,10,8,9,2,0,35
42125001600,751,617,577,21,4,3,4,0,40
42125001745,645,560,538,3,2,7,1,0,22
42085000465,1082,892,775,18,73,14,16,1,117
42021001710,479,419,401,4,5,3,1,0,18
42027000230,1537,1267,1166,14,14,22,22,0,101
42017000900,1342,1178,1060,44,23,10,15,0,118
42017000775,1609,1488,1415,23,7,14,16,3,73
42017001150,1085,842,754,31,14,14,19,0,88
42017002480,2314,1898,1723,37,27,15,74,3,175
42125001490,2028,1604,1518,34,17,5,23,2,86
42043000700,1766,1386,667,145,411,19,172,0,719
42125001356,1860,1503,1352,38,40,6,55,5,151
42071001100,1727,1331,1214,49,19,22,26,2,117
42017000950,2177,1697,1397,188,48,38,46,3,300
42017001140,2341,1804,1498,89,109,19,81,1,306
42017002700,2762,2597,2512,32,23,5,13,1,85
42069000100,1726,1410,1345,25,1,20,4,0,65
42039000430,377,304,279,3,7,8,1,0,25
42091003420,1612,1214,1100,47,30,11,25,0,114
42091001590,887,656,501,31,45,2,78,0,155
42091003620,2499,2067,1695,83,187,14,87,1,372
42091002960,2583,2088,1413,100,152,14,385,2,675
42091003233,1568,1233,1001,23,63,6,127,2,232
42033000430,824,770,549,46,164,10,2,0,221
42129002260,1405,1137,1099,7,11,1,9,0,38
42071000360,1069,840,774,25,9,0,28,0,66
42133000600,822,653,609,6,27,12,1,0,44
42091000760,1571,1413,1163,58,120,8,60,2,250
42091001620,1272,980,760,45,93,20,68,3,220
42013000150,327,244,189,7,30,12,1,0,55
42069000710,890,688,612,32,27,4,15,0,76
42129001350,1560,1314,1198,20,37,36,5,3,116
42091001050,1168,952,674,89,100,8,70,1,278
42049000210,1209,1016,907,29,54,14,11,0,109
42049000270,2405,1377,399,228,561,29,183,3,978
42049001210,2831,2399,2052,97,125,21,84,0,347
42129000860,1906,1668,1553,21,17,19,46,0,115
42129002295,712,568,547,5,5,4,5,0,21
42125001430,2833,2021,1834,34,19,15,104,2,187
42129002900,586,432,356,4,53,15,3,0,76
42047000325,984,813,788,4,6,6,6,0,25
42023000030,881,675,632,21,5,7,2,4,43
42011000960,3236,2382,197,1792,488,103,18,10,2185
42043000095,1177,932,729,60,48,23,88,1,203
42133000100,523,418,394,6,5,9,3,0,24
42091000065,1156,956,815,34,60,2,31,1,141
42107001735,1374,1168,1043,86,30,10,1,1,125
4200300F561,1039,839,764,16,27,13,2,0,75
42007000580,2016,1619,1485,26,35,30,25,2,134
4200300A040,644,558,487,6,39,2,24,0,71
42003008670,816,711,277,7,414,5,11,0,434
42003005720,747,628,506,10,84,11,15,1,122
42003002331,833,610,530,11,4,0,49,0,80
4200300F520,1390,1160,1059,15,52,4,26,0,101
4200300E715,684,580,541,8,14,6,6,0,39
4200300E940,1020,859,672,22,34,9,117,1,187
4200300E990,1788,1297,225,17,30,6,1016,1,1072
42003007600,645,609,537,20,14,6,25,2,72
4200300B470,570,456,401,8,39,2,3,0,55
42003004560,987,848,750,12,18,4,56,1,98
42003001570,657,585,522,23,19,13,12,1,63
42055000640,1703,1280,1113,57,71,20,8,0,167
42101002205,880,727,386,33,283,12,23,1,341
42101001916,973,673,13,493,198,15,12,2,660
42101004325,833,580,2,331,278,16,4,1,578
42101005302,1153,833,125,246,410,6,61,0,708
42101003210,680,563,61,17,478,12,5,1,502
42101005310,980,679,92,217,263,14,104,1,587
42101000605,537,380,27,18,291,5,57,1,353
42101001015,677,527,5,12,511,2,3,0,522
42101003226,558,424,15,16,397,5,4,0,409
42101002404,901,701,184,30,412,1,74,0,517
42101003602,641,562,283,29,204,6,45,2,279
42101005707,1208,990,305,173,417,11,107,4,685
42101000121,969,819,694,47,25,7,46,1,125
42101006122,849,767,96,62,556,16,57,1,671
42101004885,773,619,21,24,567,6,9,1,598
42101002106,1158,1065,852,55,90,19,51,2,213
42101002913,629,545,153,38,338,13,20,0,392
42101003613,708,586,172,34,330,7,46,1,414
42101004024,1275,955,61,20,822,7,51,1,894
42101002811,374,282,2,11,266,5,8,1,280
42101006629,1043,831,723,26,14,3,63,4,108
42101005820,1471,1221,843,90,171,9,111,3,378
42041000206,2884,2328,1882,118,197,25,60,4,446
42105000190,134,101,95,0,0,4,0,0,6
42105000180,224,177,164,1,3,8,2,0,13
4200300E030,1573,1266,1172,17,27,9,37,0,94
4200300F750,998,812,397,17,374,17,11,4,415
42003009270,822,662,589,17,5,2,40,0,73
42061000300,285,211,203,4,2,0,0,0,8
42003005331,930,768,733,14,7,1,4,0,35
42003003920,392,295,156,5,130,8,1,0,139
4200300A760,478,368,186,18,161,8,4,0,182
4200300D260,1280,777,343,11,383,13,33,0,434
42003009980,755,640,561,23,28,9,24,0,79
4200300F320,1314,1104,998,24,25,11,45,2,106
42003000151,853,713,650,8,21,3,24,1,63
42003005201,710,538,476,7,6,1,34,0,62
42101002617,748,628,451,44,25,5,102,1,177
42101005306,1084,804,168,195,335,23,90,1,636
42101000318,1012,836,22,18,783,6,18,0,814
42101001817,1360,1151,579,398,139,20,59,3,572
42061000100,90,68,66,0,0,2,0,0,2
42061000430,78,57,51,3,0,2,0,0,6
42029001810,2446,1914,1649,53,97,13,97,0,265
42029001680,1559,1158,610,455,62,19,17,2,548
42101003438,730,587,25,10,543,5,12,0,562
42101002813,551,412,0,10,406,2,0,2,412
42101000228,892,672,435,32,158,0,37,2,237
42101000411,907,651,9,11,618,7,17,1,642
42101001028,672,551,5,11,537,10,4,1,546
42101003641,801,647,190,52,95,11,309,1,457
42061000130,184,149,139,0,4,3,2,0,10
42035000240,469,359,343,3,5,2,3,1,16
42101005626,1051,849,497,98,64,5,165,4,352
42029001110,1078,916,748,50,77,24,13,0,168
42029000338,2242,1774,1502,116,40,14,91,1,272
42101001111,711,516,15,26,479,1,4,1,501
42101003310,1127,794,76,559,165,15,49,1,718
42101003112,940,774,374,146,74,17,169,2,400
42101004204,1099,792,15,570,247,24,9,2,777
42061000570,515,416,392,13,2,7,0,0,24
42101003913,1263,1018,333,98,188,18,393,2,685
42101004319,1048,749,5,446,304,13,52,4,744
42101005013,723,575,10,11,554,4,3,0,565
42101000217,840,729,570,30,40,4,54,0,159
42101005813,849,703,398,43,22,7,248,1,305
42101003926,851,747,605,43,11,9,82,1,142
42101001609,682,464,19,9,424,14,1,0,445
42101003603,727,621,253,54,248,17,67,3,368
42101003205,2165,2082,1128,141,510,5,260,35,954
42029000310,1924,1885,1829,23,9,5,12,3,56
42029001690,1211,897,469,345,55,36,12,0,428
42101006210,986,744,125,272,351,15,18,0,619
42101005320,1251,958,428,172,153,17,161,8,530
42101001007,728,563,4,15,538,13,2,0,559
42101001717,580,417,13,18,390,5,1,1,404
42063000090,1146,950,895,10,20,11,4,2,55
42023000010,38,37,36,1,0,0,0,1,1
42029000120,1097,824,452,110,237,22,21,3,372
42045003550,1563,1121,660,40,341,17,40,2,461
42095000270,1363,1104,836,149,76,15,29,1,268
42045002440,1745,1395,1009,50,107,12,211,0,386
42045002150,1298,996,906,27,18,4,36,0,90
42129002660,471,390,366,3,3,7,2,0,24
42091003090,1515,1144,966,25,63,10,70,2,178
42091003630,1229,1075,904,36,92,10,38,0,171
42091000970,1900,1543,1401,56,51,12,10,1,142
42045003110,1198,1020,864,42,88,5,19,1,156
42045003120,1059,825,669,30,77,16,38,2,156
42019000230,364,284,272,2,2,5,4,0,12
42091000914,1373,1084,1006,24,6,16,21,1,78
42045003030,1083,762,424,60,251,18,15,1,338
42049000330,1071,893,697,35,147,10,9,1,196
42017000760,890,641,312,170,151,17,6,0,329
42129001140,1611,1297,1214,13,28,17,11,3,83
42021000305,1011,844,807,10,17,3,3,0,37
42129002890,893,731,689,4,17,7,6,1,42
42129003040,252,212,205,4,0,1,2,0,7
42091001836,3074,2226,1686,111,355,19,50,2,540
42091000530,1104,917,144,59,709,21,22,0,773
42091003330,3931,3112,1698,176,228,15,1005,0,1414
42129000310,853,723,698,0,2,8,2,1,25
42013000030,694,591,549,9,13,4,13,0,42
42049000225,2209,1801,961,191,534,26,99,1,840
42125001090,924,732,690,10,5,13,0,0,42
42129002200,1558,1271,1218,16,10,8,12,1,53
42133000450,658,504,473,8,6,14,6,0,31
42129001955,775,627,588,4,8,6,8,0,39
42039000290,391,326,294,4,17,6,4,1,32
42011001250,2385,1618,342,1152,223,50,10,8,1276
42133001403,1216,1043,956,28,32,11,14,1,87
42069001460,1874,1463,1136,204,105,22,26,7,327
42005000470,382,306,293,3,1,3,2,1,13
42091000740,1835,1620,1362,66,76,18,91,0,258
42091000275,1799,1357,913,74,285,18,87,0,444
42091001760,1658,1162,979,30,18,3,127,4,183
42091003680,1875,1701,1346,64,171,21,98,1,355
42021001820,207,165,158,3,2,0,0,1,7
42091001815,2002,1584,1403,51,97,22,16,0,181
42091000750,992,883,679,43,118,4,49,1,204
42065000050,647,521,484,7,8,18,1,0,37
42125000820,389,304,287,1,8,4,1,0,17
42071000730,962,788,502,182,103,8,19,2,286
42011001130,1897,1358,295,950,175,52,16,16,1063
42011000330,1409,1148,1092,25,6,9,4,2,56
42085000385,1249,1049,950,11,45,10,21,0,99
42071001802,1430,1094,1004,44,10,8,10,1,90
42085000405,1420,1185,1111,11,25,11,21,0,74
42049000460,1531,1175,749,76,288,21,41,4,426
42101001919,638,455,15,383,71,13,6,1,440
42101006324,695,540,319,37,36,5,148,1,221
42101000312,861,631,7,34,588,2,17,0,624
42101005023,617,500,1,5,490,6,1,3,499
42101004405,469,376,14,8,355,5,2,0,362
42039000480,879,675,626,9,21,9,0,0,49
4200300G281,919,761,729,5,2,11,3,0,32
4200300B480,707,564,500,9,38,8,10,0,64
42003008390,828,701,361,28,245,20,53,0,340
4200300E535,1113,933,849,27,22,9,10,1,84
42003003710,805,584,260,12,298,17,6,3,324
4200300G200,1267,884,719,17,15,7,124,1,165
42003009750,1072,871,540,28,17,4,259,1,331
4200300G730,1327,1202,1104,13,54,5,12,2,98
42003005522,568,488,270,15,179,12,13,0,218
4200300B010,684,623,526,23,54,11,12,0,97
42003000571,1492,1228,1147,14,16,11,19,0,81
42003000201,1110,898,788,12,62,6,27,3,110
42003008850,399,301,14,1,279,13,4,5,287
42003007180,1287,1200,904,51,50,5,174,1,296
42003001600,637,568,512,16,20,4,13,0,56
42003001981,1065,911,874,1,24,5,4,0,37
4200300F260,913,753,707,12,13,6,10,1,46
42003008370,418,293,49,0,229,6,14,0,244
42003003131,1404,1195,1025,19,99,5,41,0,170
4200300C640,804,439,18,10,408,3,1,1,421
42003001031,1178,985,897,20,36,11,25,1,88
42003003350,910,691,615,5,7,3,52,2,76
42003009490,651,574,429,8,20,0,115,0,145
42003005076,3223,2614,2326,59,103,23,77,1,288
4200300C660,350,265,69,3,191,1,0,1,196
42101005214,1246,1129,415,66,504,22,153,1,714
42101006003,633,543,88,38,413,13,14,1,455
42101003002,939,835,499,33,214,13,73,0,336
42101003921,1009,793,659,42,16,11,66,3,134
42101004112,954,678,271,163,233,11,26,3,407
42065000565,1115,894,851,4,4,17,2,0,43
42101002904,513,344,14,24,279,8,30,1,330
42101005916,960,740,38,53,636,10,19,2,702
42101000902,812,707,358,28,292,12,27,0,349
42101003639,1015,820,402,70,296,9,62,1,418
42101000224,879,714,602,21,49,1,43,1,112
42101005616,1258,920,523,126,137,4,72,0,397
42101003511,941,713,75,161,438,1,50,1,638
4200300B230,691,565,469,37,34,15,8,0,96
4200300B860,896,769,660,28,40,5,35,0,109
4200300B510,654,515,398,25,56,13,32,0,117
4200300G360,625,554,529,4,14,8,1,0,25
4200300F480,888,703,652,11,19,9,14,0,51
4200300F730,399,311,170,14,125,7,0,1,141
42003004860,1548,1338,1177,22,94,12,20,0,161
4200300F435,1325,1032,869,15,39,12,90,2,163
42003006720,295,157,17,2,132,2,2,1,140
4200300D640,926,683,298,22,328,21,17,2,385
42003006480,146,118,6,2,110,0,0,0,112
42003001860,737,610,457,10,118,18,6,0,153
4200300E105,704,611,559,12,25,1,11,0,52
42003003125,1765,1416,1268,15,58,16,47,2,148
4200300B530,571,469,410,9,30,9,10,0,59
42003005230,755,623,585,4,13,2,22,0,38
42101005205,1440,1384,682,73,382,19,231,4,702
42101002419,1358,1321,713,87,176,1,340,0,608
42101002440,1423,1404,856,117,92,6,335,0,548
42101002418,1646,1635,1038,128,121,7,346,0,597
42101001605,531,400,11,20,378,9,2,0,389
42101001080,1225,1097,829,81,82,26,76,2,268
42101001084,1560,1396,1069,107,84,15,119,3,327
42101003008,891,747,581,45,28,6,74,0,166
4200300B740,979,664,285,10,335,20,14,2,379
42003002362,1559,1181,981,18,36,9,135,1,200
42101001506,1007,1005,917,23,43,2,20,0,88
42101001116,651,539,14,30,501,5,6,0,525
42101006413,986,670,270,89,65,3,205,1,400
42101003305,899,620,62,352,167,5,55,1,558
42101006106,1283,1035,68,90,763,11,106,0,967
42101005613,975,845,449,116,134,5,133,1,396
42003004261,3346,2457,2157,45,83,31,114,2,300
42003004870,932,774,731,3,25,4,10,0,43
42101002622,726,591,413,60,41,7,78,0,178
42101002412,555,411,27,7,372,3,3,1,384
42101003106,737,654,534,35,23,14,45,1,120
42101004216,1271,942,46,350,398,36,193,7,896
42101001018,722,579,1,6,570,2,4,0,578
42101001201,908,628,3,15,609,15,2,0,625
42101005620,766,584,343,78,44,4,82,1,241
42101000414,930,688,3,9,663,9,10,0,685
42101001105,579,440,24,54,355,11,12,0,416
42101001317,828,617,6,32,589,10,0,0,611
42101003504,929,692,198,196,237,12,63,3,494
42101003502,1294,983,361,256,341,8,52,6,622
42101002211,619,457,130,21,287,12,13,0,327
42101004705,730,553,124,54,350,3,24,1,429
42101005111,551,430,47,10,371,4,4,0,383
42101005121,643,483,12,12,448,7,12,0,471
42101003309,1194,909,139,525,185,24,106,4,770
42061000310,459,385,375,1,1,2,2,0,10
42101005009,816,697,22,20,642,21,10,1,675
42101000612,675,453,6,10,425,8,8,0,447
42101005528,857,646,367,165,94,8,21,1,279
42101001409,769,679,173,146,244,8,127,0,506
42101006306,1342,1053,603,147,250,7,53,1,450
42101005314,1071,778,176,146,172,13,274,1,602
42101005802,1646,1167,454,51,62,5,583,0,713
42101006414,872,636,293,86,60,3,176,2,343
42091000640,1109,829,517,33,202,7,70,2,312
42101003003,882,789,605,30,65,14,75,7,184
42101006523,951,801,663,46,44,6,41,1,138
4200300E060,1164,952,861,27,41,8,6,0,91
4200300E070,1739,1373,1166,33,104,23,45,0,207
42003004461,956,722,647,13,9,3,48,0,75
42003004120,1345,1133,892,29,105,9,83,4,241
42003000811,1309,1033,818,31,77,12,92,3,215
4200300G871,824,696,566,12,85,10,13,4,130
42117000220,691,508,480,4,5,14,1,1,28
42101001010,721,556,9,22,515,9,7,1,547
42101003904,963,720,379,110,33,6,204,1,341
42101005107,713,519,66,28,426,7,6,0,453
42101000508,1291,1134,854,51,70,9,132,2,280
42003003320,1382,1138,1048,23,5,4,52,0,90
42079002045,1902,1711,1580,39,49,15,36,0,131
42003008510,396,306,16,3,280,7,5,1,290
42101003527,898,684,57,204,158,15,273,1,627
42011000628,2429,1746,1477,66,43,7,146,1,269
42029000435,1504,1155,1063,23,17,11,26,1,92
42029000150,2069,1744,1283,108,212,29,125,0,461
42037000335,689,580,567,4,2,6,0,0,13
420370335P1,0,0,0,0,0,0,0,0,0
42029000830,1299,1014,701,91,188,30,14,2,313
42045003190,1041,840,555,48,181,12,56,4,285
42045002950,963,788,643,41,40,9,31,0,145
42017000690,1231,896,542,151,183,15,17,0,354
42017000490,1078,830,649,80,67,23,19,0,181
42045001620,1020,817,346,35,408,3,29,2,471
42027000590,1471,1217,1105,37,24,23,20,1,112
42025000432,1395,1136,1101,22,4,4,1,0,35
42043001010,374,303,253,14,20,9,2,1,50
42071001110,1680,1416,1333,37,28,17,6,1,83
42133000070,1352,1032,935,17,47,15,13,0,97
42133000546,2559,2122,1763,134,127,22,78,0,359
42049001000,1617,1300,1237,5,3,17,22,0,63
42005000030,334,254,252,0,0,1,0,0,2
42027000770,1155,874,694,37,50,4,77,2,180
42133000310,932,694,632,20,16,17,5,0,62
42125001500,1207,936,859,20,5,12,24,1,77
42125001470,1625,1255,1191,22,11,3,23,1,64
42095000250,3525,2742,1673,567,298,33,159,6,1069
42017001400,2144,1731,1588,29,48,9,45,0,143
42017001830,2836,2431,2156,98,119,17,54,1,275
42043001050,3105,2349,2052,75,46,30,133,2,297
42017001010,1122,831,703,40,30,10,38,1,128
42069001385,990,786,543,128,80,31,19,2,243
42069000340,688,576,510,42,15,4,1,0,66
42069002180,1490,1323,1193,83,41,2,9,5,130
42039000530,355,296,272,5,0,11,0,0,24
42129003070,1087,865,811,18,6,8,12,0,54
42069000540,780,635,594,14,10,7,8,0,41
42107000705,1432,1115,979,70,19,24,22,0,136
42091000680,1842,1467,860,81,427,17,76,0,607
42091000570,1173,955,598,32,247,9,65,2,357
42091001260,2191,1744,1311,87,123,15,223,0,433
42129000580,516,454,393,11,25,10,12,2,61
42071000355,1752,1357,1180,86,41,3,45,0,177
42133001170,323,265,249,6,1,4,6,0,16
42083000090,1094,857,798,8,8,15,15,3,59
42071001335,1978,1529,1290,67,34,15,119,0,239
42091000726,2202,1751,1522,66,68,20,75,3,229
42091000936,1185,1022,904,35,20,12,54,3,118
42129001070,472,342,233,6,86,9,3,0,109
42125000320,1116,931,843,24,39,23,2,1,88
42043000135,1247,958,848,19,23,14,43,2,110
42129002630,192,147,125,0,11,7,0,0,22
42091001550,1566,1130,990,37,28,8,63,0,140
42011001220,1576,1053,286,619,180,20,14,1,767
42017002210,1141,904,760,74,33,27,16,2,144
42017001870,2087,1666,1452,29,19,12,137,2,214
42017000813,2037,1506,1326,43,17,15,105,0,180
42017000060,2456,1907,817,561,328,29,195,4,1090
42081000040,501,395,384,3,2,3,3,0,11
42015000310,384,258,243,0,0,10,0,1,15
42003005141,691,539,470,11,44,4,1,0,69
42003003240,1259,971,786,13,18,9,136,1,185
4200300C540,640,494,124,9,350,5,4,0,370
42007000940,797,613,427,25,133,13,3,0,186
42007001195,888,743,674,14,31,15,3,1,69
42003004930,373,316,238,18,47,2,8,4,78
4200300G991,840,725,204,11,465,17,38,2,521
4200300E970,691,536,510,1,3,1,17,0,26
4200300A780,572,481,409,12,52,13,4,1,72
42003001068,982,801,725,13,20,9,20,0,76
42003000481,1023,806,738,19,7,6,20,1,68
4200300D990,770,612,539,4,17,13,39,0,73
4200300E575,797,653,602,15,8,11,4,0,51
42003006130,386,288,42,3,220,2,21,0,246
42003009590,974,786,595,47,22,8,102,1,191
4200300F280,464,374,362,4,5,0,0,0,12
42003007540,682,650,566,22,14,3,44,0,84
4200300E351,960,719,614,10,73,2,21,0,105
42003004630,1058,801,722,17,28,9,30,1,79
4200300B430,665,571,486,26,25,9,20,2,85
4200300D400,769,638,491,26,89,8,33,0,147
42003009760,603,529,379,19,8,1,116,0,150
42003009230,1520,1474,1167,109,118,1,78,0,307
4200300G530,1485,1270,1163,21,50,6,20,0,107
42067000130,807,653,594,41,11,10,1,0,59
42073000355,1520,1225,1079,28,69,18,15,2,146
42101003938,1088,857,539,137,23,16,163,4,318
42101003503,1157,904,381,182,294,11,46,5,523
42079001400,1816,1506,1224,92,127,15,52,3,282
42101002403,958,795,226,30,501,17,44,0,569
42101001005,786,644,10,6,632,0,0,0,634
42101001803,537,438,88,267,84,15,12,6,350
42101000222,1123,956,675,54,99,5,116,2,281
42101000807,1416,1371,761,59,97,1,440,1,610
42101003640,947,844,426,60,298,17,52,1,418
42101002517,678,475,75,253,151,26,8,3,400
42101003635,887,735,341,42,297,10,59,0,394
42101003105,727,613,512,24,24,8,39,0,101
42101002503,985,809,725,41,27,4,15,1,84
42101003638,840,742,312,83,274,11,67,0,430
42101004034,479,334,13,14,295,3,22,0,321
42101004047,385,245,5,27,205,3,8,1,240
42101000105,780,600,230,140,49,19,177,0,370
42101002303,778,544,124,258,166,19,2,0,420
42101003612,555,496,232,25,189,5,47,0,264
42101000913,843,682,442,29,184,6,21,2,240
42101005614,920,706,262,107,115,9,188,2,444
42101004307,1273,896,20,604,294,19,8,5,876
42101003917,1097,785,189,159,70,14,374,4,596
42101004875,1557,1269,54,72,1115,15,20,0,1215
42101006309,1118,920,641,75,132,5,60,2,279
42101002126,829,721,559,32,75,9,42,3,162
4200300A820,929,765,466,22,262,13,9,1,299
42003005225,891,716,639,26,7,7,29,0,77
42003004030,1004,796,642,11,78,13,51,0,154
4200300F310,981,845,769,21,19,9,26,0,76
42003005580,1212,929,492,21,402,21,5,0,437
4200300F030,654,509,460,13,25,1,8,1,49
4200300D320,188,161,81,5,72,3,3,0,80
42003003290,1293,1037,944,26,5,4,60,1,93
42101004620,819,568,20,24,528,13,1,0,548
42101006126,886,709,54,44,520,13,83,2,655
42061000170,122,104,96,1,0,1,0,0,8
42077001280,2931,2392,2155,95,35,19,76,1,237
42041000070,1390,1052,774,68,157,29,38,2,278
42101004213,1579,1096,32,465,605,21,27,0,1064
42101002304,1074,777,145,272,385,14,10,2,632
42079002787,1533,1127,624,273,197,24,27,7,503
42079003160,1201,969,905,18,21,5,14,0,64
42101005608,1325,1045,644,139,158,3,91,1,401
42101005309,1013,703,112,179,297,9,123,1,591
42101003324,831,551,59,325,180,10,5,0,492
42101004032,1048,770,43,11,619,1,94,1,727
42101003816,762,668,541,31,66,3,26,3,127
42101004033,642,452,9,8,402,0,36,1,443
42101003509,1388,1051,252,250,520,9,56,1,799
42101006410,847,607,338,90,86,7,86,1,269
42101003206,823,693,279,44,334,11,47,0,414
42045003220,1421,1085,935,42,74,10,21,0,150
42101002911,750,652,331,50,239,9,41,2,321
42029000041,1638,1335,1072,90,124,24,28,0,263
42077000912,1994,1704,1564,54,23,13,42,2,140
42045003048,1776,1463,1104,62,126,20,143,1,359
42045000335,478,299,28,69,214,13,0,0,271
42029001806,2309,1808,1518,71,64,16,128,3,290
42045001960,1157,875,820,7,4,13,26,4,55
42045002880,844,625,591,16,18,0,2,0,34
42091000700,2233,1693,1077,118,392,22,85,1,616
42047000315,1703,1428,1380,13,6,8,8,2,48
42025000140,373,333,305,15,5,2,7,0,28
42091002605,3341,2642,1842,252,487,40,39,4,800
42091000490,789,614,342,12,208,4,41,0,272
42107001475,921,752,678,26,24,17,5,0,74
42017001460,1257,1036,940,27,11,10,45,1,96
42017000230,1253,994,822,47,41,13,64,0,172
42017002200,1933,1530,1265,109,64,25,61,3,265
42021000040,509,424,417,1,0,6,0,0,7
42129001720,501,444,432,1,2,4,3,0,12
42041000570,364,273,254,3,7,7,1,1,19
42049000500,915,641,222,66,320,24,19,3,419
42085000435,1323,1098,1052,5,17,9,13,0,46
42107000960,278,225,206,12,3,4,3,0,19
42017000750,1049,862,666,88,76,11,28,3,196
42125000610,110,90,74,0,10,3,0,0,16
42133001416,1665,1377,1190,45,95,20,30,2,187
42081000030,527,405,400,0,0,2,2,0,5
42091000860,2160,1768,1487,48,145,13,65,0,281
42017001090,3755,2992,2163,180,264,25,320,3,829
42091000919,1980,1519,1305,52,65,25,68,1,214
42069000370,429,355,343,4,3,3,1,1,12
42125001790,779,704,673,8,7,7,3,0,31
42031000140,448,363,355,2,1,2,0,0,8
4200300D750,798,681,597,17,34,17,16,0,84
42003007450,731,675,536,18,77,3,38,1,139
4200300F470,1205,928,838,15,35,11,23,0,90
42071000990,1227,1025,762,150,85,11,27,1,263
42111000350,142,122,118,2,1,1,1,1,4
42085000732,1694,1358,1025,43,241,40,8,4,333
42101001011,1151,928,39,43,846,19,10,0,889
42101004116,756,513,220,135,139,10,17,4,293
42101006115,990,736,46,112,453,3,135,1,690
42101003624,731,538,139,67,310,11,23,0,399
42129001360,528,442,420,6,6,2,2,0,22
42101001213,746,562,40,24,489,8,3,0,522
42101000602,574,491,29,6,448,4,11,0,462
42099000030,1224,982,923,23,11,27,1,0,59
42007001220,732,601,432,9,125,24,4,3,169
42007001015,989,777,732,5,16,5,7,0,45
42003004070,1384,1223,1053,14,75,13,72,0,170
4200300E075,861,674,625,5,31,3,3,1,49
4200300E115,1205,965,771,30,114,17,42,0,194
42003005795,1866,1371,1195,50,29,6,81,1,176
42003003340,1298,1058,931,18,30,11,60,0,127
42003008160,556,482,190,19,251,8,22,0,292
4200300F290,778,675,636,12,6,4,10,0,39
42003000101,432,372,316,9,42,6,0,0,56
4200300C600,480,394,157,7,227,10,4,0,237
42003005640,861,681,216,10,432,11,11,1,465
4200300F720,618,496,292,9,179,10,3,1,204
42003004000,659,547,514,5,16,3,5,0,33
42003005770,428,333,65,12,261,13,4,0,268
42003000140,1014,874,770,16,16,9,61,0,104
42003005530,729,583,295,30,228,6,12,2,288
42003004500,800,618,556,20,20,4,15,1,62
42003002010,981,782,694,11,58,16,4,0,88
42003005830,784,560,318,15,210,18,3,0,242
42003002700,533,440,389,4,28,3,7,0,51
42055000440,214,153,141,1,4,2,2,0,12
42003000271,896,762,718,3,10,3,23,1,44
42003003280,1090,852,779,13,13,6,35,1,73
42101004039,846,610,30,40,518,4,36,1,580
42101006012,713,601,133,26,419,9,23,1,468
42101004110,936,684,277,199,187,17,26,3,407
42101001726,347,265,0,6,261,2,2,0,265
42101006607,667,527,426,36,25,14,35,1,101
42101005721,682,576,435,61,32,13,35,0,141
42101005720,831,661,367,72,85,9,113,3,294
42101001109,895,721,29,52,626,12,10,1,692
42101002110,716,650,552,26,36,4,31,1,98
42003004040,1210,952,717,22,125,6,83,0,235
42027000630,4192,3924,3160,242,111,8,333,0,764
42003003150,582,442,388,15,22,10,9,0,54
42003007140,832,799,596,61,31,2,91,0,203
42053000110,428,373,357,0,3,4,3,0,16
4200300A190,631,518,176,8,324,6,5,0,342
4200300G640,972,831,779,15,22,6,10,1,52
4200300C360,514,429,201,11,199,12,10,0,228
4200300F770,722,583,369,19,179,7,10,0,214
4200300G630,855,664,612,14,13,8,5,0,52
42101000616,733,521,13,26,481,12,9,2,508
42101004402,808,640,12,16,611,8,6,0,628
42101006514,775,549,147,128,280,11,21,1,402
42101006403,1128,865,526,163,125,15,30,3,339
42101001518,972,850,695,56,40,6,34,2,155
42101001711,722,569,12,24,528,3,12,0,557
42101005920,836,819,356,72,224,6,170,1,463
42101001025,723,580,7,14,563,13,4,0,573
42101002613,589,497,440,29,14,1,10,1,57
42101003229,530,337,0,18,326,7,5,0,337
42101006602,613,477,367,65,18,12,22,0,110
42003008730,297,244,10,2,231,9,1,0,234
42003001101,783,692,674,7,4,0,5,0,18
42101001057,1928,1885,1064,153,473,26,171,1,821
42101000104,952,816,637,81,20,20,71,2,179
42101006007,689,538,7,17,498,8,18,1,531
42101006018,786,607,15,29,561,5,14,0,592
42101003718,977,686,17,410,272,16,12,4,669
42101005902,943,678,4,23,656,5,4,2,674
42101005917,1158,1023,341,36,600,36,42,2,682
42101004321,686,492,6,284,236,2,11,0,486
42101003421,1093,842,45,31,778,6,5,0,797
42101003422,868,704,150,24,533,5,8,0,554
42101005518,1141,779,310,138,56,13,214,2,469
42101003313,1181,848,107,586,151,5,45,6,741
42101003312,1503,1131,70,757,176,22,180,1,1061
42101003307,1429,962,105,616,234,22,40,4,857
42101005029,842,702,6,12,682,12,1,0,696
42101003526,973,743,80,220,422,15,44,0,663
42101004223,824,590,61,377,151,15,13,7,529
42101000406,937,706,11,15,681,8,9,2,695
42101000904,863,733,603,33,71,16,17,1,130
42101004823,946,626,24,45,511,8,61,0,602
42101002707,1520,1429,732,90,200,25,400,2,697
42101003912,794,609,329,90,29,9,170,0,280
42117000300,591,462,441,11,1,9,2,0,21
42003000511,997,840,785,17,6,4,23,0,55
42075000140,1152,868,487,302,96,3,12,1,381
42101003528,861,576,25,82,420,10,54,0,551
42077000926,1773,1373,1087,82,90,1,107,1,286
42077001400,1096,911,708,122,39,3,50,2,203
42005000202,1394,1133,1088,4,16,17,0,1,45
42083000270,1059,856,822,16,4,6,2,0,34
42045001100,723,557,428,35,77,12,11,0,129
42045002805,1185,929,784,21,23,5,86,1,145
42045003300,1281,1004,772,45,135,12,42,2,232
42095001300,2171,1858,1367,128,229,28,105,0,491
42017002660,2138,1881,1623,112,64,20,60,1,258
42125001520,543,468,443,6,8,3,2,1,25
42017001080,1317,1045,852,36,38,18,99,5,193
42017001670,3102,2583,2275,78,65,7,129,3,308
42017000260,2132,1743,1473,47,56,14,140,3,270
42069000230,413,330,290,20,8,0,6,0,40
42069002410,300,253,242,3,0,1,2,0,11
42129000700,923,801,735,10,11,11,32,1,66
42091001072,2509,1957,1427,208,189,42,94,3,530
42017001070,1346,1032,924,32,22,11,41,0,108
42091000880,1401,1190,898,70,156,19,51,3,292
42091000660,1482,1141,312,85,502,6,241,0,829
42069001050,2039,1645,1542,42,22,14,22,1,103
42129001310,1645,1377,1310,5,16,23,14,0,67
42091001929,3113,2332,2018,31,62,13,191,2,314
42111000020,166,138,126,7,0,0,1,0,12
42129002030,751,638,631,1,1,1,1,0,7
42049000720,1137,837,594,76,121,13,18,1,243
42071001210,541,372,180,128,35,7,37,4,192
42091003170,1325,1008,834,15,27,7,118,0,174
42091003160,1315,1028,814,19,46,6,133,0,214
42021000966,497,354,162,4,185,5,0,0,192
42111000500,199,163,155,0,3,1,1,0,8
42017001703,1757,1365,1188,44,33,10,86,0,177
42007000750,259,216,201,1,6,5,1,0,15
42007000460,1405,1001,945,16,11,6,18,0,56
4200300C880,814,693,562,22,84,3,14,1,131
4200300E445,752,623,532,7,43,1,36,0,91
4200300E034,686,534,481,5,9,8,23,0,53
4200300G560,770,677,645,11,14,5,4,0,32
4200300A910,598,548,505,20,7,0,14,0,43
42003004650,739,634,547,27,12,5,39,0,87
42101002203,849,747,253,29,443,5,19,0,494
42101002204,615,482,231,6,226,7,19,1,251
42101005628,991,788,405,71,188,10,99,0,383
42101000607,742,579,33,18,514,16,10,0,546
42101005409,1512,1065,236,338,234,18,207,1,829
42101001729,738,555,7,30,522,14,0,0,548
42101002201,900,719,536,12,131,6,29,2,183
42101006620,1018,814,581,109,69,11,49,2,233
42101006213,1283,916,138,296,455,23,27,5,778
42101003424,841,711,63,19,605,18,12,2,648
42101006226,1149,824,249,244,253,13,95,3,575
42101001003,729,599,6,22,579,5,4,0,593
42079000682,2191,1805,1550,117,112,34,7,0,255
42003005100,906,797,695,6,83,6,2,0,102
4200300F700,709,544,289,17,213,18,9,0,255
4200300E080,1288,1070,989,10,29,5,19,4,81
4200300G510,1132,979,926,17,28,6,3,1,53
42003007220,1654,1464,854,56,39,13,502,0,610
4200300C940,987,792,559,15,189,12,9,0,233
42003001770,388,261,72,4,181,4,2,1,189
4200300E361,773,627,594,9,19,1,7,1,33
42101000320,698,557,13,18,529,17,0,0,544
42101003721,1053,707,10,444,292,13,0,5,697
42101006642,763,615,530,37,22,2,25,0,85
42101006604,656,514,433,40,10,4,29,0,81
42101006508,1001,753,413,110,181,12,44,1,340
42101006507,3308,3061,1139,412,1410,17,83,1,1922
42101005503,1180,857,363,261,211,12,32,0,494
42101006011,837,604,12,15,567,18,12,3,592
42101001308,595,459,9,16,440,4,2,0,450
42101002902,354,276,38,21,204,5,11,1,238
42101001217,1107,801,54,28,713,4,3,0,747
42101005924,646,505,173,30,294,11,5,2,332
42101004007,936,690,3,21,660,11,19,0,687
42101005840,840,716,546,20,31,7,114,0,170
42101001303,563,414,46,5,360,4,1,2,368
42101005408,1196,848,198,221,166,9,238,2,650
42041000540,1841,1449,1251,86,54,29,31,0,198
42101005508,1041,721,282,158,106,20,171,2,439
42059000040,203,168,148,6,14,0,0,1,20
42019000270,60,46,43,0,0,0,0,0,3
42115000130,101,84,78,1,1,1,1,0,6
42091001060,1451,1123,1011,29,21,7,43,1,112
42091000255,801,636,466,28,68,8,56,0,170
42119000205,118,95,94,0,0,0,1,0,1
42033000530,50,45,44,0,0,0,0,0,1
42071000880,1143,849,381,297,160,24,24,1,468
42097000690,257,221,191,13,10,5,1,0,30
42045001480,1563,1156,1023,35,31,11,45,1,133
42045003311,958,741,490,19,166,5,46,0,251
42091001118,1807,1401,1089,64,69,15,148,2,312
42091003812,3353,2614,1800,72,128,14,600,1,814
42043001060,2701,2073,1711,114,103,24,127,6,362
42129001710,2747,2207,1931,92,35,14,123,1,276
42071000590,1173,1003,650,214,133,7,9,0,353
42105000140,591,491,456,12,4,15,3,0,35
42015000360,358,270,256,4,3,3,0,1,14
42093000140,202,156,147,0,6,2,1,1,9
42119000070,251,191,183,4,1,4,1,0,8
42021001830,1641,1377,1318,11,23,10,4,2,59
42115000350,563,434,404,5,1,12,5,1,30
42017000480,1592,1267,979,123,120,15,27,1,288
42091001630,1661,1083,792,41,134,9,110,2,291
42017001600,2104,1643,1433,84,45,22,57,1,210
4200300E190,780,645,585,9,31,13,4,0,60
4200300D810,172,134,73,1,57,1,3,0,61
42003003420,2083,1765,1565,25,55,13,89,1,200
4200300F160,693,559,535,4,9,3,5,0,24
42101005420,1215,872,157,176,108,15,369,0,715
42101005827,1708,1319,861,87,102,14,251,1,458
42101001716,753,651,171,80,356,11,43,2,480
42003005151,541,470,313,9,138,12,6,0,157
42003004350,1007,734,639,31,17,4,43,1,95
42003004331,1453,1136,1052,18,42,1,21,1,84
4200300F250,815,679,617,12,20,9,15,0,62
42003002900,372,280,58,9,208,6,8,0,222
4200300F101,840,690,647,7,19,6,8,0,43
4200300D380,714,565,399,15,89,12,46,0,166
42003004550,746,554,481,23,7,10,29,2,73
42003003590,609,478,207,1,267,0,3,0,271
42003009740,1190,996,715,25,46,3,191,1,281
42101001408,282,184,9,15,161,3,1,0,175
42101001721,904,722,33,37,653,2,17,0,689
42101006301,993,792,650,36,60,6,40,0,142
42101006308,868,702,496,97,56,5,53,0,206
42101002136,748,676,513,51,49,12,45,1,163
42003004050,1072,887,679,16,111,14,66,0,208
42003005161,834,686,618,12,46,3,5,1,68
42101001914,333,228,10,150,75,11,11,1,218
42101005844,1132,969,797,16,11,0,133,1,172
4200300G700,921,794,740,16,35,6,2,0,54
42003006310,897,884,527,30,56,1,264,0,357
42101001513,788,646,460,41,111,12,37,4,186
42101003430,750,592,51,25,508,4,7,1,541
42101004809,779,592,99,36,292,13,163,2,493
42101003818,634,532,428,24,42,3,34,1,104
42101003523,1087,743,84,291,412,9,10,0,659
42101006113,1133,822,42,148,536,10,115,0,780
4200300F240,466,377,363,8,2,2,3,0,14
42101004206,1181,861,66,501,194,16,131,5,795
42101002817,500,391,11,8,372,9,0,0,380
42003002625,976,803,743,4,20,14,13,0,60
42101003715,730,502,17,322,164,21,13,3,485
42101001708,833,622,0,28,589,13,6,2,622
42101002131,804,669,575,14,43,10,23,1,94
42101002601,748,633,617,3,0,0,13,0,16
42101002138,949,753,590,33,89,2,37,0,163
42101003607,670,563,268,25,237,8,26,1,295
42101003416,944,746,71,33,644,4,14,3,675
42101005127,684,498,16,20,471,15,7,1,482
42101004002,665,497,6,6,484,9,5,0,491
42101001601,525,423,49,32,327,5,17,0,374
42101006402,1011,815,620,79,82,8,34,1,195
42101001103,615,442,30,40,372,6,7,0,412
42101004911,1320,1040,43,102,731,9,181,5,997
42101005413,1327,922,176,272,243,11,199,3,746
42101004604,675,540,88,19,421,16,15,2,452
4200300E950,1159,1060,901,17,13,9,122,0,159
42073000230,1070,863,817,1,23,11,9,0,46
42101003614,702,536,171,49,288,12,35,0,365
42101002223,704,580,244,33,284,16,17,0,336
42101001728,672,481,7,14,460,11,3,1,474
42101005520,1053,730,333,119,70,8,189,0,397
42101006614,976,755,675,23,21,9,27,0,80
42101004803,873,680,135,42,442,18,47,0,545
42101004023,1006,723,27,13,626,3,67,1,696
42101000609,508,384,33,12,328,8,13,0,351
42003002586,1683,1297,1228,8,12,6,35,0,69
42029000620,1132,1007,939,31,8,4,20,2,68
42029000500,1257,899,809,23,3,4,60,0,90
42045000700,1899,1410,872,67,365,13,99,0,538
42045002755,1337,984,908,18,29,4,29,1,76
42045003720,1434,1042,112,136,549,20,254,0,930
42045001080,1458,1104,546,64,477,4,27,1,558
42017000700,1061,817,596,114,84,26,11,0,221
42045000870,1393,1097,41,25,1010,34,14,0,1056
42021001490,574,452,437,5,1,0,2,0,15
42125000450,314,251,233,1,4,6,4,0,18
42125001460,1505,1154,1096,18,6,0,26,0,58
42111000040,187,150,144,0,0,2,2,0,6
42091001303,2085,1574,1391,55,74,29,25,0,183
42043001120,1051,740,267,109,330,28,19,2,473
42071001576,1334,1046,934,69,15,6,17,0,112
42017002540,1628,1327,1122,48,25,11,104,0,205
42027000160,77,62,62,0,0,0,0,0,0
42083000210,181,147,135,1,1,2,1,0,12
42129002280,1466,1191,1125,13,11,7,22,0,66
42091000840,1580,1321,1014,71,123,19,94,1,307
42091003370,2537,2003,1006,141,278,23,547,11,997
42095000630,373,308,237,28,22,10,11,0,71
42039000650,433,372,355,3,0,6,1,1,17
42091002515,1303,1178,947,38,99,6,91,0,231
42011001210,2260,1586,498,800,316,34,23,4,1088
42085000940,151,108,104,1,2,1,0,0,4
42021001860,478,384,357,8,7,2,7,0,27
42041000120,1198,981,650,82,183,27,55,2,331
42017000870,3173,2635,2356,112,77,17,73,3,279
4200300F522,692,556,525,3,16,7,6,0,31
42003005550,967,815,468,17,315,10,7,0,347
42003006540,654,457,8,9,445,11,2,0,449
4200300F140,1155,920,865,19,24,1,15,0,55
42003002641,1036,813,754,19,11,8,14,0,59
4200300C620,895,458,25,2,417,6,0,2,433
42003002300,575,474,459,7,6,2,2,0,15
42003006400,810,753,444,43,183,8,76,2,309
42001000020,867,634,521,97,9,6,6,0,113
42073000100,715,569,537,9,0,6,2,0,32
42055000660,1330,1003,883,28,61,19,9,0,120
42101002206,1173,1027,382,30,586,20,18,0,645
42101002216,670,560,256,9,275,5,15,1,304
42101001322,1123,837,11,51,769,0,10,4,826
42101002804,562,434,1,15,423,7,1,1,433
42101003716,840,595,11,357,259,21,12,0,584
42101002802,546,395,11,16,365,13,7,2,384
42101004815,966,726,192,57,368,9,97,0,534
42101005809,1206,930,658,51,71,3,150,0,272
42101004821,1468,989,52,54,862,21,22,3,937
42101006632,1185,987,696,78,176,12,35,0,291
42101004619,1123,1019,601,62,201,13,146,1,418
42101003431,976,721,67,13,612,7,25,2,654
42101005621,1260,972,574,62,118,4,159,0,398
42101001106,480,363,7,8,339,5,10,0,356
42061000320,428,315,300,3,1,4,0,0,15
42003008470,305,230,22,7,189,15,3,0,208
4200300G450,817,683,424,6,242,4,9,0,259
4200300G070,934,688,570,19,15,11,50,1,118
42101003636,757,640,317,53,215,11,60,0,323
42101002114,1132,978,599,44,276,21,53,0,379
42101002143,786,701,456,40,172,21,37,1,245
42101000523,1654,1448,966,82,247,8,146,1,482
42101005605,928,706,363,108,128,6,92,0,343
42101005312,1264,895,225,171,297,16,187,2,670
42101001311,808,631,12,36,571,12,14,1,619
42079001531,839,714,697,10,1,2,2,0,17
42101001813,613,510,119,271,104,12,40,4,391
42101002112,851,767,636,32,60,18,19,0,131
42101006521,994,700,427,94,143,20,34,0,273
42101005704,801,672,398,112,70,7,88,1,274
42101003506,1381,1012,221,292,446,19,93,2,791
42101005637,915,696,351,80,172,12,87,0,345
42045003280,604,500,388,11,72,3,27,0,112
42045003371,1275,953,745,55,114,9,32,1,208
42101001307,606,436,6,9,422,3,2,0,430
42101002918,500,443,129,27,273,6,17,3,314
42009000320,330,259,242,3,2,11,2,0,17
42045002230,1139,878,729,16,57,26,48,2,149
42045000880,588,460,270,10,168,8,10,0,190
42029001150,1334,960,846,30,16,4,60,0,114
42019000430,180,129,122,1,2,1,0,0,7
42051000650,1138,961,927,1,12,19,4,0,34
42091001420,1718,1354,1232,26,24,4,61,0,122
42107000160,335,282,272,5,3,0,0,0,10
42125001720,216,172,159,2,4,5,0,0,13
42043000119,1453,1190,1067,39,11,6,71,0,123
42043001030,228,189,186,1,1,0,2,0,3
42043000835,1473,1218,1157,20,12,8,11,0,61
42013000670,613,507,500,0,2,2,1,0,7
42091002870,1108,864,665,11,148,5,23,0,199
42091000690,1381,1097,613,78,305,16,97,0,484
42111000280,678,551,539,9,1,1,1,1,12
42101000813,868,831,623,62,39,7,98,1,208
42101002808,661,546,7,20,519,9,3,0,539
42101003633,938,672,164,41,427,11,34,0,508
42101005415,897,639,132,157,100,11,238,0,507
42101006618,906,752,498,84,120,15,36,1,254
42099000180,124,95,94,0,1,0,1,1,1
4200300G160,673,487,406,14,12,1,56,0,81
42003002032,747,634,604,5,6,7,6,0,30
42003001520,996,833,711,38,54,8,24,0,122
42003009510,668,535,437,12,12,4,59,1,98
4200300G920,1083,921,667,11,213,14,15,0,254
42003002261,667,583,495,15,55,5,12,0,88
4200300F080,782,641,610,1,12,13,1,0,31
4200300F202,718,583,553,9,10,2,1,0,30
42003005740,716,609,478,6,116,9,0,0,131
42003004191,517,473,259,11,111,3,87,0,214
4200300G830,850,705,623,9,3,1,69,0,82
42003007930,702,615,527,9,59,6,8,0,88
42003005970,529,476,55,4,412,10,6,0,421
42001000490,683,496,270,205,14,3,3,1,226
42101005207,1206,1140,367,64,529,11,185,4,773
42101004870,1011,787,25,34,636,4,87,1,762
42101004921,1423,1181,70,44,953,19,115,1,1111
42101006418,1194,1045,685,105,136,7,102,1,360
42101000817,1454,1370,984,64,85,11,221,0,386
42003002760,979,780,747,7,15,7,3,0,33
42003000881,1214,1011,860,21,93,17,23,0,151
4200300F500,980,788,744,4,10,3,19,0,44
42003000591,743,618,557,7,27,4,21,2,61
42003009390,880,725,539,25,95,14,48,1,186
4200300F690,656,516,362,15,138,16,1,0,154
42101004317,778,584,16,457,119,17,7,2,568
42101001715,743,509,6,24,487,9,3,2,503
4200300G301,1247,1060,1039,7,0,1,2,0,21
42101001917,446,334,31,214,104,3,0,1,303
42101004822,590,475,165,29,80,3,198,1,310
42101000505,1152,1071,777,49,57,7,171,5,294
42101002221,729,592,44,8,532,9,9,0,548
42101000713,730,519,31,407,121,17,10,0,488
42101005019,894,715,7,4,695,9,1,0,708
42017000575,2553,1931,1598,147,115,28,56,2,333
42003006440,365,249,2,2,244,11,1,1,247
42101000702,777,573,20,504,80,2,6,1,553
42101003531,859,640,78,188,326,10,56,3,562
42101003705,705,431,15,59,357,5,1,0,416
42101000301,1100,846,100,29,710,21,21,0,746
42101001206,740,557,68,37,448,8,12,1,489
42101001604,586,440,7,13,400,5,19,0,433
42101000419,617,475,8,16,443,10,11,1,467
42101000214,944,737,334,43,268,8,96,0,403
42101002501,943,762,664,57,11,9,20,5,98
42101001821,730,620,545,26,8,4,33,0,75
42091001530,1609,1296,1002,38,182,11,63,1,294
42101001316,746,576,14,46,518,15,7,6,562
4200300D710,525,421,387,0,22,4,4,0,34
42003005281,1056,764,639,11,7,3,103,0,125
42101005803,1827,1582,927,80,134,13,429,0,655
42101006645,676,542,471,43,17,6,8,0,71
42101002002,675,532,128,115,227,19,79,8,404
42101000712,1315,954,25,793,177,40,24,2,929
42003008720,597,488,5,6,479,6,2,0,483
42003008180,608,527,251,25,217,12,30,1,276
42029001100,545,411,346,48,14,5,0,1,65
42029000470,2536,1913,1518,53,18,12,292,0,395
42045001170,1522,1204,974,22,93,1,113,3,230
42045003180,2218,1848,916,87,648,16,194,2,932
42133000260,476,356,329,5,4,14,3,0,27
42017000505,1980,1519,1234,119,99,32,19,0,285
42017002110,1510,1136,1003,27,19,14,70,0,133
42039000510,337,257,227,15,0,11,0,0,30
42091002930,837,658,312,13,295,7,29,0,346
42033000650,230,179,171,0,0,7,0,0,8
42091002970,1544,1201,924,27,97,13,135,2,277
42095000410,223,172,157,6,1,8,2,0,15
42049001480,353,252,233,1,4,10,0,0,19
42039000670,141,107,96,2,1,5,1,0,11
42023000020,113,89,86,0,3,1,0,0,3
42007001520,384,326,319,0,2,3,0,0,7
4200300G770,877,705,639,4,6,7,45,1,66
4200300C480,517,444,304,14,100,12,9,0,140
4200300C460,588,435,124,4,295,9,2,2,311
4200300G520,844,689,554,17,98,14,6,2,135
4200300B560,1373,1216,888,70,78,15,161,0,328
42101002318,854,509,21,56,439,8,2,0,488
42101002702,934,812,519,62,79,20,138,0,293
42101000211,1048,897,559,86,32,26,202,2,338
42031000030,77,66,62,0,1,0,0,0,4
42101006205,952,643,131,245,284,6,6,2,512
42101004203,1163,832,53,531,267,30,16,5,779
42101002909,359,292,46,20,208,4,15,1,246
42101004806,708,551,98,40,370,18,49,3,453
42101006002,803,648,152,34,454,6,17,3,496
42101000811,1807,1739,1277,125,66,6,221,2,462
42101000719,970,668,23,539,125,6,6,3,645
42101006225,1090,804,254,234,176,11,143,2,550
42101004305,985,672,9,431,269,16,9,1,663
42101004304,1036,736,30,495,241,12,11,4,706
42101000827,1135,1081,679,71,71,4,269,1,402
42003005630,529,438,208,9,202,20,8,0,230
4200300F445,854,710,649,11,26,4,19,0,61
42101006634,813,608,543,33,5,3,14,0,65
42009000280,192,152,133,15,3,4,0,0,19
42029001090,972,818,711,29,46,17,24,0,107
42101004010,810,578,24,48,422,3,90,3,554
42101006224,1098,818,244,256,199,14,107,0,574
42101004417,631,483,5,18,465,5,0,0,478
42101006630,914,687,572,51,22,3,31,4,115
42009000420,286,217,209,7,0,0,0,0,8
42101004614,640,471,2,17,452,18,9,0,469
42101001219,770,557,29,21,504,24,2,5,528
42101003202,663,410,12,13,374,5,9,2,398
42101002908,520,385,47,20,315,8,7,0,338
42101003322,1409,947,81,644,261,8,31,1,866
42101002515,838,620,155,271,166,9,42,2,465
42101004412,461,320,5,9,307,0,1,1,315
42101005412,1271,892,162,249,196,12,239,0,730
42101006636,1303,1066,856,59,83,24,47,0,210
42101002708,877,831,446,72,83,15,226,4,385
42101004817,1005,814,291,43,254,12,227,0,523
42045002200,594,496,406,4,51,13,24,0,90
42025000450,809,622,576,26,9,3,2,0,46
42091001190,1076,793,645,33,79,4,25,0,148
42045003250,1790,1490,928,43,340,18,170,2,562
42091001055,1312,1074,952,30,26,7,58,1,122
42045001470,680,511,446,15,13,4,29,0,65
42129000030,783,645,619,4,8,9,4,1,26
42125001400,1519,1174,1130,5,7,7,12,0,44
42129001460,204,144,77,5,62,0,0,0,67
42037000250,597,476,442,17,7,5,7,1,34
42033000590,436,359,349,2,3,0,2,0,10
42091000728,1789,1655,1306,119,162,25,63,2,349
42091002450,2097,1647,1261,80,209,10,79,2,386
42071001940,2628,2021,1719,99,60,26,118,0,302
42003002576,935,763,725,7,4,3,18,0,38
42101006021,576,431,9,13,414,2,4,1,422
42101004416,724,534,22,6,500,7,3,0,512
42101002605,807,689,617,25,3,1,36,5,72
42071001146,3558,2755,1372,840,424,27,169,0,1383
42007000930,129,104,101,3,0,0,0,0,3
42003002541,1515,1179,1094,23,4,7,39,0,85
42003007020,1159,1027,760,44,19,2,184,1,267
42003008890,399,277,6,5,263,4,1,0,271
42003007640,678,633,549,9,55,0,14,0,84
4200300G325,1761,1507,1454,13,8,6,21,0,53
42003000760,637,570,413,16,114,9,8,1,157
42101002116,681,600,520,23,30,2,19,0,80
42101003004,979,852,464,56,224,14,97,2,388
42101003321,698,432,39,224,165,8,10,0,393
42101001907,792,575,14,495,94,15,11,7,561
42101005618,814,625,400,59,59,7,96,0,225
42003002790,81,61,60,0,0,0,0,0,1
4200300H101,1123,1007,633,35,270,15,46,0,374
4200300F981,1227,1001,841,10,130,15,2,0,160
42003001931,1036,861,743,31,58,5,29,0,118
4200300C380,460,364,197,8,140,2,13,0,167
42003006640,769,691,285,28,350,5,31,0,406
42101001304,831,682,153,16,504,5,15,3,529
42003004291,876,705,638,16,33,9,6,0,67
42101001512,891,722,541,44,96,2,35,0,181
42101002145,698,626,528,12,38,0,44,0,98
42101005919,997,873,311,37,505,24,17,0,562
4200300A520,906,866,742,31,38,10,28,3,124
42101003216,495,356,25,7,323,9,4,0,331
42101003934,970,755,325,163,67,17,191,6,430
42101004814,837,743,306,71,130,9,235,5,437
42101006627,798,657,548,25,37,8,40,2,109
42101001019,657,528,6,5,516,5,4,1,522
42101003221,628,478,9,26,447,16,5,0,469
42101000701,794,590,14,526,66,11,7,2,576
42101003508,1016,812,182,205,399,14,36,2,630
42101001903,745,531,14,464,87,15,6,0,517
42101005908,797,593,38,11,537,14,1,1,555
42101005502,1202,853,354,227,269,11,21,0,499
42101004102,1040,723,236,198,280,18,14,1,487
42101006319,749,616,457,34,26,3,98,0,159
42091002510,1778,1438,930,62,171,12,261,3,508
42091003740,1100,795,699,17,32,8,35,0,96
42101002130,1314,1143,746,66,259,21,78,0,397
42101001101,443,332,5,6,317,2,2,1,327
42101002521,855,625,184,302,137,18,20,8,441
42101004219,1502,1143,77,321,553,15,230,3,1066
42003005570,987,804,394,36,368,13,10,1,410
42017002260,1353,1081,987,42,35,6,15,1,94
42045002610,699,498,375,16,90,9,10,2,123
42045000820,1122,804,102,17,687,5,2,4,702
42019000366,1601,1292,1161,17,51,5,56,0,131
42019000367,1540,1285,1012,47,32,11,164,2,273
42027000680,901,748,645,31,19,2,53,0,103
42017002490,964,808,738,19,29,12,18,0,70
42125001220,260,228,217,1,4,4,1,1,11
42129001320,691,558,504,5,10,14,8,0,54
42129002610,230,186,173,0,0,11,0,0,13
42069002400,730,590,536,17,15,9,7,0,54
42129000800,526,438,425,1,2,8,0,0,13
4200300A560,850,816,721,22,35,5,30,1,95
42003008140,452,391,41,14,322,3,11,1,350
42003004031,1253,1018,636,19,286,8,76,0,382
42003005510,787,663,301,5,330,7,9,0,362
42101004418,547,405,10,24,389,6,2,2,395
42101005513,901,695,292,136,70,3,172,0,403
42101001704,802,734,0,25,545,2,171,1,734
42101004601,994,853,554,34,162,13,95,1,299
42101000302,1187,893,49,38,798,13,22,3,844
42101005806,1030,837,603,60,57,7,90,7,234
42101002210,772,687,225,19,429,10,13,0,462
42101002214,1117,907,149,48,715,22,19,2,758
42061000410,379,282,270,6,2,2,1,1,12
42003004580,1024,844,733,17,28,2,49,0,111
42101000103,832,716,598,52,9,7,50,1,118
42101006111,1075,765,25,138,517,10,95,0,740
42009000290,191,139,138,1,0,0,0,0,1
42079001210,108,99,95,2,0,1,1,0,4
42079000430,917,750,716,12,11,6,1,1,34
42101002914,363,288,44,15,226,7,5,0,244
42101006101,1038,772,37,121,503,8,121,0,735
42101005322,1071,802,229,134,233,20,191,2,573
42101003501,1514,1238,403,191,559,14,82,0,835
42101001501,1115,963,756,37,79,8,78,4,207
42101002910,1821,1602,850,101,521,21,139,2,752
42101000113,1294,1041,487,155,143,14,259,4,554
42101003617,531,456,181,23,218,7,36,0,275
42011001070,970,614,65,498,62,39,11,3,549
42101003717,666,491,19,290,184,15,14,1,472
42101005106,927,814,471,51,240,13,49,0,343
42101004019,1200,853,52,93,502,4,210,1,801
42101002320,1018,771,147,198,440,7,13,3,624
42029001275,708,611,425,16,19,7,148,2,186
42091002840,750,636,418,37,168,3,11,1,218
42045002480,375,282,188,10,67,10,12,0,94
42045002190,617,469,421,8,24,3,3,2,48
42095000790,2096,1714,1480,88,34,9,94,1,234
42045003555,1441,1076,222,118,549,9,182,1,854
42091001105,1471,1187,1025,28,18,4,103,1,162
42049001080,476,369,343,4,7,8,2,0,26
42125001580,392,323,305,8,4,4,2,0,18
42017001620,1210,956,844,46,15,5,42,2,112
42133001440,239,191,174,9,3,6,2,0,17
42133000730,256,213,195,6,1,3,4,1,18
42125002020,109,91,83,1,4,2,0,0,8
42021000250,162,124,109,2,3,4,1,0,15
42091003020,1560,1260,993,65,90,18,89,4,267
42091003270,1061,858,617,22,53,4,149,1,241
42003002430,471,325,274,6,24,7,3,0,51
42101006505,864,650,320,110,161,8,60,1,330
42029000410,2090,1802,1237,120,117,10,318,0,565
4200300F201,832,682,659,7,4,2,7,0,23
4200300B310,859,694,585,7,66,18,21,0,109
4200300F710,442,335,171,7,136,17,4,0,164
4200300G230,821,670,600,9,46,6,0,0,70
4200300F172,899,752,728,9,3,2,5,0,24
42003005390,590,427,391,15,15,5,4,1,36
4200300C420,396,297,98,11,183,8,4,2,199
4200300C400,593,510,292,10,196,4,9,0,218
4200300F130,750,625,585,17,10,8,4,0,40
42101000832,1318,1281,976,65,80,2,161,2,305
4200300B350,722,593,492,37,41,12,20,1,101
42101000515,862,788,570,63,67,12,75,4,218
42101005612,1166,878,444,118,103,9,187,1,434
42003001041,878,726,581,11,31,10,86,0,145
42003006580,462,388,72,9,292,11,15,1,316
42003004380,883,657,586,16,14,5,21,0,71
42003004391,743,538,499,12,3,4,17,0,39
42101001718,790,612,30,16,546,20,19,0,582
42101006638,1023,794,645,48,42,1,54,0,149
42101006114,1039,754,38,107,505,7,100,0,716
42003004480,557,416,367,8,5,2,33,0,49
42101004616,1147,1040,620,83,199,14,137,3,420
42101000603,1457,1273,387,80,596,25,212,3,886
42101004613,679,534,62,10,462,2,3,0,472
42101001027,822,616,4,11,601,9,1,0,612
42101000102,880,758,612,38,16,15,92,0,146
42101004820,774,677,332,37,50,5,259,0,345
42101000703,623,440,12,366,77,7,11,3,428
42101004322,352,291,6,35,249,2,5,0,285
42101001208,1097,840,82,42,702,8,20,1,758
42101005816,846,674,537,27,20,3,81,0,137
42101000108,1132,906,446,219,28,17,206,0,460
42101005318,1268,990,289,188,183,10,319,6,701
42003007410,711,642,514,19,55,16,42,2,128
4200300G970,602,519,259,13,234,7,9,0,260
42101003933,870,676,445,71,10,2,148,0,231
42101002229,632,546,20,17,497,11,9,3,526
42101001812,976,851,753,42,15,4,36,0,98
42101003418,881,711,28,15,655,6,12,0,683
42041000060,1046,828,653,44,107,18,17,3,175
42117000310,400,298,284,1,0,7,2,0,14
42125000940,376,319,287,3,17,3,2,2,32
42021000550,203,152,149,0,3,1,0,0,3
42017000190,1319,1083,790,76,109,15,94,3,293
42043000762,1565,1235,1062,22,47,4,98,0,173
42091001480,1202,970,456,86,386,8,45,0,514
42107000660,461,380,350,16,3,4,1,2,30
42003001690,883,606,263,17,328,7,0,0,343
42003004341,962,792,679,20,27,4,34,1,113
42003002581,820,672,619,17,7,9,19,0,53
42003003390,673,552,467,14,17,10,33,0,85
42101005636,876,698,364,84,99,9,92,1,334
42101004612,869,654,48,13,588,6,8,0,606
42101003014,782,659,418,32,132,5,67,1,241
42101003222,475,364,5,9,348,14,3,0,359
42101005020,864,701,2,9,683,14,7,0,699
42101001323,601,466,17,31,411,4,9,3,449
42101005512,1069,761,332,115,71,8,205,1,429
42101005622,1120,932,716,52,63,5,66,2,216
42003005642,772,619,354,13,248,6,1,0,265
42073000200,969,821,773,6,7,6,14,0,48
42073000345,1231,1000,886,9,80,15,1,1,114
42079002600,911,771,751,7,3,7,1,0,20
42061000420,309,234,226,0,0,8,0,0,8
42101004415,807,601,27,16,548,9,5,2,574
42101000503,464,419,370,12,9,0,25,0,49
42101002118,730,638,541,25,31,8,17,1,97
42101002308,977,704,117,167,415,28,31,4,587
42101003601,548,478,242,20,192,5,19,0,236
42101002522,694,546,459,48,27,5,13,0,87
42101000416,933,679,2,15,649,19,15,4,677
42101002907,215,161,7,7,149,3,1,0,154
42101005606,1048,876,599,68,109,7,84,0,277
42091000330,1263,995,842,16,93,8,32,1,153
42107000550,387,306,243,58,2,2,1,1,63
42045002890,986,806,738,8,13,7,40,0,68
42021000090,213,177,175,1,0,0,0,0,2
42115000430,220,194,184,3,0,2,0,0,10
42017001120,1343,1113,999,40,24,17,21,1,114
42011001080,2492,1686,261,1291,206,83,14,7,1425
4200300C960,1033,827,457,24,330,9,17,0,370
42107000740,91,76,73,2,1,0,1,0,3
42101003408,831,647,8,14,617,14,10,0,639
42101005517,1157,855,376,164,71,1,194,1,479
42101006127,837,692,30,31,589,5,49,0,662
42101006116,1012,781,36,126,407,20,220,3,745
42101003622,475,382,52,21,303,8,10,0,330
42101004509,1195,898,227,409,275,35,17,0,671
4200300G854,749,618,564,4,10,1,38,0,54
4200300E036,789,652,588,17,27,2,17,0,64
4200300F120,854,713,685,4,8,5,7,0,28
42003003270,1845,1432,1221,33,19,11,143,1,211
42003005520,1120,902,359,10,520,12,10,0,543
42003004530,537,405,365,11,8,4,17,0,40
42003004430,598,463,417,9,21,3,7,0,46
42101003510,953,701,111,156,402,18,44,1,590
42101001915,489,338,19,223,111,18,2,0,319
42003004245,2282,1886,1714,48,47,21,38,2,172
42003000596,707,654,573,31,21,2,32,1,81
4200300B110,626,537,430,4,82,10,8,1,107
42003009410,528,417,357,6,20,3,22,0,60
42101003707,505,400,18,39,349,10,4,1,382
42101002710,644,547,260,37,86,3,163,0,287
42101005122,804,596,27,21,535,18,10,2,569
42101005223,868,675,14,8,642,12,9,0,661
42101006510,1561,1342,1022,72,105,12,127,2,320
42101006643,1031,812,754,27,7,5,19,2,58
42101006105,1148,891,35,186,399,21,284,0,856
42101002402,1056,949,452,41,270,9,181,0,497
42101005723,1020,775,456,48,98,10,169,0,319
42101001009,787,617,14,21,582,13,6,0,603
42101006519,925,687,372,153,97,6,57,3,315
42101000303,899,729,14,13,654,6,45,0,715
42101005112,710,538,37,11,485,7,2,0,501
42101003319,1036,713,77,423,211,13,38,2,636
42101006609,785,616,547,33,11,4,21,1,69
42101005311,1001,741,135,158,249,14,179,6,606
42003009810,720,640,379,28,15,4,207,0,261
42101001209,821,630,90,29,505,8,2,2,540
42101001312,605,467,6,12,450,4,2,0,461
42101006325,744,657,435,60,70,2,90,3,222
42101000514,1022,961,708,59,85,4,96,1,253
42003006190,750,715,484,19,147,3,62,0,231
42017002040,1968,1661,1558,24,19,2,51,0,103
42045002700,1017,796,717,18,9,3,45,0,79
42043000103,1767,1394,835,119,117,3,311,1,559
42091000335,1219,964,763,38,114,9,44,1,201
42129002410,449,353,342,0,2,0,4,0,11
42129002010,1312,1089,1032,11,24,7,13,3,57
4200300E465,2049,1625,1151,30,56,6,375,0,474
42007000045,847,693,445,7,227,9,4,1,248
42003009080,594,294,0,3,289,1,0,0,294
42003000235,1775,1411,817,35,220,19,327,0,594
4200300G430,428,365,336,3,16,4,2,0,29
42101004306,913,689,17,537,176,15,10,3,672
42101002508,883,678,492,75,71,12,42,0,186
42101003104,919,810,682,41,29,19,38,1,128
42101006013,615,476,79,15,358,7,27,0,397
42101005026,827,666,10,11,642,10,3,1,656
42101003411,880,663,10,10,638,11,4,0,653
42101005912,657,492,58,13,418,6,8,0,434
42003002231,724,616,485,16,81,7,27,1,131
42003000623,767,605,556,7,8,8,23,0,49
42101000912,1116,951,538,37,323,18,38,2,413
42101004220,1404,974,33,368,499,19,105,3,941
42101003819,747,602,206,40,280,14,77,0,396
42101004323,459,356,13,40,300,2,6,1,343
42101001511,1001,874,578,79,160,7,56,2,296
42101003530,1153,811,51,314,246,5,223,0,760
42101004218,1345,1024,90,360,464,35,138,2,934
42101005316,1049,763,242,123,114,20,272,1,521
42101002222,837,701,24,16,658,11,11,2,677
42101002718,1071,1049,345,111,236,15,346,5,704
42045003635,1042,713,72,88,521,12,39,1,641
42045002590,917,699,664,8,8,1,15,0,35
42045003362,1354,1110,841,50,186,9,26,1,269
42129001995,3082,2173,2002,35,41,14,57,0,171
42107001725,595,474,420,31,3,12,3,0,54
42091001731,827,584,534,15,8,4,17,0,50
42091001732,395,263,242,2,2,3,7,0,21
42003003810,847,547,173,3,366,5,0,0,374
42003000625,958,812,758,12,9,6,19,3,54
42091001098,1048,811,644,26,20,5,112,1,167
42083000260,612,470,438,4,11,14,3,0,32
42101006506,592,432,196,65,108,6,61,0,236
42101001309,715,533,11,37,493,9,1,0,522
42101000313,698,493,7,6,460,13,9,0,486
42101004051,926,658,58,18,546,8,41,0,600
4200300C770,737,597,403,13,163,7,7,0,194
42101003611,636,550,144,43,279,25,76,0,406
42101003415,1172,845,20,7,812,15,3,0,825
42101001113,1096,773,18,40,714,17,6,2,755
42003009690,766,622,503,24,18,4,64,0,119
42003003151,1042,784,700,28,16,7,21,0,84
42003006270,998,994,421,27,45,0,499,0,573
42101003606,738,636,227,37,336,2,35,1,409
42003008810,344,275,2,2,271,2,1,1,273
42003005791,580,476,422,13,19,4,12,0,54
42101003401,607,441,16,18,400,4,14,0,425
42101001509,821,710,616,29,37,11,24,1,94
42101005217,1003,781,10,7,750,23,16,0,771
42101005105,932,695,127,19,528,11,27,0,568
42101000507,1039,965,740,59,46,7,102,1,225
42101001707,1026,734,12,27,700,11,6,0,722
42101005001,698,576,4,10,549,8,5,1,572
42101005117,779,564,35,16,500,10,9,4,529
42101006518,1007,781,274,132,357,6,31,5,507
42101000322,844,634,3,11,601,9,16,0,631
42101003317,836,585,53,377,149,14,27,11,532
42101004105,712,547,218,156,152,18,41,2,329
42101004045,765,646,47,12,539,3,49,0,599
42101005417,1054,768,172,207,143,15,188,1,596
42101006624,902,685,497,36,113,4,25,2,188
42101005301,1283,862,115,257,442,4,70,0,747
42101001514,828,703,640,11,13,5,31,1,63
42101005022,967,797,9,16,758,13,2,1,788
4200300E850,1241,1107,1058,10,31,8,5,0,49
42089000300,688,537,294,92,130,9,23,1,243
42045000770,1090,810,323,30,425,10,21,0,487
42045000780,1154,826,365,34,369,6,47,0,461
42045002300,717,578,473,16,61,9,21,0,105
42095000827,1495,1154,990,78,19,9,52,1,164
42017002785,4284,3235,2447,64,55,20,626,3,788
42091001570,1599,1189,817,57,55,8,251,2,372
42091000195,1385,1089,650,52,320,18,61,1,439
42129002140,731,603,574,8,6,0,9,0,29
42003002971,797,656,548,4,89,2,7,0,108
42101002023,1905,1811,575,150,685,6,335,53,1236
42101002011,4115,4089,2103,379,829,10,698,34,1986
42101004311,709,500,10,422,97,18,4,3,490
42101003919,798,619,262,64,45,6,248,1,357
42101000720,713,484,23,359,101,20,11,5,461
42101005315,1087,844,276,116,230,16,197,6,568
42101004111,859,599,238,137,208,10,16,3,361
42101006625,671,514,441,35,25,5,23,1,73
42101002814,510,360,8,5,349,1,1,1,352
42101000409,829,627,7,13,611,6,0,0,620
42101002506,726,585,499,33,13,9,23,0,86
42101003909,712,580,202,113,120,4,138,0,378
42101004120,1045,729,337,160,204,4,37,1,392
42101001211,1086,867,132,44,680,19,15,1,735
42045003670,901,603,50,53,441,7,64,4,553
42129001965,990,794,761,7,4,8,6,0,33
42129000010,142,121,112,3,2,1,3,0,9
42021001910,40,30,28,1,0,1,0,0,2
42101002135,1125,957,743,56,83,3,65,1,214
42101005630,1970,1545,1007,68,214,15,253,1,538
42101000307,765,600,19,22,555,13,13,0,581
42101003220,560,432,14,19,403,6,2,0,418
42007000600,1588,1184,1111,17,16,7,26,1,73
4200300A990,239,233,219,4,6,1,4,0,14
42003004950,287,232,179,0,50,0,0,0,53
42003000191,1211,971,793,5,51,10,104,0,178
42101005505,1134,798,317,271,207,14,24,2,481
42101000601,1423,1258,395,85,487,26,291,4,863
42101005101,642,485,25,18,432,10,14,1,460
42101001724,919,702,19,24,656,14,3,2,683
42101002514,690,493,161,193,135,11,16,1,332
4200300B840,897,822,611,16,78,8,105,0,211
4200300F820,800,695,441,15,214,4,12,3,254
42003007040,1183,1140,625,31,80,2,394,0,515
42003006740,306,188,16,9,166,2,2,0,172
4200300B800,506,423,111,17,280,9,10,1,312
42101001013,904,755,6,13,736,6,3,0,749
42101003522,1287,888,92,293,489,11,36,5,796
42101002701,1230,1086,511,68,81,8,410,0,575
42101000570,726,691,448,56,59,4,119,0,243
42101002411,851,749,255,42,348,10,107,0,494
42101003621,579,476,119,17,296,6,31,0,357
42101000119,785,674,578,26,18,8,32,0,96
42101000604,1094,738,15,39,644,11,52,0,723
42101001023,713,571,12,11,543,19,3,2,559
42101006321,767,608,351,34,20,2,204,2,257
42101002142,702,565,439,15,64,10,36,0,126
42101005801,1215,1008,600,83,56,6,263,3,408
42045002840,1432,1033,945,15,17,3,45,0,88
42045003445,1248,921,221,115,415,17,169,3,700
42045003480,1941,1471,167,97,971,28,229,8,1304
42091001560,2068,1843,1264,52,288,6,231,0,579
42129001170,146,121,119,2,0,0,0,0,2
42129001050,808,664,599,6,45,6,2,0,65
42017000270,2157,1730,1363,80,74,9,199,0,367
42003004790,468,360,229,12,107,5,10,0,131
42003000865,755,616,543,13,24,11,19,0,73
42101003931,1034,805,622,74,16,0,89,0,183
42101002208,724,580,168,27,381,8,9,0,412
42101005028,930,746,5,6,711,17,15,0,741
42101003923,1207,841,130,199,69,24,436,1,711
42003007470,1034,962,511,78,97,11,263,0,451
42101002705,1150,1096,537,116,119,2,313,2,559
42101006611,828,656,569,44,35,9,13,0,87
42101001908,674,521,9,429,107,9,7,2,512
42101001505,735,627,533,35,25,2,32,0,94
42101002227,744,610,17,11,562,10,21,0,593
42101003706,531,347,9,66,281,4,6,2,338
42045003710,607,449,67,74,172,12,140,0,382
42005000040,112,88,84,2,2,2,0,0,4
42045002250,766,616,576,11,6,10,16,2,40
42133000290,518,407,378,5,9,3,7,0,29
42129000640,751,622,556,21,26,7,10,0,66
42133000130,707,533,492,14,7,13,0,0,41
42091001699,1475,1407,846,126,94,16,343,0,561
42041000257,1171,928,762,28,25,15,96,2,166
4200300G030,482,369,170,6,185,3,6,0,199
42101006412,1018,726,305,127,103,4,151,4,421
42101000315,851,664,21,13,623,16,3,2,643
4200300E110,1040,831,712,15,77,11,12,0,119
42003009900,786,669,552,21,35,5,49,1,117
42101004108,1116,786,268,196,302,11,21,4,518
42101005208,765,719,67,35,587,21,27,2,652
42101005715,1018,791,538,75,102,11,58,1,253
42003003975,1134,923,522,29,210,6,150,1,401
42101001612,586,439,15,28,392,5,1,1,424
42101000914,681,534,330,24,146,14,27,5,204
42101000106,884,717,388,150,87,5,86,1,329
42101006022,622,451,13,10,425,3,7,0,438
42101000810,2316,2257,1824,99,118,7,195,0,433
42101005304,1214,865,112,208,455,11,105,5,753
42101005815,919,720,292,24,31,7,353,0,428
42101006307,306,298,287,3,6,0,4,0,11
42101004713,422,341,51,14,273,7,6,0,290
4200300E555,922,758,720,4,11,2,16,0,38
42045000920,682,504,349,13,124,2,11,0,155
42091000590,1692,1380,203,89,1018,22,80,2,1177
42007000885,604,499,468,8,9,3,3,0,31
4200300E880,757,627,600,7,2,1,12,0,27
42003003095,1081,899,817,13,51,8,8,0,82
42101002618,741,600,504,19,10,5,63,0,96
42101002603,693,599,585,1,3,0,9,0,14
42101005514,1045,809,385,121,79,5,191,0,424
42003005650,874,701,294,22,364,8,5,2,407
42101002812,528,372,6,8,355,1,2,2,366
42101004607,813,710,330,59,266,5,55,0,380
42101004908,1073,836,47,39,735,19,25,10,789
42101002905,345,253,7,31,230,9,2,0,246
42101003215,562,370,10,15,342,1,14,1,360
42101000111,807,687,587,26,11,16,46,0,100
42045001540,759,631,282,22,306,7,21,1,349
42119000055,1713,1562,1164,91,81,8,212,3,398
42129002240,229,201,188,5,3,0,2,1,13
42115000280,245,207,200,0,0,1,2,0,7
42101004123,988,727,394,159,140,17,36,0,333
42101003627,809,631,295,50,218,3,75,0,336
42101006513,950,723,385,187,138,3,27,0,338
42003005808,1078,734,677,10,9,15,23,0,57
42101005724,1021,794,537,45,142,12,56,1,257
42101001913,610,448,15,313,136,13,9,2,433
42101005226,884,713,19,13,674,14,3,1,694
42101005212,1099,1016,334,34,636,13,17,0,682
42101000305,802,593,5,11,562,5,13,2,588
42101000407,1078,818,3,32,770,18,15,0,815
42101006120,649,550,20,32,471,3,23,0,530
42101003519,1050,778,78,191,470,11,68,2,700
42101004036,896,636,43,21,547,9,26,0,593
42101002519,912,610,86,318,215,11,12,2,524
42101005834,956,787,582,22,27,3,147,0,205
42003009090,709,534,12,8,510,16,5,0,522
42101006208,1147,790,112,221,445,28,32,1,678
42101005716,773,626,472,70,31,4,42,0,154
42045001580,587,445,174,32,218,10,17,1,271
42091000996,663,522,448,9,21,2,39,0,74
42125000460,371,292,282,1,4,4,1,0,10
42011001120,2046,1472,389,822,331,64,21,6,1083
4200300B090,527,460,408,16,20,9,6,0,52
42101002714,1235,1090,600,84,148,11,257,0,490
42101004602,742,617,309,42,230,8,41,1,308
42101002510,652,532,442,45,21,7,20,7,90
42101006221,966,723,185,281,163,14,115,5,538
42101001112,462,373,15,11,346,9,2,0,358
42101000808,897,838,627,62,39,6,97,1,211
42101006124,833,683,121,61,508,8,13,1,562
42101005125,898,640,4,19,607,8,8,0,636
42101002611,696,601,500,23,23,4,37,2,101
42101005817,928,763,442,21,12,2,287,0,321
42101005632,721,551,260,64,59,6,166,0,291
42129001410,413,294,189,13,87,4,3,0,105
42033000610,42,33,31,0,0,0,1,0,2
4200300E270,725,592,549,9,11,12,3,1,43
42101006503,928,700,293,137,215,25,56,2,407
42101003204,500,396,50,12,320,7,10,1,346
42101002507,795,660,575,37,20,10,19,1,85
4200300E505,862,692,669,7,6,10,2,0,23
42101006128,799,620,20,55,530,3,22,0,600
42101002511,872,665,379,157,95,11,28,2,286
42101005116,640,490,9,6,466,4,9,0,481
42101005119,605,429,3,4,423,6,3,1,426
42101006406,1050,768,496,135,91,5,35,2,272
42101000321,621,473,7,3,460,7,6,0,466
42101005526,1107,797,357,218,200,12,31,0,440
42101005906,699,486,15,21,446,3,6,4,471
42003008210,731,642,502,9,70,6,53,1,140
42045001680,807,571,376,16,159,12,12,0,195
42045003560,891,693,130,90,357,3,110,0,563
42045000690,985,746,440,14,239,21,22,2,306
42101001608,508,346,2,12,330,1,2,0,344
42101004805,688,565,163,51,209,5,139,0,402
42101001705,766,589,13,18,555,4,3,0,576
4200300E038,724,591,535,4,16,5,26,1,56
42101000212,1023,820,577,87,60,26,85,0,243
42101005701,903,751,619,64,36,10,25,1,132
42041000420,1015,769,667,22,42,18,10,2,102
42047000100,207,164,161,1,0,1,0,0,3
42091000600,1853,1474,189,89,1126,22,76,2,1285
42101005003,877,693,12,17,675,14,0,0,681
42003006020,715,573,136,21,359,14,51,0,437
42101000520,672,580,440,52,56,2,35,2,140
42003005130,675,589,518,15,46,3,0,1,71
4200300E485,861,671,629,3,16,3,15,1,42
42101006216,1095,806,170,258,331,10,40,2,636
42101003521,1280,909,96,231,504,7,99,0,813
42101003311,1261,929,141,577,192,12,69,3,788
42101004419,749,584,5,27,559,13,8,0,579
42101005838,1767,1342,1052,27,33,5,207,3,290
42101004221,926,641,20,228,314,11,96,2,621
42101006613,678,513,421,27,21,3,35,0,92
42003006780,103,71,18,1,48,2,2,0,53
42091000550,1130,945,646,36,171,12,88,0,299
42091001520,1378,1112,887,66,49,7,97,0,225
42101001722,688,543,6,23,503,1,11,2,537
42101004016,981,702,50,34,566,11,54,0,652
42101000421,650,549,3,7,539,4,5,0,546
42101000722,913,637,47,459,134,36,17,3,590
42101005839,883,715,617,30,24,7,42,1,98
42101001503,1824,1646,1114,147,211,7,163,2,532
42101003902,958,693,167,151,81,18,293,0,526
42101000723,739,552,97,351,128,13,18,4,455
4200300G981,1158,998,147,6,814,7,25,2,851
42003004700,725,556,497,13,7,7,38,1,59
42101001709,679,507,12,22,472,10,1,1,495
42101001008,802,591,5,16,567,7,6,0,586
42101005703,1019,824,514,70,83,8,145,2,310
42101000114,1015,867,407,130,114,9,212,2,460
42101005905,939,695,12,24,669,31,1,1,683
42045003630,912,612,72,37,487,12,21,0,540
42059000210,264,218,195,4,5,13,1,0,23
42045002845,998,766,654,9,33,3,69,0,112
42045003660,1141,832,122,76,612,11,28,0,710
42101004022,821,576,45,17,480,6,34,1,531
42003003120,583,488,453,11,11,4,7,0,35
42101005722,689,560,475,41,15,1,26,0,85
42101003807,773,608,20,22,568,1,0,0,588
42101002815,449,328,4,5,315,0,1,0,324
42101003218,735,509,13,14,479,4,4,1,496
42101003303,909,678,109,379,72,5,133,0,569
42101004038,917,734,49,27,625,8,38,2,685
42101005211,1023,893,186,41,556,15,97,1,707
42045003230,1218,924,797,14,87,5,18,1,127
42091001795,1364,1060,920,17,12,2,96,0,140
42091000610,1122,1000,602,43,301,12,36,0,398
42003006560,356,300,46,5,244,6,1,0,254
42101004522,820,648,600,15,12,4,10,3,48
42101002616,804,717,567,50,28,4,65,3,150
42101003935,1084,947,671,95,47,13,125,2,276
42101002619,745,621,520,22,29,4,53,0,101
42101006637,1166,957,608,120,200,13,21,0,349
42101002809,754,600,8,11,585,8,2,1,592
42101003618,718,597,140,51,364,17,39,2,457
42101004615,837,629,2,20,594,17,16,0,627
42101004406,793,596,13,15,557,6,10,0,583
42003005682,864,714,411,4,284,10,10,0,303
42101002523,892,639,323,183,137,15,4,0,316
42101005414,881,676,112,167,125,2,267,0,564
42025000410,231,185,172,11,1,1,1,1,13
42101004516,926,616,111,333,161,17,28,4,505
42003005960,355,276,33,5,228,5,9,0,243
4200300G060,907,731,570,3,148,2,6,0,161
42045003420,579,409,155,33,138,7,88,0,254
42017000150,3162,2506,783,648,316,33,744,1,1723
42003003980,613,526,476,15,27,8,1,0,50
42101006408,855,627,447,48,60,10,43,0,180
4200300E085,816,640,589,5,26,12,8,0,51
4200300F150,686,580,544,5,8,4,18,0,36
42101005219,788,667,33,14,624,11,2,0,634
42101004411,890,641,15,18,604,4,4,1,626
42101002209,747,560,91,21,427,15,20,0,469
42101003006,932,805,575,45,114,10,63,0,230
42101004044,822,627,37,7,526,1,51,2,590
42101003518,1093,753,23,193,513,13,34,2,730
42101004043,822,588,72,24,446,10,56,0,516
42101002516,604,413,77,232,117,7,11,7,336
42003005540,981,746,360,14,348,11,11,0,386
42045001490,1600,1303,1048,34,61,4,150,0,255
42007001125,509,380,302,10,51,7,2,0,78
42101006015,713,564,52,10,467,20,24,1,512
42101005014,702,563,1,4,549,11,3,0,562
42101004208,1226,875,51,590,179,11,79,11,824
42101005725,795,638,463,40,58,9,67,1,175
42101006019,667,535,9,9,511,4,12,0,526
42101003604,492,418,153,25,222,3,19,0,265
42091001600,1031,735,609,27,38,4,59,3,126
42003005670,1065,926,462,17,416,19,10,0,464
42101006504,882,838,711,29,73,6,23,0,127
42101003513,1302,876,67,182,588,6,54,4,809
42101000522,862,807,571,49,97,2,72,1,236
42101003532,928,749,274,178,248,10,62,3,475
42101006628,928,720,584,62,33,25,30,1,136
42101001302,742,540,33,16,482,16,3,1,507
42123000010,148,112,107,0,0,5,0,0,5
42101005629,643,588,446,70,36,7,43,1,142
42101005705,865,714,348,106,93,14,158,2,366
42009000370,76,68,65,0,1,2,0,0,3
42101005915,740,535,61,24,446,13,4,0,474
42101001918,497,387,13,232,159,8,16,1,374
42101003404,591,434,2,26,403,9,1,0,432
42101000818,1612,1542,1118,74,70,5,251,2,424
4200300E346,1545,1209,1071,19,32,8,72,0,138
42003003135,674,556,546,3,0,2,6,0,10
42101002220,659,530,78,12,432,4,7,0,452
42101001607,598,435,14,4,417,5,2,0,421
42101005901,916,599,1,12,574,14,7,0,598
42107001385,282,193,153,33,3,0,3,0,40
4200300B070,586,539,441,10,73,5,7,1,98
42003007990,680,558,285,7,249,1,13,0,273
42101001110,566,383,7,21,361,4,0,0,376
42101005305,1383,1013,159,265,474,9,117,3,854
42101000916,949,870,297,32,452,16,68,0,573
42101000420,750,549,2,5,540,12,0,0,547
42101000816,759,748,647,22,19,10,49,0,101
42101005015,771,624,13,10,598,6,9,1,611
42003000121,564,520,446,9,51,11,5,0,74
42003001630,666,551,515,14,10,8,5,0,36
42101003801,476,341,2,7,333,0,7,0,339
42101002502,867,610,293,158,144,13,21,2,317
42101000306,796,571,5,12,529,17,27,0,566
42101005025,688,542,11,7,519,2,1,0,531
4200300F830,323,263,64,14,174,6,9,4,199
42045003390,808,637,217,89,181,10,143,0,420
42101003920,849,704,615,29,20,4,43,0,89
42003005590,780,638,369,21,241,4,5,0,269
42101004712,1532,1366,541,100,440,11,262,30,825
42101002722,1681,1670,809,155,146,3,537,0,861
42091001145,708,557,449,17,20,3,64,0,108
42101005027,777,637,15,24,604,5,2,0,622
42003004620,690,523,486,5,8,4,11,1,37
42003005261,443,363,297,3,46,2,12,0,66
42101003217,400,291,6,22,263,5,2,0,285
4200300C300,690,606,468,20,101,10,9,0,138
42101004015,723,560,43,31,430,6,65,2,517
42101001617,696,543,3,10,534,9,0,0,540
42101006520,1935,1865,1621,58,135,3,41,0,244
42101002524,795,561,302,160,87,13,7,1,259
42017001880,1302,1030,874,24,29,2,87,0,156
42101006009,1055,888,308,52,471,22,65,1,580
42003005500,572,463,189,11,258,9,4,0,274
42101004413,667,492,8,28,444,9,23,1,484
42101002218,536,449,69,11,369,1,12,0,380
42101003407,845,652,7,22,622,9,2,0,645
42101001012,833,632,4,3,623,6,1,0,628
42003006150,235,175,28,6,119,3,22,0,147
42101002213,837,618,38,32,546,20,23,1,580
4200300G111,697,499,456,6,7,3,17,0,43
42101001222,1030,901,266,28,509,9,94,1,635
42091001180,1088,925,714,21,111,4,68,0,211
42017001630,872,676,593,31,25,2,26,1,83
42101004606,989,710,16,18,672,20,2,3,694
42101004225,913,698,41,98,452,10,111,1,657
42101006317,632,486,437,21,0,3,22,0,49
42101000309,836,660,16,16,623,21,7,0,644
42045003640,796,557,71,52,375,9,63,1,486
42003004150,1619,1345,686,43,341,20,260,1,659
42003009770,1562,1458,820,61,117,3,451,0,638
42101003427,771,580,40,19,524,0,4,1,540
42101005726,931,779,333,95,199,17,143,7,446
42101003402,814,612,8,7,591,24,8,0,604
4200300A415,206,161,109,3,43,2,0,0,52
4200300G740,716,609,534,12,7,4,52,0,75
42101001504,636,628,457,39,42,2,87,0,171
42101005416,1323,934,200,194,148,15,314,0,734
42101002915,484,379,91,18,267,5,9,0,288
42101003619,502,408,49,29,323,8,7,0,359
42101004403,599,452,21,15,407,11,6,0,431
42101003720,612,437,9,322,133,11,12,0,428
4200300G750,786,618,581,6,3,9,16,0,37
42101004324,598,466,13,75,379,5,4,3,453
42101006417,998,724,277,99,51,9,251,0,447
42101003315,989,708,82,477,144,6,51,1,626
42101006612,1103,809,527,126,106,10,46,0,282
42101001606,612,449,25,16,415,1,5,0,424
42101005921,837,727,252,26,422,9,22,1,475
42101006646,800,635,561,30,11,8,24,0,74
42003003330,2042,1673,1549,13,23,13,65,1,124
42101005307,1231,912,98,253,387,14,176,1,814
42045003610,1095,733,80,98,542,15,21,0,653
42045002863,892,662,603,5,18,0,31,2,59
42101004118,802,573,314,112,111,8,47,0,259
42003009110,1047,960,468,37,28,2,416,0,492
42101003911,1171,834,150,203,68,16,421,3,684
42101000213,612,445,178,47,158,7,58,0,267
42101004701,1285,1188,613,103,342,10,119,0,575
42101006619,965,781,573,64,95,7,43,1,208
42101003406,813,641,7,21,615,15,11,1,634
42101005204,626,594,133,31,349,2,91,2,461
4200300E605,949,820,765,17,12,6,21,0,55
42101006223,835,653,236,209,117,6,81,5,417
42101006616,611,480,427,20,10,2,19,0,53
42101004315,613,442,7,72,366,3,2,0,435
42129002035,350,274,267,1,4,0,1,0,7
42101005228,759,736,316,45,288,9,76,1,420
42101002715,783,701,248,17,354,8,76,3,453
42101002008,638,471,99,74,248,10,55,0,372
4200300G820,769,591,491,5,5,5,82,0,100
4200300B170,892,713,464,106,107,17,30,0,249
42101006119,1008,773,42,86,417,7,235,1,731
42101006603,674,531,467,18,19,2,25,1,64
42003009210,984,920,704,37,28,2,149,0,216
42101000821,769,740,604,37,27,4,64,0,136
42057000120,6,5,5,0,0,0,0,0,0
42045003401,714,540,341,13,147,3,34,0,199
42129002040,689,550,525,3,3,3,14,0,25
42101003442,647,488,7,20,453,14,12,1,481
42003006230,2927,2927,2191,59,373,49,167,1,736
42101005833,1967,1480,1180,38,33,3,214,5,300
42003005660,1020,848,585,2,239,2,7,0,263
4200300F425,1959,1486,1288,17,32,13,132,0,198
42101005717,744,619,596,13,5,1,4,1,23
42101002614,718,589,534,18,13,6,20,1,55
42003006290,638,624,445,10,10,0,159,0,179
42003006250,1064,1047,578,22,152,3,297,0,469
4200300F405,1086,883,797,8,32,7,38,2,86
42101005832,812,632,426,30,31,1,139,1,206
4200300G800,488,481,467,0,3,0,10,0,14
42101005323,929,705,117,209,257,1,135,0,588
42101002721,778,772,210,76,111,3,370,3,562
42101002720,958,942,330,109,155,4,346,0,612
42101002103,734,591,208,14,334,2,40,6,383
