GEOID,TOTAL_POP,TOTAL_VAP,WHITE_VAP,HISPANIC_VAP,BLACK_VAP,NATIVE_VAP,ASIAN_VAP,PACIFIC_VAP,MINORITY_VAP
39061031AKJ,1234,1098,419,36,597,8,22,4,679
39061031ABK,1505,1207,1052,31,62,22,35,2,155
39061031BAE,1040,760,663,18,43,18,19,1,97
39061031AEK,1241,929,818,26,33,21,39,0,111
39061031BKQ,1722,1291,633,36,524,12,75,0,658
39061031BLU,1617,1277,648,56,530,16,38,1,629
39061031BMA,1501,1195,896,21,180,29,61,0,299
39061031AYG,1738,1217,840,20,303,9,41,1,377
39061031AOO,2028,1464,1115,42,273,24,11,3,349
39061031BQN,1815,1636,1157,61,312,23,81,5,479
39061031AHE,1837,1620,1117,70,292,30,95,2,503
39167084ABR,1133,870,801,4,35,29,4,1,69
39167084ACY,952,747,607,6,98,50,2,0,140
39167084ACM,547,421,405,4,3,7,1,0,16
39061031BNQ,1398,1017,858,25,43,16,63,1,159
39061031BKN,1720,1300,612,72,555,20,42,6,688
39061031ABE,899,775,652,16,67,12,27,0,123
39061031AFB,1276,1222,943,73,83,10,108,4,279
39061031BQM,1997,1945,1168,44,602,15,110,5,777
39061031AFA,1853,1789,1205,95,311,13,143,2,584
39061031AJP,1260,857,75,25,723,17,21,1,782
39061031AVB,1296,1130,939,48,75,26,40,0,191
39061031AFD,1738,1441,1005,22,349,21,45,2,436
39061031AFC,1406,1252,776,64,325,22,65,1,476
39061031AWL,1076,844,657,16,133,23,11,1,187
39061031ANR,1916,1490,595,71,774,33,28,3,895
39061031BDM,1108,835,643,28,82,15,40,0,192
39061031BDT,1768,1348,1195,43,40,28,36,3,153
39061031BAQ,1003,750,696,21,9,12,11,1,54
39061031AZK,1685,1257,1148,43,10,22,22,1,109
39061031BHE,1632,1319,1176,7,78,11,42,1,143
39061031BOM,2367,2039,731,75,1113,10,106,0,1308
39061031AKY,2056,1604,1261,45,230,31,43,10,343
39061031AJA,1954,1574,824,103,576,30,55,7,750
39061031ACB,2285,2112,1442,112,360,35,158,4,670
39061031AJN,1956,1648,1195,60,304,30,56,2,453
39061031BEY,1816,1457,1247,22,111,27,24,1,210
39061031BFB,1482,1176,1077,11,29,22,30,0,99
39061031BOI,2158,1645,1515,23,52,26,11,0,130
39061031ABB,381,325,300,3,2,9,2,1,25
39061031AUG,1273,1072,575,26,425,21,11,0,497
39061031AUJ,1796,1355,627,25,656,37,17,1,728
39061031AKL,1660,1413,778,37,547,15,35,0,635
39061031AMU,1271,945,613,12,302,10,17,4,332
39061031ACI,1975,1774,1496,78,95,38,65,3,278
39061031BEB,1864,1322,1112,26,107,45,29,2,210
39061031BDZ,2014,1527,1312,17,139,37,16,1,215
39061031AXW,875,711,312,36,335,7,24,4,399
39061031ASP,2261,1660,1450,57,75,31,47,1,210
39061031AMC,1658,1381,692,27,620,24,21,0,689
39061031AMD,2111,1246,90,19,1130,30,1,0,1156
39061031BMW,1690,1369,1024,61,123,8,152,1,345
39061031ARE,1325,1070,906,35,69,27,22,5,164
39061031BHG,1682,1320,1193,18,51,18,23,1,127
39061031BHV,2021,1438,1286,25,51,31,18,3,152
39061031AAF,906,641,292,25,219,17,93,1,349
39061031BMP,887,680,556,19,48,3,47,0,124
39077039ABE,1583,1309,1103,150,29,22,7,2,206
39077039ABG,1620,1227,1039,141,15,21,12,2,188
39077039ACK,1116,734,698,22,1,14,0,0,36
39077039ABP,1002,706,657,6,2,27,8,0,49
39077039ABQ,1409,1052,999,18,4,23,4,0,53
39013007ACL,771,649,628,1,10,2,6,0,21
39013007AAB,1428,1115,933,25,111,36,4,0,182
39013007ACF,1042,873,831,5,9,17,2,0,42
39013007AAE,1159,918,791,17,75,30,2,0,127
39077039ACF,1054,825,789,13,6,12,2,0,36
39077039ACI,1300,951,913,12,7,9,4,1,38
39061031AFM,1675,1131,78,14,1027,29,4,0,1053
39061031BMO,2131,1747,1391,82,149,50,68,10,356
39061031AGN,1358,1067,250,27,767,26,22,1,817
39061031AGQ,1349,1095,142,11,931,10,10,5,953
39061031AFF,1634,1330,183,22,1117,15,16,7,1147
39061031AWN,1078,896,610,14,227,28,16,0,286
39061031BOF,902,590,543,14,2,10,14,1,47
39061031ARG,1496,1254,1065,20,103,18,49,1,189
39061031BMX,1730,1391,1215,22,68,31,62,1,176
39061031AQZ,1350,1114,929,47,76,28,28,1,185
39061031AXK,1794,1538,742,48,684,18,45,0,796
39061031AKX,1716,1346,1215,10,77,19,7,0,131
39061031BAS,1344,952,874,14,5,7,42,0,78
39061031BKL,1582,1202,1070,28,41,8,48,2,132
39005003ACO,1267,978,906,20,2,38,3,1,72
39013007ADK,859,720,694,7,3,8,4,0,26
39013007ADW,286,234,226,0,4,1,0,0,8
39013007ABZ,821,666,625,2,11,16,1,0,41
39013007ADI,1461,1197,1141,13,6,22,6,0,56
39127064AAY,1420,1134,1090,3,8,21,0,1,44
39127064ABM,1088,774,723,15,13,13,6,1,51
39127064AAQ,721,541,516,4,2,12,4,0,25
39127064AAR,1000,725,706,1,1,10,2,0,19
39127064AAP,1040,816,776,1,5,30,1,0,40
39129065ABD,1098,856,815,4,6,21,5,0,41
39129065AAQ,433,363,347,1,2,5,4,0,16
39129065AAR,1557,1263,1187,12,26,25,15,3,76
39077039ACM,1571,1240,1150,26,12,29,10,1,90
39077039ABS,1060,853,808,14,2,21,1,0,45
39005003ABI,1565,1258,1190,29,3,27,6,0,68
39005003ABJ,954,732,704,6,3,13,0,1,28
39005003ACH,827,615,587,6,5,10,8,1,28
39005003AAB,2054,1783,1572,57,57,20,80,7,211
39005003ABZ,744,514,501,2,3,5,1,1,13
39005003ACB,531,395,382,3,1,6,1,2,13
39077039ABT,873,715,687,7,2,7,5,1,28
39077039AAD,1823,1334,1212,45,21,32,5,0,122
39077039ABU,1598,1270,1106,109,9,43,11,3,164
39077039ABC,1471,958,627,255,61,32,3,4,331
39077039ABA,1523,1061,782,237,27,15,2,0,279
39013007ACN,990,808,785,6,2,4,2,1,23
39013007ACO,1287,1072,996,16,19,9,18,0,76
39013007ABG,412,320,292,5,12,4,7,1,28
39013007ADD,505,418,402,4,3,7,1,0,16
39013007ADE,703,536,514,5,3,12,2,0,22
39083042AAY,854,636,603,10,8,6,4,1,33
39059030ABE,1345,1091,1025,7,11,29,12,0,66
39059030AAJ,1162,914,850,12,24,20,4,0,64
39059030AAG,1173,938,833,21,59,18,3,3,105
39059030ABR,538,445,412,6,6,18,2,0,33
39059030ACR,1405,1103,1042,16,7,23,4,0,61
39059030AAX,1002,836,766,16,31,13,10,1,70
39059030ABS,884,718,692,1,10,6,8,0,26
39059030AAA,1479,1093,919,14,127,17,6,3,174
39059030ABU,1188,901,882,5,2,8,0,0,19
39059030ABQ,1066,819,787,12,2,14,1,1,32
39129065AAA,1428,1081,1017,12,12,21,14,0,64
39129065AAI,2232,1679,1512,17,90,34,15,0,167
39127064ABN,1056,774,741,6,4,15,4,0,33
39127064ABR,1497,1134,1060,8,5,43,2,4,74
39127064AAM,1094,744,704,8,3,15,11,0,40
39129065ABJ,1253,981,918,16,15,23,1,0,63
39127064ABK,728,596,557,7,6,16,3,1,39
39057029AHW,1080,847,794,5,7,27,7,0,53
39057029AHS,961,749,710,10,7,17,3,0,39
39057029ACO,848,627,564,26,6,8,22,1,63
39057029AFG,1404,1156,998,17,99,29,11,3,158
39057029AIQ,755,620,579,10,3,21,4,0,41
39057029AHJ,889,758,608,33,69,21,29,3,150
39167084ABP,1410,1096,1037,19,12,13,4,0,59
39167084ADE,1344,1076,1034,5,6,18,4,0,42
39129065AAJ,1391,1062,953,13,46,27,12,2,109
39129065AAS,1054,804,758,4,5,15,12,0,46
39129065ABM,785,606,586,4,2,5,0,1,20
39059030ACK,1060,841,805,5,8,13,4,1,36
39075038AAX,3992,2723,2683,17,8,3,5,2,40
39129065AAW,1613,1194,1114,12,13,38,2,0,80
39057029AFS,1038,807,694,9,93,5,1,1,113
39057029AFP,909,710,582,5,87,22,18,2,128
39057029AIO,638,575,202,3,334,12,3,1,373
39057029AIL,585,478,447,1,13,7,6,1,31
39057029AIP,1135,903,840,6,29,26,2,0,63
39057029AHR,978,762,729,9,5,11,8,1,33
39057029AFN,872,654,504,7,101,39,3,0,150
39057029AGZ,690,505,464,4,16,6,8,0,41
39057029AHB,1020,778,677,12,38,19,17,0,101
39083042AAO,1772,1376,1309,12,5,29,8,7,67
39083042ABO,783,590,554,3,4,15,8,4,36
39129065ABI,813,636,598,2,2,22,0,0,38
39129065ABZ,427,330,309,1,2,14,0,0,21
39083042ABL,1242,1030,976,18,14,9,8,2,54
39083042ABM,1101,820,779,15,7,14,4,1,41
39083042ABP,1315,1064,1003,14,10,24,2,3,61
39083042ACB,1137,845,811,1,9,16,4,0,34
39083042AAZ,1668,1264,1196,22,21,17,5,1,68
39081041ADW,1259,1040,981,11,20,9,6,0,59
39121061AAL,618,458,448,1,0,6,1,0,10
39121061AAJ,464,389,377,1,0,3,2,0,12
39059030ABM,1041,818,744,23,16,20,3,1,74
39059030ABK,1320,1021,936,18,12,19,11,1,85
39059030ABG,1054,841,795,4,5,19,8,0,46
39121061AAS,3563,3337,2457,102,752,16,7,0,880
39121061AAK,208,173,168,1,0,1,3,1,5
39121061AAC,1308,983,947,5,1,24,6,1,36
39097049AAG,2631,1950,1720,153,21,50,7,0,230
39127064ABE,1481,1159,1097,6,4,34,3,2,62
39077039AAL,1347,1065,950,47,28,23,12,1,115
39077039AAS,1213,969,884,41,20,10,5,4,85
39077039ACD,627,470,441,8,5,7,5,0,29
39077039ABJ,1028,834,796,9,10,19,1,0,38
39077039ABI,899,695,656,4,10,13,3,0,39
39063032ACL,734,559,518,26,4,6,6,0,41
39063032ABV,1208,938,896,10,9,13,9,0,42
39063032ABH,1377,1099,886,90,61,25,27,2,213
39063032ABG,1390,1243,1028,67,76,26,44,2,215
39063032ABI,1130,955,835,44,23,24,20,3,120
39063032AAP,1387,1099,977,36,34,23,33,0,122
39063032AAZ,1414,1139,992,54,47,11,30,0,147
39063032AAV,1424,1089,862,126,47,29,22,0,227
39063032ACB,2474,1817,1628,90,26,28,36,4,189
39063032ABJ,1107,901,754,60,27,19,44,2,147
39063032ABE,1079,794,655,78,19,23,6,2,139
39103052AFW,1364,950,876,18,10,8,27,0,74
39103052AFL,1848,1432,1326,26,6,42,20,0,106
39009005ABM,1530,1215,1097,5,59,35,11,0,118
39009005ABK,515,428,366,12,9,13,30,0,62
39009005AAA,1757,1567,1195,55,105,31,175,9,372
39009005AAB,731,642,585,10,14,6,22,3,57
39009005ABU,1016,798,756,9,12,13,5,0,42
39009005ABS,959,719,678,14,7,24,3,1,41
39009005ABT,842,726,645,9,31,26,16,4,81
39009005ACP,1754,1433,1367,5,21,24,7,1,66
39009005ACC,1664,1308,1251,4,21,19,0,1,57
39009005ACE,1659,1235,1168,8,29,22,3,2,67
39009005ACB,400,328,310,3,2,14,0,0,18
39009005ABB,1052,848,795,8,16,17,2,2,53
39077039ACC,1339,968,877,29,16,34,2,0,91
39077039AAH,1679,1376,1209,62,32,32,19,2,167
39097049AAO,1758,1288,1233,16,4,27,5,0,55
39097049AAP,1970,1541,1451,17,15,38,9,1,90
39097049AAN,2379,1898,1751,30,36,48,24,3,147
39097049AAQ,1105,890,825,17,17,21,9,0,65
39097049AAL,967,768,681,22,15,36,10,3,87
39097049AAJ,1924,1368,1262,22,14,30,28,0,106
39097049AAK,932,720,676,12,2,14,9,0,44
39097049AAH,1405,1047,966,15,17,28,14,1,81
39103052AEE,1553,1201,1122,23,11,16,14,0,79
39103052AFN,369,317,298,4,2,5,6,1,19
39103052AFP,1546,1219,1134,21,20,24,9,1,85
39063032ACI,1301,1014,964,15,7,19,11,0,50
39063032AAL,1031,883,788,34,18,19,23,0,95
39063032AAM,902,670,610,31,6,12,8,0,60
39063032AAH,961,800,732,15,34,3,19,0,68
39063032ACR,1435,1122,1056,21,19,14,9,0,66
39063032ACO,1024,738,708,10,7,10,1,1,30
39063032ABQ,1475,1040,977,21,7,16,15,0,63
39063032ABY,1103,860,752,47,33,12,11,0,108
39063032ACA,1575,1136,1042,28,21,14,29,0,94
39063032ABR,1036,798,754,18,14,16,1,0,44
39013007ADF,775,614,581,5,5,12,3,1,33
39013007ADH,829,652,609,1,6,26,1,0,43
39013007ACP,797,638,601,3,1,19,2,0,37
39013007ABN,1393,1172,1092,35,6,29,4,1,80
39013007ABP,638,507,492,5,2,7,1,1,15
39097049AAM,1452,1133,1087,4,14,17,3,1,46
39083042AAS,1542,1115,1056,13,5,29,1,2,59
39083042ABN,1034,807,777,4,2,18,3,2,30
39129065AAF,2033,1719,1535,26,64,41,20,1,184
39129065AAC,1310,1074,989,15,28,16,25,0,85
39129065AAB,969,800,747,11,18,20,2,0,53
39119060ACO,1153,884,827,5,14,22,2,0,57
39119060ACM,489,379,373,1,2,4,0,0,6
39119060ACL,1625,1247,1188,16,18,9,7,2,59
39119060AAX,619,386,376,2,2,3,2,0,10
39119060ABZ,496,340,322,1,7,5,1,0,18
39119060ABB,1797,1302,1221,15,10,43,4,1,81
39119060AAT,1538,1204,1056,20,98,23,8,0,148
39119060AAU,1374,1148,1009,20,80,22,16,0,139
39119060AAN,2022,1521,1264,25,170,40,15,3,257
39119060ACI,1130,934,883,3,20,13,4,0,51
39119060ABN,1521,1162,1106,10,9,27,2,4,56
39119060ADD,1241,978,934,3,11,14,12,0,44
39119060ACN,946,738,691,5,13,26,3,0,47
39119060ABX,1122,876,836,3,9,19,0,0,40
39119060AAI,1992,1407,1095,27,226,56,1,0,312
39083042AAE,1402,1014,912,45,14,32,8,2,102
39083042ABQ,1656,1169,1117,17,7,16,4,3,52
39115058AAL,1181,876,603,8,226,71,1,1,273
39115058AAP,1343,1118,1035,10,51,21,8,0,83
39115058AAQ,944,758,678,9,37,25,7,0,80
39115058AAS,656,525,497,3,21,6,4,0,28
39115058AAU,1897,1529,1420,13,48,39,7,2,109
39059030ABH,762,632,603,1,8,17,3,0,29
39121061AAV,889,704,662,7,1,19,11,0,42
39121061AAP,670,514,505,2,2,7,0,0,9
39059030ACE,1566,1260,1220,8,9,20,3,0,40
39059030ACF,422,333,314,1,5,7,3,1,19
39059030AAW,1520,1169,1050,24,51,32,12,2,119
39135068ABQ,1180,922,890,8,3,16,0,2,32
39135068ABR,455,351,330,4,3,13,0,0,21
39135068AAL,1303,1023,980,4,8,13,9,0,43
39135068AAP,1952,1536,1469,3,4,42,11,0,67
39135068AAN,1430,1119,1082,6,6,16,4,0,37
39135068ABH,458,366,347,5,0,11,2,0,19
39035018BWA,1653,1506,1342,56,63,9,17,1,164
39035018BVX,1208,1046,932,39,43,13,31,0,114
39035018BVU,1265,1184,1032,45,56,12,32,3,152
39035018ARI,873,746,53,16,671,17,9,1,693
39035018ARK,762,617,10,11,593,8,0,0,607
39035018ARP,753,567,40,8,512,8,4,0,527
39035018ANN,1628,860,114,53,660,8,25,2,746
39035018AOT,1227,854,73,32,748,13,7,1,781
39035018AYR,1821,1725,1222,75,259,26,159,6,503
39035018ACA,1219,1030,526,48,438,26,6,0,504
39035018ACB,1130,918,545,23,334,10,5,0,373
39035018CTP,1668,1315,662,34,582,10,28,3,653
39035018CTD,1576,1221,439,21,692,17,41,4,782
39035018CTM,1665,1233,520,37,659,13,18,3,713
39035018CME,1603,1393,1145,74,84,17,65,1,248
39035018CLZ,1687,1321,1083,89,60,47,46,4,238
39035018CMT,1797,1572,1305,68,143,13,55,3,267
39035018CMP,2133,1691,1174,96,224,24,178,2,517
39035018AON,762,470,12,21,440,14,2,0,458
39035018APX,766,603,24,15,559,16,4,1,579
39035018AXH,842,597,202,28,371,2,3,3,395
39035018AOU,1410,702,8,5,693,3,0,0,694
39035018AOR,581,467,21,6,438,8,2,0,446
39035018AEI,1294,1039,930,24,41,26,14,4,109
39035018AEK,778,633,570,19,22,14,7,0,63
39035018CDB,1692,1396,1227,62,34,32,30,0,169
39035018BTA,1607,1380,849,36,470,9,14,2,531
39035018BSP,1555,1193,161,14,1005,9,9,0,1032
39035018BSY,1474,1066,472,36,535,8,20,2,594
39035018BOO,1292,990,373,24,576,15,23,2,617
39035018CHE,1690,1342,1159,62,76,28,18,1,183
39035018CHC,1718,1456,1018,166,194,26,60,2,438
39035018AZU,1544,1067,370,437,262,33,18,1,697
39035018BDV,1478,1142,465,440,223,38,22,5,677
39035018BDW,1529,1029,385,260,345,32,25,11,644
39035018BEH,1152,838,368,267,194,18,6,1,470
39035018CEJ,1761,1356,1216,68,20,18,38,0,140
39035018CEL,1758,1427,1258,61,35,21,47,0,169
39035018BFJ,541,383,105,98,155,17,27,1,278
39035018ANR,731,567,231,63,266,15,0,1,336
39035018AZJ,1438,1100,672,87,327,26,5,0,428
39035018AOF,988,751,269,123,340,22,0,0,482
39035018AKB,905,718,16,15,683,5,1,2,702
39035018AKI,883,653,48,18,587,5,3,0,605
39035018AKE,818,625,4,8,610,16,0,0,621
39035018AJH,705,505,16,3,484,3,2,0,489
39035018AWE,1423,1131,384,19,706,12,15,2,747
39127064ABO,794,610,583,4,5,8,4,0,27
39091046ABD,1512,1198,1154,10,11,16,6,0,44
39091046ABV,1157,968,905,15,13,19,8,2,63
39035018BBN,1056,924,684,119,85,6,42,2,240
39035018BBW,1501,1163,740,243,170,36,20,4,423
39035018BBR,1765,1401,607,297,463,32,18,4,794
39035018BBP,1086,816,377,207,211,32,24,0,439
39035018AWX,1296,960,108,18,838,8,2,0,852
39035018BVF,1404,1075,1000,15,17,15,16,2,75
39035018BVJ,1408,1155,1094,23,12,8,18,0,61
39035018BMW,1095,869,26,11,826,17,3,1,843
39035018CSO,1507,1134,849,28,155,10,80,0,285
39035018CSX,1783,1414,947,23,175,9,257,0,467
39035018BKQ,1261,1003,848,28,85,4,32,0,155
39035018CQW,1600,1125,190,26,885,17,26,1,935
39035018CRQ,1564,1199,675,25,445,9,44,2,524
39035018CQN,1562,1188,485,30,610,19,45,1,703
39035018AIZ,912,730,5,6,709,19,5,2,725
39035018AIX,1130,864,6,9,841,8,3,3,858
39035018AMM,734,537,6,2,525,6,1,0,531
39035018AMZ,867,693,7,8,670,3,4,1,686
39035018AZW,952,883,366,76,431,6,9,0,517
39035018AYX,2771,2732,1545,198,906,10,86,1,1187
39035018DDT,1488,939,103,165,671,9,16,2,836
39035018BDZ,1525,1383,967,175,159,28,75,1,416
39035018AYV,1633,1580,1254,83,118,14,107,2,326
39035018AZI,2035,1913,1468,137,198,23,103,1,445
39035018AJJ,1238,892,233,39,613,8,13,1,659
39035018CLI,1558,1245,1100,59,30,13,40,3,145
39035018CLQ,1784,1448,1233,74,48,22,59,1,215
39035018BDE,1631,1368,1025,163,111,47,25,2,343
39035018CCO,1175,941,867,25,21,11,12,1,74
39035018CCQ,1363,1137,789,58,59,9,224,0,348
39035018CCI,1497,1179,609,30,35,12,497,1,570
39035018BCI,1690,1235,622,393,198,26,24,6,613
39035018BDQ,1305,941,365,394,160,25,4,0,576
39035018CGO,923,732,659,26,10,11,13,1,73
39035018CGP,889,718,677,14,14,6,3,0,41
39035018AGA,1402,1143,911,76,47,23,87,0,232
39035018BAC,717,605,304,174,89,14,30,2,301
39035018BAQ,971,696,228,254,210,27,17,4,468
39035018BAT,1210,862,220,384,248,28,9,2,642
39035018BMQ,1003,761,7,12,741,8,0,2,754
39035018CPH,1267,971,875,34,11,6,38,2,96
39035018CPE,1329,1059,899,41,28,15,86,1,160
39035018CSV,1978,1440,979,31,208,12,197,0,461
39035018CSN,949,774,636,9,58,5,64,0,138
39035018CST,1781,1389,1003,20,222,17,120,1,386
39035018CGB,2383,2076,1710,68,143,30,113,2,366
39035018CFW,1534,1264,1128,32,27,14,51,3,136
39035018CKF,1359,1123,1032,36,19,5,30,0,91
39035018CKE,1078,886,784,38,8,17,35,0,102
39075038AAW,4685,2904,2863,24,7,5,2,2,41
39075038AAP,4564,2808,2771,21,6,7,2,5,37
39035018CUQ,1537,1235,1108,45,22,13,43,2,127
39035018AFI,1452,1143,1047,24,12,17,40,1,96
39035018AYN,1109,954,388,103,393,16,62,2,566
39035018CBA,1082,914,816,15,29,9,49,0,98
39035018CBM,849,780,634,32,63,10,37,2,146
39091046ABI,954,746,698,9,5,15,11,0,48
39091046ABZ,1191,943,894,22,4,13,6,1,49
39103052AEL,1564,1289,1236,14,6,20,2,0,53
39103052ADO,1425,1176,1118,15,9,15,9,1,58
39103052ADJ,1744,1426,1341,20,10,32,11,3,85
39063032ACX,945,725,654,39,17,10,4,0,71
39063032ACY,1424,1198,998,78,79,18,29,6,200
39045023AAP,1628,1290,1185,17,29,43,12,0,105
39045023AFF,1274,928,471,85,294,15,75,1,457
39045023AEL,1878,1311,557,70,551,28,121,1,754
39045023ADV,1013,808,718,17,48,15,5,1,90
39045023ABT,1689,1277,1193,9,21,27,16,1,84
39045023ACF,1718,1336,1259,11,9,31,11,1,77
39045023ACI,1239,971,924,4,4,31,3,0,47
39045023ABM,1711,1319,1239,11,9,53,2,1,80
39045023ACA,2070,1421,1181,32,130,43,22,4,240
39103052AEI,654,555,512,14,10,8,7,0,43
39103052AFD,1834,1375,1328,14,6,17,6,2,47
39103052AFG,1136,825,756,19,12,18,15,0,69
39103052ACG,1866,1299,1188,28,7,9,61,0,111
39103052ADU,1917,1502,1414,27,5,11,26,0,88
39035018BUW,965,783,706,14,15,7,39,0,77
39035018BUT,1158,921,689,19,42,10,166,0,232
39035018BUP,1043,885,782,10,33,2,59,0,103
39035018CHA,1510,1271,1078,92,49,41,22,2,193
39035018AZF,1390,1273,1002,94,86,16,85,5,271
39035018AZE,1639,1402,988,112,237,15,49,2,414
39035018DCS,662,550,58,11,486,3,2,0,492
39035018ABH,2266,1889,1021,56,551,5,235,1,868
39035018DEX,836,745,22,7,713,17,3,2,723
39035018ANT,2318,1452,490,216,761,22,3,4,962
39035018ANV,1222,675,12,36,635,5,3,0,663
39035018AOH,925,512,6,4,503,2,0,0,506
39035018CZX,1519,1202,1091,47,29,12,29,3,111
39035018AMQ,956,751,23,9,717,24,2,4,728
39035018AQB,1290,926,29,15,884,1,2,0,897
39035018AND,910,706,15,19,681,6,1,1,691
39061031BIT,1754,1461,1323,21,58,18,28,2,138
39061031BGI,1479,1185,1076,13,52,32,4,0,109
39061031BKY,2119,1740,960,62,652,26,39,0,780
39061031AWT,1919,1468,799,258,302,58,72,13,669
39061031BKW,842,688,526,13,133,11,12,3,162
39061031BGD,1325,1062,826,26,150,24,25,3,236
39061031BNM,384,309,231,3,56,12,6,3,78
39061031AMB,1933,1540,913,65,477,43,47,5,627
39119060ABV,946,743,693,7,19,21,3,1,50
39075038AAY,1675,1257,1204,9,6,28,5,1,53
39075038AAD,2719,2108,2003,19,63,26,2,2,105
39075038AAH,1060,857,801,17,7,22,6,0,56
39075038AAF,2091,1648,1542,35,16,28,17,1,106
39033017ACD,1358,1059,1017,3,1,20,1,0,42
39033017AAB,1123,848,798,10,12,14,4,1,50
39075038AAR,3096,2115,2060,17,12,22,3,1,55
39075038AAT,1193,895,852,9,8,22,2,0,43
39075038AAM,3222,2197,2146,13,10,14,7,2,51
39033017ACR,773,608,590,3,3,5,0,0,18
39075038AAC,4322,2809,2754,41,11,3,3,3,55
39053027AAA,840,650,602,3,17,7,8,0,48
39053027AAI,898,708,670,4,2,28,2,0,38
39119060ACQ,1755,1386,1300,7,46,19,8,0,86
39119060ABS,1112,870,809,2,11,27,6,1,61
39119060ABQ,1029,767,712,7,12,9,6,0,55
39119060ACJ,1142,905,870,1,11,16,1,0,35
39119060ACH,1445,1096,1022,17,15,31,6,0,74
39119060ACF,968,714,679,4,10,19,2,0,35
39063032ABX,1031,764,732,11,6,5,4,1,32
39063032ABW,1090,849,797,19,6,10,1,0,52
39063032ABA,1405,1064,965,42,14,16,17,3,99
39063032ABB,1043,856,769,36,29,10,14,0,87
39103052AEF,1728,1181,1075,27,13,29,25,2,106
39103052ABI,1940,1504,1377,33,28,28,25,1,127
39103052ABE,1118,897,769,37,64,25,16,3,128
39103052AEH,1380,1137,1046,22,13,20,12,2,91
39061031AIG,2000,1483,136,30,1313,35,12,0,1347
39061031AOR,2277,1585,938,52,526,32,27,5,647
39061031BHD,1159,908,758,18,114,6,8,0,150
39061031ATA,1082,807,695,61,6,11,27,0,112
39061031BFO,1081,887,784,5,61,9,20,0,103
39061031AWA,796,645,569,10,45,18,5,0,76
39061031ACE,1652,1258,482,34,699,35,26,5,776
39061031BQI,3068,2829,1422,59,604,33,694,4,1407
39061031AHO,2744,2657,1949,82,377,17,221,3,708
39061031ATS,1246,938,806,18,32,5,74,1,132
39061031BNN,1425,1020,854,42,24,8,88,2,166
39061031BNX,1480,1092,853,82,38,7,107,0,239
39033017AAK,1289,1011,961,14,10,13,7,0,50
39033017ACK,1595,1294,1245,11,11,18,2,0,49
39091046ABE,1081,841,806,0,6,18,2,0,35
39091046ABU,755,607,582,3,4,5,1,1,25
39091046AAV,1181,947,891,11,9,27,5,2,56
39091046AAY,639,508,477,11,4,5,4,2,31
39091046AAB,1646,1236,1095,29,68,25,13,4,141
39091046AAG,1999,1508,1301,91,68,28,19,2,207
39091046AAX,1245,955,898,12,15,25,6,1,57
39033017AAV,1420,1073,962,8,53,28,7,3,111
39033017ABK,1539,1233,1129,30,14,39,4,2,104
39033017ABC,1594,1312,1254,15,9,23,5,1,58
39009005ABO,556,429,331,1,71,24,5,1,98
39009005ABH,1066,838,758,5,28,32,8,0,80
39009005AAP,1010,885,773,21,31,13,41,1,112
39009005AAS,1020,817,691,29,31,11,48,1,126
39009005AAW,1903,1777,1423,90,194,11,57,0,354
39009005AAJ,1479,1219,908,43,113,22,131,2,311
39009005AAV,842,781,629,31,61,8,53,0,152
39009005AAN,1072,992,864,34,37,19,35,2,128
39009005ABP,1332,1099,1015,20,15,33,15,1,84
39009005AAX,1098,868,793,18,27,25,6,1,75
39009005ABD,1706,1463,1213,41,162,41,6,1,250
39009005ACM,1313,1032,976,5,9,30,2,0,56
39009005ABX,1944,1526,1461,10,6,32,4,0,65
39009005ABW,917,728,684,9,18,8,6,0,44
39063032ACN,906,676,638,14,3,18,2,1,38
39103052ADL,1448,1184,1148,12,4,14,6,0,36
39103052ADB,1378,1138,1054,27,20,17,18,2,84
39103052ADC,1587,1319,1199,40,11,31,21,1,120
39103052AAR,1301,1027,947,21,18,19,12,0,80
39103052AAZ,1439,1117,1013,33,28,28,8,0,104
39103052AAS,1172,947,870,24,9,23,13,3,77
39119060ACT,1894,1521,1407,7,60,31,4,0,114
39119060ACG,504,390,373,2,0,11,1,0,17
39119060ACK,1103,834,809,11,6,8,1,0,25
39119060AAJ,1858,1321,851,21,370,85,4,0,470
39119060AAL,2058,1518,1078,16,368,70,1,2,440
39119060AAF,2138,1587,1217,14,294,75,2,2,370
39135068ABT,1088,836,802,3,11,14,4,2,34
39135068AAG,1354,1130,1059,24,19,14,10,0,71
39135068AAC,644,502,476,3,6,8,8,0,26
39135068ABL,811,661,639,7,4,6,1,0,22
39135068AAI,568,432,418,1,3,6,1,0,14
39053027ABD,1348,1045,926,19,58,27,7,3,119
39053027ABA,947,727,692,3,5,15,3,0,35
39053027ABJ,1021,707,681,7,5,12,1,0,26
39045023AEF,1489,1210,1148,14,7,32,7,0,62
39167084ABS,858,703,671,7,3,13,0,0,32
39167084ABZ,827,666,645,2,10,8,1,0,21
39167084ACG,1145,924,900,5,1,16,3,1,24
39167084AAJ,1552,1256,1177,30,11,26,8,1,79
39167084AAU,1011,808,722,19,21,22,11,2,86
39167084AAA,1626,1283,1194,11,21,31,23,4,89
39167084ABW,824,653,634,1,1,9,1,2,19
39167084ABV,315,263,260,0,0,2,0,0,3
39033017ABY,1598,1265,1211,19,6,11,4,0,54
39033017ABS,821,651,620,7,4,7,9,2,31
39033017AAF,1343,1126,1069,9,24,13,8,1,57
39033017AAW,1125,812,752,9,22,15,4,0,60
39009005ABZ,1251,1002,877,14,62,55,4,0,125
39009005ABN,1772,1443,1297,28,50,39,22,2,146
39009005ABJ,1653,1333,1199,19,40,25,40,0,134
39009005AAD,1349,1253,999,47,93,23,92,2,254
39009005AAH,875,774,503,37,112,10,105,0,271
39009005ACL,1039,857,805,7,5,24,10,0,52
39009005ABG,1023,816,756,8,23,25,4,0,60
39009005ABF,1754,1360,1306,10,12,14,10,0,54
39009005AAK,965,953,730,51,146,9,24,0,223
39009005ABY,1419,1084,1020,17,16,23,6,1,64
39119060AAA,2000,1442,1229,18,133,41,1,0,213
39119060AAB,2146,1674,1429,29,150,70,8,5,245
39119060ADE,953,764,719,5,14,23,1,0,45
39091046ABL,1836,1447,1383,16,10,26,11,2,64
39053027AAZ,1379,1038,966,8,29,22,1,0,72
39053027ABF,1065,824,731,7,69,10,1,0,93
39053027ABG,1270,979,897,7,47,18,5,0,82
39101051AAR,663,504,445,14,16,4,7,0,59
39033017ABI,1353,1010,924,13,22,35,9,3,86
39033017ACJ,1559,1260,1209,13,12,20,2,2,51
39091046ABJ,923,687,652,3,4,15,1,1,35
39091046ABG,1250,929,881,7,8,19,9,3,48
39033017ACF,1216,945,918,4,8,8,4,0,27
39097049AAT,2182,1609,1512,45,13,35,3,2,97
39083042AAQ,2048,1369,1310,14,18,16,2,2,59
39083042AAC,2141,1871,1728,50,49,28,20,1,143
39083042ABR,1653,1280,1246,7,4,12,5,0,34
39083042AAJ,1440,1253,1132,38,45,21,11,0,121
39129065AAY,2143,1548,1426,38,19,35,16,2,122
39129065AAX,1602,1236,1147,19,13,40,4,1,89
39129065ABT,1576,1220,1148,7,9,26,7,0,72
39083042AAT,468,375,349,7,5,1,5,2,26
39083042AAB,965,823,743,20,13,31,5,0,80
39083042AAK,1186,855,794,26,4,21,5,0,61
39083042AAA,1173,903,850,19,5,15,6,1,53
39057029AAW,1116,876,675,44,62,28,87,2,201
39129065ABG,1250,1000,948,11,5,27,2,0,52
39083042AAF,899,692,616,15,17,33,1,1,76
39083042AAV,1035,818,781,8,12,13,2,1,37
39083042ABF,1076,756,719,3,8,20,0,0,37
39061031ABG,1605,1283,1109,25,87,25,30,5,174
39061031BAO,1059,837,741,34,27,12,19,3,96
39061031ABJ,1519,1250,1087,24,95,20,20,1,163
39061031BJT,1883,1328,1236,25,26,4,29,1,92
39061031ARS,2279,1593,300,170,815,27,274,15,1293
39061031ARN,812,656,209,4,371,4,64,1,447
39061031BLY,1913,1524,679,46,719,19,56,2,845
39061031BNV,1875,1402,1039,38,60,23,229,0,363
39061031BNT,648,480,422,9,16,1,30,0,58
39061031BNP,1411,1061,692,46,117,23,179,4,369
39061031BIB,1287,1030,964,9,12,21,23,0,66
39061031BJH,1957,1406,1336,13,8,35,16,1,70
39061031BMM,2034,1598,1191,102,109,35,60,94,407
39061031BGO,1266,974,678,21,199,10,70,7,296
39061031BHH,1128,875,547,21,254,6,44,2,328
39061031AIY,1330,1059,818,23,171,11,33,1,241
39061031AIZ,1641,1340,787,61,434,16,31,6,553
39061031AFI,1494,1155,125,33,988,28,6,1,1030
39119060AAY,622,489,463,2,14,7,0,0,26
39119060AAQ,1351,1119,972,20,102,22,7,1,147
39119060ADH,1764,1630,1483,21,65,28,29,0,147
39119060ABG,1593,1275,1181,9,33,18,29,0,94
39119060ABE,1336,1068,986,10,31,11,9,0,82
39119060ABD,1030,806,749,4,30,21,2,0,57
39167084AAY,1187,962,887,16,30,17,14,0,75
39167084AAI,1826,1503,1359,29,52,32,7,5,144
39167084ACC,1381,1124,1077,7,9,14,12,1,47
39167084AAO,1730,1280,1192,19,24,33,6,0,88
39053027AAT,503,370,341,4,4,14,2,0,29
39053027AAL,1412,1114,1016,11,43,25,3,0,98
39035018BHP,1920,1483,859,243,319,43,44,0,624
39035018BHQ,2043,1549,914,318,270,42,32,0,635
39035018AHG,1584,1334,1085,85,98,23,44,0,249
39103052ABA,1371,1081,1021,28,9,9,10,0,60
39103052AAP,1356,1076,966,32,18,18,27,0,110
39103052AEM,1635,1326,1255,18,11,24,5,0,71
39063032AAO,1612,1264,1125,66,16,16,34,3,139
39063032ACS,1346,1098,1024,32,13,10,17,1,74
39005003AAV,1026,819,741,21,18,29,11,1,78
39005003ACF,1147,906,858,13,7,21,4,2,48
39005003ACJ,753,582,561,5,10,5,0,0,21
39005003ABG,2217,1547,1491,13,6,28,3,3,56
39005003AAH,1785,1431,1296,31,24,32,35,10,135
39005003ACI,1816,1398,1315,15,9,34,12,3,83
39005003ABC,1767,1356,1283,15,13,28,6,2,73
39005003ABT,2320,1592,1511,13,9,34,8,2,81
39005003AAJ,1254,980,915,18,17,25,8,0,65
39005003ABN,1736,1358,1282,14,12,34,8,6,76
39135068AAW,680,541,511,3,10,13,1,0,30
39135068AAE,1071,807,746,6,12,23,14,0,61
39135068AAD,1368,1079,1018,9,14,23,10,0,61
39135068AAJ,881,652,625,3,0,18,3,0,27
39135068AAK,1727,1283,1215,15,10,26,11,0,68
39063032ABN,1403,1105,934,97,43,12,21,1,171
39103052ADW,1690,1218,1115,24,9,21,49,0,103
39103052ADX,1541,1294,1236,14,13,2,14,0,58
39063032ABU,1008,781,736,31,5,5,3,0,45
39103052AEN,1687,1402,1345,21,8,12,11,0,57
39103052ADR,1357,1060,979,15,13,42,12,0,81
39103052ADP,1717,1407,1309,12,18,43,14,3,98
39063032ABZ,1049,799,725,25,11,7,28,0,74
39119060ABC,971,709,674,6,11,15,2,1,35
39057029AGX,874,728,686,6,6,17,11,0,42
39057029ACP,1198,875,761,15,28,31,27,6,114
39035018AHF,1636,1306,1184,46,40,16,22,1,122
39035018AHI,1653,1336,1147,85,47,29,26,0,189
39035018BHY,1106,616,96,146,372,22,12,7,520
39035018BJN,1341,1072,795,97,64,20,95,0,277
39035018AGO,1343,1057,832,49,131,17,29,0,225
39001001AAA,1380,1062,1027,7,2,24,3,0,35
39139070ACX,1094,895,828,10,16,17,10,0,67
39139070ACW,1734,1306,1222,21,27,17,14,0,84
39139070AAE,1850,1588,1382,31,109,30,28,1,206
39139070AAC,1396,1086,829,17,209,15,20,0,257
39139070AAF,855,724,672,5,33,7,11,0,52
39139070AAL,1478,1252,1049,22,157,17,6,1,203
39139070AAJ,1320,1079,977,24,44,13,7,4,102
39139070AAU,1160,900,602,22,244,22,6,3,298
39139070AAV,1691,1225,668,24,502,22,2,1,557
39139070AAX,1146,808,378,16,374,29,6,5,430
39139070AAW,6462,6124,3072,192,2801,48,15,1,3052
39139070AAT,1572,1102,631,27,391,52,3,1,471
39139070AAP,1593,1258,988,25,203,16,19,0,270
39139070AAQ,1744,1491,1167,46,214,24,26,5,324
39139070AAS,1538,1142,783,26,287,33,15,0,359
39139070AAZ,2801,2065,1591,57,350,59,12,2,474
39139070ACZ,1091,884,838,12,19,11,2,3,46
39139070ACH,1276,1019,968,10,2,28,3,0,51
39139070ADF,1884,1379,1323,14,11,15,4,1,56
39139070ADG,941,689,661,5,0,13,4,0,28
39139070AAM,1361,1049,707,40,258,40,2,2,342
39139070AAN,1380,1094,826,18,204,22,11,1,268
39119060ACB,521,358,341,9,2,6,0,0,17
39035018BIM,1588,1263,744,128,223,45,150,7,519
39035018BIO,1083,953,826,46,31,19,31,1,127
39035018AWW,1231,1012,201,6,794,17,7,0,811
39035018DDZ,1194,923,93,18,802,18,5,0,830
39035018AWS,1050,851,364,4,481,7,3,0,487
39035018AOQ,986,705,191,63,445,20,1,2,514
39035018DEA,1586,1191,501,496,180,36,12,6,690
39035018CFD,1507,1199,1130,11,12,5,34,0,69
39035018AIQ,1083,894,7,14,871,8,4,0,887
39035018ARF,1731,1458,325,182,204,17,751,1,1133
39035018DDR,1314,1163,313,151,421,21,267,3,850
39035018AYP,457,417,137,24,170,8,79,4,280
39035018AYZ,2885,2788,2089,141,249,23,270,1,699
39035018CUG,1060,839,280,38,511,11,9,1,559
39035018CWK,1459,1130,1026,27,16,4,56,0,104
39035018CWM,1416,1130,955,20,29,12,94,0,175
39035018DDY,1041,819,7,4,795,8,2,0,812
39035018AMS,866,643,8,15,623,5,6,0,635
39035018AKV,675,555,16,4,536,2,0,0,539
39035018ANA,941,733,10,6,713,5,3,0,723
39035018CEB,1565,1281,1118,42,49,16,51,0,163
39035018CDN,1501,1230,1078,34,40,7,50,2,152
39035018DBJ,2966,1836,1576,84,46,18,102,8,260
39035018DBF,1523,1127,935,43,47,29,66,1,192
39035018BNY,1069,951,187,5,753,5,9,0,764
39035018AIA,1163,893,9,13,863,2,0,1,884
39035018BLT,1453,1112,307,18,678,19,87,3,805
39139070ABO,1679,1259,1217,11,17,10,2,2,42
39139070AAY,1642,1227,763,30,388,33,6,2,464
39139070ABB,1511,1141,623,32,454,31,8,0,518
39139070AAI,1594,1043,722,19,274,30,3,2,321
39139070ADA,1787,1350,1273,23,22,22,4,0,77
39139070ABX,2173,1714,1592,30,28,44,8,5,122
39139070ADE,1622,1296,1210,16,21,25,7,1,86
39139070ABW,1932,1589,1402,28,91,40,5,1,187
39139070ABN,1596,1119,1072,15,8,21,2,0,47
39091046ABW,874,631,614,2,4,7,3,0,17
39045023ABP,1340,1029,963,12,6,34,6,0,66
39045023ABQ,1321,1043,999,9,0,30,1,0,44
39045023AFA,1288,1033,970,9,18,17,20,0,63
39045023AFB,1585,1359,1248,36,27,21,23,1,111
39045023ADM,1696,1287,998,33,204,16,20,1,289
39045023ADL,1401,1116,955,25,71,30,22,0,161
39045023AAW,1881,1393,1282,24,36,35,12,3,111
39045023AAV,1472,1116,995,34,28,45,6,3,121
39135068ABI,415,306,286,4,0,12,3,1,20
39135068ABF,879,653,611,3,1,25,4,0,42
39135068AAA,953,728,691,3,10,17,7,0,37
39135068ABM,1195,854,804,4,4,26,1,0,50
39063032ABC,1416,1093,922,91,38,22,18,1,171
39103052AFC,1104,846,769,22,9,12,29,0,77
39103052AGF,1340,1056,984,11,8,22,20,0,72
39103052AFA,1619,1189,1086,17,39,14,20,1,103
39103052ACU,2106,1616,1512,25,21,29,21,5,104
39103052ACT,1901,1468,1311,46,41,42,19,0,157
39035018ABN,561,542,518,0,10,0,12,0,24
39035018ABF,1759,1509,1183,32,105,6,174,0,326
39035018ABP,2268,1928,1129,39,433,7,322,0,799
39035018BZD,1124,969,823,21,95,1,18,1,146
39035018BZB,1132,1063,866,8,129,4,50,1,197
39035018AZC,983,791,274,50,441,16,7,3,517
39035018ANZ,607,568,64,75,431,4,7,2,504
39035018AZK,1066,932,661,84,153,17,32,2,271
39035018BAE,974,805,263,350,184,26,5,2,542
39035018BAG,1012,829,328,301,194,26,22,3,501
39035018AZG,594,489,299,96,66,17,6,2,190
39035018CMY,1486,1191,817,49,134,4,178,0,374
39081041ADT,1631,1349,1280,8,13,18,2,2,69
39081041ACK,232,185,169,3,2,8,0,0,16
39081041ACL,616,522,493,4,8,9,2,0,29
39081041ADI,1025,823,786,4,2,17,8,0,37
39081041AAN,2002,1865,1503,76,226,19,33,1,362
39081041AAI,1664,1237,872,52,264,47,7,1,365
39081041AAM,1215,1023,587,19,376,27,2,1,436
39081041ADM,1154,886,740,19,52,23,13,1,146
39035018DEM,1964,1504,52,42,1411,19,9,1,1452
39035018ACV,1382,1049,156,34,837,27,11,0,893
39035018AIC,1079,890,4,11,871,10,4,0,886
39035018BEC,986,852,412,209,191,7,38,3,440
39035018BEB,1456,1317,888,244,122,16,60,3,429
39113057AWC,1084,927,789,35,55,16,31,3,138
39113057AVT,1366,1164,1039,16,40,35,26,1,125
39113057AWD,1999,1517,1104,43,261,27,87,3,413
39113057AHC,1254,924,334,26,539,19,9,0,590
39113057AGR,1317,939,202,37,685,29,12,3,737
39113057ACM,1131,767,146,24,576,29,8,2,621
39113057AAP,1847,1632,1222,257,83,23,36,1,410
39113057AXI,1943,1455,1282,45,40,21,59,8,173
39113057ASU,1567,1279,1185,22,19,29,27,3,94
39113057ASX,1214,1013,799,10,127,17,56,2,214
39113057ATG,1101,857,814,9,7,13,9,0,43
39113057ATJ,1523,1275,1198,7,31,19,11,0,77
39113057AWV,1329,1042,850,25,124,38,15,0,192
39113057AOY,1338,935,826,28,13,14,43,1,109
39113057AXF,2317,1858,1124,41,635,27,22,6,734
39113057AUM,1379,1079,942,31,61,41,12,4,137
39081041ADA,816,680,661,5,4,4,0,0,19
39045023AAX,1689,1325,1213,25,46,31,8,0,112
39045023ABA,1854,1399,1290,23,42,34,6,2,109
39119060ACC,1694,1263,1184,9,41,6,16,0,79
39009005ACJ,1082,894,852,4,6,21,1,0,42
39009005ACI,454,357,339,3,2,10,1,0,18
39009005AAU,847,684,539,11,39,19,70,0,145
39139070AAG,1269,969,759,12,170,10,12,3,210
39139070AAO,1399,1102,919,19,136,20,6,1,183
39101051ABU,668,565,538,7,1,15,0,0,27
39101051ABD,1426,1077,895,48,86,33,12,2,182
39101051ACP,653,554,505,11,13,17,6,1,49
39101051AAD,3395,3107,1855,81,1144,21,7,0,1252
39101051ACQ,482,381,352,8,10,2,2,0,29
39101051ACL,1349,1053,939,28,57,19,10,0,114
39035018APP,630,477,16,1,434,3,20,0,461
39035018APR,741,624,9,9,607,2,3,0,615
39035018APB,1018,800,72,21,648,12,62,1,728
39035018ARJ,567,491,40,54,416,7,14,1,451
39117059AAY,1064,831,784,12,5,23,4,1,47
39045023AAB,1488,1179,1089,22,16,31,10,1,90
39045023AAC,1450,1229,1153,23,7,30,10,0,76
39089045AEY,1953,1525,1360,31,45,53,27,0,165
39089045AEZ,2572,1836,1488,41,127,56,112,1,348
39089045AEV,2045,1445,979,35,207,27,204,1,466
39089045AES,1886,1471,1264,48,76,40,36,6,207
39089045AEU,2032,1544,1111,52,159,35,174,2,433
39089045AAP,1996,1601,1427,36,71,56,20,0,174
39089045AAA,1838,1524,1408,22,39,29,10,3,116
39089045AAQ,3275,2573,2303,48,136,59,8,5,270
39089045AAH,1918,1541,1405,26,50,18,35,2,136
39071036AAF,2221,1678,1585,17,31,38,3,4,93
39071036ABJ,1874,1433,1405,7,6,10,3,0,28
39167084ABG,326,254,237,3,1,9,1,0,17
39163082AAA,255,206,196,0,2,6,2,0,10
39163082AAL,721,584,569,0,3,8,3,0,15
39163082AAP,846,655,628,6,2,10,4,0,27
39139070ABL,1295,877,851,6,3,15,2,1,26
39017009AMF,2143,1714,1491,51,121,38,8,0,223
39017009AGH,1315,1027,958,14,28,17,5,1,69
39017009ACF,566,481,403,18,40,15,3,2,78
39017009AGC,1142,954,901,12,9,28,3,1,53
39017009ABW,1678,1412,1271,25,74,16,22,0,141
39017009ALN,468,371,350,1,11,5,0,1,21
39017009AGD,716,593,569,2,6,6,5,0,24
39089045AAX,3150,2108,1894,29,50,49,61,1,214
39089045ACZ,2809,2150,1970,46,25,36,55,3,180
39089045ACX,666,516,478,3,4,9,18,0,38
39089045ADW,1369,1061,1001,11,10,26,9,0,60
39089045ACT,2112,1717,1615,19,15,43,16,1,102
39089045AFH,2326,1831,1697,28,35,50,10,1,134
39089045AFF,2033,1621,1505,25,19,40,21,2,116
39089045AAD,1947,1531,1422,28,34,29,5,2,109
39089045AAE,1417,1164,1073,20,35,21,9,3,91
39089045ADP,1534,1244,1146,20,15,40,12,5,98
39089045AFC,1123,924,859,18,13,26,5,0,65
39089045AFR,1847,1371,684,43,278,17,346,2,687
39089045AET,2810,2152,1648,74,261,36,129,2,504
39089045ACN,2033,1622,1412,33,96,39,42,4,210
39089045AAG,1675,1240,1150,5,36,32,11,7,90
39089045ACJ,1682,1310,1237,13,8,31,7,1,73
39089045AFJ,2495,2039,1929,12,16,64,9,0,110
39089045ABU,1468,1156,1009,33,52,26,29,2,147
39017009AHH,1940,1481,1427,5,8,30,8,3,54
39173087ADC,1200,1001,901,35,31,13,8,1,100
39173087AEJ,1331,1000,942,30,8,15,0,1,58
39173087AEK,1182,871,818,33,4,3,6,0,53
39173087ABT,1326,1004,908,68,8,17,7,0,96
39173087ABS,1318,1035,973,36,5,3,7,0,62
39173087ADM,1209,913,852,27,16,18,0,0,61
39173087ADN,474,364,291,48,5,12,4,3,73
39069035AAS,1061,809,652,143,6,11,0,0,157
39069035ABC,906,692,658,26,4,3,0,1,34
39069035AAO,1163,911,846,46,3,13,3,0,65
39003002AES,1487,1101,1054,14,14,11,6,0,47
39003002ABP,1113,796,447,17,301,17,11,3,349
39003002ABT,1334,1004,648,35,284,23,12,2,356
39003002AAY,1511,1128,859,29,203,31,2,1,269
39003002ABQ,1145,835,397,24,384,37,6,1,438
39003002AGN,1231,906,866,6,15,16,3,3,40
39069035AAQ,962,762,735,13,1,7,2,1,27
39069035AAP,967,725,684,29,1,13,1,0,41
39061031BJB,1497,1197,1117,27,11,24,11,4,80
39061031BEH,1334,988,949,1,8,14,6,2,39
39061031BOH,1865,1543,1443,21,13,41,8,0,100
39061031BOJ,2352,1636,1466,71,34,52,3,2,170
39061031ATE,1636,1174,1042,35,42,3,43,2,132
39061031ATF,778,526,491,13,2,2,15,0,35
39061031BBV,2128,1631,1103,32,297,33,145,4,528
39173087AAZ,1761,1363,1176,74,39,15,52,1,187
39173087AEE,2761,2034,1652,117,68,16,163,1,382
39173087ACP,2689,1892,1649,59,31,21,124,0,243
39173087AEH,2052,1515,1251,87,37,32,102,0,264
39173087ADD,894,698,521,145,8,19,8,0,177
39173087AAY,1540,1200,1073,57,10,25,30,0,127
39173087ADI,1495,1206,1093,40,15,36,11,0,113
39017009AAK,1434,1206,663,127,379,16,35,3,543
39017009AAH,1635,1353,689,269,341,32,37,1,664
39017009AAF,1937,1467,589,154,641,32,83,6,878
39017009AAG,925,755,562,25,103,8,56,4,193
39017009ACJ,1356,1090,991,11,38,29,17,3,99
39057029AFO,704,515,177,9,314,21,3,0,338
39057029AGK,952,793,696,27,16,29,27,2,97
39057029AGJ,3177,2699,1744,157,628,47,137,18,955
39057029AEC,3613,3166,2004,131,490,52,476,3,1162
39057029AGS,2223,1511,1215,58,68,28,129,0,296
39057029AJB,2467,2115,1580,59,168,27,278,4,535
39057029AAA,2236,1824,1312,86,146,33,241,4,512
39057029AGM,893,724,653,10,20,26,15,3,71
39057029AHA,3237,3131,2825,39,80,35,140,6,306
39057029AGY,952,709,666,5,18,9,4,0,43
39057029ADG,1344,950,772,21,103,41,11,2,178
39057029ADL,1247,1002,814,34,92,41,30,3,188
39005003AAU,1231,1071,993,14,17,6,35,1,78
39005003ACE,775,622,599,1,3,6,0,0,23
39163082AAQ,774,606,577,0,4,16,0,0,29
39163082AAF,667,513,494,0,1,15,0,0,19
39163082AAD,404,321,315,0,1,4,0,0,6
39013007ADB,1735,1405,1359,9,10,17,9,0,46
39057029AAP,1250,986,791,43,49,16,77,4,195
39057029AAJ,1086,896,820,13,18,10,30,0,76
39049025AXW,1105,864,794,21,12,4,26,1,70
39049025BAQ,1177,842,741,20,18,10,44,1,101
39049025AYC,1135,827,768,9,6,5,27,0,59
39049025BBS,935,817,739,10,24,17,15,0,78
39049025ANH,2993,2632,1894,128,211,30,344,0,738
39049025AXV,1073,752,647,23,12,23,51,1,105
39049025AXU,1110,857,810,7,15,5,13,0,47
39105053AAC,1252,972,947,1,4,11,2,1,25
39105053AAD,1245,1009,986,7,4,5,2,0,23
39105053AAQ,463,381,352,5,4,16,3,1,29
39105053AAJ,1085,846,813,7,2,7,3,1,33
39105053ABB,781,642,622,2,5,5,3,1,20
39105053AAY,795,629,611,3,3,11,0,1,18
39105053AAI,814,644,623,1,1,14,3,0,21
39105053AAH,837,678,658,5,3,5,0,0,20
39117059AAK,1721,1415,1341,13,8,37,0,0,74
39117059AAE,980,809,781,3,3,12,0,0,28
39117059AAF,1089,800,746,7,11,26,5,0,54
39069035AAT,1260,956,891,24,5,27,3,0,65
39069035AAV,1108,813,763,23,1,13,8,0,50
39003002AGL,1065,752,704,9,14,9,0,6,48
39003002AGK,1133,832,775,6,15,25,2,2,57
39003002AFP,907,684,606,13,34,5,13,1,78
39003002AFQ,1012,879,803,4,39,6,27,0,76
39003002ABW,1508,1058,641,30,360,25,2,0,417
39003002AEX,855,628,601,1,2,14,1,0,27
39003002AAG,663,494,459,20,3,9,0,0,35
39003002ACD,1776,1501,1146,60,251,24,18,2,355
39003002ADB,820,672,504,19,117,7,20,0,168
39003002ADG,1120,966,827,28,74,19,12,0,139
39003002ADC,1077,917,837,15,37,13,7,0,80
39003002AFB,1169,956,866,17,33,27,3,2,90
39003002ABR,1090,804,244,22,517,26,3,0,560
39003002AFC,1089,828,686,9,110,20,6,1,142
39163082AAU,694,577,559,0,1,15,2,0,18
39061031BDX,1699,1326,1251,11,8,33,2,1,75
39061031BJJ,2353,1465,1356,21,14,33,22,2,109
39061031ALU,1699,1228,542,76,576,38,9,0,686
39061031ALT,2973,1877,483,683,663,49,19,0,1394
39061031AMW,1259,974,420,28,489,7,27,3,554
39061031ANF,2145,1653,471,24,1020,19,122,1,1182
39061031AYF,1617,1123,875,38,145,29,32,1,248
39061031AKW,1566,1229,1017,42,109,49,13,1,212
39061031BDL,791,685,584,19,56,15,8,0,101
39061031BJS,1635,1260,1182,19,13,7,31,0,78
39061031BDQ,9,8,7,1,1,1,0,0,1
39061031BDN,3,3,0,2,0,3,0,0,3
39061031BDP,4,0,0,0,0,0,0,0,0
39061031ASH,1453,1078,964,24,13,13,45,0,114
39013007ABV,1230,997,927,7,24,26,4,0,70
39013007ABW,1259,1053,966,12,31,17,1,0,87
39013007ABQ,905,710,607,8,67,16,12,0,103
39013007ABS,677,543,470,5,35,15,6,0,73
39013007ACH,1137,922,866,1,18,12,2,0,56
39013007ACE,1695,1365,1280,6,24,31,3,0,85
39021011AAN,1374,1162,1071,13,54,13,7,4,91
39021011AAH,1234,1054,956,18,41,8,20,1,98
39021011ABU,1418,1124,1027,15,34,18,14,0,97
39095048ACI,1154,856,794,35,11,9,7,0,62
39095048AHG,1623,1070,147,52,856,18,15,0,923
39095048AHI,1137,899,193,20,651,30,5,0,706
39095048AKM,1288,956,140,29,768,15,12,7,816
39095048AKN,1046,789,189,45,524,25,16,4,600
39095048AKP,1098,856,182,26,633,10,13,0,674
39095048AAU,1531,1263,1146,29,48,19,21,0,117
39095048AAT,1776,1419,1191,55,109,19,44,0,228
39095048AEO,963,668,189,47,416,12,7,0,479
39095048AIJ,1150,830,198,58,564,7,6,5,632
39095048AJE,1383,1019,745,58,179,23,6,0,274
39095048ASK,1575,1234,1201,13,5,12,1,1,33
39095048ATJ,940,755,688,22,8,19,0,0,67
39095048ATL,676,536,472,35,8,14,2,0,64
39095048ARB,1354,1081,716,75,230,30,38,1,365
39095048AQZ,1798,1372,791,71,459,24,32,1,581
39095048ARA,1211,1071,796,56,175,15,30,0,275
39027014AAI,1237,953,873,19,34,18,5,1,80
39027014AAU,2014,1543,1470,23,2,30,7,1,73
39027014ABT,1509,1120,1065,4,12,27,5,1,55
39027014ABX,505,375,344,6,8,14,1,0,31
39027014ABM,1479,1142,1067,5,18,30,6,0,75
39027014ABI,789,622,559,14,14,24,7,1,63
39057029ADJ,1810,1376,1137,56,93,32,58,1,239
39057029ADI,632,528,464,11,13,13,22,0,64
39101051ADF,1106,855,811,13,7,13,6,0,44
39101051ACY,743,579,552,4,5,5,7,0,27
39035018CAE,1585,1207,407,45,737,19,14,0,800
39035018CTX,1637,1474,956,58,389,11,37,7,518
39035018AXS,1094,780,271,72,442,6,2,0,509
39095048AMK,1626,1258,920,121,172,42,14,0,338
39095048AMX,973,691,364,66,226,37,21,0,327
39095048AVL,2319,1955,1765,70,62,16,35,1,190
39095048ARW,1601,1428,1356,14,11,6,31,0,72
39095048AVE,1994,1584,1431,36,39,29,40,0,153
39027014ABY,1360,1047,1001,12,13,21,3,0,46
39027014AAY,1108,867,815,10,16,25,5,0,52
39095048ANJ,2042,1423,709,333,346,49,10,3,714
39095048ANE,1256,878,400,269,189,36,4,2,478
39095048ANB,948,708,329,196,171,24,5,0,379
39095048ATY,1333,1070,881,28,90,11,54,0,189
39095048AAA,1452,1161,1032,53,39,21,19,1,129
39095048AVD,1202,959,814,35,63,10,29,0,145
39117059AAL,1609,1169,1114,10,6,15,7,0,55
39093047AEJ,1505,1232,719,334,179,19,8,1,513
39093047AEP,1607,1294,729,257,288,41,5,3,565
39093047ADE,1922,1251,514,264,487,25,3,3,737
39093047ABW,1577,1141,782,83,239,40,9,2,359
39093047ADF,1841,1577,1204,94,216,58,17,0,373
39093047AIR,1963,1605,1460,35,34,45,20,2,145
39093047AIS,1120,918,826,29,22,26,9,0,92
39093047AHL,1043,1007,827,52,67,17,47,2,180
39093047AHJ,1024,911,640,54,125,54,43,8,271
39093047AHK,713,595,427,30,102,6,33,4,168
39093047AKD,1583,1292,1199,37,14,29,16,0,93
39093047AJZ,1909,1589,1520,32,4,24,7,0,69
39093047AHO,1274,1036,595,58,342,27,18,0,441
39099050ACO,2417,1998,540,179,1281,13,4,1,1458
39099050AJP,1610,1389,1330,20,7,17,13,0,59
39099050AJO,1215,938,895,11,3,8,9,0,43
39099050APL,831,690,630,7,16,23,1,0,60
39093047AEC,960,721,458,139,110,17,3,3,263
39093047ADT,1630,1290,776,237,238,41,7,0,514
39093047AEB,655,571,430,83,46,19,4,1,141
39093047ALH,2552,1763,1503,68,52,24,104,3,260
39093047AKY,1988,1357,1166,65,33,11,76,0,191
39093047AAO,1996,1240,1032,36,58,18,91,0,208
39093047AIN,1900,1515,1401,60,14,21,11,2,114
39093047AIC,897,715,633,33,2,19,8,0,82
39093047AEX,2501,1671,553,650,473,42,12,1,1118
39093047AEZ,2087,1515,388,863,307,43,3,6,1127
39109055ADF,1109,820,780,10,17,8,6,1,40
39109055ACP,1035,844,798,15,11,12,4,2,46
39109055AAG,1877,1519,1337,35,84,30,25,0,182
39109055AAA,1124,827,745,11,30,29,11,0,82
39109055ACT,996,785,766,6,0,5,2,1,19
39159080AAS,1128,804,764,11,6,13,6,0,40
39095048AOX,1307,1018,819,51,115,20,15,0,199
39027014ABR,587,469,432,6,10,15,5,4,37
39027014ACF,874,698,668,2,14,5,3,0,30
39027014AAE,929,735,642,19,47,10,8,0,93
39027014AAF,2219,1890,1505,68,244,53,11,1,385
39027014ACB,848,658,622,9,1,13,0,0,36
39095048ADK,1989,1489,485,207,775,58,2,1,1004
39095048ARI,982,774,552,50,142,9,22,0,222
39095048ASJ,1015,782,734,19,4,21,3,0,48
39095048ASI,1155,921,848,31,6,26,8,0,73
39095048AHH,1554,1039,512,43,459,21,19,2,527
39163082AAH,778,583,558,4,2,12,0,0,25
39163082AAN,302,233,223,0,6,3,0,0,10
39163082AAO,230,182,176,0,1,2,0,0,6
39163082AAG,1504,1136,1087,6,5,31,6,0,49
39163082AAI,594,462,453,0,0,8,0,0,9
39013007AAA,1283,1043,952,13,43,27,2,0,91
39013007ACD,364,287,275,6,1,2,0,0,12
39159080ABX,2284,1577,1156,34,27,8,347,0,421
39159080ABD,1457,989,766,37,25,6,151,0,223
39159080ABA,1908,1317,1248,17,10,20,21,0,69
39159080AAW,1249,912,860,12,8,16,9,0,52
39159080AAV,1148,864,836,2,0,15,7,0,28
39159080AAI,1497,1189,1072,23,26,20,36,2,117
39155078ACS,1782,1334,1023,30,194,52,15,4,311
39155078AJB,1313,1087,1027,8,18,26,1,0,60
39155078ADW,1282,902,434,29,392,51,10,1,468
39155078ADU,1221,1001,797,24,159,30,1,0,204
39155078AHK,1134,959,824,7,88,19,6,0,135
39155078AAQ,760,629,602,15,3,2,0,0,27
39147074ACF,665,522,491,18,0,6,2,0,31
39053027ABC,754,596,574,4,5,12,0,0,22
39001001ABG,1203,897,869,7,3,13,1,0,28
39001001ABH,987,743,721,6,4,12,3,0,22
39001001ABC,1569,1270,1224,12,15,18,3,0,46
39151076ACI,870,671,449,34,156,26,3,0,222
39151076ACF,1845,1351,720,75,520,43,1,2,631
39151076AAC,1466,1041,874,18,110,20,1,3,167
39151076AKL,1969,1551,1446,22,18,39,9,0,105
39151076AIL,1257,987,894,24,31,11,27,0,93
39151076ANH,959,681,512,16,121,23,16,0,169
39151076ADL,1757,1477,1192,45,210,30,7,0,285
39151076ADG,1301,945,627,45,243,29,3,0,318
39151076AMJ,1286,989,702,15,222,23,18,1,287
39151076AMV,1358,1073,758,48,201,64,6,1,315
39151076AJP,1013,819,774,15,2,10,10,0,45
39151076AJO,1157,908,846,16,8,28,6,0,62
39151076ADR,1790,1298,1181,28,22,36,15,4,117
39151076ACD,2750,2074,1126,61,797,57,21,2,948
39151076ANA,1137,881,762,17,69,17,10,0,119
39151076AMD,923,724,631,9,56,19,10,1,93
39151076ALY,1296,1064,1017,4,8,20,4,1,47
39151076AOI,1292,1022,945,22,11,20,11,3,77
39095048AUZ,946,731,667,6,8,17,24,2,64
39095048AUV,1567,1192,1104,32,18,24,14,0,88
39095048AUT,1409,1049,998,22,10,12,8,0,51
39095048AUX,1788,1349,1265,27,17,12,9,1,84
39095048AUU,1661,1161,1079,39,5,7,18,0,82
39095048AUY,1084,789,739,13,9,10,5,0,50
39095048AUR,1366,1150,1058,40,14,15,7,0,92
39095048ADR,1535,1045,273,215,555,26,5,2,772
39095048AHF,1587,1417,690,102,598,19,24,0,727
39095048AHD,825,580,19,30,532,8,0,1,561
39095048AHC,945,697,44,19,632,18,3,0,653
39095048ABK,1422,1121,1012,53,12,19,4,0,109
39095048ABM,1906,1561,1420,66,16,31,22,1,141
39095048ABO,1828,1464,1252,130,40,35,18,0,212
39095048AHX,1627,1223,798,101,299,41,8,3,425
39095048AOU,1465,1097,773,101,209,31,9,0,324
39095048AQH,1399,1048,939,35,32,21,9,1,109
39095048ACY,1049,861,761,65,20,5,5,0,100
39095048ATC,1784,1475,1133,89,189,44,33,3,342
39095048ASV,1888,1345,983,53,210,33,59,1,362
39095048AHU,1897,1355,791,88,418,48,13,1,564
39095048AKE,1310,1047,554,59,400,17,17,1,493
39095048AVZ,2059,1489,840,127,485,41,7,0,649
39095048ATS,1572,1341,1131,39,85,15,68,0,210
39005003ABO,1888,1489,1413,20,9,28,5,3,76
39005003AAZ,1390,1068,987,14,18,32,4,6,81
39005003AAG,1453,1124,1042,14,24,25,10,0,82
39139070ACN,1568,1252,1045,51,71,25,51,0,207
39095048ALB,653,501,10,14,476,14,4,0,491
39095048ALA,765,587,29,9,541,18,1,0,558
39095048ALC,757,511,20,8,476,2,1,0,491
39095048ALG,737,568,56,8,498,6,1,0,512
39027014ABE,1296,970,916,6,9,23,3,0,54
39027014ABG,1590,1254,1172,13,5,39,4,5,82
39027014ABA,1325,1014,974,9,5,20,5,2,40
39095048ARV,1343,1026,871,18,43,14,72,1,155
39095048AQI,1852,1418,1123,83,138,37,7,0,295
39095048AJW,1296,1124,569,85,350,13,110,0,555
39159080AAG,2063,1537,1378,36,21,19,70,4,159
39159080ACA,1263,1072,946,42,23,23,32,1,126
39159080AAJ,1830,1401,1243,46,47,37,27,3,158
39151076AOB,1797,1418,1362,16,10,14,6,3,56
39151076AEN,1825,1412,1223,46,84,27,4,1,189
39151076ABU,2146,1426,669,62,671,21,1,0,757
39151076ABY,1166,885,705,15,131,19,7,1,180
39151076ABZ,1779,1378,1137,24,172,38,5,2,241
39151076AFX,1896,1529,1372,20,80,29,7,0,157
39151076AKU,1523,1247,1122,12,72,22,7,0,125
39151076ALK,1718,1363,1200,39,76,35,10,5,163
39155078AEX,1249,891,850,3,23,8,1,2,41
39155078AKT,1400,1124,1064,17,12,11,17,0,60
39095048ASP,2158,1654,1296,90,132,56,60,3,358
39095048ATI,1624,1313,1097,59,92,21,33,1,216
39095048AVA,1406,1053,977,29,6,20,7,0,76
39095048AMH,1354,1077,729,75,249,20,5,0,348
39095048ALT,1410,1185,689,51,408,37,10,1,496
39095048AMP,1652,1289,1041,95,105,36,19,0,248
39095048AQP,1672,1287,1149,59,25,25,12,1,138
39095048ACC,1688,1331,1170,23,45,24,66,3,161
39095048AUF,1509,1150,943,31,90,9,76,0,207
39095048ADI,2776,2290,1187,236,792,65,20,1,1103
39095048ADG,977,800,377,110,301,15,1,1,423
39095048AUG,1143,853,742,25,28,19,39,0,111
39095048ATP,1568,1148,971,12,60,12,96,0,177
39095048AVV,1828,1383,1223,48,32,31,34,0,160
39095048AEP,865,667,261,45,356,11,0,0,406
39095048AET,1425,989,218,82,683,15,3,0,771
39095048ASA,1752,1183,987,33,28,17,99,0,196
39095048ASB,1674,1265,970,38,62,8,179,0,295
39095048AOM,1226,874,618,146,98,21,1,0,256
39095048AON,1199,791,441,76,242,37,5,1,350
39095048AAO,1631,1319,1177,63,29,19,22,0,142
39027014ACD,1172,908,841,19,16,10,8,1,67
39005003ACV,1231,991,942,11,2,18,3,1,49
39151076ABD,2038,1487,585,54,797,55,6,3,902
39147074ACN,556,415,380,12,3,4,1,0,35
39147074ABJ,1247,962,903,21,3,21,4,1,59
39165083ADD,1457,1144,1066,25,13,20,9,0,78
39165083ADE,1197,899,837,18,11,15,17,3,62
39165083AGV,799,615,568,11,9,18,9,0,47
39165083AGH,1252,884,794,29,24,11,13,0,90
39165083ADK,1437,1020,945,17,28,18,10,0,75
39155078AII,1731,1393,1062,50,231,26,16,1,331
39097049AAR,2126,1571,1471,37,20,21,11,6,100
39097049ABB,1435,1148,1104,4,5,25,1,0,44
39099050ANH,1105,933,904,6,3,13,1,0,29
39093047AKH,1018,791,589,94,59,37,4,1,202
39109055AAD,1496,1189,1072,17,52,32,6,2,117
39109055AAC,1268,960,879,12,42,14,7,0,81
39109055AAH,869,648,552,15,39,30,5,1,96
39109055AAI,1258,910,814,11,41,24,7,1,96
39095048ADT,1220,905,720,50,96,23,10,1,185
39027014ACC,1206,976,901,25,12,29,6,1,75
39027014AAM,1355,1027,857,26,95,33,12,2,170
39139070ABF,1073,816,796,7,3,4,0,0,20
39139070ABM,1167,737,722,1,2,7,4,0,15
39139070ACI,1461,1043,997,5,7,25,0,2,46
39151076AHT,1236,929,814,20,33,26,29,1,115
39101051ACN,1890,1484,1343,35,58,29,15,0,141
39101051AAH,4982,4342,2767,192,1311,49,17,4,1575
39117059AAM,422,330,292,19,4,13,0,1,38
39117059AAP,712,565,530,6,7,9,5,3,35
39117059AAQ,638,514,484,2,8,15,5,1,30
39117059AAN,570,460,449,5,0,2,2,0,11
39071036AAY,670,486,456,6,3,13,3,0,30
39139070ACQ,886,718,681,11,5,5,8,2,37
39013007ABI,1351,1104,1063,9,9,7,9,0,41
39013007ABH,1116,913,873,10,8,10,7,0,40
39139070ACR,1465,1171,1091,16,29,9,19,1,80
39097049AAC,2243,1847,1672,28,106,20,19,1,175
39097049AAE,2440,1852,1653,31,97,38,23,2,199
39097049ABD,5862,5610,3473,137,1971,25,5,1,2137
39097049AAS,522,425,408,2,6,5,3,1,17
39139070ACT,886,699,641,8,27,13,8,0,58
39079040ABE,1216,974,921,7,8,28,9,2,53
39079040AAT,1551,1172,1121,5,15,26,4,2,51
39079040ABJ,1034,794,754,2,5,24,4,0,40
39079040AAV,445,342,330,0,1,11,0,0,12
39067034AAV,377,310,300,0,0,0,1,1,10
39029015AAA,1179,897,794,4,57,24,5,0,103
39029015AAB,1692,1191,1003,11,146,23,2,2,188
39029015ACC,1135,918,866,13,10,7,3,1,52
39099050AJS,772,705,656,3,26,17,6,0,49
39099050AJQ,1331,1200,1138,8,37,12,3,0,62
39099050ASJ,1143,945,287,168,496,23,3,5,658
39099050AQR,1170,862,302,96,466,24,0,1,560
39029015ADC,1355,1155,1110,8,4,17,5,2,45
39029015ADQ,1151,927,895,4,2,14,2,0,32
39029015ABV,1324,968,835,6,100,13,0,0,133
39029015AEF,1071,886,844,7,11,11,3,0,42
39029015AFH,732,592,553,4,16,9,0,0,39
39029015ADO,842,684,658,12,3,10,0,0,26
39049025BBR,856,650,551,8,47,17,32,0,99
39049025APZ,2637,2266,1547,167,288,39,242,4,719
39049025AYI,635,534,468,16,30,3,18,0,66
39049025BHQ,2184,1731,1062,94,268,28,256,6,669
39049025BAP,1003,703,657,20,6,1,11,0,46
39049025AWY,1520,1157,1022,18,65,18,35,0,135
39049025AWI,2090,1888,1589,63,150,23,65,2,299
39049025ANL,1491,1155,665,70,354,20,33,1,490
39049025AQQ,2182,1866,1411,82,151,24,188,5,455
39049025AZV,2007,1613,1359,28,161,23,29,1,254
39049025BAB,1120,914,823,34,22,13,19,1,91
39049025AKO,2207,1391,919,111,258,62,57,4,472
39049025AZZ,1589,1303,1074,40,103,35,36,0,229
39049025BFQ,1169,815,683,23,71,21,19,0,132
39049025AQR,940,817,583,31,146,16,34,0,234
39049025ANO,1865,1339,681,21,528,44,64,1,658
39049025AQT,1299,984,802,30,89,20,43,0,182
39049025BHV,648,493,378,18,70,10,13,0,115
39049025AYM,1989,1490,1163,54,189,34,57,3,327
39049025ASJ,1238,951,720,25,139,28,53,0,231
39049025ASH,1312,936,663,19,225,8,26,0,273
39049025ASI,1041,797,679,29,62,14,10,1,118
39049025ASK,2089,1587,1037,49,398,43,55,0,550
39049025ADQ,1605,1510,1177,88,115,23,88,7,333
39049025ADU,1049,877,793,15,26,14,20,0,84
39049025ACQ,2047,1543,1098,151,231,47,30,0,445
39049025AYW,1659,1343,1129,81,74,47,21,5,214
39049025AMR,1917,1489,1169,77,166,34,41,0,320
39049025AZM,1137,893,791,26,13,33,27,1,102
39049025AYX,1480,1069,708,238,66,42,26,8,361
39049025AMQ,1280,992,747,61,103,23,53,0,245
39049025BJL,1899,1483,1127,88,192,36,42,2,356
39049025AHV,1531,1169,858,85,144,39,40,1,311
39049025BEG,1409,1005,753,75,102,37,39,0,252
39049025BMX,1337,1000,603,103,241,25,38,1,397
39049025AMP,1848,1385,1163,97,56,35,32,0,222
39049025BHJ,2188,1752,1198,127,340,39,45,1,554
39049025AZA,1576,1243,993,88,105,30,10,4,250
39049025AHF,764,668,244,28,364,19,14,1,424
39049025BII,1883,1567,547,69,909,29,29,3,1020
39049025AHE,1233,999,260,45,697,16,11,0,739
39049025AGM,2331,1558,619,251,601,54,51,2,939
39139070ABH,1170,856,807,20,10,15,3,0,49
39119060ABF,1042,806,724,9,56,23,1,0,82
39119060ABJ,740,592,553,5,10,7,1,0,39
39119060ABU,1080,847,804,11,8,19,2,0,43
39099050AOF,431,380,359,12,5,4,1,0,21
39099050AOO,610,479,455,9,7,5,8,0,24
39099050ABP,818,680,630,17,16,12,6,0,50
39073037AAW,1670,1368,1319,14,7,15,7,0,49
39073037ABD,756,599,580,3,4,11,0,0,19
39021011AAR,1536,1101,1000,20,40,31,11,0,101
39021011AAA,1390,1033,893,26,82,28,4,1,140
39021011AAP,1171,949,877,17,33,12,9,3,72
39021011ABR,1099,853,803,7,9,26,1,1,50
39171086ABE,759,609,559,29,3,10,0,0,50
39171086AAG,1727,1378,1282,58,4,17,15,0,96
39151076ALU,1384,1150,1079,17,8,18,3,1,71
39151076AIG,1388,1027,971,13,18,19,8,0,56
39151076AIA,1315,989,937,17,3,0,18,0,52
39151076AHX,1435,1018,953,7,16,24,10,0,65
39151076ALF,1698,1338,1196,14,88,29,8,0,142
39151076AKX,1792,1457,1312,34,56,27,2,3,145
39151076ANG,1037,850,713,24,61,29,14,1,137
39151076ADN,1318,957,896,17,4,19,9,0,61
39151076AJR,1484,1223,1148,12,20,30,4,0,75
39151076AFM,1088,916,895,0,6,9,1,0,21
39151076AFR,1846,1487,1414,15,12,32,5,0,73
39151076AFL,340,337,325,4,7,0,0,0,12
39151076AAX,1838,1273,899,63,265,33,9,4,374
39151076ACY,1499,1187,1009,33,92,26,23,0,178
39151076ANI,890,707,602,24,53,18,6,0,105
39099050ASI,1109,825,126,97,606,19,5,1,699
39099050ABY,2888,2763,1406,201,1125,41,21,7,1357
39099050ARC,769,613,109,33,466,6,1,0,504
39099050AFP,829,638,73,43,527,23,4,0,565
39099050ACB,1231,910,74,80,755,11,6,0,836
39029015ACK,993,803,781,3,6,7,0,0,22
39029015ACJ,3335,3185,2072,175,901,34,13,2,1113
39029015AAF,1317,1021,924,18,54,14,8,0,97
39029015AAH,996,766,701,3,31,19,2,0,65
39099050ASG,827,625,70,66,491,14,4,1,555
39099050AOQ,1403,1104,1026,26,6,12,30,0,78
39099050AJN,1146,890,833,7,14,23,4,0,57
39099050AQZ,1342,1124,935,46,134,10,1,1,189
39099050ARB,1361,1162,913,72,146,21,4,1,249
39029015ACU,1392,1145,1083,19,9,16,15,0,62
39029015AEU,1286,1034,980,9,7,27,7,1,54
39029015ACN,967,760,734,5,2,10,3,2,26
39099050APV,1569,1249,1186,12,11,27,4,2,63
39099050ANQ,1323,1059,1013,12,5,19,2,0,46
39099050ADD,1333,986,429,96,440,31,12,2,557
39099050ARX,1156,903,291,26,569,14,6,1,612
39099050AKR,1415,1152,1033,53,54,8,7,1,119
39089045ADI,1774,1373,1292,17,13,37,7,0,81
39089045ADK,2131,1672,1499,27,42,62,27,1,173
39089045ACB,2288,1705,1507,34,95,45,14,0,198
39089045ADC,2715,2593,1735,182,147,11,367,0,858
39089045AEW,2153,1605,1357,26,72,29,108,1,248
39089045ABC,2149,1646,1525,37,38,30,11,2,121
39173087AAG,1946,1673,1295,197,113,25,44,1,378
39173087ABR,1140,881,815,44,11,11,5,0,66
39173087ACE,1767,1301,1132,81,25,42,12,0,169
39173087ACG,1779,1383,1206,85,41,28,5,0,177
39173087ACK,1663,1354,1206,94,15,20,8,0,148
39173087ACB,1783,1377,1223,71,35,20,22,0,154
39173087ACJ,1348,1176,1110,20,12,20,2,0,66
39173087ABV,661,517,480,22,2,7,0,1,37
39173087ABU,925,719,640,45,5,16,1,5,79
39173087AEF,1747,1170,948,41,20,10,139,0,222
39173087ADW,1408,1143,983,78,15,39,26,0,160
39173087ACL,1565,1220,1094,70,15,35,3,1,126
39017009ABL,1197,933,827,21,38,23,28,3,106
39017009ABD,957,747,586,32,57,15,62,2,161
39017009ALF,865,699,510,25,111,18,33,3,189
39017009ABJ,1490,1216,792,35,296,14,78,1,424
39017009ABK,1101,848,728,20,42,20,45,0,120
39017009ABN,1044,817,678,25,54,15,39,0,139
39119060ABT,1354,1027,968,4,6,27,11,3,59
39119060ABH,1243,1022,924,4,56,17,18,0,98
39119060ACE,1436,1093,1026,5,21,19,11,0,67
39057029ADV,1038,832,726,17,41,17,33,1,106
39057029ADN,1633,1261,1042,43,88,31,51,0,219
39151076AJE,1256,1011,847,21,92,19,8,0,164
39151076ABS,1600,1144,407,38,673,29,3,5,737
39151076AGB,1743,1409,1124,22,163,88,1,0,285
39151076ABR,1036,878,244,17,611,5,0,0,634
39017009ADA,1576,1153,801,124,167,47,6,15,352
39017009ACO,1435,949,285,144,490,28,6,18,664
39057029AII,1261,970,899,13,11,15,23,0,71
39057029AAI,1065,849,713,25,34,7,57,0,136
39057029ADU,1293,982,740,13,168,13,42,2,242
39037019AAN,1699,1278,1217,13,8,31,6,0,61
39037019AAM,1644,1220,1169,15,5,17,2,1,51
39037019AAV,1139,872,828,2,6,20,12,1,44
39171086AAK,847,640,606,15,0,6,6,1,34
39171086AAL,1774,1344,1235,55,10,25,11,3,109
39171086ABI,1789,1539,1175,139,199,19,7,1,364
39171086ABJ,1259,935,829,88,2,11,1,0,106
39171086ABM,1285,1041,998,10,7,23,2,0,43
39171086AAN,1434,1139,1059,48,3,13,3,0,80
39171086AAR,1277,962,911,16,8,19,1,2,51
39107054AAS,1099,825,791,12,6,8,3,1,34
39107054AAE,1178,932,889,13,2,16,7,7,43
39107054ABS,1201,843,802,15,4,10,4,4,41
39107054ABH,1224,957,913,9,5,10,11,2,44
39107054AAH,1488,1085,920,51,29,21,20,38,165
39107054AAG,1392,1023,897,27,6,20,1,62,126
39107054ABE,1024,763,742,14,3,2,1,1,21
39107054ABG,828,674,636,14,5,6,10,1,38
39039020AAS,1048,830,668,119,15,16,6,2,162
39039020AAT,884,705,675,16,2,8,1,0,30
39039020AAL,1456,1193,981,144,47,22,14,1,212
39039020ABL,977,769,694,41,10,18,7,1,75
39039020ABM,1163,919,855,34,6,16,2,0,64
39125063AAB,1332,1049,964,49,3,24,2,0,85
39125063ABG,663,514,483,10,1,15,2,1,31
39125063AAQ,1511,1167,1088,39,14,26,3,0,79
39125063AAC,1019,749,714,13,8,17,5,1,35
39125063AAF,1924,1476,1381,53,6,27,5,1,95
39029015AEN,1242,978,961,6,1,3,2,0,17
39029015AEQ,1833,1397,1317,14,8,43,5,1,80
39049025BBV,993,747,561,145,20,16,6,2,186
39049025ARP,1673,1243,910,48,22,7,252,0,333
39049025ARL,1011,732,644,20,23,16,31,0,88
39049025BCJ,2609,2310,1643,122,117,28,401,3,667
39049025BNC,772,594,478,8,16,3,76,3,116
39049025BMC,1065,792,559,77,83,17,53,4,233
39049025BAR,564,480,407,22,12,10,35,0,73
39049025ANF,2123,1713,1142,132,130,22,293,4,571
39151076AAO,777,656,575,13,39,10,4,2,81
39151076AGA,1882,1561,1460,9,27,44,6,2,101
39151076ACU,1253,1019,871,24,94,19,9,0,148
39151076ACS,1498,1246,977,31,201,28,5,0,269
39095048AUE,1057,791,684,22,35,5,37,3,107
39095048AUB,1379,1134,933,44,63,23,61,3,201
39095048ANA,1322,900,436,149,308,16,7,3,464
39095048ALQ,1586,1163,663,178,295,36,10,2,500
39095048AQR,973,768,671,33,31,19,14,0,97
39095048APW,1481,1134,902,36,141,15,44,0,232
39095048APV,1033,869,764,27,40,14,21,0,105
39015008ACJ,1699,1319,1277,9,4,21,2,0,42
39015008AAJ,1299,953,913,11,10,17,4,0,40
39015008ACM,1265,986,947,5,9,11,3,0,39
39015008ACG,3048,2189,2073,29,21,42,12,1,116
39015008AAH,970,784,724,4,18,27,5,0,60
39015008ACT,1620,1295,1250,12,6,19,3,0,45
39175088AAX,790,624,605,4,3,7,2,0,19
39079040AAX,545,419,402,5,3,6,0,0,17
39079040ABA,1349,1051,1010,5,2,21,1,1,41
39079040AAZ,1300,910,883,2,2,16,3,0,27
39067034AAS,1719,1459,1375,9,28,14,7,0,84
39131066AAU,1240,968,908,9,16,28,5,0,60
39131066AAX,2111,1592,1517,9,21,33,4,2,75
39131066AAY,1370,1057,1012,4,6,25,2,1,45
39079040ABB,795,623,599,6,4,4,1,1,24
39079040AAQ,1426,1099,1018,25,10,31,2,2,81
39067034AAO,702,560,534,6,3,10,1,0,26
39095048ADW,1285,1026,811,52,140,16,12,0,215
39095048ADV,1778,1330,897,104,268,45,20,0,433
39143072ACK,1143,943,857,61,15,11,1,0,86
39143072ACS,1100,898,783,55,34,20,7,1,115
39143072ABV,697,588,542,35,3,7,0,0,46
39143072ABJ,1300,975,648,170,135,15,15,2,327
39143072ACD,616,452,410,17,9,13,0,0,42
39143072ACC,860,688,635,26,4,11,3,0,53
39151076AJU,1187,956,902,7,13,12,10,0,54
39151076ABV,927,739,461,29,215,27,6,2,278
39151076ACC,2318,1638,1170,63,339,49,10,3,468
39169085ADI,3036,2031,1990,9,16,9,8,3,41
39169085ADE,3471,2030,1998,20,3,6,6,2,32
39169085ABX,1969,1445,1377,18,14,29,1,1,68
39169085ACC,1670,1350,1258,17,8,41,8,0,92
39169085ABJ,1360,1081,995,15,17,21,23,0,86
39015008ACL,1146,903,858,11,5,24,3,1,45
39013007AAL,1782,1298,1133,12,103,33,11,1,165
39013007AAK,708,569,511,7,30,16,2,1,58
39013007AAJ,479,373,306,4,44,17,1,0,67
39069035AAK,1783,1411,1294,75,5,21,5,0,117
39069035ABD,635,476,446,15,2,10,3,1,30
39069035ABE,1096,826,766,40,2,19,1,1,60
39069035AAL,1580,1185,1033,113,6,21,11,1,152
39069035AAJ,607,445,416,19,1,6,3,0,29
39003002ABZ,1684,1148,279,30,813,18,10,1,869
39033017ABF,1288,961,907,11,11,18,4,0,54
39015008ACH,1738,1375,1331,7,13,11,3,3,44
39015008ACI,1407,1044,1016,6,4,15,1,1,28
39003002ADT,1027,758,718,10,3,16,2,0,40
39003002ADU,423,310,291,8,0,7,2,0,19
39165083AAA,1635,1167,1018,27,64,38,14,1,149
39165083ACP,1603,1207,1117,8,27,34,6,1,90
39165083AAI,2091,1605,1479,31,41,41,7,2,126
39165083ACO,1675,1350,1270,20,11,36,8,0,80
39017009ADJ,679,616,554,9,26,7,12,0,62
39017009ADM,1483,1128,917,40,98,68,12,1,211
39165083AHC,2107,1294,979,45,96,23,133,2,315
39165083ABJ,1439,1024,841,18,45,13,105,1,183
39165083AGY,1145,879,831,1,12,9,22,0,48
39165083AGF,1744,1314,1207,40,24,15,22,5,107
39155078AEW,1636,1376,1310,9,7,28,2,1,66
39155078AHW,1061,857,734,26,35,50,13,1,123
39155078AGL,1149,947,894,15,4,27,2,1,53
39155078AGK,886,746,731,2,2,1,1,2,15
39155078AIY,1682,1325,1243,18,26,21,4,0,82
39147074ABO,757,611,598,6,1,3,0,0,13
39147074ABV,1280,1076,975,50,28,8,18,2,101
39165083ACF,1298,976,790,27,46,16,92,4,186
39155078AKI,1042,839,805,13,16,9,0,0,34
39025013ADC,1625,1198,1109,37,9,33,4,0,89
39025013ADB,1416,1061,975,11,24,44,2,0,86
39025013ADJ,658,476,428,15,7,19,0,0,48
39025013AAP,1972,1612,1400,32,113,57,10,8,212
39025013AGR,773,599,560,4,4,17,2,1,39
39025013AGS,571,459,426,1,8,19,4,3,33
39025013ACI,931,681,577,38,21,24,13,2,104
39025013AHV,1563,1018,923,7,31,16,37,0,95
39025013AHZ,987,736,684,12,7,14,12,0,52
39025013ACG,1196,921,885,8,2,21,4,0,36
39025013ABR,798,633,552,26,16,17,19,3,81
39025013AHU,1712,1269,1177,22,20,5,46,0,92
39025013AHT,1146,785,721,24,8,3,20,2,64
39037019AAH,1304,1022,948,10,27,28,7,0,74
39049025AWJ,1189,905,812,7,46,14,15,1,93
39049025BLQ,1166,1047,734,54,184,17,68,1,313
39049025ADI,1809,1672,1196,91,246,31,108,3,476
39049025ACW,805,651,236,29,369,18,19,0,415
39025013AEI,1146,927,874,10,3,31,6,0,53
39025013AFD,1310,998,911,19,15,13,30,0,87
39007004ADG,620,476,446,6,13,9,0,2,30
39007004ADJ,1708,1297,1227,11,26,17,1,1,70
39007004ACH,678,569,485,28,21,23,2,0,84
39007004AAI,1082,907,802,31,46,22,4,2,105
39151076AEP,1378,1111,1038,11,12,30,9,0,73
39151076AGL,2029,1661,1416,54,103,26,43,3,245
39151076ABX,2221,1542,1130,45,315,45,10,0,412
39151076AMR,1472,1208,1113,14,50,12,14,0,95
39151076AEX,1380,1105,864,192,26,14,12,0,241
39151076ANQ,1657,1309,1259,5,10,25,5,1,50
39151076ANV,1206,939,885,10,10,21,3,0,54
39151076ACO,729,586,476,13,62,20,14,1,110
39151076AFU,1836,1459,1326,17,43,50,7,3,133
39151076AHM,1726,1220,1073,12,33,11,85,3,147
39151076AIT,1221,977,940,9,8,9,4,0,37
39151076AFT,1024,825,783,5,13,17,3,0,42
39169085AAR,2006,1601,1369,49,115,42,20,2,232
39037019ABD,1582,1179,1029,71,37,17,7,3,150
39037019ABL,1452,969,952,5,8,3,2,0,17
39037019AAT,1210,895,875,1,4,7,5,0,20
39037019AAA,1132,885,827,13,13,23,3,0,58
39037019ABH,1647,1240,1212,4,4,15,3,0,28
39093047ADD,1586,1261,835,92,288,26,23,5,426
39093047ADC,1726,1332,1037,68,190,23,15,0,295
39093047AJM,1553,1313,1149,55,60,26,13,0,164
39093047AIG,1732,1408,1302,43,27,20,5,2,106
39093047AAE,1389,1144,1037,49,26,24,10,0,107
39093047AIK,1581,1293,1197,36,14,37,7,1,96
39093047ABX,1627,1260,791,83,328,42,12,0,469
39025013AFR,975,826,727,40,12,31,10,0,99
39025013AGM,879,694,660,10,6,6,1,0,34
39025013AFK,1458,1310,1114,39,86,24,37,0,196
39025013ACK,1414,1113,1027,15,36,20,8,0,86
39025013AHM,942,800,715,21,20,24,11,1,85
39025013AGU,1576,1239,1179,3,12,31,4,0,60
39025013AGV,1268,987,902,12,2,56,2,0,85
39109055ACX,1702,1309,1227,10,13,44,3,0,82
39109055ACS,1464,1203,1143,10,6,25,9,2,60
39093047AJY,2056,1563,1428,39,17,29,2,0,135
39093047AJP,1496,1187,1102,25,5,31,10,1,85
39093047AAI,1249,1013,930,45,15,6,3,1,83
39093047AIE,1377,1136,994,67,29,32,6,0,142
39099050ADU,1547,1184,814,75,265,27,5,3,370
39099050ARM,1773,1304,818,118,343,25,7,3,486
39099050ARL,1233,1013,744,59,166,16,11,4,269
39093047AJG,1994,1672,1545,42,16,48,8,1,127
39093047AAY,1082,760,697,25,10,15,14,1,63
39093047AAZ,1095,796,719,11,9,9,45,1,77
39093047AEO,1180,918,428,216,266,27,11,1,490
39093047AEQ,1099,873,589,228,43,21,7,0,284
39093047AKI,1243,901,655,158,72,21,12,3,246
39093047AHZ,2034,1689,1568,45,13,32,8,0,121
39155078AHC,1176,1069,998,6,35,4,17,0,71
39155078ADG,1342,1146,1018,16,98,6,6,0,128
39155078AGN,1119,949,854,25,50,11,7,0,95
39155078ADF,1022,866,758,5,75,10,7,0,108
39147074ABE,1344,1046,925,41,13,25,39,5,121
39147074AAR,1694,1293,1149,60,19,42,13,5,144
39147074AAS,1080,800,699,32,27,20,15,2,101
39147074AAE,1478,1080,830,150,72,24,15,1,250
39147074ACG,1614,1228,1104,75,27,21,5,2,124
39153077AXB,1107,850,806,9,9,10,12,1,44
39153077AXA,1016,803,725,7,6,9,42,0,78
39153077BAV,1156,837,759,27,15,7,21,1,78
39153077AUG,945,789,741,20,6,2,10,0,48
39153077ANJ,1269,1098,806,10,186,12,79,1,292
39153077AMW,1343,1081,831,32,137,9,66,1,250
39153077ARW,1519,1161,825,19,243,21,43,0,336
39153077AQS,1525,1268,894,18,238,11,102,1,374
39153077AQP,1276,984,733,25,191,10,30,0,251
39153077AQQ,1088,892,747,7,101,7,30,0,145
39153077AYE,1101,890,823,11,3,30,6,1,67
39153077BBO,1139,897,843,5,11,21,7,1,54
39153077AYD,1015,818,765,15,7,19,7,1,53
39163082AAM,541,439,432,2,4,0,0,0,7
39013007AAH,1757,1423,1269,22,89,22,1,0,154
39049025AYL,1621,1142,811,104,174,32,29,0,331
39049025BHT,2144,1460,562,86,706,18,102,2,898
39049025BHS,1839,1333,713,113,348,43,144,1,620
39049025ANN,2598,1999,830,186,725,49,222,3,1169
39049025ANM,1338,972,625,35,213,22,65,2,347
39049025AWP,669,516,462,7,9,14,20,1,54
39049025BGV,1649,1232,995,61,63,16,97,1,237
39049025BGW,1829,1351,1074,82,89,14,90,0,277
39049025AMH,1353,1008,643,104,152,20,98,0,365
39049025AYY,1311,1033,805,119,36,51,27,0,228
39049025ABY,2097,1700,1073,95,452,37,47,3,627
39049025AHS,1610,1244,890,75,222,26,26,0,354
39049025ABX,2590,1896,1178,94,540,88,12,7,718
39049025BEQ,1686,1634,1273,63,132,18,144,1,361
39049025AFM,2898,1936,374,465,1076,51,12,0,1562
39049025AXH,1940,1388,521,109,729,38,28,4,867
39049025AFL,1646,1285,312,58,890,22,20,8,973
39049025AIW,1981,1541,261,100,1120,31,50,6,1280
39169085ACW,1824,1377,1276,31,19,19,21,3,101
39169085ACX,1636,1228,1171,17,4,16,10,0,57
39169085AAC,2048,1526,1280,65,116,35,25,1,246
39169085ACO,1781,1332,1259,17,3,25,9,1,73
39169085ACH,1783,1390,1302,24,18,35,3,3,88
39169085AAO,3280,2657,2209,113,195,75,72,6,448
39169085ADS,1474,1199,1102,11,34,36,12,1,97
39169085ACN,1430,1099,1035,12,7,32,4,3,64
39087044ACP,1078,843,785,12,21,12,9,1,58
39087044ADC,685,530,503,1,6,12,5,0,27
39087044ACY,1013,768,743,0,8,14,0,0,25
39087044ABV,950,747,715,1,10,16,2,0,32
39087044AAT,499,374,344,2,21,5,0,1,30
39087044AAU,574,459,431,0,20,5,0,0,28
39087044ABC,868,624,605,2,4,10,2,1,19
39037019AAD,1128,856,782,25,17,26,5,0,74
39109055AAJ,1311,1005,891,14,73,17,14,1,114
39109055AAL,1439,1058,902,25,88,35,8,1,156
39109055ACQ,1150,884,850,4,6,7,13,0,34
39109055ABB,1267,946,896,7,9,16,14,1,50
39109055ACR,853,673,638,9,9,14,2,0,35
39109055ABU,1478,1186,1104,12,36,17,9,1,82
39109055ACI,1226,915,886,6,7,14,4,2,29
39093047AGN,2251,1709,1524,56,47,27,41,1,185
39093047AGX,1456,986,829,49,37,15,51,0,157
39093047AKF,1842,1509,1258,65,130,39,17,3,251
39093047AJL,1697,1422,1169,99,106,35,10,3,253
39109055ABI,869,641,574,18,22,13,12,0,67
39109055ABJ,1628,1321,1144,18,105,18,32,0,177
39109055ADC,1241,988,892,17,42,9,22,2,96
39109055ABF,1144,861,768,9,52,8,9,1,93
39109055ABW,767,568,541,5,0,11,9,0,27
39109055ABM,1780,1386,1210,21,86,21,39,0,176
39109055AAQ,1261,925,705,16,67,5,118,0,220
39109055ABC,1541,1162,1016,22,77,37,13,0,146
39109055ABA,1103,868,770,17,53,11,8,0,98
39109055ACG,1290,1015,945,14,10,21,4,0,70
39109055AAX,1211,897,799,26,30,21,9,2,98
39109055AAZ,1143,901,824,5,33,13,12,1,77
39049025AAD,1372,925,826,15,44,14,21,0,99
39049025AAB,1905,1304,1159,26,44,10,51,1,145
39143072ABE,1320,982,772,93,82,35,12,0,210
39143072ABS,1072,888,762,73,34,11,4,0,126
39019010AAA,1531,1150,1085,7,8,36,1,0,65
39019010AAW,977,761,731,0,4,10,7,1,30
39019010ABD,811,660,618,7,4,11,0,0,42
39019010ABE,1089,908,862,8,7,25,1,0,46
39019010ABK,868,717,688,3,5,8,5,1,29
39099050AMX,1098,873,794,24,22,18,12,1,79
39099050AAG,780,644,469,76,88,16,0,0,175
39029015ACM,895,698,676,5,2,9,3,0,22
39029015ACR,944,741,695,17,8,11,2,1,46
39029015ACS,1354,1151,1093,21,1,27,5,3,58
39029015ACE,1155,948,898,6,12,20,8,0,50
39029015ACB,981,786,774,1,6,3,1,1,12
39029015ACH,1428,1119,1036,19,17,21,5,0,83
39099050ABF,517,399,280,26,76,9,4,0,119
39095048AST,888,706,562,47,45,18,31,0,144
39095048ABS,1518,1161,1031,36,34,26,25,0,130
39095ZZZZZZ,0,0,0,0,0,0,0,0,0
39095048ACU,1339,1114,992,62,23,16,5,0,122
39095048AOS,1461,1062,673,164,186,27,4,1,389
39095048AOL,2209,1621,1169,184,233,35,28,1,452
39095048ANP,1299,990,755,135,82,19,11,0,235
39095048ANY,1249,889,483,200,175,32,4,0,406
39095048AOJ,1245,924,616,184,104,21,3,1,308
39095048AOG,1411,1011,633,138,200,41,3,1,378
39095048ACV,1324,1058,904,92,20,32,7,0,154
39095048AUO,1598,1196,1042,70,22,47,5,0,154
39095048ALR,1389,1104,949,69,62,11,8,0,155
39095048ALY,1670,1379,732,67,362,37,187,2,647
39093047AKE,792,622,581,9,4,13,5,1,41
39099050ARO,1545,1087,701,79,294,32,3,1,386
39099050ASA,1273,823,240,80,486,22,1,0,583
39099050AHR,1067,862,754,20,62,13,5,0,108
39093047AJR,1134,909,855,14,7,10,3,1,54
39093047AJH,2062,1656,1543,30,11,47,11,0,113
39143072ACA,1069,847,754,59,8,15,7,0,93
39143072ACB,823,644,582,32,2,23,4,1,62
39159080ABP,895,700,667,9,4,16,3,0,33
39159080ABO,621,488,465,3,7,8,1,0,23
39159080ABS,903,713,659,12,8,19,10,0,54
39099050AQI,1215,843,316,122,406,8,3,5,527
39099050AGK,866,622,317,92,201,16,6,2,305
39065033ABI,1424,1124,1088,18,5,10,1,0,36
39065033AAD,2454,1796,1656,34,32,41,18,2,140
39065033AAA,2075,1577,1469,35,13,50,6,0,108
39099050AJR,448,322,316,1,0,0,0,0,6
39099050AKP,990,831,775,23,6,5,22,0,56
39099050AQT,1450,1094,563,85,429,34,4,0,531
39099050AKD,935,759,613,38,81,17,19,0,146
39099050ASM,674,610,551,11,22,10,12,0,59
39099050AJL,857,762,670,20,45,25,10,2,92
39099050AJJ,970,792,697,31,42,17,3,1,95
39099050AOP,688,589,563,9,3,6,2,0,26
39093047AJX,1361,1111,1042,18,10,23,7,1,69
39095048AJR,1231,1001,564,59,339,17,32,1,437
39095048ABV,1349,1012,925,24,14,13,24,0,87
39095048ABR,1593,1234,1099,47,25,19,37,2,135
39095048ABT,1084,858,799,18,8,12,18,0,59
39095048AMO,1052,691,335,83,244,27,21,0,356
39095048AAL,911,700,644,25,13,6,5,0,56
39095048AMM,1057,885,796,41,28,14,7,2,89
39027014AAS,1179,933,903,3,3,14,4,0,30
39095048AUD,2020,1531,1204,28,70,10,189,0,327
39143072ABC,1586,1233,918,188,101,15,7,1,315
39049025BBT,172,141,115,3,16,3,6,1,26
39049025BEL,703,587,357,29,182,15,10,2,230
39049025AUN,1283,1021,709,51,203,33,39,1,312
39049025BGI,1462,1364,612,52,591,21,93,3,752
39049025BMB,1336,869,164,38,447,12,215,0,705
39049025BIB,1495,1081,604,52,330,29,79,5,477
39049025ASA,1380,1023,759,35,169,19,46,2,264
39049025ARX,1109,818,667,54,70,19,13,1,151
39049025ATI,1300,997,928,24,18,10,10,0,69
39049025BKT,1079,782,667,20,40,19,33,1,115
39049025ATK,1077,802,749,14,22,8,11,0,53
39049025BJC,1302,916,810,24,42,24,18,0,106
39049025AMI,1730,1420,1121,61,96,18,119,0,299
39049025AMJ,1540,1244,854,101,173,36,91,0,390
39049025ABP,1189,995,307,19,625,16,30,0,688
39049025AJN,1772,1307,539,84,634,26,30,1,768
39049025AJI,1493,1031,323,72,570,42,50,2,708
39049025ADR,1154,966,860,31,20,15,39,0,106
39049025ACU,1838,1709,1285,84,186,31,131,3,424
39095048ACS,1920,1408,1194,75,106,32,8,1,214
39095048AJS,1503,1240,1035,43,102,14,40,2,205
39027014AAN,1891,1499,1344,25,73,16,34,0,155
39027014ACA,452,372,341,3,9,11,9,0,31
39041021AGG,359,263,248,1,5,9,0,0,15
39041021AGF,1016,724,669,21,6,13,12,1,55
39041021ABK,1778,1282,1131,54,26,25,33,5,151
39041021AGD,634,478,441,3,5,9,8,0,37
39041021ABH,924,665,606,10,17,9,20,0,59
39041021ABJ,1645,1095,923,21,61,14,52,2,172
39095048AGE,1299,1098,339,53,652,31,40,2,759
39095048ALD,1864,1614,601,68,810,15,115,2,1013
39095048ALV,1669,1243,751,118,337,40,12,1,492
39095048APS,1311,1082,838,63,132,14,36,0,244
39095048AFL,1162,996,692,56,210,19,15,0,304
39041021AGO,1066,832,441,38,114,9,235,1,391
39041021ADH,1315,991,655,78,115,15,124,1,336
39041021AEH,2860,1992,881,75,181,27,816,7,1111
39041021ABQ,1402,1134,1038,14,26,34,11,0,96
39041021AEJ,1640,1211,1043,28,59,14,61,1,168
39041021AEX,1252,938,788,18,60,7,65,0,150
39041021ABE,1125,946,864,7,39,6,33,1,82
39041021AEA,1476,1056,896,22,66,7,61,2,160
39107054AAZ,791,528,513,3,2,2,4,0,15
39107054ABC,1487,1013,981,21,5,1,0,3,32
39107054ABD,1109,834,804,23,0,0,2,5,30
39015008ACV,1148,959,916,3,19,18,2,1,43
39015008ACU,1591,1239,1136,10,59,18,11,1,103
39047024AAB,2178,1512,1330,24,110,27,11,2,182
39047024ABJ,1086,835,801,3,16,11,3,0,34
39141071ACE,765,603,550,4,10,28,1,1,53
39141071ACF,1153,859,798,9,21,24,6,1,61
39141071ACR,828,692,644,9,24,12,4,1,48
39015008ACD,1477,1095,1032,10,12,31,3,1,63
39015008ACE,1475,1152,1095,10,2,29,2,0,57
39093047AKS,1120,1017,865,29,95,8,22,0,152
39099050AOW,472,390,372,2,3,7,1,0,18
39099050APO,849,700,673,11,7,2,2,0,27
39093047AIT,1351,1076,992,34,7,23,13,1,84
39093047AIU,1787,1501,1391,24,18,34,20,0,110
39025013AGW,1793,1405,1298,6,20,65,2,0,107
39131066AAK,1057,780,723,8,11,31,7,3,57
39175088ABA,404,337,304,7,5,18,0,0,33
39175088ABF,846,637,619,12,0,5,2,0,18
39175088AAT,1171,912,852,21,3,18,13,1,60
39175088AAV,1045,790,767,9,0,5,3,1,23
39079040AAY,1214,999,904,6,51,36,3,1,95
39137069ABT,644,505,457,42,1,11,1,0,48
39137069ABW,2177,1591,1060,489,14,28,12,0,531
39161081AAW,446,339,326,4,3,6,1,0,13
39145073ADR,1106,834,804,4,7,13,3,1,30
39145073ABU,1114,863,813,9,8,20,4,1,50
39145073ABS,670,513,497,3,1,8,2,0,16
39153077AGZ,1042,889,771,4,92,6,15,0,118
39153077AHA,1145,972,868,11,56,14,24,0,104
39153077AZQ,1186,963,834,6,88,13,9,1,129
39123062ACC,1147,961,881,41,13,22,4,0,80
39123062ACS,1184,941,885,28,1,14,1,2,56
39123062ACY,941,702,664,17,4,13,0,0,38
39123062ACW,1047,808,733,49,5,11,5,2,75
39123062ACV,840,661,614,26,2,7,1,1,47
39123062ACU,1299,1072,999,39,6,22,1,0,73
39147074ACR,1370,1061,998,23,9,21,1,0,63
39147074AAT,1917,1476,1348,46,32,26,17,4,128
39147074ABZ,831,670,651,10,2,8,0,0,19
39147074ACH,632,475,444,14,8,6,2,0,31
39165083AEJ,2046,1418,1003,50,50,33,284,1,415
39165083AHB,1648,1063,722,27,65,12,229,1,341
39165083AEG,1645,1200,1004,49,24,48,59,6,196
39165083AAT,1840,1288,1185,27,10,22,30,0,103
39165083AFF,1357,1074,722,20,54,4,271,1,352
39003002AEB,1128,852,803,8,9,10,15,1,49
39003002AEA,850,646,617,9,6,7,2,0,29
39003002AEC,1318,997,832,42,65,18,31,1,165
39003002AEW,517,399,361,10,3,11,6,0,38
39003002AEY,695,561,537,1,4,9,3,0,24
39067034ABF,1031,814,774,2,6,16,1,2,40
39131066AAT,1061,835,803,5,3,18,4,2,32
39175088ABH,532,387,370,7,0,2,4,0,17
39067034AAU,1095,875,837,2,1,17,3,0,38
39109055ABH,2039,1449,1280,20,50,8,84,0,169
39109055ADD,1395,999,802,40,25,15,108,0,197
39109055ABO,1222,933,771,28,59,12,60,1,162
39109055ABN,941,800,676,22,24,10,63,0,124
39093047ADZ,1290,942,366,296,286,27,6,0,576
39093047AEA,1449,1043,342,330,365,41,2,0,701
39145073ABX,609,468,452,0,0,8,0,0,16
39141071ABL,1084,859,764,4,45,40,9,1,95
39043022ACO,608,524,495,7,7,12,2,0,29
39043ZZZZZZ,0,0,0,0,0,0,0,0,0
39043022ACM,997,873,805,27,17,2,14,0,68
39043022ADY,1862,1611,882,106,582,30,16,0,729
39043022ACL,1448,1185,1095,22,31,23,19,0,90
39043022ADX,406,363,339,6,5,9,4,0,24
39043022AAA,1338,1113,1043,14,4,29,8,0,70
39055028ACY,1760,1159,1120,7,4,7,4,0,39
39145073ACJ,743,561,537,4,1,15,2,0,24
39145073AEH,500,393,363,8,0,13,1,0,30
39145073AEI,1860,1439,1369,16,6,30,9,1,70
39145073ACK,742,596,573,1,4,8,1,1,23
39145073ACB,966,826,679,6,116,17,6,0,147
39145073ACF,1001,770,727,13,2,22,4,0,43
39145073AEF,949,715,688,3,3,16,1,0,27
39123062ACH,1361,1041,931,67,1,19,12,1,110
39067034AAB,390,313,289,1,4,14,1,1,24
39131066AAV,1115,837,823,4,4,6,5,1,14
39131066AAP,1810,1398,1323,16,14,40,6,0,75
39131066AAJ,1583,1139,1095,4,10,21,6,0,44
39131066AAO,1210,919,868,3,1,32,6,0,51
39175088AAM,704,564,540,6,3,7,6,0,24
39175088ABE,897,723,696,12,4,6,1,1,27
39079040AAE,1492,1188,1107,18,17,29,16,1,81
39079040AAW,1044,781,745,10,11,13,3,0,36
39079040ABD,1393,1103,1052,5,16,21,2,2,51
39079040ABI,607,468,450,3,3,12,1,0,18
39079040ABH,781,582,573,2,1,0,1,1,9
39067034ABB,1275,934,882,12,13,22,6,1,52
39067034ABH,439,346,340,0,0,2,0,0,6
39025013AFE,1326,938,846,7,24,17,43,0,92
39025013AFG,1936,1547,1419,52,23,15,33,0,128
39025013AEY,1381,957,888,15,12,23,16,1,69
39025013ACL,1080,739,687,17,7,2,24,2,52
39025013ADA,1711,1240,1121,31,29,18,28,1,119
39025013AAZ,1378,1063,1009,3,12,26,6,1,54
39025013AHD,1331,1046,983,10,3,43,2,0,63
39025013AGZ,903,732,690,2,9,18,5,0,42
39023012AAA,2051,1528,1249,172,19,57,23,1,279
39023012AAB,1660,1302,1169,91,7,21,14,1,133
39023012ADA,949,798,689,81,6,38,2,1,109
39041021ADR,1374,1104,1041,5,15,21,12,0,63
39041021ADS,1279,981,916,12,7,16,20,0,65
39041021ABW,835,634,563,14,19,9,21,0,71
39041021AFT,1418,973,795,19,20,10,126,2,178
39041021AEL,936,730,638,13,28,12,43,0,92
39041021AFU,2116,1303,932,22,20,7,299,0,371
39041021AGQ,1226,768,547,15,19,6,177,0,221
39041021ACN,1449,1037,893,39,13,27,64,0,144
39041021AAP,1082,812,735,24,33,5,18,1,77
39041021ADM,1180,894,816,15,10,17,16,0,78
39015008ACQ,1198,971,926,7,9,14,8,1,45
39015008ACO,1830,1389,1266,15,28,44,13,0,123
39015008ABI,958,734,669,7,23,23,2,1,65
39145073ABV,1170,972,938,10,11,6,4,0,34
39145073ABY,728,578,519,13,14,13,16,2,59
39145073ABW,1009,791,758,2,10,14,0,0,33
39145073ADF,1388,1056,1015,9,6,13,3,0,41
39145073ABL,1239,939,885,10,6,25,5,0,54
39145073ADL,1417,1064,1033,7,2,15,6,0,31
39145073ADJ,642,504,479,8,8,5,1,0,25
39153077AIH,1470,1074,485,47,487,28,24,2,589
39153077AZW,1360,1026,585,19,343,29,33,6,441
39153077ATN,1289,1007,944,6,4,39,5,0,63
39153077ATO,1510,1153,1093,17,7,25,1,0,60
39153077APZ,1102,858,804,4,16,8,16,0,54
39153077APX,1049,846,781,11,19,17,14,0,65
39153077BCB,1107,872,828,3,10,8,13,0,44
39153077AOC,948,789,750,12,8,9,5,1,39
39153077ATG,1368,1130,1034,15,29,42,6,0,96
39153077AUN,1265,1042,956,11,14,28,18,0,86
39153077BCK,1194,1022,959,12,7,6,20,0,63
39051026AAS,2168,1687,1480,145,19,33,5,0,207
39051026AAQ,1475,1069,885,138,6,22,10,0,184
39153077AGY,1432,1203,795,47,282,17,41,2,408
39153077AGN,1359,1057,908,23,84,8,32,0,149
39153077AYX,1144,843,220,15,598,10,7,0,623
39153077ACT,1250,986,460,14,479,17,18,4,526
39153077ACO,1174,811,134,25,637,25,15,2,677
39153077AOO,1254,949,875,13,31,9,16,0,74
39153077ACR,1119,877,157,11,689,17,11,1,720
39153077ASI,1432,1237,1068,12,96,17,37,0,169
39153077ASO,1241,1046,948,17,26,31,14,1,98
39153077AFR,1562,1248,968,18,172,19,62,0,280
39153077ASL,1218,1002,875,25,32,39,17,0,127
39153077AFQ,1832,1200,657,43,424,27,33,9,543
39153077ATE,1527,1183,1092,8,14,50,11,1,91
39153077AJL,1823,1137,611,16,472,26,12,4,526
39153077AKC,1407,1091,970,21,45,43,5,1,121
39153077AKA,1118,944,880,13,15,19,5,1,64
39153077BAF,1399,1127,1032,15,22,36,12,2,95
39153077AQF,955,757,680,11,20,14,23,0,77
39153077BCC,957,742,708,5,7,9,8,1,34
39153077AZT,1895,1425,1021,34,350,28,2,0,404
39153077AHL,1440,1142,669,24,395,44,14,0,473
39153077AHJ,1595,1208,833,31,281,55,11,0,375
39141071ACG,1080,858,815,2,10,22,3,2,43
39141071ACK,1121,873,807,8,22,22,12,1,66
39141071ABB,831,617,533,10,56,17,2,0,84
39141071AAQ,1022,819,707,8,83,16,2,1,112
39141071AAV,917,666,532,4,113,6,11,0,134
39141071ACO,840,649,622,5,7,12,4,0,27
39141071ACV,594,457,420,2,12,19,6,1,37
39113057AAO,1097,1025,911,32,42,13,27,1,114
39113057ADC,1360,1040,46,17,969,12,1,0,994
39113057ADJ,1317,889,41,11,818,8,8,4,848
39113057AIE,1564,1213,192,27,974,25,10,0,1021
39113057ALH,2309,1853,1509,54,163,68,44,6,344
39113057AVI,1502,1238,639,32,533,26,7,2,599
39113057AOR,1692,1292,1001,27,205,40,21,1,291
39113057ABG,1282,1113,903,39,113,32,28,0,210
39113057AFH,978,774,60,13,699,6,0,0,714
39113057AHJ,1112,839,34,10,787,9,5,2,805
39113057AFQ,2705,2234,727,37,1438,36,10,8,1507
39113057AVE,1004,797,760,2,5,16,2,0,37
39113057AOB,1820,1368,1208,25,67,38,26,2,160
39113057AOE,1805,1434,1295,18,87,20,15,0,139
39113057AYL,2281,1648,1224,41,92,15,268,0,424
39113057AAK,1933,1550,1368,22,62,11,80,0,182
39113057AYG,1803,1502,1221,38,128,18,85,2,281
39167084ACJ,1901,1519,1488,0,7,23,1,0,31
39061031BFJ,2087,1534,944,105,419,58,9,4,590
39061031AFL,1972,1638,237,27,1365,21,11,3,1401
39061031ANT,2870,2038,887,513,557,76,35,3,1151
39061031AWP,911,769,575,15,147,17,15,1,194
39061031ADP,1059,904,768,11,82,11,32,0,136
39061031ASS,1453,1040,922,34,23,18,32,5,118
39023012ACT,1707,1193,452,64,639,39,5,1,741
39023012ACN,1979,1412,1093,28,254,21,12,3,319
39123062ABT,983,899,863,15,1,9,5,0,36
39141071ACS,1119,888,799,10,15,50,4,0,89
39037019AAO,1008,745,713,24,6,3,1,0,32
39037019AAR,2056,1519,1448,18,12,19,4,10,71
39107054AAI,1496,1127,1020,37,21,25,8,18,107
39107054AAJ,789,629,595,16,2,7,7,3,34
39003002ABX,1377,1082,616,37,426,10,3,2,466
39167084AAG,1800,1446,1313,19,32,54,18,2,133
39167084ABL,827,681,634,8,15,21,2,0,47
39167084ABI,981,765,742,6,9,5,2,1,23
39167084ACN,1058,814,781,2,2,15,3,0,33
39107054ABQ,1330,1039,988,13,5,14,1,16,51
39107054AAQ,1272,932,882,27,4,13,1,2,50
39107054ABN,1501,1071,1006,27,1,21,8,6,65
39107054AAY,992,674,662,6,1,2,1,0,12
39171086ABA,752,585,537,18,3,17,3,2,48
39171086AAC,1878,1454,1290,82,13,45,22,2,164
39147074ACT,873,682,656,13,0,8,6,0,26
39147074AAN,2074,1786,1535,80,117,17,28,2,251
39165083AAX,1107,831,639,72,29,31,48,8,192
39165083ADI,1244,975,892,21,19,9,35,0,83
39155078AKB,1238,950,865,30,25,16,3,0,85
39155078AIQ,1201,975,877,11,58,6,6,1,98
39155078AJM,1337,1097,1052,7,6,21,4,1,45
39155078AJY,1013,783,725,7,7,28,6,2,58
39155078AEK,1854,1369,818,33,464,42,6,2,551
39155078ACA,1793,1366,1201,32,56,42,9,1,165
39007004AAS,912,770,581,80,67,31,1,0,189
39025013ABP,1432,1135,1084,4,7,36,1,1,51
39049025AHY,1804,1359,907,116,306,28,29,0,452
39049025AYZ,1568,1186,1002,76,58,33,14,4,184
39049025BJO,1571,1463,1216,46,70,15,112,1,247
39049025BKX,1302,1122,840,48,80,12,148,1,282
39049025BKW,1952,1735,1328,57,72,12,270,2,407
39049025BKM,819,688,493,26,43,10,116,0,195
39049025BMV,897,695,582,29,25,18,39,1,113
39001001ABA,1435,1103,1065,6,8,19,2,0,38
39001001AAZ,1098,860,829,4,7,9,5,0,31
39151076AJZ,1611,1313,1230,17,17,33,8,0,83
39151076ACT,1550,1199,1019,42,86,29,14,1,180
39151076AMI,1132,905,822,16,23,8,27,1,83
39151076AGX,1091,912,831,33,12,7,15,3,81
39151076AHN,1439,1156,1073,22,31,15,20,0,83
39151076AER,1282,1051,975,16,20,20,4,1,76
39151076AMZ,1579,1299,1174,14,79,10,18,1,125
39151076AFE,1548,1221,1126,40,25,23,12,0,95
39151076AOP,1617,1238,1191,14,3,14,5,1,47
39151076ADB,1392,1135,978,21,102,10,19,0,157
39151076ALH,953,782,717,15,21,17,6,1,65
39151076ALB,1048,828,750,14,35,18,4,1,78
39151076AOH,1473,1181,1139,5,4,24,6,2,42
39151076AKH,1301,1024,967,9,9,32,5,0,57
39151076ANP,1837,1344,1290,5,10,31,2,2,54
39049025BIA,1760,1293,955,61,149,12,96,0,338
39049025BAT,1565,1052,779,25,80,24,142,4,273
39049025AFF,1917,1307,264,109,898,43,7,2,1043
39049025BAJ,1405,1020,503,102,374,35,14,1,517
39049025ACZ,1453,961,148,54,745,12,6,0,813
39049025APR,1281,1092,782,66,87,14,131,0,310
39049025BJN,1334,1060,427,23,101,8,503,0,633
39049025BDD,911,686,571,14,18,9,75,1,115
39049025BCE,2090,1418,846,31,23,23,497,3,572
39049025BDQ,2346,1645,995,43,48,18,539,2,650
39049025BGZ,1742,1324,822,166,149,28,165,2,502
39049025BBH,1142,887,744,76,19,24,28,1,143
39049025ATZ,1509,1116,932,58,63,19,42,1,184
39049025BNP,997,800,589,31,112,13,54,0,211
39049025AZP,1164,929,879,10,15,14,8,1,50
39049025BHL,1462,1064,837,54,110,29,37,0,227
39049025BKS,1519,1274,1106,67,51,22,15,0,168
39049025BHK,1778,1405,1095,70,173,26,47,2,310
39049025ATN,1536,1262,1024,45,89,31,59,1,238
39049025BCG,1805,1344,1107,51,118,28,37,0,237
39049025AMU,1946,1513,1263,73,97,35,39,1,250
39049025AHU,3294,2696,1491,147,963,40,67,0,1205
39049025AZQ,1031,625,184,42,367,13,20,3,441
39049025ANZ,1304,1133,773,20,86,6,242,0,360
39049025ABZ,902,871,718,48,44,15,48,1,153
39049025ACA,1356,846,347,219,243,23,23,3,499
39049025BAO,682,546,499,12,8,6,18,0,47
39049025BHB,1165,980,777,41,73,9,88,1,203
39049025AVW,1242,963,805,19,13,9,110,0,158
39049025APW,1085,922,770,44,38,28,37,0,152
39049025AFJ,1433,963,130,59,769,19,7,1,833
39049025AHA,1918,1867,1366,116,92,17,264,6,501
39049025BMA,1426,1380,1076,58,98,18,122,4,304
39049025AAX,1174,896,309,17,507,33,17,6,587
39049025ABE,1009,809,247,41,492,31,17,3,562
39049025ALS,849,727,364,24,313,14,17,2,363
39049025ABG,1065,768,123,20,617,26,5,0,645
39049025AAS,1394,1259,1116,32,50,20,33,0,143
39049025AKG,1389,1078,181,47,811,39,35,2,897
39049025BBA,1307,1064,972,36,22,40,6,0,92
39143072ACE,1135,910,826,64,4,17,1,0,84
39143072ACI,1139,898,831,53,6,16,0,0,67
39143072AAJ,1132,869,766,48,15,22,7,2,103
39143072AAK,1234,935,807,68,17,25,5,2,128
39143072ACM,1214,986,866,88,13,11,9,0,120
39007004ADQ,1127,877,822,7,16,18,5,1,55
39007004AER,888,700,670,5,1,11,1,0,30
39007004AEJ,824,708,642,18,21,13,9,3,66
39007004AAC,1070,811,666,31,63,20,10,3,145
39025013AHR,1696,1303,1166,33,32,30,32,0,137
39025013AAJ,1046,808,751,10,6,31,7,0,57
39025013AEF,1293,1057,988,20,9,15,16,0,69
39025013AAC,1553,1257,1162,17,18,17,35,0,95
39113057AQQ,1416,1083,231,10,828,20,6,3,852
39113057AGJ,1487,1244,60,13,1166,7,6,0,1184
39113057AQS,1325,1003,181,15,801,11,7,0,822
39113057ARF,1329,921,225,38,645,18,3,2,696
39113057AQX,1826,1335,438,29,828,34,12,0,897
39113057AQI,1493,1168,424,26,703,23,15,0,744
39113057AQK,1083,886,58,12,807,12,1,0,828
39113057ATE,498,392,354,21,10,8,3,2,38
39113057AFP,1265,765,52,11,704,19,0,1,713
39113057ARK,2245,1716,1476,31,134,49,28,1,240
39113057AIN,2087,1630,1288,49,201,35,50,0,342
39113057AXD,1174,944,673,9,226,18,24,3,271
39113057ADK,654,436,89,6,340,3,1,0,347
39113057ACR,1073,806,109,18,673,21,5,1,697
39113057AHH,436,341,31,8,301,9,2,1,310
39113057ANZ,1264,991,891,27,50,20,7,1,100
39113057ANV,1801,1373,1285,22,22,20,11,2,88
39073037AAN,1429,1081,1024,8,6,24,4,0,57
39021011ABQ,1242,917,886,5,5,14,0,1,31
39143072ADC,1022,833,723,78,9,13,2,0,110
39107054ABO,1151,833,817,9,0,4,1,1,16
39107054AAT,1081,823,792,7,2,10,2,1,31
39107054AAU,1051,812,747,22,6,10,10,12,65
39107054ABL,1587,1087,1071,7,1,2,0,1,16
39107054ABM,1735,1219,1199,12,5,2,1,0,20
39107054AAO,1045,756,696,18,2,10,1,27,60
39107054AAW,1213,1020,1000,6,1,9,1,2,20
39107054AAX,1298,1097,1063,15,2,9,4,0,34
39107054AAK,611,432,416,8,0,8,1,0,16
39171086ABG,1881,1451,1348,48,11,37,10,0,103
39171086AAV,1814,1482,1404,26,5,32,2,1,78
39021011ABK,1714,1337,1264,23,8,21,15,1,73
39021011ABA,882,681,647,6,3,18,6,0,34
39039020ABQ,548,450,395,23,13,14,3,1,55
39039020AAU,612,469,423,19,6,23,4,0,46
39039020AAV,1115,910,822,60,13,18,3,1,88
39039020AAH,1358,1041,813,148,40,32,7,3,228
39039020ABA,1454,1125,1073,16,15,19,2,1,52
39039020ABC,1412,1019,914,70,13,15,9,4,105
39039020AAY,802,586,536,30,6,12,1,1,50
39039020AAK,1400,1105,975,69,35,10,11,1,130
39011006AAJ,1221,885,837,11,5,17,11,1,48
39021011ABT,899,709,683,3,6,10,5,0,26
39021011ABV,1733,1360,1256,20,30,41,10,0,104
39021011ABS,1213,904,847,10,19,19,3,0,57
39043022ACI,1383,1095,1026,27,5,18,8,2,69
39055028ABU,1484,1202,1126,18,14,9,21,1,76
39055028ABV,2104,1364,1316,8,20,10,8,3,48
39043022ADM,1092,947,839,25,38,10,30,0,108
39001001AAT,1293,985,941,6,10,23,3,0,44
39145073ABQ,1089,844,784,7,7,33,6,0,60
39145073ADW,1185,936,879,4,11,26,7,0,57
39145073ADX,872,684,665,2,2,13,2,0,19
39161081AAQ,533,399,372,9,8,7,6,1,27
39161081AAO,1236,1043,975,25,23,12,7,2,68
39161081ABA,548,390,376,12,0,1,0,0,14
39161081ABD,1324,980,936,17,10,13,5,0,44
39011006ABB,233,171,169,1,1,0,1,0,2
39011006ABA,1337,983,950,12,6,9,5,0,33
39011006ABO,1004,757,733,4,8,4,3,0,24
39011006ABN,940,700,677,10,5,6,0,0,23
39011006AAO,790,602,572,7,2,11,3,1,30
39011006AAY,871,594,582,8,2,1,0,1,12
39011006AAZ,1720,1243,1209,11,5,4,9,1,34
39011006AAV,1803,1374,1332,13,8,10,9,0,42
39011006ABG,1227,962,924,5,10,18,1,0,38
39011006AAK,1081,772,703,30,6,21,5,1,69
39137069ABO,1181,880,839,25,0,7,8,4,41
39137069AAQ,1495,1129,1083,26,4,15,5,2,46
39137069AAX,1481,1120,916,153,18,19,15,0,204
39161081ABM,1021,748,728,6,5,5,5,2,20
39011006AAR,1154,893,848,16,8,8,2,1,45
39011006ABJ,1862,1519,1457,13,9,21,10,2,62
39011006AAD,1558,1241,1193,13,14,12,6,4,48
39011006AAE,1772,1333,1229,27,18,32,24,2,104
39137069AAN,2044,1522,1444,34,5,21,3,2,78
39161081ABG,1012,754,693,26,3,29,3,0,61
39011006AAN,1706,1311,1214,33,16,29,15,4,97
39049025ASU,1269,939,890,3,5,2,22,2,49
39049025BKY,1580,1462,1000,88,213,29,121,15,462
39049025ABT,916,868,589,42,153,18,65,0,279
39049025BNQ,1325,1264,915,52,194,31,82,1,349
39049025AYG,1235,948,764,22,108,16,36,1,184
39049025AXZ,1119,822,716,14,65,5,19,0,106
39141071ACD,1288,1007,952,7,9,31,1,0,55
39141071ACJ,630,535,387,9,122,15,0,0,148
39141071AAO,1380,1141,1009,8,54,44,20,0,132
39141071AAH,817,635,551,8,54,13,9,0,84
39141071ABA,1380,995,860,23,86,25,1,0,135
39141071ABR,867,679,639,10,12,14,0,0,40
39081041AAE,1370,981,661,30,266,15,5,0,320
39081041ABA,1382,1138,1062,12,19,19,13,2,76
39081041ACF,401,337,296,4,11,24,1,0,41
39081041ABY,878,739,721,1,8,6,0,0,18
39169085ADD,1613,1258,1188,29,9,34,3,4,70
39169085ADB,1351,1051,1021,8,1,8,5,1,30
39085043AAV,1795,1387,1322,19,13,9,17,0,65
39085043ACT,1385,1112,744,174,154,35,18,2,368
39085043ACZ,1053,820,531,111,157,26,11,3,289
39085043ACU,1537,1159,807,187,127,38,15,2,352
39085043AIG,1145,871,720,83,41,21,8,0,151
39085043AIT,2051,1488,1355,36,47,18,20,5,133
39145073ADI,907,721,688,1,4,23,2,0,33
39145073ADC,839,668,621,9,4,30,2,0,47
39145073ADZ,2073,1874,1084,18,741,22,5,3,790
39145073AAQ,1127,887,763,14,59,36,14,1,124
39145073ABE,704,556,490,4,33,6,10,1,66
39019010AAX,1368,1048,986,9,6,26,6,2,62
39019010ABJ,1444,1145,1100,9,5,23,4,1,45
39141071ACL,1282,990,895,10,48,34,5,0,95
39141071ABQ,572,466,451,0,2,12,0,0,15
39043022ACD,1674,1335,1209,62,11,41,10,0,126
39043022ACC,651,502,478,7,2,13,0,0,24
39093047AHV,2336,1884,1642,87,69,37,35,2,242
39109055ACM,1459,1137,1097,10,8,14,0,0,40
39109055ACO,1241,930,866,15,9,27,0,4,64
39049025BGD,836,609,477,22,52,17,47,2,132
39049025BGQ,1643,1257,924,74,91,35,135,1,333
39049025AKF,1481,1049,161,121,736,28,29,0,888
39049025AHT,2541,1628,702,66,838,38,6,3,926
39049025AMN,1743,1243,679,114,345,40,78,0,564
39049025AIV,1465,1040,139,75,807,18,18,1,901
39049025AIT,2037,1403,208,77,1100,10,13,1,1195
39049025AFW,1542,1110,138,69,873,37,27,1,972
39049025AAV,1015,954,834,34,21,11,48,0,120
39049025BJF,1524,1496,889,57,451,15,80,2,607
39049025AYT,1513,1127,684,188,179,48,41,0,443
39049025AIL,1570,1161,482,232,383,61,56,4,679
39049025ABV,1380,1331,1145,41,58,5,58,0,186
39049025BFZ,1815,1232,957,38,48,13,157,2,275
39049025BLM,1884,1328,1023,65,77,22,131,1,305
39049025AKB,1562,1252,543,65,607,21,21,4,709
39049025AFX,993,746,66,36,631,20,10,2,680
39049025ABJ,1715,1451,622,52,720,13,55,1,829
39049025AFN,1126,915,353,35,518,18,6,0,562
39023012ACH,1825,1383,482,53,812,34,9,0,901
39023012ACV,1197,901,290,29,561,38,6,5,611
39023012ACI,2303,1505,646,110,720,38,7,2,859
39023012AEW,1928,1521,1435,13,41,16,14,0,86
39023012ADB,2040,1525,1352,81,24,44,14,3,173
39041021ACH,1124,857,807,12,6,18,5,0,50
39141071ABV,1189,927,867,13,10,26,6,1,60
39043022AEG,1522,1172,727,54,346,34,10,0,445
39043022AEC,1469,1163,857,43,236,22,5,0,306
39043022ADA,1140,881,817,25,3,17,9,0,64
39043022AAI,938,712,660,17,9,14,6,0,52
39043022AEB,1729,1354,891,56,377,27,17,0,463
39043022AEF,1825,1304,884,62,329,27,13,0,420
39043022AEN,997,783,729,25,6,20,6,0,54
39043022ACW,974,779,723,19,3,24,3,0,56
39043022ACR,968,807,733,35,6,26,1,1,74
39043022ACP,774,619,571,21,4,19,2,0,48
39043022ACF,1123,939,877,21,9,18,5,1,62
39043022ACK,1359,1067,993,39,10,14,7,0,74
39055028AAK,1074,864,817,5,16,7,12,0,47
39055028AAD,1453,1119,1050,20,20,18,16,1,69
39055028AAE,1150,887,819,16,14,8,8,0,68
39099050AKH,1560,1269,1055,62,97,16,33,6,214
39099050ABT,989,808,745,18,20,8,9,0,63
39099050AQF,923,756,691,20,24,8,2,0,65
39099050ARY,1350,1056,286,84,687,27,6,0,770
39099050ACC,1403,1244,778,107,297,31,53,5,466
39093047AIM,855,690,665,3,3,14,0,0,25
39093047AIO,1508,1220,1153,18,13,18,7,0,67
39093047AKL,1247,991,833,65,40,31,23,0,158
39093047ACW,1719,1298,832,110,330,42,11,3,466
39093047AHT,2230,1738,1519,101,50,43,17,2,219
39093047ACZ,1794,1087,398,156,521,37,7,5,689
39019010AAF,944,716,682,10,5,9,2,0,34
39019010AAJ,1086,850,777,13,29,20,4,0,73
39019010AAG,1155,946,895,9,2,29,1,0,51
39019010AAL,1721,1313,1239,19,5,34,3,0,74
39019010AAV,808,613,588,2,1,14,4,0,25
39041021ABT,1049,762,636,24,12,10,78,0,126
39041021AFO,1294,887,657,24,18,7,175,0,230
39041021AAY,881,712,628,15,15,3,34,0,84
39041021AFL,1613,1195,962,31,27,5,161,0,233
39041021AEQ,1371,1178,958,32,36,20,125,3,220
39041021AEK,1470,997,856,20,9,12,93,0,141
39041021ACT,1909,1441,1127,50,63,15,183,0,314
39041021ACZ,1454,1074,874,23,40,19,120,0,200
39041021AAS,1346,1074,970,42,33,16,5,2,104
39023012ADN,1976,1583,1468,18,47,39,9,2,115
39023012ADM,1154,946,895,14,18,5,13,1,51
39023012ACO,1673,1295,1119,41,93,35,8,1,176
39023012AFW,1130,902,835,10,15,15,16,3,67
39023012ACU,1917,1404,409,74,898,22,9,1,995
39023012ACC,1608,1237,1109,19,81,11,19,1,128
39023012AFB,1693,1415,1302,14,51,32,13,4,113
39023012ABJ,1736,1252,992,44,161,22,17,2,260
39047024AAA,1793,1318,1188,32,42,23,30,3,130
39015008AAW,1081,795,750,5,6,29,4,0,45
39137069AAF,885,659,653,1,0,2,3,0,6
39137069ABA,1137,823,792,19,6,7,0,1,31
39137069ABQ,1490,1095,1063,15,0,3,1,3,32
39137069ABR,1455,1105,1068,13,0,1,3,0,37
39109055ADH,4147,2819,2117,89,302,59,241,5,702
39109055ABQ,1202,962,900,16,5,31,8,2,62
39109055ADE,1467,1169,1010,20,69,23,45,0,159
39113057AJI,2139,1665,1191,39,324,35,68,6,474
39113057AJJ,1772,1411,1051,36,233,23,60,2,360
39093047AAL,1860,1487,1331,98,22,21,14,2,156
39093047ALF,1322,1273,1074,37,74,30,58,9,199
39093047AFE,2176,1618,934,471,219,53,12,3,684
39093047AFD,1958,1400,718,487,187,42,5,2,682
39093047AHR,2141,1683,1507,85,42,32,8,2,176
39093047AHP,2250,1844,1557,121,67,50,33,3,287
39109055ABP,1006,795,738,23,11,10,2,0,57
39109055ABE,860,637,588,11,18,15,2,0,49
39109055ADB,1025,775,692,14,26,29,10,3,83
39109055ABY,821,662,608,18,8,10,16,0,54
39157079ADW,548,445,417,4,1,14,0,0,28
39169085ACQ,2890,1837,1783,25,9,15,2,1,54
39093047ADX,1509,1181,646,232,283,49,4,2,535
39093047ADY,1660,1196,680,238,257,38,8,1,516
39109055ACZ,1412,1108,1055,8,10,21,9,1,53
39109055ABG,957,700,612,23,40,17,4,0,88
39093047AIH,1051,859,770,57,9,10,6,0,89
39093047AKM,1465,1252,1085,39,58,17,37,0,167
39099050AAN,946,772,384,172,213,15,6,0,388
39001001AAU,981,697,673,4,3,14,3,1,24
39001001ABE,1351,992,949,2,11,28,3,1,43
39159080AAL,903,692,631,18,12,7,21,0,61
39159080ACC,1501,944,665,31,23,15,204,0,279
39159080ABC,1897,1222,857,17,25,7,311,0,365
39159080ABB,1066,724,450,17,39,13,197,0,274
39159080ABY,2060,1354,558,22,34,10,711,0,796
39159080ABH,1487,1119,1056,15,7,14,6,0,63
39123062ABO,1300,987,880,67,10,22,2,0,107
39123062ABL,1386,1084,991,40,10,17,13,0,93
39111056AAX,595,472,461,0,3,7,1,0,11
39169085ABU,1882,1380,1338,7,9,17,1,2,42
39169085ABH,1588,1188,1044,27,55,13,32,2,144
39169085ABN,1689,1363,1224,19,22,11,58,0,139
39169085ADG,1381,1101,1057,8,8,11,6,2,44
39007004AEQ,611,466,433,5,5,11,4,0,33
39159080ABU,1341,1031,967,14,13,18,15,1,64
39159080AAK,1711,1236,1076,77,42,22,21,0,160
39159080ABL,1596,1249,1163,24,9,22,24,2,86
39159080ACB,1469,944,779,16,15,16,102,0,165
39159080ABJ,1116,845,799,12,11,14,9,1,46
39159080AAA,1466,1098,980,32,47,28,15,2,118
39059030ABL,1312,1044,990,4,11,26,4,0,54
39111056AAN,883,716,687,0,2,13,9,2,29
39111056AAW,444,283,278,0,0,0,2,0,5
39071036ABR,1096,873,822,9,10,32,1,0,51
39151076ACL,1498,1120,748,68,254,34,10,1,372
39151076ACK,839,678,505,20,130,20,5,0,173
39151076AII,1625,1213,1143,19,11,23,5,1,70
39151076AEV,867,663,607,8,15,10,13,0,56
39151076AHI,1828,1369,1249,25,31,15,32,0,120
39169085ABP,1683,1198,1155,15,7,12,14,1,43
39159080AAP,1259,992,940,11,8,28,8,0,52
39157079ACD,1150,909,835,26,13,24,3,0,74
39157079AAA,1040,773,588,162,7,71,2,0,185
39157079AAM,1230,883,588,242,30,92,7,4,295
39157079AAO,951,837,767,38,16,18,1,0,70
39157079ACK,2099,1669,1588,21,7,37,5,0,81
39157079ACN,1286,1037,973,19,15,23,6,2,64
39157079AEO,2409,1581,1529,15,5,16,8,3,52
39157079ACM,1461,1179,1124,25,5,12,5,0,55
39157079AAN,934,709,572,99,15,44,4,0,137
39157079AAI,1019,778,685,37,12,28,13,0,93
39121061AAD,509,400,391,2,1,5,0,0,9
39059030ABI,894,722,678,6,4,20,4,2,44
39065033AAM,1393,1077,1012,27,9,14,5,0,65
39065033AAX,1717,1312,1246,15,19,25,5,2,66
39065033ABB,3333,2952,2633,109,98,30,76,1,319
39025013ABW,1124,852,781,18,17,18,20,0,71
39025013ACT,911,692,639,9,10,25,3,1,53
39025013ACW,1157,853,777,34,9,21,1,1,76
39025013ABX,1159,808,721,25,20,27,12,0,87
39025013AEM,1370,1051,999,3,6,33,1,2,52
39025013AEV,1049,808,760,12,6,27,1,2,48
39025013AHA,1276,1050,978,5,18,27,4,0,72
39007004ABK,656,566,537,16,1,7,3,0,29
39007004ABI,838,665,602,16,24,9,9,1,63
39007004ABO,946,769,698,16,19,25,0,0,71
39007004ABN,722,543,515,6,8,7,4,0,28
39007004ACI,1264,991,883,42,51,18,1,2,108
39007004AAX,819,559,342,71,127,21,1,0,217
39007004AAU,1482,1151,955,68,75,48,2,1,196
39007004AEF,1000,771,716,17,10,16,3,0,55
39007004ABZ,952,774,728,3,13,24,3,3,46
39007004AEZ,1577,1219,1145,8,27,15,9,0,74
39007004AEG,959,731,675,16,6,9,10,0,56
39007004ADT,944,747,696,3,11,24,4,0,51
39007004AEH,616,503,451,22,15,11,4,0,52
39007004ADL,787,616,579,17,8,6,0,0,37
39007004ADF,745,572,554,2,3,3,0,0,18
39007004ADI,731,562,526,12,7,3,5,2,36
39007004ABD,1463,1094,981,38,33,30,9,0,113
39151076ANT,940,748,711,6,7,14,6,1,37
39159080AAN,990,730,683,7,2,20,9,1,47
39159080ABW,1375,1019,973,9,6,24,4,1,46
39041021ABZ,955,803,712,14,19,26,19,0,91
39041021AGP,1003,901,691,14,73,5,109,1,210
39041021ABC,779,566,458,10,33,8,58,1,108
39041021AFJ,1239,1064,848,34,104,14,66,0,216
39041021AED,792,666,586,19,26,7,22,0,80
39041021ABX,767,635,563,10,26,17,19,1,72
39041021ABV,584,461,413,14,10,2,20,1,48
39041021ABS,1095,903,864,14,6,4,9,2,39
39041021AAB,1533,1044,914,30,49,19,26,0,130
39041021AAH,1323,914,803,35,33,19,16,1,111
39041021AAC,1674,1208,1086,22,44,17,28,0,122
39041021ACM,1027,767,738,1,1,9,14,1,29
39041021AFB,2099,1541,1328,49,70,41,40,3,213
39041021AAI,1840,1426,1281,20,62,30,30,3,145
39041021AAJ,1761,1271,1139,30,50,23,26,3,132
39023012ADW,1594,1259,1156,16,37,29,8,4,103
39023012AAQ,2090,1511,877,94,506,35,8,2,634
39073037AAU,1194,900,866,6,6,16,1,0,34
39021011AAW,1952,1485,1404,11,16,49,7,1,81
39021011AAY,1681,1262,1190,11,27,23,8,0,72
39151076ADC,820,700,544,16,105,18,12,1,156
39151076AFH,1365,1050,925,48,24,23,20,0,125
39151076AMG,1508,1232,999,31,173,14,19,1,233
39025013ADN,987,768,692,30,11,28,4,2,76
39025013ADL,1210,894,820,14,11,47,1,0,74
39169085ACU,2432,1639,1594,14,9,15,3,0,45
39169085AAZ,1307,1018,932,20,25,17,19,0,86
39169085ADN,1956,1602,1528,17,17,24,4,0,74
39169085ADU,1550,1221,1155,14,17,25,4,0,66
39169085AAP,1224,894,795,14,46,31,6,1,99
39153077AHO,1661,1276,820,21,385,35,8,0,456
39153077AHP,1712,1276,894,24,293,39,24,1,382
39153077AZV,1721,1312,939,10,295,36,12,0,373
39153077BAY,1062,783,690,17,14,3,54,0,93
39153077AXO,1136,794,713,19,9,13,34,1,81
39153077APR,1146,931,850,12,23,17,23,1,81
39153077BCA,1232,1016,892,11,56,14,29,1,124
39153077APQ,937,794,734,2,23,14,19,1,60
39153077ARZ,1465,1229,1077,25,45,41,43,2,152
39153077ASA,1461,1181,1074,16,29,46,7,0,107
39153077AVS,1696,1368,1256,15,30,34,14,1,112
39153077AVO,1441,1167,1093,8,19,17,26,1,74
39153077ASP,1231,1044,985,10,17,14,1,0,59
39153077ASK,1165,963,889,10,30,5,8,0,74
39153077AJH,1312,1063,960,18,31,24,18,0,103
39153077ANS,1074,877,817,10,23,15,2,0,60
39153077ANP,966,769,698,5,39,15,5,0,71
39153077ASD,1398,1108,899,29,116,32,13,2,209
39153077AEN,1223,1024,918,8,65,19,3,1,106
39153077AZG,1359,832,265,29,508,24,10,0,567
39153077AIF,1662,1350,1088,29,142,52,25,1,262
39153077AYJ,1291,1109,591,29,452,22,19,0,518
39153077AAA,1093,885,496,21,343,17,14,0,389
39153077ABY,1167,968,174,12,744,22,12,3,794
39153077AAF,1129,968,588,26,314,19,20,0,380
39051026AAW,1515,1139,1071,43,6,12,1,3,68
39051026AAX,1117,917,859,21,6,26,2,1,58
39051026ABD,2088,1561,1395,69,53,22,9,0,166
39051026AAN,1354,1009,910,76,6,13,8,0,99
39051026AAP,1231,946,861,66,8,9,3,1,85
39051026AAO,1810,1450,1173,236,12,16,9,0,277
39051026ABC,1613,1277,1224,23,10,12,1,1,53
39051026AAM,1534,1191,1085,58,6,32,3,1,106
39153077ABX,1487,976,355,40,537,28,28,5,621
39153077ACG,1447,958,95,26,812,16,8,7,863
39153077AYS,1065,773,162,51,526,29,33,1,611
39023012AFO,1222,942,885,9,14,14,5,0,57
39169085AAL,1905,1486,1380,23,6,34,24,1,106
39169085ACS,1589,1250,1195,15,11,11,4,0,55
39169085AAU,1823,1422,1198,54,91,19,47,4,224
39169085ADH,4542,2682,2643,19,6,13,3,2,39
39169085AAG,1186,934,812,52,40,15,14,2,122
39037019ABR,988,710,675,7,2,20,2,1,35
39049025AKE,2347,1623,311,233,1054,35,18,0,1312
39049025BBU,1345,975,485,56,392,25,29,0,490
39049025BLV,1244,902,123,64,695,15,9,1,779
39049025BBC,1037,857,799,4,23,29,12,0,58
39049025BJA,1606,1176,952,35,115,36,45,0,224
39049025ANG,979,838,767,7,15,1,32,2,71
39049025AEJ,1341,1250,1071,51,93,25,19,1,179
39049025AMX,2002,1859,1220,59,162,23,408,1,639
39049025ANV,1552,1296,1030,62,89,26,86,1,266
39049025AGC,1939,1480,740,129,523,52,36,5,740
39049025AAO,1933,1561,1153,57,312,40,18,0,408
39049025AGE,1622,1306,1140,36,63,52,11,0,166
39017009AIT,2104,1697,1381,53,116,21,123,5,316
39017009AIS,1080,898,765,19,44,11,56,0,133
39173087ACA,1627,1319,1182,79,8,32,13,1,137
39085043AGM,1132,931,818,32,31,28,20,0,113
39085043AFT,692,546,516,7,5,2,11,0,30
39085043AFW,1645,1314,1242,10,6,32,7,0,72
39085043AFV,1483,1255,1213,5,11,18,5,0,42
39085043AGY,394,331,298,15,8,10,0,0,33
39149075ABV,1788,1348,1317,8,6,5,11,4,31
39149075ABX,1590,1134,1116,8,2,7,3,0,18
39133067AFC,1258,999,764,26,175,28,5,0,235
39133067AFB,1274,1054,1005,15,17,11,0,0,49
39133067AFS,1432,1168,1085,16,14,28,4,1,83
39133067AFT,1181,976,882,13,46,17,7,1,94
39133067ABV,1090,821,680,13,81,34,6,2,141
39085043AFR,1489,1318,1274,6,8,4,24,0,44
39085043AFJ,1585,1230,1177,23,7,6,6,0,53
39085043ACP,2429,1950,1266,335,282,69,13,1,684
39085043AAF,1204,987,874,21,55,13,10,0,113
39049025BAA,921,720,564,54,39,24,19,0,156
39049025BAC,1039,880,740,33,37,17,36,1,140
39049025AZO,1161,913,853,16,20,10,3,2,60
39049025BKQ,950,780,714,19,12,21,5,0,66
39065033AAV,2029,1495,1422,23,26,21,3,1,73
39007004ABR,695,529,484,18,9,8,7,1,45
39007004ADO,643,521,495,8,4,15,1,1,26
39065033ABL,593,436,428,3,3,1,1,0,8
39065033ABD,591,448,439,0,3,4,0,1,9
39029015ADS,1166,973,952,3,4,11,0,0,21
39029015ADR,1022,828,790,3,3,18,5,1,38
39029015AFD,1259,968,930,11,5,16,3,0,38
39029015ADJ,741,604,562,12,9,17,2,0,42
39099050AQL,1064,848,648,33,137,12,5,0,200
39099050AGJ,1302,1079,902,57,93,23,6,0,177
39099050AAJ,966,760,422,176,153,19,7,0,338
39099050AAI,755,605,420,102,88,7,1,0,185
39029015AEY,796,653,627,3,4,8,0,0,26
39099050AQJ,1848,1334,497,171,665,11,5,3,837
39099050ASQ,639,503,439,30,20,14,3,0,64
39099050AHM,719,614,558,5,30,2,7,0,56
39017009AEE,1252,1018,902,35,51,24,8,2,116
39017009AID,1525,1224,1148,21,3,34,4,0,76
39017009AIC,526,418,376,11,13,9,2,0,42
39017009AIB,1453,1187,1123,11,15,25,2,0,64
39017009ACX,3458,2718,1459,696,461,92,30,34,1259
39017009ACY,1877,1355,966,214,98,55,21,15,389
39017009ACM,621,513,461,15,19,2,13,0,52
39017009ACK,1633,1165,885,19,218,34,3,3,280
39017009ALB,1324,1022,762,16,113,17,112,1,260
39017009ALA,1235,899,728,29,61,23,47,2,171
39017009AKX,1250,938,833,9,44,9,34,0,105
39017009ALS,1693,1095,603,222,173,39,78,0,492
39017009ALJ,2105,1616,1236,74,150,29,135,1,380
39017009ALT,1533,1179,985,30,63,21,67,0,194
39017009AJC,1554,1173,946,29,36,29,125,4,227
39017009AJB,1466,1119,916,32,41,9,111,3,203
39149075ABO,973,729,715,3,2,3,4,1,14
39149075ABQ,1441,1034,987,12,4,17,7,0,47
39149075ACD,1163,905,867,16,7,6,4,2,38
39133067AAG,1059,771,725,18,5,7,17,1,46
39133067AAH,2071,1486,1317,27,51,12,81,0,169
39099050ACM,1200,927,95,274,577,25,1,1,832
39099050ACK,1226,904,129,428,378,19,4,0,775
39099050APW,818,785,767,0,9,3,0,1,18
39099050APX,913,729,686,11,2,20,3,0,43
39099050ARZ,1142,901,161,58,663,21,15,0,740
39099050ALQ,1336,992,766,57,140,17,17,0,226
39029015ACP,903,693,669,2,3,12,1,0,24
39029015ADU,1171,909,872,4,5,22,1,2,37
39029015ADW,1709,1372,1307,12,1,27,6,0,65
39029015ABC,991,805,760,6,7,9,10,0,45
39029015ABN,1769,1445,1338,41,23,39,5,0,107
39029015ADN,921,783,754,7,5,13,3,1,29
39049025BHH,2345,1752,1240,126,204,28,150,0,512
39049025BGN,1396,1148,806,118,120,31,76,2,342
39049025BLU,1064,778,615,28,62,11,63,0,163
39049025AUB,1758,1240,1045,29,44,8,110,2,195
39049025BGO,2348,1623,958,195,317,40,122,10,665
39049025ADL,1966,1441,403,112,885,47,21,2,1038
39087044ABL,1017,798,686,7,86,18,0,1,112
39087044ABN,1141,905,782,24,70,21,6,2,123
39087044ABF,1073,861,805,12,15,20,2,0,56
39087044ABZ,1427,1040,965,2,49,20,3,1,75
39087044ABY,1436,1050,987,6,32,20,1,1,63
39087044ABW,802,617,615,1,0,0,1,0,2
39087044ABQ,912,701,689,1,2,9,0,0,12
39113057ACD,2163,1487,742,59,571,35,75,1,745
39113057ACB,1840,1369,1045,114,129,36,40,5,324
39113057AYE,2266,1898,1323,55,161,43,320,0,575
39113057AOO,1402,1170,1086,17,31,12,18,0,84
39113057AWH,1725,1231,1027,39,62,27,68,1,204
39113057AWI,2492,1733,1454,55,78,61,81,4,279
39113057ARX,1829,1449,1267,26,104,19,26,2,182
39113057AJD,1805,1456,1074,59,192,14,112,4,382
39113057ASV,1038,823,648,25,98,16,38,2,175
39113057AJA,1207,982,773,22,147,22,24,4,209
39113057ACA,1628,1317,1040,116,100,39,12,2,277
39113057AUB,2324,1550,947,32,529,36,8,3,603
39113057AQM,1369,1113,84,8,1024,11,5,0,1029
39113057AKK,2407,1850,1511,52,183,20,70,5,339
39113057AKM,2264,1739,1312,44,254,30,84,0,427
39113057AYH,1808,1418,950,38,72,33,331,4,468
39113057AAQ,1602,1332,1053,22,41,20,187,0,279
39073037AAG,2127,1655,1554,17,32,32,7,0,101
39073037AAJ,1594,1227,1158,10,24,22,3,0,69
39025013AFA,1116,873,782,42,16,26,7,1,91
39025013AGN,1270,1001,886,27,42,30,12,0,115
39025013AAK,2264,1441,1231,40,84,33,38,3,210
39007004ADN,816,665,630,5,5,17,1,0,35
39155078AAM,1042,832,673,16,113,27,3,0,159
39155078AAL,1265,964,870,18,46,15,4,0,94
39015008ACF,1293,956,913,10,6,17,4,0,43
39071036ABI,1007,776,753,3,1,16,1,0,23
39071036AAV,1510,1122,1056,12,12,37,2,0,66
39147074AAL,1272,952,750,82,96,17,12,1,202
39165083ABH,1461,1098,842,58,61,22,91,10,256
39165083ADO,1120,881,839,10,6,22,2,1,42
39165083ADS,1273,1016,953,20,5,23,5,0,63
39165083AGI,1634,1165,1027,46,22,13,40,1,138
39165083AHA,1808,1217,1070,37,36,10,49,3,147
39165083AEF,1334,1047,1005,9,7,15,5,1,42
39165083AGT,1447,1050,952,29,24,9,34,1,98
39155078AJO,1409,1211,1104,20,35,20,24,2,107
39155078AJQ,1148,935,887,15,5,18,5,2,48
39155078AGG,1219,1038,991,8,0,18,1,1,47
39161081ABB,694,552,509,24,3,11,6,2,43
39161081AAK,774,601,535,31,13,13,10,1,66
39137069AAB,1224,904,855,36,1,3,1,3,49
39161081AAD,536,401,375,11,5,9,3,0,26
39161081AAA,515,387,352,22,3,7,0,2,35
39071036ABG,2076,1587,1518,10,17,30,0,1,69
39071036AAB,2125,1606,1483,3,76,33,7,1,123
39007004AAN,687,411,213,94,71,21,5,0,198
39007004AAR,699,545,386,63,77,23,3,1,159
39007004AAQ,985,684,328,124,207,22,10,3,356
39007004ABS,1413,1098,947,85,19,34,10,0,151
39007004ACP,1091,914,845,28,13,17,13,3,69
39157079ABW,1109,756,741,11,0,1,1,0,15
39111056AAQ,1038,780,766,1,1,3,6,4,14
39065033AAP,1490,989,941,12,5,28,3,1,48
39065033AAS,1537,1108,1054,11,6,19,13,1,54
39161081AAM,528,392,355,21,9,6,5,0,37
39049025AHK,1331,950,143,24,772,12,8,0,807
39049025AYB,971,707,658,11,12,4,19,0,49
39049025AAT,1320,1261,1123,58,39,12,31,0,138
39049025AUF,1914,1353,1133,16,36,20,119,1,220
39049025BAL,1272,921,786,52,21,22,32,3,135
39049025BKO,1417,1186,1000,36,82,16,49,1,186
39049025ATR,910,694,624,21,17,14,5,1,70
39049025AUE,2231,1828,1456,105,115,34,103,2,372
39049025AYF,974,764,653,16,50,17,26,2,111
39049025AXY,1217,894,834,14,14,9,20,1,60
39049025AGI,2203,1756,1150,146,352,67,48,1,606
39049025BAK,1237,909,409,124,347,17,13,1,500
39049025BMS,1058,857,429,33,305,15,82,2,428
39049025AUM,1292,974,500,24,343,8,97,0,474
39049025AYU,2090,1505,645,241,560,47,30,1,860
39049025AEW,1997,1440,534,138,726,46,16,0,906
39049025ALY,1618,1131,137,98,803,14,92,0,994
39049025AEY,2378,1814,728,129,895,40,30,3,1086
39143072ACV,1333,1060,996,40,3,14,4,2,64
39143072AAT,998,744,540,121,76,15,0,0,204
39143072AAC,1399,1066,961,37,11,27,20,2,105
39143072ADK,1460,1153,1085,30,1,21,4,2,68
39157079AEG,1194,958,914,6,5,23,4,0,44
39157079ADI,1264,950,879,17,16,29,1,2,71
39157079ABE,1273,976,807,107,21,59,12,0,169
39113057ACO,808,637,326,10,278,14,12,1,311
39113057ARE,1757,1279,228,17,1016,16,6,2,1051
39113057ADQ,1601,1262,915,67,168,32,90,10,347
39113057ABC,6495,6400,5485,258,389,92,247,19,915
39113057ADP,2434,2156,1270,92,411,53,344,4,886
39113057AYZ,1812,1360,795,210,317,20,14,2,565
39113057APL,2553,2065,1514,97,297,86,76,11,551
39113057AWT,992,834,784,7,15,12,17,3,50
39113057AAE,988,750,651,27,45,12,14,2,99
39113057AOF,1717,1316,1199,26,39,33,29,1,117
39113057AMB,1328,1130,965,21,96,27,21,0,165
39113057ABD,1755,1694,1175,66,325,31,98,2,519
39113057ABE,1365,1260,619,49,566,7,27,1,641
39113057ABU,1219,924,637,99,150,22,7,1,287
39113057AQZ,1688,1221,755,22,419,38,7,0,466
39113057AFZ,1082,797,52,23,723,9,7,1,745
39113057AID,1455,1129,166,8,940,22,9,1,963
39085043ACV,1881,1366,851,206,272,26,18,0,515
39149075ABU,1459,1044,1006,7,3,15,2,2,38
39133067ADU,1386,1134,1060,19,7,29,8,2,74
39133067AET,761,611,583,1,2,9,3,3,28
39133ZZZZZZ,12,11,8,0,1,0,0,1,3
39133067AEQ,736,589,557,4,2,17,2,0,32
39133067AEW,1480,1182,1121,11,5,22,3,0,61
39085043AGO,1156,1014,924,24,21,12,22,1,90
39085043AHZ,1400,1153,1044,25,42,13,18,0,109
39085043AGZ,1469,1155,1081,19,22,16,4,1,74
39085043AHD,1602,1232,1137,29,21,26,20,0,95
39049025ABW,1293,1219,1071,37,39,7,51,1,148
39085043AGD,1473,1155,1043,34,16,29,10,0,112
39085043AHK,1520,1297,1195,34,13,18,33,0,102
39085043AAY,1487,1260,1140,44,37,13,17,1,120
39149075ACN,1899,1429,1366,8,13,22,4,2,63
39149075AAQ,2640,2034,1762,58,93,34,64,12,272
39133067AEF,1137,904,858,11,6,9,0,0,46
39133067ACB,1018,833,778,14,25,14,3,0,55
39085043ABX,1295,1034,963,6,14,12,28,1,71
39085043ABK,933,752,704,21,4,13,3,0,48
39143072ADE,1297,1009,929,53,3,9,2,0,80
39143072ADG,1208,936,845,56,4,13,6,0,91
39143072AAG,1327,999,896,60,17,23,3,1,103
39143072AAL,1429,1111,1015,64,9,17,5,2,96
39143072AAU,1014,780,548,129,80,11,4,1,232
39173087ADZ,1942,1499,1286,104,29,38,25,1,213
39173087ADE,1446,1169,956,66,57,51,34,1,213
39173087ADG,1192,908,770,40,15,6,69,0,138
39173087AEI,1632,1247,1034,52,35,21,102,1,213
39173087ADA,1324,1113,972,51,24,25,24,0,141
39173087ABE,1875,1401,1092,65,84,23,126,0,309
39173087ABG,1167,846,782,26,10,12,20,0,64
39173087ABF,1332,943,821,35,23,11,43,1,122
39173087AAC,3367,3340,2674,140,406,48,83,4,666
39173087AED,1549,1537,1188,71,232,16,31,3,349
39173087AAA,1914,1742,1364,123,144,45,64,2,378
39173087ACY,1192,945,855,34,28,20,7,2,90
39173087ACZ,376,295,278,14,4,5,1,1,17
39173087ABD,1087,805,731,33,6,6,24,2,74
39173087ABB,1321,1153,1000,53,48,14,25,1,153
39017009AGL,2632,1797,1094,367,185,43,127,1,703
39143072ABN,1197,942,865,43,13,16,4,1,77
39157079ACG,924,752,712,10,4,9,11,0,40
39157079ABM,1602,1239,1168,25,9,19,12,0,71
39157079ABH,1040,842,800,8,4,19,1,1,42
39157079ACU,1231,1024,980,10,9,16,5,1,44
39157079AEP,1329,1068,1035,7,4,13,1,0,33
39157079AAJ,1214,886,709,140,20,60,1,1,177
39087044AAY,442,346,331,0,9,6,0,0,15
39087044AAZ,608,470,460,2,0,3,0,0,10
39149075ACF,913,718,695,6,8,5,2,3,23
39133067AFZ,1103,917,878,8,3,12,6,5,39
39133067AFY,1117,921,892,4,5,9,0,0,29
39133067AEJ,1001,836,791,15,1,17,3,0,45
39151076ABL,2005,1433,1048,57,281,41,5,0,385
39151076ABP,966,722,317,25,365,27,2,0,405
39151076AFN,1125,935,908,3,6,10,6,0,27
39151076AGN,1658,1293,1132,13,33,24,86,1,161
39151076AAG,1042,774,560,25,162,17,4,2,214
39151076AAK,3217,2789,2256,64,357,69,41,10,533
39093047ABY,2066,1703,1127,140,318,72,27,1,576
39093047ABZ,1835,1422,659,107,611,37,18,2,763
39109055ABR,1414,1098,1019,21,13,25,8,2,79
39093047AJV,1779,1474,1346,45,18,46,13,8,128
39093047AJB,1948,1573,1448,36,8,34,23,0,125
39099050AQY,1523,1257,1052,61,127,6,4,0,205
39099050AAS,768,663,620,16,6,6,16,0,43
39099050AMT,1037,835,772,13,8,15,10,1,63
39099050AAW,1128,946,880,23,14,13,13,0,66
39099050AAX,862,690,656,6,4,1,20,0,34
39099050ADW,1098,801,471,72,235,23,7,2,330
39173087AAP,1710,1299,1084,64,86,16,41,3,215
39173087ADP,1517,1163,1060,46,13,28,9,0,103
39173087ACN,992,759,711,21,4,16,1,0,48
39173087AAI,1864,1691,1298,120,172,37,76,2,393
39173087AAH,2249,2068,1585,204,170,31,56,0,483
39173087ABZ,702,499,433,45,1,18,3,2,66
39017009AFD,3375,3357,2722,118,199,8,301,3,635
39017009AHQ,1239,971,901,8,21,14,16,0,70
39017009AFC,850,683,558,13,42,18,44,1,125
39017009AEZ,1550,1471,1256,63,55,11,82,0,215
39017009AEW,2106,1949,1303,63,153,28,398,0,646
39017009AFB,1699,1335,1031,56,70,35,137,0,304
39017009AFE,2788,2774,2287,104,199,10,177,0,487
39017009AEF,1461,1069,857,53,119,36,8,0,212
39017009ADN,1970,1527,1207,94,178,44,8,1,320
39017009ADO,969,724,638,13,39,10,12,0,86
39017009ADP,1526,1212,815,114,226,37,15,3,397
39049025BLY,1822,1241,533,48,389,27,235,0,708
39049025BFU,2040,1457,1011,42,291,21,100,3,446
39049025AJV,1487,1235,703,52,413,18,63,0,532
39049025BKE,1219,790,459,28,205,11,68,2,331
39049025BKC,1238,835,434,15,178,13,200,0,401
39049025AMF,1587,1128,679,119,280,63,16,4,449
39085043AAS,1812,1433,1326,21,25,21,26,2,107
39085043AGC,1846,1439,1296,73,3,42,10,0,143
39085043AGF,1447,1188,1101,24,24,26,7,2,87
39131066AAF,628,491,455,3,8,19,0,1,36
39175088ABC,741,564,539,13,2,6,1,0,25
39155078ADN,1029,777,358,22,394,16,5,0,419
39155078AEE,1238,918,280,37,562,38,1,5,638
39155078AIW,3404,2042,1984,8,41,9,3,1,58
39155078AAE,1206,1015,896,20,57,20,15,0,119
39147074ACM,1118,874,834,6,4,23,2,0,40
39021011ABB,1195,924,862,10,9,36,1,3,62
39157079AAQ,1304,992,763,159,22,93,21,0,229
39157079AAS,1094,922,805,57,28,34,4,1,117
39157079AAF,1386,1123,1066,11,11,16,11,1,57
39157079ACE,1056,869,839,11,6,5,1,1,30
39157079AAE,954,728,687,16,9,8,7,0,41
39157079ADG,1995,1506,1460,8,5,15,2,0,46
39157079ABQ,1384,1052,967,18,21,28,7,0,85
39157079ADJ,1445,1075,991,20,27,23,1,1,84
39157079ABU,1258,966,909,13,14,21,4,0,57
39157079ABS,1608,1185,1109,8,30,30,3,1,76
39157079ABO,1022,755,709,5,14,15,6,1,46
39157079AEC,2091,1439,1406,8,6,4,6,2,33
39157079AEE,872,662,642,12,4,2,2,0,20
39151076AGP,1404,1161,1048,26,15,30,44,1,113
39151076AJK,1251,1006,952,9,2,21,8,1,54
39151076AAA,1245,915,693,20,161,19,14,0,222
39151076AJD,999,826,792,7,13,11,0,0,34
39151076ANY,1817,1436,1329,12,6,43,19,1,107
39151076AEO,1869,1426,1347,20,29,25,1,0,79
39151076ANX,1066,857,832,5,9,6,3,0,25
39151076AEQ,1338,1082,988,31,34,22,1,0,94
39151076AJY,1474,1155,1063,15,44,29,1,0,92
39151076ADW,866,704,608,20,56,16,4,0,96
39151076AAY,1051,773,482,42,212,25,4,0,291
39151076ACP,1520,1377,1099,85,145,13,36,1,278
39151076ACM,1184,942,658,28,208,21,20,0,284
39151076ADE,1377,981,534,43,359,57,4,0,447
39151076ADT,1122,998,867,19,72,16,23,2,131
39151076ADZ,1167,1027,926,13,58,16,6,1,101
39087044AAL,411,293,230,0,55,5,0,0,63
39087044AAJ,531,403,322,2,66,9,1,0,81
39155078AHS,816,692,656,5,0,19,5,0,36
39155078ADH,1489,1299,1117,33,124,13,17,2,182
39155078ACW,1557,1020,567,21,378,34,6,0,453
39155078AAW,958,786,724,23,20,10,7,1,62
39155078AAX,827,706,640,3,45,9,1,2,66
39155078AHM,1401,1166,1109,21,9,13,4,0,57
39155078AEC,1630,1046,310,44,688,10,1,0,736
39147074AAC,1314,1001,775,116,88,26,3,0,226
39147074AAA,1661,1272,1003,151,96,24,9,2,269
39147074ACB,1401,1096,1007,50,16,18,10,0,89
39147074AAZ,883,715,636,19,16,19,19,0,79
39147074ABY,1169,915,881,14,7,8,7,1,34
39147074AAI,1843,1355,1064,119,128,36,5,2,291
39147074ABQ,714,570,546,5,3,10,2,0,24
39147074AAX,1218,923,834,30,22,23,11,1,89
39165083ACX,1112,892,824,17,21,16,12,0,68
39165083ACY,1399,1084,799,75,151,15,47,3,285
39165083ACW,1222,989,845,29,65,36,13,2,144
39165083AAF,1210,921,866,7,6,21,16,0,55
39165083AAE,1161,898,844,12,16,23,3,3,54
39165083ACM,1106,936,873,17,10,30,11,0,63
39165083AAB,1003,787,726,16,14,10,18,3,61
39155078AKS,1164,905,863,14,6,7,9,0,42
39155078AKW,1040,858,808,13,14,10,3,0,50
39155078ABK,1048,879,833,5,23,10,8,1,46
39155078ABS,1561,1224,1081,40,62,32,13,1,143
39157079AEJ,819,678,650,4,11,7,0,0,28
39157079AEM,1014,780,768,2,0,10,1,0,12
39157079ABZ,737,567,546,3,2,11,2,0,21
39157079ACA,1240,953,909,10,7,15,3,1,44
39157079ACP,673,483,457,13,9,5,0,0,26
39049025AZK,2353,1766,1250,117,316,50,52,4,516
39049025AZL,1248,902,733,38,93,40,12,0,169
39049025BBX,1614,1222,643,63,435,41,45,6,579
39133067AER,1003,802,765,8,5,8,7,0,37
39133067AGI,1050,778,677,14,42,24,6,0,101
39133067ADE,796,658,580,15,22,25,7,0,78
39073037ABE,427,334,327,0,1,4,1,0,7
39151076ANO,1794,1397,1286,9,29,42,10,0,111
39143072ABY,736,600,532,53,1,12,3,0,68
39049025BID,1819,1358,232,80,866,20,171,1,1126
39049025BNR,1250,856,86,35,551,7,190,0,770
39049025AQZ,918,646,520,22,32,14,48,2,126
39049025AOL,1082,813,629,35,36,13,94,1,184
39049025BLE,1875,1369,1109,37,47,18,155,0,260
39049025BJZ,1339,1048,841,34,32,15,117,1,207
39049025ANB,1902,1364,897,177,199,39,73,2,467
39049025BLG,1174,931,843,13,15,2,58,0,88
39049025BGK,2402,1712,516,65,1051,30,76,7,1196
39049025BAD,1420,1129,827,61,193,33,29,0,302
39157079ADZ,1308,1009,955,13,2,26,2,1,54
39157079ADY,652,489,446,3,1,25,6,0,43
39157079ADP,1062,816,752,15,30,8,0,0,64
39049025ABC,1141,914,489,29,356,27,22,4,425
39049025ABB,1236,939,403,39,474,22,14,3,536
39153077AJO,1133,962,902,10,26,11,13,0,60
39153077AJM,1578,1288,989,8,243,27,8,1,299
39153077AOR,1421,1200,1040,46,33,26,50,1,160
39049025BHA,1403,968,724,73,68,18,91,0,244
39049025AHB,1182,1147,971,35,53,11,56,7,176
39049025ASX,1683,1485,1276,52,47,13,94,2,209
39049025ASY,1778,1540,1347,51,47,11,74,0,193
39049025ALX,1332,847,97,25,709,11,14,1,750
39049025BET,1384,1050,220,44,753,18,28,4,830
39049025BIE,1825,1402,162,26,1182,17,19,0,1240
39049025AFG,1715,1207,80,44,1080,12,9,0,1127
39049025APY,1894,1587,1067,64,155,15,289,3,520
39049025AEE,1696,1358,1231,34,35,19,34,0,127
39049025ALV,1130,1001,649,48,271,11,17,5,352
39049025API,1331,948,156,50,734,17,21,1,792
39049025APJ,1494,1218,234,60,868,34,24,4,984
39049025APH,1579,1166,347,150,643,29,33,2,819
39049025BIO,2350,1739,983,123,573,37,40,1,756
39049025BLX,1387,1068,394,55,594,20,16,1,674
39049025BFW,1156,800,633,15,40,6,100,0,167
39049025BIR,2481,1905,968,62,812,16,59,1,937
39049025BIS,1798,1197,519,62,572,22,35,1,678
39049025BAF,670,542,478,14,40,17,5,0,64
39049025AZX,431,345,298,12,24,5,6,0,47
39049025BGY,2016,1449,1117,124,110,15,92,1,332
39049025BGX,2501,1802,984,298,307,37,161,0,818
39049025AYA,1108,822,744,13,19,11,30,2,78
39049025AKA,1681,1156,329,199,596,21,30,3,827
39049025AXI,1986,1479,771,187,443,56,25,0,708
39133067AGP,1041,788,759,1,1,26,1,0,29
39085043ADF,1200,982,904,25,40,18,3,0,78
39085043ADK,1702,1398,1169,11,175,30,19,0,229
39085043ACL,3073,2151,963,881,259,84,12,2,1188
39085043AFN,1192,1062,963,7,30,20,34,0,99
39085043AFM,1271,993,925,22,19,2,15,0,68
39085043AGS,1087,881,768,40,27,32,14,0,113
39133067AAP,973,780,703,9,37,13,10,0,77
39051026AAC,938,702,666,23,4,9,1,0,36
39153077BCY,1425,1156,1071,8,23,39,11,0,85
39153077ADQ,1810,1196,256,160,624,32,125,0,940
39153077ADS,1506,1133,295,99,563,48,148,1,838
39153077AZX,1700,1264,741,42,399,59,37,3,523
39153077AII,1315,992,458,42,441,40,31,1,534
39153077AAN,1122,978,852,23,79,8,13,1,126
39153077AZR,1349,1055,784,28,172,30,51,0,271
39153077AYK,2859,2782,1932,95,457,13,274,4,850
39153077AZH,932,770,421,31,234,23,72,0,349
39153077AAC,864,846,527,29,248,26,27,3,319
39153077AJA,1414,1150,1044,16,45,23,5,4,106
39153077BAB,1495,1193,1069,22,49,33,8,2,124
39153077BAD,1413,1073,938,17,52,55,14,3,135
39153077AJD,1485,1144,1004,38,56,32,10,1,140
39153077AHS,1677,1280,1058,6,163,49,8,1,222
39153077ALW,1163,948,798,14,21,11,103,0,150
39153077BAN,1154,926,833,19,14,14,41,4,93
39153077BAO,1175,937,828,18,21,26,36,0,109
39153077BCN,1480,1106,942,17,62,24,57,1,164
39153077ASE,1408,1104,1032,9,34,9,3,2,72
39153077ANO,911,726,701,0,4,11,4,0,25
39153077BBP,1010,820,776,6,8,13,9,1,44
39153077AOA,1050,810,753,12,18,17,4,0,57
39051026AAL,695,516,480,27,0,6,4,1,36
39051026AAU,1733,1347,1258,33,5,30,5,0,89
39113057AOU,2157,1754,1106,65,445,37,96,2,648
39113057AOP,1283,1000,826,43,49,39,41,2,174
39113057ARO,2086,1604,1362,26,129,55,29,2,242
39113057ARQ,1817,1495,1334,19,73,43,17,9,161
39113057ADD,579,465,16,5,435,7,1,0,449
39113057ADA,1070,788,45,2,729,10,2,2,743
39113057ABH,780,655,481,41,90,20,19,0,174
39113057AKY,1876,1478,1250,51,87,23,52,7,228
39113057ASW,1445,1161,1048,23,23,20,33,2,113
39113057AAR,1333,1113,904,45,44,13,92,0,209
39113057ATK,1767,1388,1311,9,20,23,20,2,77
39113057ASE,2269,1787,1551,74,104,49,14,2,236
39113057ASG,1160,900,820,23,21,32,12,0,80
39113057AIT,1074,825,617,13,137,19,33,4,208
39113057ABY,1406,1034,750,119,98,23,32,3,284
39113057ADS,2006,1469,1070,148,166,45,40,0,399
39113057AIF,1559,1131,69,26,1031,24,4,2,1062
39113057AHX,1749,1211,88,19,1106,15,2,1,1123
39111056ABC,336,254,248,0,2,3,0,0,6
39173087ADJ,2076,1780,1340,114,134,28,161,3,440
39085043AEN,1861,1575,1078,20,406,18,49,1,497
39085043AEO,1717,1417,551,15,780,19,47,1,866
39047024ABC,774,628,582,13,9,9,4,3,46
39149075ABK,1627,1246,1201,9,5,16,8,1,45
39133067ACI,1597,1223,862,38,206,31,72,4,361
39133067AGQ,1171,996,770,20,142,5,49,3,226
39049025BBB,1320,1061,997,15,10,23,7,1,64
39049025ADJ,1728,1637,1234,125,166,19,110,1,403
39049025ACT,2454,1996,1269,127,480,30,98,1,727
39049025BHI,1689,1175,720,105,225,34,109,2,455
39049025BBE,1476,1147,996,45,19,43,20,3,151
39049025AXT,1859,1329,392,53,832,37,30,1,937
39049025AXR,1778,1359,436,138,764,25,17,6,923
39049025AHH,1125,825,256,82,459,16,20,1,569
39049025AXS,2549,1876,815,216,768,40,44,4,1061
39049025AXP,1441,1115,469,134,452,27,34,6,646
39049025ALQ,1669,1201,340,100,626,26,122,2,861
39049025ALF,1057,848,555,49,182,22,33,0,293
39049025AXA,1256,906,788,13,49,14,34,0,118
39049025AQM,1044,809,693,7,23,11,62,1,116
39049025AKN,2055,1671,1399,64,114,49,33,1,272
39049025AGF,1613,1320,1172,40,60,31,6,3,148
39049025ASV,1114,889,809,10,20,9,25,2,80
39049025AAU,1162,1084,924,39,77,22,20,0,160
39049025AFQ,1410,1081,215,103,742,36,13,0,866
39049025BAW,1572,1183,1055,23,35,26,27,1,128
39049025BFX,1799,1198,894,41,89,11,155,1,304
39049025BLP,1231,742,503,25,54,6,149,2,239
39049025BJV,1656,1213,1025,35,53,12,76,1,188
39049025BJB,1232,962,784,32,81,16,27,6,178
39049025ATG,1089,872,816,11,12,21,6,0,56
39049025ATO,1783,1511,1229,97,101,26,47,0,282
39049025BCV,2319,1644,1108,76,404,29,33,2,536
39049025BDU,1403,1098,938,37,50,30,49,0,160
39049025ADG,1640,1540,1147,86,203,10,91,3,393
39049025AXF,940,734,661,14,30,5,22,0,73
39049025AWW,1538,1221,879,43,227,22,48,4,342
39049025ABI,1375,1002,99,236,663,32,8,0,903
39049025ABS,1679,925,171,36,718,6,20,1,754
39049025BHX,1894,1584,1254,62,165,20,82,1,330
39049025BKK,1546,1382,1070,50,198,22,38,0,312
39049025BHY,2184,1949,1497,53,267,26,103,1,452
39049025BKL,1739,1564,1199,75,155,48,90,0,365
39049025BIL,1647,1276,886,66,287,27,36,3,390
39049025AUH,1516,1155,662,28,406,29,35,0,493
39049025AWL,787,610,554,18,18,12,7,0,56
39049025BHN,853,639,450,45,84,19,47,1,189
39049025AMA,1626,1123,91,156,861,17,16,3,1032
39049025AQB,2737,2176,1147,112,330,48,541,0,1029
39049025BAE,2027,1471,829,68,483,40,54,2,642
39049025BAI,1542,1161,731,68,308,40,23,5,430
39049025AUR,1865,1398,933,149,222,20,80,2,465
39049025AUO,740,534,343,30,92,9,61,1,191
39111056AAE,1236,1011,981,2,2,15,5,1,30
39047024AAY,833,646,618,3,13,13,0,1,28
39047024AAZ,1258,937,803,30,62,39,7,8,134
39047024AAU,704,554,533,5,8,8,1,3,21
39047024AAE,938,715,632,23,37,19,3,2,83
39017009ADV,1394,978,400,113,445,36,1,0,578
39017009ADU,1448,1063,882,62,102,16,2,1,181
39017009ALP,2118,1532,1038,73,262,29,115,7,494
39017009AFY,1495,1137,897,34,101,33,71,1,240
39017009ALI,782,672,548,16,89,4,12,1,124
39017009AKK,3650,2473,1976,86,234,52,128,0,497
39017009AKL,1282,902,802,12,37,19,18,0,100
39017009AIV,1402,1099,779,61,169,12,66,0,320
39017009AIK,1319,947,751,8,63,19,103,0,196
39017009ALU,1173,933,778,34,45,19,53,1,155
39017009AGT,1562,1053,895,23,28,18,87,0,158
39017009ACT,2758,1973,915,563,440,87,14,19,1058
39017009ACU,2329,1815,1269,240,222,58,31,4,546
39017009ADH,1400,1060,845,54,111,36,8,2,215
39017009AHA,1673,1323,1279,7,12,8,6,0,44
39017009AGZ,2387,1748,1600,69,21,43,13,0,148
39017009AJG,1228,952,732,37,111,11,58,1,220
39017009AIW,1412,1034,834,36,75,16,75,0,200
39017009AJH,1135,872,675,31,68,19,88,0,197
39133067ACY,1474,1199,1074,27,43,26,14,2,125
39133067ACT,1996,1650,1363,50,105,26,82,1,287
39133067AEA,1152,968,930,6,4,12,4,0,38
39049025AJT,1930,1282,607,53,339,24,274,0,675
39049025BCU,1349,865,300,15,515,19,23,0,565
39049025BMN,1549,1030,428,54,354,14,188,2,602
39049025AEX,1681,1326,823,85,341,52,37,1,503
39061031AVD,1264,1047,898,37,75,10,24,1,149
39061031AVF,2228,1786,1353,121,244,43,24,1,433
39061031ADD,1613,1175,177,33,949,18,9,5,998
39061031BLG,1233,922,248,32,623,29,1,0,674
39061031AND,1575,1270,476,25,743,19,11,0,794
39061031ADV,1535,1194,1051,57,28,11,41,0,143
39049025AIR,1394,1087,801,53,166,26,22,1,286
39071036ABQ,1969,1529,1469,10,15,26,2,1,60
39173087ADT,1230,965,905,24,6,14,8,0,60
39017009ACZ,2114,1631,795,88,616,29,113,4,836
39017009AFQ,1228,963,714,103,77,17,52,0,249
39017009ALH,1195,901,742,21,89,15,35,0,159
39017009AFS,1061,715,420,18,233,10,31,0,295
39017009AIE,2217,1668,1498,41,76,49,6,0,170
39017009ABU,1649,1229,1063,40,81,39,7,3,166
39017009AHB,2142,1675,1588,9,15,40,14,2,87
39017009AJM,1584,1219,875,30,136,25,152,0,344
39017009AJX,1248,991,846,32,37,11,64,0,145
39017009AJN,1318,1006,871,20,51,19,42,2,135
39017009AJV,2964,1719,287,692,705,120,40,1,1432
39017009AJR,1647,1348,1122,45,69,19,74,2,226
39017009AGK,1340,1024,923,39,33,25,10,4,101
39173087ABC,1099,808,739,24,9,18,20,1,69
39173087ADL,1625,1207,1085,68,9,23,14,1,122
39173087AAL,1598,1321,1180,57,24,17,38,0,141
39173087AAQ,1239,775,704,23,19,4,25,1,71
39173087ABW,711,575,541,19,2,10,3,0,34
39173087ABX,1717,1300,1166,66,11,41,4,1,134
39173087ABY,1651,1222,1124,71,7,16,1,0,98
39035018AQF,1239,1155,791,69,116,28,159,1,364
39035018AUF,1744,1651,679,65,395,17,500,0,972
39035018AUJ,2194,2142,938,87,328,13,756,4,1204
39113057AHO,1784,1495,1337,31,55,41,12,1,158
39113057AHP,1681,1425,1258,54,52,25,15,2,167
39113057ACU,597,451,22,7,420,18,5,0,429
39113057AOX,1161,830,727,27,19,20,43,0,103
39113057AKQ,1305,1062,880,28,99,30,16,5,182
39113057AVW,1716,1326,1015,102,135,37,43,0,311
39113057AVV,1561,1192,994,61,62,45,32,0,198
39113057ANE,1461,1082,940,44,65,24,23,3,142
39113057ANB,1386,1083,922,38,67,26,23,2,161
39149075ABS,1191,877,853,4,1,9,1,0,24
39133067AFG,1379,1049,905,14,105,27,3,2,144
39133067AFH,1384,1160,1047,16,26,39,5,0,113
39133067AEB,1244,958,896,12,5,18,3,0,62
39133067ADZ,996,912,652,56,158,8,13,0,260
39133067AFO,1079,908,725,8,27,16,126,0,183
39133067AFR,1330,1044,983,12,21,17,9,0,61
39085043ACF,1169,940,861,23,9,6,35,0,79
39085043ACE,1443,1220,1117,20,28,18,34,1,103
39085043ABA,1113,922,868,22,14,7,6,1,54
39085043AAZ,1377,1096,1010,11,24,17,28,2,86
39085043ABB,1276,1000,934,16,21,9,19,0,66
39157079ADM,1087,862,817,4,9,23,0,0,45
39157079ADO,1218,985,911,16,32,15,7,0,74
39157079ADV,1036,813,779,6,4,18,1,0,34
39035018AWU,1230,998,430,7,540,16,3,2,568
39035018BDX,1220,1008,568,230,188,27,17,2,440
39035018AGQ,1573,1274,1128,44,57,19,21,0,146
39035018ALP,786,633,12,3,607,5,2,0,621
39035018ALJ,823,623,7,9,603,11,0,0,616
39035018CZS,897,662,613,11,13,5,15,1,49
39035018DAB,1232,1016,951,16,22,10,7,0,65
39035018DAA,1262,1003,969,13,3,5,8,0,34
39035018BQH,1275,1002,387,18,577,11,9,0,615
39035018BQF,1258,957,240,15,681,13,17,0,717
39035018BGH,1801,1339,524,466,316,47,51,2,815
39035018BGI,2026,1488,686,334,381,42,52,6,802
39035018BGK,1709,1266,540,374,313,34,54,3,726
39035018DBU,773,610,546,12,18,11,19,2,64
39035018DBW,1333,1042,912,23,55,3,42,1,130
39035018DBV,1356,1044,899,17,57,7,65,2,145
39035018CPY,1496,1307,1204,30,28,10,24,3,103
39035018CPX,1466,1214,1088,39,25,15,46,0,126
39035018AKX,642,512,5,2,502,2,0,0,507
39035018ALS,627,472,5,10,461,8,0,0,467
39035018ATJ,893,691,13,4,678,7,0,1,678
39035018ATL,710,562,10,9,541,4,1,1,552
39035018AAA,1301,1043,967,22,20,7,22,1,76
39035018CCJ,1503,1359,1232,35,24,10,40,4,127
39035018ACR,1696,1355,103,10,1220,16,28,0,1252
39035018ACP,1207,1022,352,204,429,39,18,7,670
39035018CEG,1585,1311,1199,19,27,15,40,0,112
39035018CEE,1227,1024,914,31,22,17,35,1,110
39035018CEF,244,227,204,10,4,0,6,0,23
39035018BUD,1396,1043,541,42,450,19,2,0,502
39035018BUB,1457,1088,523,29,522,25,11,1,565
39035018BLS,1182,1012,380,18,573,10,35,3,632
39035018BMI,1602,1309,142,25,1112,20,19,3,1167
39035018BAO,1172,823,224,423,185,11,14,7,599
39035018BRM,1217,923,869,20,10,14,13,0,54
39113057AOV,1624,1121,1001,20,28,13,49,1,120
39113057ADB,590,447,18,0,424,3,0,0,429
39113057AVR,1521,1203,1084,23,18,49,18,0,119
39113057AFO,1366,1155,332,128,690,13,6,3,823
39113057AXA,1588,1225,764,33,376,35,23,0,461
39113057ACT,1085,922,318,19,565,18,10,1,604
39113057ATF,926,746,697,21,4,15,7,0,49
39043022AEA,1153,904,681,36,179,10,7,0,223
39043022ACS,1272,1017,923,63,12,14,7,0,94
39043022ADW,796,654,613,19,2,13,4,0,41
39043022ACH,1373,1117,1046,22,7,28,1,1,71
39043022ADV,771,624,574,20,1,27,1,0,50
39043022ADU,979,831,779,16,3,17,4,1,52
39043022AAJ,1163,931,888,16,5,18,5,0,43
39043022AAE,1273,1049,962,30,21,21,8,4,87
39055028ABC,999,808,777,7,11,8,4,0,31
39055028ABB,1275,1006,966,13,6,10,5,0,40
39055028AAW,1229,1002,953,9,5,18,16,0,49
39055028AAY,1206,927,885,10,9,11,15,3,42
39055028ACC,658,519,485,8,6,7,7,0,34
39055028ABZ,1249,1002,946,6,8,6,13,0,56
39055028ACX,1092,873,836,7,4,22,2,0,37
39173087ADU,1455,1074,901,98,12,42,7,2,173
39173087ABM,1259,1015,902,54,24,6,10,5,113
39017009ALO,655,526,477,10,9,24,7,0,49
39017009ACB,1305,970,854,28,38,38,6,1,116
39017009ALV,733,556,516,4,22,11,1,0,40
39017009ALM,672,542,527,3,2,5,1,0,15
39017009ABY,1342,1007,895,30,61,13,7,1,112
39017009AFJ,1580,1117,1025,14,34,22,13,3,92
39017009AFI,1625,1199,1102,27,15,15,19,3,97
39017009ACN,1328,1005,433,128,406,25,10,23,572
39017009ACQ,2913,2268,1790,200,173,75,25,10,478
39035018BRX,1188,927,852,28,17,11,7,6,75
39035018AWQ,1155,976,257,36,674,7,2,1,719
39035018BCO,1160,934,669,165,70,32,18,0,265
39035018AGD,1413,1155,792,125,125,20,101,1,363
39035018BQZ,1595,1241,386,31,816,17,5,1,855
39035018AWO,1509,1255,501,35,706,17,16,4,754
39035018BQA,1613,1191,489,27,658,9,9,2,702
39035018BHV,1646,1307,737,198,246,34,105,2,570
39035018BHT,1321,1046,690,156,118,24,71,1,356
39157079ADA,1760,1385,1320,18,4,27,1,0,65
39157079ADE,998,817,775,6,2,20,3,2,42
39157079ACZ,1111,891,840,11,15,13,3,0,51
39113057ANA,1248,1044,888,33,89,7,14,2,156
39113057APB,1543,1130,1036,29,4,9,43,1,94
39113057AMX,1402,1109,1004,14,63,19,18,3,105
39071036AAZ,1273,942,892,10,14,17,0,2,50
39053027AAG,1484,1113,1055,8,20,18,9,0,58
39053027AAF,676,534,508,0,4,13,7,0,26
39053027AAR,1437,1108,1067,3,9,20,1,0,41
39157079ACI,1509,1200,1144,5,6,33,7,0,56
39157079AAX,1188,871,755,51,27,31,4,0,116
39157079ACS,880,723,690,5,6,14,0,0,33
39157079AEU,921,760,719,21,7,3,8,0,41
39157079ABG,772,591,513,38,17,19,4,1,78
39071036AAQ,1418,1064,1021,13,8,17,1,0,43
39085043ADJ,1549,1230,1117,21,54,11,25,0,113
39085043AIV,1963,1335,1038,80,121,24,55,3,297
39085043ACY,1838,1319,614,387,268,53,29,3,705
39085043AGP,1761,1467,1289,63,59,26,20,0,178
39085043ACX,948,804,633,39,79,1,52,4,171
39085043ABV,1506,1224,1145,13,10,9,26,2,79
39085043ABG,1869,1509,1295,39,94,36,50,1,214
39085043ABU,1211,972,906,11,13,3,24,0,66
39085043ABJ,1151,985,931,15,12,3,17,0,54
39111056AAA,620,498,490,2,0,2,4,0,8
39111056AAM,411,352,345,0,0,3,0,1,7
39111056AAC,271,232,228,0,0,3,1,0,4
39111056ABB,429,339,328,4,1,2,0,0,11
39111056AAB,298,243,233,0,0,8,0,0,10
39085043AEQ,1016,871,798,16,23,5,22,0,73
39085043ADB,1501,1266,1094,27,105,15,19,1,172
39085043AEP,1045,913,844,12,20,6,24,0,69
39085043ACQ,2311,1734,1087,464,133,30,13,0,647
39149075ABF,1372,1033,1012,3,4,9,0,0,21
39149075ABH,1155,848,813,9,2,12,7,1,35
39149075ABE,1470,1084,1021,12,18,20,13,0,63
39043022ACG,1097,918,870,18,0,17,3,1,48
39077039ACO,1771,1347,1282,21,5,27,1,0,65
39055028AAQ,706,552,516,2,12,7,12,2,36
39055028ACZ,1018,874,840,7,7,7,11,1,34
39043022ADT,1391,1229,1155,30,11,24,8,0,74
39043022ACB,810,619,588,10,3,13,8,0,31
39055028ACS,1063,876,834,12,9,7,3,1,42
39055028ABR,1613,1172,1133,9,13,14,1,1,39
39055028ACH,911,777,714,15,8,28,5,0,63
39055028ACJ,932,768,715,6,14,9,10,0,53
39055028AAC,1346,1011,946,18,5,8,17,0,65
39017009AJK,1777,1456,1072,91,153,44,112,1,384
39017009AJE,1999,1459,732,87,335,21,262,2,727
39017009AIF,950,723,650,20,21,27,6,0,73
39017009ABR,1430,1146,1004,27,84,20,14,0,142
39017009ABQ,1029,838,753,8,35,26,12,0,85
39017009AIZ,1160,877,711,28,97,13,26,0,166
39173087ACT,1290,955,877,38,4,27,2,0,78
39173087ACU,1988,1491,1402,45,10,20,7,1,89
39173087ACW,879,666,597,36,3,27,3,0,69
39159080ABI,932,681,644,7,4,16,8,1,37
39159080AAY,1237,982,920,15,16,10,13,0,62
39159080ABK,1332,1036,974,19,15,6,10,0,62
39159080ABF,945,696,641,6,6,26,13,0,55
39159080ABE,730,579,548,6,5,11,7,0,31
39159080AAX,1089,818,764,4,5,32,7,0,54
39159080ABV,1672,1036,888,24,23,19,70,0,148
39159080AAD,1842,1340,1171,29,33,33,58,0,169
39173087AAV,807,623,588,16,2,8,5,1,35
39017009ADT,1407,978,807,56,72,34,9,0,171
39017009AHO,1048,835,782,5,20,18,6,0,53
39017009AFF,976,764,653,18,40,7,34,5,111
39017009AEV,1134,893,768,20,26,8,62,2,125
39095048ADH,1218,781,324,71,367,24,0,0,457
39095048AKQ,820,596,51,6,530,10,6,1,545
39095048AEW,1178,807,241,106,449,14,3,0,566
39095048AER,1034,712,227,53,431,7,7,2,485
39095048ANT,1461,1063,664,215,161,34,5,3,399
39095048ANR,1515,1122,696,267,142,39,8,1,426
39095048AIY,1507,1080,783,87,174,31,11,2,297
39095048AIN,843,608,62,13,528,1,2,4,546
39027014ABK,1027,807,779,5,4,11,3,0,28
39167084ABY,289,229,222,2,1,4,0,0,7
39167084ABU,1396,1124,1088,1,3,20,3,1,36
39095048ATO,1645,1294,1129,56,37,32,33,0,165
39095048ATM,1638,1303,1183,49,39,25,11,0,120
39095048AMN,664,517,416,38,37,12,10,0,101
39095048AQM,1195,941,823,37,45,18,19,0,118
39095048AOW,1030,830,665,29,109,10,15,0,165
39095048AOZ,829,657,567,16,38,11,17,0,90
39095048ARR,1408,1141,1074,30,9,20,8,0,67
39095048ARS,1487,1222,1080,83,9,24,4,1,142
39027014ABC,1123,875,844,12,5,10,3,1,31
39027014AAQ,868,690,658,8,3,10,1,1,32
39095048AVT,1726,1269,973,38,154,11,93,0,296
39095048APB,1368,1094,901,69,81,35,10,0,193
39095048ASR,1453,1086,942,45,68,18,18,0,144
39095048ATH,1853,1535,1206,56,203,21,56,1,329
39167084ACF,924,739,694,7,3,18,13,0,45
39167084ABX,438,352,334,2,1,12,0,1,18
39013007ACM,1066,855,811,2,3,12,9,0,44
39167084ACR,1712,1305,1253,9,6,32,3,0,52
39167084ACU,1835,1433,1369,10,7,28,9,0,64
39061031ACA,2051,1652,707,48,864,17,10,0,945
39061031AMS,818,637,124,11,478,23,5,0,513
39061031BCK,806,588,378,22,164,13,12,0,210
39061031BDW,1978,1377,1273,17,29,26,13,0,104
39061031BAU,1492,1225,1143,11,25,18,18,0,82
39061031BBJ,1602,1327,1202,6,76,16,13,1,125
39061031BEN,1927,1441,1352,17,36,9,17,1,89
39061031BOP,1768,1323,33,34,1250,13,11,7,1290
39061031BOQ,1376,842,29,14,792,13,7,1,813
39061031AIF,1097,869,230,18,588,8,23,2,639
39061031AAV,2054,1588,1096,31,388,42,20,1,492
39061031ATC,1657,1187,1058,30,17,19,45,0,129
39061031BOE,1453,1008,969,23,1,5,8,1,39
39061031ALS,1429,1018,418,32,555,20,6,0,600
39061031ALV,1010,710,68,24,607,8,2,3,642
39061031ABF,1680,1436,1097,39,216,18,62,3,339
39013007ACW,1415,1120,1072,3,8,17,7,0,48
39013007ACV,612,470,437,3,5,9,4,0,33
39013007ACQ,1433,1152,1108,8,4,15,3,2,44
39061031BBS,1028,905,826,13,21,27,8,2,79
39061031AXD,1188,940,830,7,39,7,36,0,110
39061031AWU,1688,1356,771,70,195,31,294,5,585
39061031AAG,1352,1013,745,45,46,17,165,0,268
39061031AWZ,2152,1840,1295,54,157,43,279,7,545
39061031BHA,1113,792,782,2,3,4,1,0,10
39061031BIF,1390,1079,1046,6,5,6,7,0,33
39061031BKH,1095,840,813,12,5,4,2,1,27
39095048AHY,1064,757,475,55,209,7,6,2,282
39037019ABX,1445,1174,1149,5,0,11,4,0,25
39037019ABV,1799,1303,1275,12,4,10,1,0,28
39037019ABY,1247,963,936,3,5,13,4,0,27
39037019AAS,1280,976,946,8,6,16,3,0,30
39037019AAZ,1450,1072,1024,10,11,21,7,0,48
39081041ADK,770,607,571,5,8,14,0,0,36
39037019ABA,889,686,667,4,1,10,7,0,19
39013007ACS,810,587,569,1,1,6,0,0,18
39013007ACT,432,310,301,1,0,7,1,0,9
39013007ADL,147,119,114,5,0,0,0,0,5
39081041AEH,1136,902,871,4,6,10,1,0,31
39081041AEF,531,434,408,2,6,12,0,0,26
39081041ACH,526,430,411,0,4,5,1,1,19
39081041AAQ,1125,897,759,17,94,20,8,1,138
39081041AEE,1174,935,870,2,14,26,12,1,65
39061031AYS,1002,802,614,12,73,9,80,0,188
39061031AYE,1794,1239,1053,8,99,21,39,0,186
39061031ANW,2608,2005,1061,236,599,53,67,14,944
39061031BJG,2020,1618,1514,21,23,34,16,1,104
39061031BJI,1978,1434,1381,15,6,11,15,0,53
39061031BJF,2139,1582,1502,21,10,32,8,3,80
39081041ACZ,326,244,229,6,2,7,0,0,15
39081041ABI,384,304,285,1,1,9,0,0,19
39081041ABG,1292,1004,920,2,31,31,6,4,84
39081041ABE,1431,1126,1036,5,35,23,10,1,90
39077039AAN,1589,1251,1142,48,38,11,9,4,109
39077039ACB,1501,1171,1097,38,6,26,9,0,74
39077039ABK,1578,1249,1166,21,6,33,2,1,83
39077039ABX,810,642,610,8,5,20,0,0,32
39115058AAC,299,242,226,6,4,6,0,0,16
39115058AAI,1686,1284,1210,10,45,26,4,2,74
39127064ABI,1062,816,757,3,11,30,1,0,59
39127064ABU,599,452,438,2,0,11,3,0,14
39127064ABJ,1126,831,804,6,2,19,2,0,27
39083042ABT,1012,746,710,5,7,12,2,0,36
39083042ABU,1494,1029,1001,6,3,15,3,0,28
39083042AAR,1294,823,815,1,4,2,1,0,8
39083042AAU,1390,1097,989,35,13,42,17,4,108
39059030ABO,1323,1010,948,6,14,30,6,1,62
39059030ABC,1414,1173,1126,6,12,14,14,0,47
39059030AAP,1254,1037,968,10,31,16,13,0,69
39081041ADC,478,387,359,1,13,5,3,1,28
39081041ADE,704,563,501,5,10,33,5,0,62
39081041ADD,468,401,387,0,5,7,0,0,14
39081041AEA,547,450,419,3,11,7,0,1,31
39115058AAF,1644,1325,1263,7,28,21,4,0,62
39115058AAA,742,607,569,5,13,18,0,2,38
39167084ACP,1484,1136,1083,9,11,22,2,1,53
39129065AAP,541,426,405,2,5,7,1,0,21
39129065ABL,1251,1004,957,5,8,26,0,0,47
39129065ACA,1712,1245,1176,16,10,31,3,0,69
39129065ABN,1256,971,915,18,11,22,7,1,56
39121061AAT,802,628,607,5,2,10,2,0,21
39121061AAR,494,380,369,0,0,9,0,0,11
39013007ABF,1402,1071,1044,0,4,17,1,0,27
39049025ABU,1149,1120,639,47,380,20,41,4,481
39049025BNK,1661,1638,1162,94,142,16,197,0,476
39049025AGS,1066,902,716,45,101,22,18,2,186
39049025AFD,1522,1187,777,102,256,17,30,3,410
39049025AFA,1926,1459,740,163,459,58,38,4,719
39049025AMK,1293,1031,664,203,123,35,32,4,367
39049025ACB,3002,2147,1045,223,782,54,47,2,1102
39049025BGC,1222,979,754,29,63,33,100,0,225
39049025BMU,1459,1094,726,158,173,41,17,4,368
39049025ACC,1170,1101,908,68,78,22,37,1,193
39049025BIT,2323,1690,682,110,820,23,75,0,1008
39049025BLD,1832,1409,601,87,671,31,45,3,808
39049025AJK,1123,855,331,38,458,22,31,0,524
39049025BIU,2301,1849,942,74,743,42,79,2,907
39049025AAA,1380,1021,703,48,190,27,44,2,318
39049025AOX,1990,1538,1119,128,205,26,66,1,419
39049025APE,970,684,466,53,93,25,60,0,218
39049025BMP,1098,775,172,25,550,18,16,1,603
39049025AJG,1485,1039,208,59,742,17,18,0,831
39049025AIX,2302,1730,313,233,1148,42,27,4,1417
39049025AJJ,1227,947,359,66,495,21,25,0,588
39167084ABF,1516,1165,1137,4,0,16,0,0,28
39081041ABC,1198,953,897,4,15,14,8,1,56
39081041AAR,1121,902,822,17,50,6,1,0,80
39081041AAU,1057,846,721,27,71,16,5,0,125
39081041ACT,589,468,428,7,11,9,5,0,40
39081041ACP,1321,1092,1041,3,5,25,4,1,51
39083042ABZ,813,621,589,2,16,14,5,0,32
39129065AAU,1068,800,732,17,2,30,10,0,68
39063032ACD,1078,777,745,8,2,12,1,2,32
39063032ACC,685,509,479,9,4,5,9,0,30
39103052ABG,1847,1514,1323,42,94,24,23,1,191
39103052AEX,1332,1075,1026,17,11,15,6,0,49
39103052ADD,1244,1009,958,11,3,20,6,0,51
39103052AFJ,1461,1125,1070,13,11,21,5,0,55
39103052AFY,1439,1039,959,18,10,12,18,0,80
39081041ADF,709,550,481,7,33,11,5,3,69
39063032AAQ,1480,1100,939,43,25,27,62,0,161
39063032AAR,1266,953,830,55,28,18,26,0,123
39109055AAW,1257,996,945,8,11,14,10,2,51
39109055ACF,1392,1061,999,16,8,20,11,0,62
39109055ACW,784,653,635,4,2,7,3,2,18
39099050ANE,713,587,521,27,16,18,3,0,66
39099050ALC,1161,1013,879,33,56,8,36,1,134
39099050AHH,1080,831,716,33,58,15,5,1,115
39099050AIK,1519,1154,932,43,133,25,9,2,222
39099050AHZ,991,839,771,10,32,22,5,1,68
39099050AOZ,607,471,449,5,5,0,13,0,22
39099050ANV,1164,935,896,10,6,16,1,0,39
39093047AFU,2175,1567,1222,183,87,38,31,1,345
39093047ACM,1538,1268,989,57,186,26,19,3,279
39093047ADK,1874,1452,1206,82,105,37,30,0,246
39021011ABH,1882,1393,1302,17,7,30,13,0,91
39021011ABD,1121,867,814,14,7,22,2,0,53
39021011AAB,1240,956,826,13,76,41,9,1,130
39121061ABA,479,391,381,0,0,3,1,0,10
39121061AAI,435,342,330,3,2,0,5,2,12
39107054ABU,840,617,606,6,0,2,1,0,11
39165083AAR,1427,1102,972,40,48,23,16,2,130
39165083AEO,1180,930,885,7,4,25,8,1,45
39165083AEM,1666,1315,1230,23,10,32,11,0,85
39165083AEQ,1315,1044,968,16,18,35,6,0,76
39165083ADQ,1195,945,878,8,13,35,7,0,67
39165083ABG,1422,1088,855,26,25,8,170,0,233
39165083AAW,1015,778,642,49,26,4,47,2,136
39155078ACJ,1402,1094,666,15,380,11,8,1,428
39155078AJX,1245,1015,924,25,21,32,8,0,91
39155078ABR,1758,1360,1197,17,78,33,3,0,163
39155078ABZ,1476,1142,1016,24,50,21,4,1,126
39155078AGV,1383,1063,1007,7,15,15,22,1,56
39147074ABM,1397,1064,1035,13,1,7,3,0,29
39077039ACH,897,690,653,7,4,11,8,2,37
39093047AAR,1561,1233,1107,59,29,24,24,0,126
39109055ACC,1082,870,818,5,5,15,10,1,52
39109055AAV,1215,908,825,33,8,22,22,0,83
39109055AAU,1427,1111,1025,33,8,25,11,3,86
39099050APN,1195,1086,1022,19,17,4,12,0,64
39063032ACK,1558,1127,941,124,10,29,19,0,186
39063032ACJ,819,584,545,22,1,6,7,0,39
39063032ABS,1184,941,895,21,3,11,7,0,46
39103052ACY,1369,1062,986,20,4,13,22,0,76
39103052AAE,1300,1009,917,38,14,26,7,1,92
39103052ACL,1608,1187,1090,16,16,32,28,0,97
39103052ACP,1762,1206,1117,16,21,24,17,1,89
39103052ACS,1907,1426,1311,26,10,37,20,5,115
39103052ACM,1460,1246,1141,16,51,8,20,0,105
39077039ACG,985,791,687,75,10,10,8,2,104
39049025AJH,1477,1020,337,61,583,37,21,2,683
39049025ADV,1322,1192,968,53,62,24,68,3,224
39049025ATH,1369,1005,878,20,38,10,59,0,127
39049025ATJ,1773,1250,1128,22,37,19,40,1,122
39049025ATV,1149,878,794,23,22,4,36,2,84
39049025BAN,926,742,689,9,10,7,20,0,53
39049025BHE,1290,1062,934,26,43,22,41,0,128
39049025AZE,1351,1188,1080,28,18,39,21,1,108
39049025AKR,1776,1235,631,60,490,25,30,2,604
39049025AKK,1494,1076,780,36,202,39,22,1,296
39049025BKB,1454,1036,825,16,154,25,7,0,211
39059030ACG,1041,831,791,9,5,19,5,0,40
39059030AAN,1478,1083,997,10,40,27,8,1,86
39121061AAB,985,748,732,1,2,9,3,1,16
39121061AAY,330,244,234,1,0,6,1,0,10
39121061AAF,548,413,402,2,0,6,3,0,11
39103052AFQ,1184,977,932,11,2,13,9,0,45
39103052ABH,2157,1528,1351,47,75,30,14,0,177
39063032ACH,1909,1466,1331,44,27,25,32,0,135
39063032ABD,1357,1100,1009,42,17,18,15,0,91
39077039ACE,1022,813,774,21,4,14,5,1,39
39077039ABL,1124,868,809,23,3,23,4,0,59
39077039AAA,1827,1368,1242,58,18,38,2,2,126
39099050ANK,1160,906,861,13,4,15,7,0,45
39035018CAR,1635,1180,140,18,1014,12,11,0,1040
39035018CAS,1875,1405,169,33,1196,18,7,0,1236
39035018CQQ,1420,1032,771,35,137,7,78,3,261
39035018CQR,1676,1391,586,37,494,7,267,0,805
39035018ANC,1245,1147,703,30,334,17,70,0,444
39035018AIW,1127,926,2,11,916,9,2,0,924
39035018AIS,1137,912,12,11,893,13,4,2,900
39035018BNJ,973,763,35,14,714,8,1,1,728
39035018BNG,925,690,2,3,683,8,3,0,688
39035018BNN,798,596,18,9,574,9,0,0,578
39035018BMD,1513,1153,39,11,1090,12,11,1,1114
39035018BQD,1141,870,323,18,524,5,5,2,547
39035018BPH,1162,878,318,18,528,8,11,3,560
39035018AKH,825,647,9,4,632,8,0,1,638
39035018AHW,894,674,13,8,646,18,2,0,661
39035018AMC,671,493,32,7,456,6,3,1,461
39035018BZL,1282,1115,946,20,118,7,18,2,169
39035018BZC,1147,980,810,31,105,8,25,1,170
39035018BZM,1175,1039,762,19,183,0,55,0,277
39135068ABG,1211,933,883,14,2,15,14,1,50
39135068AAS,947,745,713,2,1,12,4,0,32
39135068AAT,988,742,714,1,2,8,5,0,28
39135068AAU,757,570,538,5,2,13,10,0,32
39135068AAR,667,538,516,6,5,8,2,0,22
39103052AAI,1297,1032,973,24,4,12,12,0,59
39103052AAN,1139,886,817,16,11,23,6,0,69
39009005ABI,171,125,115,1,6,3,0,0,10
39009005ACR,369,367,253,16,83,10,13,0,114
39009005AAG,2313,2277,1678,127,439,27,28,0,599
39009005AAF,633,614,464,33,83,6,29,0,150
39059030ACP,1035,776,737,2,8,14,13,1,39
39059030ACA,1410,1079,1026,5,13,21,6,1,53
39035018APN,831,639,46,20,569,8,11,2,593
39035018AMX,1109,853,20,21,812,6,7,5,833
39035018BHM,1432,1056,515,228,247,28,47,6,541
39035018CZN,1542,1269,1097,34,30,11,87,1,172
39035018CZC,1593,1384,1227,27,31,11,73,0,157
39035018BIG,1300,1056,917,43,45,21,40,0,139
39035018BAJ,1572,1109,418,497,191,48,10,3,691
39035018CSI,2081,1528,757,46,308,12,406,1,771
39035018COW,1198,970,917,26,4,2,8,1,53
39035018COV,1330,1072,997,22,29,8,11,1,75
39035018COX,1192,927,860,23,21,9,12,0,67
39035018CFQ,1223,977,896,12,3,12,45,0,81
39035018CFR,2214,1776,1496,53,30,19,173,0,280
39035018CFS,1232,1030,943,9,11,9,55,0,87
39035018BSR,1023,787,28,22,742,9,3,2,759
39035018BZS,1581,1250,375,58,801,30,16,1,875
39035018BZR,1694,1370,565,58,715,21,17,1,805
39053027AAO,910,741,671,5,31,26,11,0,70
39053027ABB,1524,1037,983,6,11,30,3,1,54
39081041AEB,774,645,605,3,15,7,0,0,40
39081041ADH,544,414,395,7,1,9,2,0,19
39081041AAV,1124,913,804,19,42,10,40,0,109
39001001AAW,1733,1376,1330,6,10,28,5,2,46
39035018CDT,1716,1395,1273,50,16,21,11,0,122
39035018BLK,1432,947,329,15,575,16,27,0,618
39035018BLG,1351,1021,314,38,641,12,17,2,707
39035018BLQ,1795,1383,579,25,519,14,237,1,804
39035018CYN,1490,1233,1088,33,47,17,44,0,145
39035018CVX,1767,1454,1321,32,53,18,28,1,133
39035018CWB,1328,1050,944,39,16,27,25,1,106
39035018CIT,1514,1261,1072,76,34,38,30,0,189
39035018CIS,1866,1475,1192,128,58,38,54,0,283
39035018AKZ,1187,838,85,67,685,33,4,1,753
39035018AJX,666,541,8,18,517,11,0,0,533
39035018AKP,545,419,8,7,405,3,0,0,411
39035018ACJ,1830,1445,735,57,608,30,15,4,710
39035018ABU,1143,897,366,25,499,17,6,2,531
39035018CHU,1869,1499,1308,80,45,35,35,2,191
39035018CKY,1981,1544,1331,93,49,32,33,2,213
39035018AJP,786,590,11,6,571,7,1,0,579
39035018AJY,548,412,1,1,408,4,1,0,411
39035018CGN,1112,916,792,31,43,15,21,0,124
39035018CGT,875,638,572,27,11,12,13,0,66
39035018CVW,2116,1719,1540,36,27,10,97,0,179
39035018ABY,968,817,423,29,360,10,5,1,394
39035018CTI,1276,951,146,6,783,20,20,0,805
39035018CTG,1366,1032,176,18,823,8,25,0,856
39035018BMH,1563,1193,236,25,900,12,19,0,957
39035018BMA,1501,1151,150,24,958,10,26,0,1001
39035018CAY,1132,887,79,7,787,25,3,1,808
39035018BKI,1212,989,849,34,58,4,25,1,140
39045023ACM,2736,2512,1769,35,670,27,13,1,743
39045023ACL,1057,872,829,5,8,16,6,0,43
39045023ACK,1057,837,800,8,6,21,2,0,37
39045023ADI,1479,1054,985,10,15,30,8,3,69
39045023ACW,1686,1358,1316,5,6,17,5,1,42
39167084AAE,1608,1353,1276,9,27,21,7,0,77
39167084ADC,1221,997,962,7,7,14,7,3,35
39167084ACW,1541,1181,1133,3,3,31,4,2,48
39075038AAO,1605,1167,1140,6,7,11,2,0,27
39033017AAA,1465,1156,1104,10,16,14,7,1,52
39033017AAE,1722,1312,1241,24,15,17,7,0,71
39033017AAJ,965,766,722,16,4,10,12,0,44
39075038AAL,1144,864,801,18,9,20,2,3,63
39045023AAR,1714,1390,1292,21,36,20,15,2,98
39045023ADE,963,720,685,4,0,25,0,0,35
39045023AEK,1925,1371,429,48,620,34,255,4,942
39045023AAL,1235,1030,973,20,11,12,8,1,57
39045023AAM,1384,1039,934,24,34,30,1,0,105
39091046AAA,1467,1044,928,32,45,31,13,1,116
39135068AAX,1141,892,866,0,3,15,8,0,26
39045023AEY,1281,989,917,12,16,32,6,0,72
39045023ABR,1171,886,821,6,9,36,8,0,65
39045023ABO,1225,938,906,10,0,15,1,1,32
39035018CPM,1510,1326,1138,37,56,9,65,0,188
39035018CPT,1402,1200,1106,17,13,5,52,0,94
39035018APD,1022,960,404,26,432,6,94,2,556
39035018AQQ,991,735,143,9,454,2,122,0,592
39035018ARE,957,765,14,12,732,14,3,2,751
39035018AUI,838,689,101,11,546,17,20,2,588
39035018CBR,1407,1075,868,42,98,8,50,0,207
39035018BQK,1252,1045,466,16,538,4,19,2,579
39035018BQJ,1387,1024,476,19,522,7,9,0,548
39035018AAH,1407,1041,973,22,13,7,22,0,68
39035018AAS,1304,971,945,10,2,0,10,0,26
39035018ACM,1919,1497,748,48,666,16,26,2,749
39035018BGL,1662,1196,540,296,301,29,57,3,656
39035018BOS,1036,840,678,22,129,8,7,2,162
39035018CID,1547,1218,1056,65,40,22,24,1,162
39035018CIC,1640,1292,1120,66,42,37,27,2,172
39035018BQC,1655,1198,185,11,975,20,16,1,1013
39035018BGG,1644,1273,601,320,301,47,49,4,672
39035018BGE,1574,1138,568,294,273,14,32,2,570
39035018BHO,1390,1101,461,248,344,23,59,3,640
39035018COF,1396,971,908,32,8,4,13,1,63
39035018COC,1315,1118,1026,28,14,4,42,0,92
39035018CSK,1831,1360,930,16,104,11,302,0,430
39035018CSF,1692,1257,803,25,128,11,288,1,454
39035018BKH,1377,1128,903,47,119,9,41,3,225
39035018CQM,1203,903,525,20,292,2,63,1,378
39035018CQL,1389,996,551,15,351,7,58,3,445
39035018CRS,1481,1050,803,36,160,10,42,0,247
39053027AAB,1610,1300,1139,18,91,32,10,0,161
39053027AAV,705,547,522,1,8,10,0,0,25
39123062AAA,1665,1232,1011,125,58,24,1,0,221
39123062AAT,1142,983,881,56,19,9,4,2,102
39123062AAH,1442,1132,1029,57,27,19,3,0,103
39009005AAI,810,631,510,20,14,13,64,3,121
39009005ABL,1098,884,800,11,19,5,37,0,84
39009005ACO,486,379,357,5,0,12,3,0,22
39091046ABT,1059,887,838,9,7,20,10,0,49
39091046ABR,1780,1593,1517,12,10,31,9,1,76
39091046ABH,1630,1265,1204,4,7,25,8,2,61
39091046ABA,1770,1391,1299,19,11,49,5,4,92
39091046AAZ,1354,1053,987,9,9,37,5,1,66
39091046AAN,2549,2030,1702,96,115,55,56,0,328
39053027AAU,424,324,313,1,6,1,1,0,11
39167084ACZ,1579,1266,1216,5,18,19,6,0,50
39167084AAT,1236,989,896,13,20,42,9,0,93
39167084ABA,465,382,353,5,11,7,3,1,29
39167084AAS,1085,917,855,15,10,15,27,1,62
39167084ACE,1134,937,883,9,10,19,10,0,54
39091046ABX,1320,1032,953,16,14,36,13,1,79
39101051ACR,1651,1284,1215,26,5,36,3,1,69
39101051ACT,1016,767,707,29,5,18,2,3,60
39035018BNF,869,786,27,6,747,7,6,0,759
39035018BKZ,1086,852,491,34,270,21,45,2,361
39035018CBV,1849,1448,1199,30,117,19,89,0,249
39035018CBX,1927,1527,1263,39,113,22,79,0,264
39035018AWM,991,756,136,26,590,25,9,0,620
39035018CAM,1545,1129,139,30,946,21,9,2,990
39035018CAX,1407,1034,164,22,849,13,5,0,870
39035018CAC,1865,1372,483,28,846,24,13,0,889
39035018CAL,1647,1176,178,14,965,15,17,1,998
39035018CGQ,1157,953,852,33,26,19,20,0,101
39035018AUV,630,490,7,11,475,9,0,2,483
39035018AVK,988,747,15,6,723,12,5,0,732
39035018AUZ,661,489,30,4,456,9,2,1,459
39035018AVJ,683,525,14,8,503,12,1,0,511
39035018BWL,1351,1092,949,58,33,15,31,1,143
39035018DCU,573,458,397,14,16,12,17,1,61
39035018AXY,1452,1116,456,80,552,31,14,3,660
39035018BZJ,1193,963,670,18,219,11,42,0,293
39035018COP,1251,1117,1028,29,20,9,29,0,89
39035018COM,1476,1202,1090,18,26,11,49,2,112
39035018BLC,1036,785,279,24,466,10,21,1,506
39035018BKX,1023,828,582,34,163,17,37,0,246
39035018AUE,617,452,17,1,431,6,3,1,435
39035018CXA,1946,1151,973,32,79,4,27,0,178
39035018CWX,1445,1137,912,31,160,8,33,0,225
39035018AKT,791,597,3,9,581,12,3,1,594
39035018BWK,1571,1309,1150,42,52,18,40,0,159
39035018BWR,1537,1261,1176,27,21,10,17,2,85
39035018BWQ,1572,1237,1091,43,43,10,44,0,146
39035018AXT,1028,742,257,66,414,21,2,0,485
39035018BTU,1916,1559,797,46,683,33,23,1,762
39035018CJX,1257,1068,991,17,28,13,20,1,77
39035018CJQ,1496,1245,1152,44,18,8,26,0,93
39035018COA,1432,1015,977,12,1,1,20,2,38
39035018ASB,690,536,56,20,459,4,1,0,480
39035018ASU,1163,857,54,25,783,10,4,0,803
39035018ASV,888,697,8,12,671,10,11,0,689
39035018CZT,1430,1301,972,32,218,2,48,0,329
39035018BFC,1235,862,311,202,317,20,23,0,551
39035018BGM,1047,835,373,149,239,28,59,3,462
39035018CGE,1388,1158,1033,29,29,25,27,0,125
39035018CGC,1319,1170,1000,44,71,0,40,0,170
39035018BTI,2210,1674,661,53,923,30,32,4,1013
39035018BSX,1305,964,383,32,547,14,3,0,581
39169085ABQ,2112,1597,1495,36,9,41,1,0,102
39169085ACM,1497,1142,1081,12,11,27,3,0,61
39169085AAV,2202,2038,1761,65,126,39,47,8,277
39001001AAK,1893,1387,1320,16,7,32,6,0,67
39001001AAB,1097,862,841,0,1,20,1,0,21
39123ZZZZZZ,0,0,0,0,0,0,0,0,0
39123062AAZ,931,804,743,28,8,17,6,0,61
39123062ACQ,813,715,689,2,6,3,3,0,26
39123062ABW,807,741,707,12,1,13,0,0,34
39123062ABF,969,848,806,14,4,4,13,1,42
39123062ACA,865,749,705,18,13,3,9,4,44
39123062ABR,1265,1094,1040,30,13,7,5,0,54
39117059AAT,722,601,561,14,3,18,3,0,40
39045023ABL,1011,762,709,4,7,31,4,0,53
39045023ACG,1789,1385,1327,5,9,28,16,0,58
39045023AAQ,1488,1228,1135,29,12,38,17,1,93
39045023AAU,1558,1179,1074,16,43,28,0,0,105
39117059AAR,1073,805,699,51,22,18,4,1,106
39117059ABJ,1488,1119,1082,4,7,16,8,0,37
39043022ADE,1301,1067,846,33,165,22,13,0,221
39043022ACT,840,662,619,11,6,19,3,0,43
39019010ABL,1116,850,818,9,3,14,4,0,32
39045023AEV,1312,865,486,19,254,7,85,1,379
39045023AEM,1359,1125,817,51,209,22,42,0,308
39045023AFE,1290,949,557,18,258,19,87,1,392
39045023ABI,1621,1181,791,50,248,31,72,1,390
39045023AAZ,1751,1322,1175,32,57,43,17,2,147
39005003AAQ,1247,980,914,15,14,27,4,0,66
39005003ACA,1629,1252,1192,15,5,32,3,0,60
39005003ACP,1353,979,941,9,1,24,2,0,38
39005003AAD,1452,1142,1092,9,6,14,18,0,50
39117059ABH,1261,985,943,6,6,15,5,0,42
39013007ABL,987,842,812,12,7,11,1,0,30
39013007ACK,1058,843,800,6,11,13,14,1,43
39013007ACJ,3622,3485,2345,85,988,28,28,9,1140
39013007ACU,248,199,189,0,0,10,0,0,10
39035018BGQ,1569,1188,693,245,193,36,47,3,495
39035018BGP,1681,1278,717,253,270,23,36,3,561
39035018BGY,1260,968,552,135,143,14,131,2,416
39035018BYK,1490,1186,831,85,170,17,92,0,355
39035018BYG,1477,1223,985,64,84,25,68,3,238
39117059AAI,875,670,621,28,2,10,6,0,49
39101051AAE,778,583,503,23,39,7,3,0,80
39101051ABN,1428,1145,1026,23,61,13,10,1,119
39101051ACI,516,394,389,2,1,3,1,0,5
39101051ACG,993,828,749,16,40,10,7,0,79
39101051ABK,588,475,442,6,16,5,7,2,33
39101051ACZ,701,526,509,3,1,4,2,0,17
39101051ACU,1040,820,738,26,18,14,25,0,82
39101051ADE,678,532,515,3,2,5,5,1,17
39045023AFC,1819,1277,1192,18,19,16,28,0,85
39045023AAF,1528,1241,1141,20,30,21,18,0,100
39045023AEG,1495,1147,1085,16,9,20,3,2,62
39045023ACX,1682,1250,1188,13,14,31,5,2,62
39045023ADH,1512,1153,1100,3,11,27,9,1,53
39045023ADG,1005,783,726,5,5,35,2,1,57
39045023AFG,2061,1299,820,47,376,16,43,1,479
39045023AEW,1798,1203,741,32,374,14,43,1,462
39045023ABU,1655,1270,1208,17,10,18,14,1,62
39101051ACA,978,769,722,4,13,20,3,0,47
39083042ACD,1866,1404,1332,14,6,28,15,3,72
39033017ACC,1562,1273,1215,10,6,35,6,0,58
39057029AAN,1662,1361,1031,46,112,16,151,2,330
39057029AHU,818,640,610,6,5,10,3,0,30
39101051ABP,736,560,523,7,24,6,1,1,37
39101051ADI,1405,1064,972,18,27,33,7,1,92
39101051ACF,770,610,586,9,1,7,2,0,24
39101051ACE,310,238,227,1,4,7,0,0,11
39117059ABC,1496,1175,1118,10,12,28,4,0,57
39117059AAW,847,661,623,5,4,20,0,0,38
39061031ANS,2512,2061,845,60,1098,20,42,2,1216
39061031AZB,1596,1121,1025,25,24,18,27,1,96
39061031AHQ,2751,2573,1693,65,330,30,468,2,880
39061031BQJ,3553,3332,2414,78,500,12,331,1,918
39061031AHP,3665,3630,2642,40,700,3,243,0,988
39061031AGE,1425,1325,1074,36,139,16,65,4,251
39165083ACB,2387,1919,1164,89,99,21,540,1,755
39061031ARO,1440,1049,181,126,695,13,54,0,868
39061031BFS,1261,1009,808,33,151,8,8,0,201
39061031BFR,1037,905,741,33,98,13,23,1,164
39061031BFX,1810,1338,325,44,939,26,20,3,1013
39061031AIS,1617,1284,831,38,358,26,26,4,453
39061031AVI,1824,1416,1059,94,214,28,15,1,357
39057029AFI,987,707,584,0,82,30,6,1,123
39057029AFH,1175,857,726,14,86,22,10,1,131
39057029AIN,1731,1710,74,7,1586,4,0,0,1636
39057029AIR,685,570,526,7,24,6,0,0,44
39157079ADN,1422,1079,1009,19,22,19,3,0,70
39157079ACT,1360,1071,1019,6,12,26,0,0,52
39157079AAR,1070,849,702,101,12,45,3,0,147
39057029AIA,1016,836,782,6,9,23,5,0,54
39057029AFQ,910,706,395,24,250,31,6,3,311
39057029AGR,1360,922,752,38,40,15,75,0,170
39057029AIZ,1886,1344,1093,50,60,29,102,2,251
39083042ABX,993,751,724,1,6,14,1,0,27
39083042ABW,1239,912,846,9,2,34,7,3,66
39057029AHI,790,657,489,21,112,24,10,0,168
39057029AHG,581,502,448,6,24,10,11,0,54
39057029AIF,1300,983,894,21,6,20,30,0,89
39057029AJA,2166,1566,1354,27,37,18,104,1,212
39057029AGQ,918,804,684,24,38,17,45,1,120
39057029AFA,1165,909,744,16,94,37,12,4,165
39057029AIK,819,698,647,13,29,7,2,1,51
39057029AFD,1609,1292,1064,18,163,34,13,3,228
39057029AIX,3410,2735,2156,89,247,66,165,11,579
39101051ACD,633,465,433,10,9,11,1,0,32
39005003ACT,1423,1112,1081,5,3,16,2,0,31
39057029AIM,394,311,172,5,115,12,5,0,139
39057029ADX,1165,933,705,26,159,30,17,0,228
39057029AHV,600,487,467,4,4,5,5,2,20
39057029AHX,1247,891,841,5,16,20,5,1,50
39057029AAV,898,686,624,18,18,18,11,1,62
39057029AAU,877,691,633,13,8,12,22,0,58
39057029AGL,964,768,715,8,11,9,8,8,53
39061031AAE,844,637,548,14,27,10,40,1,89
39061031ATT,806,585,505,18,17,0,47,0,80
39061031ATO,1447,1054,937,22,34,6,54,4,117
39061031AKT,924,670,73,13,580,7,0,0,597
39061031AKM,1477,1091,314,23,738,14,22,0,777
39061031AAK,748,568,297,28,70,5,172,0,271
39061031BQO,1456,1136,854,34,77,16,144,1,282
39061031AAA,911,707,611,25,32,10,31,3,96
39061031AAB,1307,1132,888,31,90,14,103,0,244
39061031BCE,1698,1240,811,36,325,31,39,1,429
39061031BBA,1916,1473,884,56,383,37,112,0,589
39061031AGG,1750,1493,636,53,755,19,46,8,857
39061031AIA,1517,1083,65,7,1006,14,1,2,1018
39061031AZG,1827,1375,1254,24,38,30,11,0,121
39025013AIC,768,595,571,10,0,6,7,1,24
39025013AGJ,1352,1038,887,18,35,22,65,3,151
39079040ABO,1246,888,857,7,5,15,1,1,31
39079040AAA,1674,1285,1215,15,9,24,19,1,70
39079040AAG,1631,1229,1142,12,17,31,17,1,87
39079040ABM,900,671,640,6,1,18,0,1,31
39007004AEX,2659,1660,1615,4,23,10,2,1,45
39025013ADE,1307,996,944,10,5,31,5,0,52
39079040AAO,787,561,531,4,5,16,3,0,30
39079040AAJ,977,725,690,9,1,18,2,0,35
39067034AAX,1562,1139,1099,8,10,20,3,0,40
39131066AAL,1170,915,794,10,59,51,1,4,121
39131066AAG,914,701,660,3,10,18,5,2,41
39131066AAA,721,562,525,3,3,16,10,0,37
39079040AAM,1115,882,838,4,11,16,5,1,44
39079040AAL,1107,843,784,10,6,29,4,0,59
39101051ABW,560,435,412,6,6,8,0,0,23
39105053AAX,1213,925,870,9,4,28,1,1,55
39105053AAA,1249,977,942,1,3,23,1,1,35
39069035ABF,1847,1381,1307,15,7,29,4,1,74
39003002AAK,1511,1046,732,32,262,20,2,0,314
39003002AAX,1402,1093,686,51,320,31,7,2,407
39003002AAJ,1540,1123,862,38,174,22,17,3,261
39003002AAQ,1698,1233,898,41,243,17,14,1,335
39003002AED,864,660,570,19,26,21,13,0,90
39113057AVJ,860,742,29,24,681,8,0,0,713
39113057AVG,1575,1292,766,22,471,20,8,3,526
39113057ALK,2328,1771,1473,44,148,47,41,5,298
39113057ARL,1429,1049,924,25,69,12,15,0,125
39113057ATO,1669,1302,1244,10,9,32,10,0,58
39113057ATR,2087,1609,1490,28,33,35,11,2,119
39113057ATS,2542,1797,1678,21,53,24,12,0,119
39113057AXO,1434,1137,1015,11,14,13,71,2,122
39113057APN,1474,1089,920,25,71,32,26,1,169
39113057ATA,1079,850,625,7,182,12,17,1,225
39113057ATB,857,703,653,2,22,17,7,0,50
39113057AGI,1293,912,88,15,793,19,6,0,824
39003002ADA,1047,867,663,33,137,22,17,0,204
39003002AAP,1689,1302,918,37,285,26,35,2,384
39003002AAO,1938,1328,797,42,424,20,43,0,531
39003002AAE,1211,963,851,62,23,20,5,0,112
39003002AAH,3240,2745,1618,106,957,62,11,3,1127
39003002AFF,902,682,638,16,9,14,1,0,44
39003002AFJ,1417,1193,1037,35,76,3,13,0,156
39003002AFV,1041,809,737,10,29,16,9,0,72
39003002AEZ,1124,885,824,10,21,14,2,1,61
39003002AFG,887,645,621,11,3,7,2,2,24
39003002AFI,1201,974,925,7,13,8,12,0,49
39073037AAX,823,638,616,2,7,8,3,0,22
39073037ABA,1117,886,840,4,3,22,0,1,46
39139070AAR,1659,1379,1203,21,103,35,14,1,176
39139070ABJ,1343,1074,1037,10,3,20,2,0,37
39139070ABG,1248,904,856,16,7,20,2,2,48
39139070ACO,1710,1367,1188,26,72,28,51,0,179
39139070AAH,1545,1169,952,32,156,26,16,2,217
39139070ADH,2047,1597,1511,17,6,30,18,0,86
39139070AAA,1260,993,826,28,64,24,53,1,167
39139070AAD,1823,1549,1318,25,152,23,10,8,231
39139070AAK,1373,1159,1005,24,104,20,11,0,154
39015008ACN,1432,1114,1067,7,5,29,2,2,47
39097049AAW,1327,1048,986,12,10,27,3,2,62
39097049AAV,1945,1472,1366,36,13,44,13,2,106
39011006AAP,1865,1470,1415,11,10,22,3,2,55
39011006ABR,928,759,726,5,14,10,2,3,33
39011006AAS,863,627,582,15,9,8,3,1,45
39011006AAU,800,591,577,9,2,1,3,1,14
39011006ABD,1585,1264,1228,5,11,4,7,0,36
39137069ABM,1204,918,866,29,11,4,4,2,52
39137069ABZ,1114,752,731,15,2,1,0,0,21
39137069AAT,969,725,705,6,0,3,7,1,20
39011006ABF,1215,926,882,9,4,9,17,0,44
39011006AAF,1653,1184,1094,23,9,31,9,7,90
39137069AAG,2002,1511,1472,18,2,13,3,1,39
39161081AAB,701,533,506,12,5,11,2,0,27
39011006ABH,1482,1154,1099,11,11,15,13,0,55
39147074ACA,732,561,527,20,5,7,1,0,34
39113057ARI,1869,1422,1304,23,37,41,7,4,118
39113057ARJ,1276,1038,913,19,59,33,14,1,125
39113057ALI,1693,1365,1208,45,62,21,18,2,157
39113057AAI,1761,1555,1347,55,87,18,44,1,208
39113057AAC,1764,1317,1140,40,66,26,42,2,177
39113057AAG,1735,1436,1272,36,52,14,55,2,164
39113057APZ,1560,1193,790,46,106,29,223,3,403
39113057APT,1124,857,714,16,84,16,29,1,143
39145073ABK,929,688,644,6,11,17,2,1,44
39145073ABJ,938,725,666,7,19,25,2,0,59
39145073ADD,1380,1055,1014,6,4,23,3,0,41
39165083ACD,1595,1373,1105,38,72,18,133,2,268
39165083AFJ,1252,964,849,12,28,19,44,2,115
39155078AKN,980,713,672,10,13,11,0,0,41
39155078AKO,1128,912,867,10,16,15,2,0,45
39155078AES,848,693,639,13,14,17,5,0,54
39155078AKX,1062,791,725,9,21,15,19,0,66
39155078AAB,1205,948,855,31,32,19,5,0,93
39147074ACU,810,642,610,11,0,10,2,0,32
39165083AFB,1317,996,873,17,24,13,65,3,123
39165083AAL,1553,1173,975,55,87,26,23,1,198
39165083AEL,1178,917,840,9,15,33,12,1,77
39165083ADZ,852,692,650,7,3,16,7,0,42
39105053AAN,939,685,655,4,4,21,0,0,30
39113057ACW,969,915,219,29,632,11,27,0,696
39113057ACL,1270,871,367,18,448,28,11,5,504
39113057ABZ,1445,1135,850,35,215,39,9,3,285
39113057AUH,1585,1233,463,28,705,25,6,3,770
39113057ADZ,1624,1341,1136,53,95,42,17,3,205
39113057ANX,1282,982,881,28,36,24,11,0,101
39173087ABI,1558,1172,1022,61,38,26,21,2,150
39017009AHS,1163,911,847,10,12,27,6,0,64
39017009AGJ,1020,700,456,203,9,31,6,1,244
39105053AAE,1220,966,922,9,3,22,1,0,44
39173087ABJ,1105,897,838,21,19,15,11,1,59
39017009ADX,1529,1253,1129,29,56,30,2,6,124
39015008AAY,1326,1026,970,8,5,30,5,2,56
39015008AAV,1121,897,850,6,3,31,3,0,47
39015008AAM,963,796,737,20,7,25,4,0,59
39015008AAK,1515,1228,1141,17,30,26,6,0,87
39113057ASJ,2264,1824,1375,74,278,34,64,2,449
39113057ADY,1402,1181,1003,31,99,24,23,1,178
39113057AOA,1790,1312,1183,31,57,32,7,2,129
39113057AUZ,975,712,684,4,3,14,3,0,28
39105053AAW,421,323,300,3,11,5,0,0,23
39087044ACA,515,412,355,3,33,18,3,0,57
39165083ACT,1152,923,866,8,13,27,1,1,57
39165083AAH,1530,1210,1139,11,7,40,7,4,71
39165083AAG,1339,1036,917,23,33,19,28,0,119
39107054AAM,1031,744,725,6,5,5,0,2,19
39107054AAN,1235,877,841,16,6,7,0,6,36
39003002AGD,1231,971,868,28,31,22,21,0,103
39069035AAH,1803,1436,1205,160,26,40,14,0,231
39139070ACK,1002,761,697,15,20,18,6,0,64
39139070ABS,1337,1020,971,4,6,20,1,0,49
39113057APY,2430,1865,1284,63,375,78,66,4,581
39113057ATZ,1853,1461,1347,29,35,41,9,0,114
39113057ATX,878,717,660,11,28,14,2,0,57
39155078AAF,1395,1105,940,37,89,15,10,2,165
39155078ADD,1507,1176,958,40,127,25,15,2,218
39155078AKE,1065,901,833,14,30,17,4,0,68
39165083AEI,1073,791,718,24,28,6,8,0,73
39165083ADH,818,609,536,27,3,12,31,0,73
39165083AGJ,1572,1057,957,19,28,10,36,0,100
39165083AES,1405,1088,981,22,35,17,18,0,107
39165083AEY,1295,1014,944,13,11,10,34,1,70
39165083AGD,1636,1104,572,42,36,8,449,2,532
39165083ABW,1553,1099,693,56,80,15,258,0,406
39155078AFH,1409,1101,996,17,42,24,5,0,105
39093047AFG,2125,1510,449,824,253,52,8,0,1061
39093047ADU,2063,1521,881,320,293,34,6,2,640
39093047ALE,1423,1235,1020,76,63,7,55,4,215
39093047ACY,2680,2152,1549,92,481,36,5,3,603
39093047AGP,2105,1536,1347,85,27,12,53,0,189
39099050AOR,831,712,666,23,13,17,0,1,46
39099050AOS,935,787,728,26,5,11,8,0,59
39109055AAF,1353,1029,934,13,32,16,19,0,95
39109055ADA,1503,1242,1155,17,12,28,13,3,87
39093047ADL,1041,847,699,38,77,20,10,0,148
39099050AQK,1153,875,456,120,276,14,5,0,419
39001001AAD,1097,867,810,10,3,38,0,0,57
39139070ACL,933,728,687,9,2,20,2,0,41
39073037AAO,2057,1611,1525,13,15,33,14,2,86
39073037ABF,1131,949,910,6,7,19,0,0,39
39021011ABM,1152,875,850,11,8,5,2,0,25
39017009ADF,928,645,369,209,37,51,7,8,276
39017009AFN,1993,1388,1244,37,58,33,14,1,144
39017009AAB,1932,1452,626,141,381,39,275,8,826
39017009AAP,1767,1274,743,395,66,95,24,7,531
39113057APP,1074,853,754,20,39,23,17,0,99
39113057AEM,1118,880,785,20,37,22,8,2,95
39113057AET,2850,2195,1511,146,438,78,42,4,684
39113057AEK,1276,1020,890,36,37,17,24,0,130
39113057APU,1993,1594,1342,54,83,58,44,1,252
39049025ANX,2077,1749,1284,123,111,41,196,3,465
39049025BAS,1494,1053,972,22,13,4,40,1,81
39049025BKR,1705,1140,867,19,37,18,200,0,273
39049025ARS,896,610,509,10,5,6,65,4,101
39049025ADE,3584,3223,1610,181,290,38,1095,5,1613
39049025AIB,2343,2279,1665,114,169,17,308,17,614
39049025AHZ,1936,1933,1689,66,119,5,48,5,244
39049025AVN,1358,1035,902,19,24,5,86,2,133
39049025AEF,1210,1111,974,38,36,22,50,3,137
39049025AGW,1430,1375,1065,86,85,27,118,2,310
39049025AIA,2089,2004,1335,77,152,17,419,0,669
39049025AVE,1165,789,732,15,6,2,26,2,57
39049025AEG,1290,1091,947,34,25,26,46,1,144
39049025AYV,896,828,661,31,47,15,76,5,167
39049025BKZ,1637,1578,1074,55,68,11,367,3,504
39049025ADF,998,903,758,27,25,18,73,0,145
39049025BNU,1508,1483,780,49,127,4,512,8,703
39049025AVO,1172,855,733,8,5,13,84,0,122
39049025AGX,1193,1152,945,44,49,12,91,0,207
39049025AIM,2541,1758,338,180,1107,26,116,1,1420
39049025BIW,2135,1345,668,66,523,30,72,3,677
39049025BFR,1038,895,629,16,192,15,41,0,266
39049025BGL,2521,1862,690,88,1004,61,62,7,1172
39049025AOK,2540,1991,1418,149,144,15,245,0,573
39031016AAT,1728,1388,1343,10,6,28,3,1,45
39031016AAW,1903,1433,1370,9,8,28,4,1,63
39003002AET,1207,975,957,6,1,9,2,0,18
39003002AAC,863,684,653,19,7,4,0,0,31
39003002AGI,869,665,628,5,9,11,3,0,37
39003002ABI,1441,1065,841,32,160,14,6,2,224
39003002ABH,1117,859,647,39,150,12,16,3,212
39003002ABE,1157,927,761,22,118,22,13,0,166
39003002ADW,1307,1008,957,8,10,17,3,0,51
39003002AAA,1198,902,821,45,8,21,1,0,81
39069035AAY,1083,837,765,44,5,25,2,1,72
39113057APS,1122,872,755,14,67,24,8,2,117
39113057ATP,1282,1014,970,10,14,8,7,0,44
39113057AVY,1295,999,931,15,11,25,8,2,68
39113057AGH,1143,888,105,23,757,13,3,1,783
39113057AUL,1063,822,129,4,683,6,5,3,693
39113057ARS,1176,967,827,20,68,33,19,0,140
39113057ANG,1516,1367,1231,24,29,12,65,6,136
39113057ATM,1251,937,884,5,6,17,13,4,53
39113057AUG,1681,1280,300,39,909,32,5,2,980
39113057APQ,1177,888,809,23,20,31,8,1,79
39113057AKW,1915,1527,1328,41,54,54,37,6,199
39031016AAL,1922,1508,1427,15,34,16,16,2,81
39031016ABQ,1987,1500,1456,12,4,25,3,0,44
39031016AAP,1331,1000,951,10,4,21,9,0,49
39023012AEM,1719,1413,1292,28,33,31,26,2,121
39023012ADJ,1213,946,882,13,12,24,3,0,64
39041021AAG,991,739,655,28,24,16,18,0,84
39041021AAR,1513,1190,1114,18,27,26,9,0,76
39041021AAQ,1252,950,836,15,52,22,14,0,114
39041021AGN,1402,796,596,13,56,6,119,0,200
39041021AFY,1528,965,795,24,39,7,99,1,170
39041021AFE,2491,1512,845,36,78,9,537,1,667
39031016AAA,872,696,632,14,20,20,7,1,64
39031016ABA,1833,1433,1394,5,10,17,4,2,39
39031016ABH,1759,1307,1240,12,19,28,4,3,67
39031016AAU,1852,1483,1437,10,15,17,5,0,46
39031016AAR,1589,1147,1109,3,7,9,2,2,38
39037019ABP,1902,1492,1444,5,5,25,9,0,48
39037019ABQ,1359,1016,995,4,4,7,5,0,21
39037019ABN,820,580,566,3,1,7,0,0,14
39171086AAX,895,660,619,20,2,8,7,0,41
39171086AAY,1429,1082,993,46,11,21,2,0,89
39171086ABF,785,629,593,20,2,7,4,0,36
39171086ABB,1139,907,863,12,4,21,1,0,44
39069035AAW,1301,976,841,103,9,15,6,0,135
39031016AAS,1950,1204,1177,6,4,6,6,1,27
39107054ABI,909,652,640,4,5,3,3,1,12
39069035ABB,880,680,656,16,1,5,1,0,24
39069035ABA,561,452,439,7,2,5,0,1,13
39003002AEG,1183,902,775,35,45,37,5,0,127
39003002ABF,1360,998,599,40,322,31,3,0,399
39003002AAW,1695,1183,649,60,442,32,4,1,534
39003002ACG,1558,1181,861,44,243,25,16,2,320
39037019ABJ,1505,1184,1126,9,7,17,2,4,58
39023012ABG,1072,801,715,20,39,12,9,0,86
39047024ABG,947,679,638,14,3,23,1,0,41
39047024ABK,1793,1375,1292,27,27,25,5,1,83
39047024AAG,1045,816,760,7,21,19,9,1,56
39047024ABI,719,551,525,5,9,5,0,0,26
39047024ABM,1341,1034,974,18,11,25,7,2,60
39047024AAM,1464,1258,1186,16,20,18,21,0,72
39047024AAQ,937,703,640,16,16,19,11,2,63
39047024AAH,1228,906,820,12,46,16,6,1,86
39047024AAK,1234,1014,943,12,24,26,6,1,71
39049025AGP,889,652,344,119,165,26,9,3,308
39155078AAT,1092,892,841,12,8,3,4,0,51
39155078AKD,1486,1262,1179,10,46,14,4,1,83
39155078AGR,1224,986,859,16,47,36,23,2,127
39155078ADV,1235,999,725,20,211,25,8,0,274
39147074ABR,941,748,692,10,23,12,5,6,56
39165083ABN,1161,942,874,24,12,30,7,0,68
39155078AIP,932,759,702,15,24,4,9,0,57
39087044AAE,587,479,450,1,18,7,2,1,29
39087044ABO,643,521,488,12,6,13,0,0,33
39087044AAA,552,432,411,8,10,1,2,0,21
39089045AAK,3493,2573,2255,45,177,68,12,6,318
39089045AAS,1499,1141,1005,9,78,36,5,1,136
39089045AEK,2175,1769,1672,18,32,24,17,1,97
39089045ACA,2242,1669,1480,22,71,77,12,1,189
39089045ADD,1270,883,846,6,8,17,5,0,37
39089045ADZ,1264,955,892,3,8,40,0,0,63
39089045ADB,1524,1125,1056,20,16,9,21,1,69
39003002ADR,878,661,601,13,30,6,8,1,60
39003002ADQ,1040,749,698,15,18,5,3,0,51
39003002ACW,1144,917,832,26,41,11,9,0,85
39069035AAB,1079,811,675,93,14,13,17,0,136
39069035AAA,1265,941,752,114,29,43,13,1,189
39069035AAE,2186,1727,1524,149,11,27,22,0,203
39089045AFM,2048,1506,1418,16,17,49,2,1,88
39089045AFL,944,757,723,10,4,15,2,1,34
39089045ACK,1799,1382,1288,20,14,37,9,0,94
39089045ADT,2303,1817,1703,25,21,44,12,0,114
39089045ADJ,1200,953,895,10,15,15,15,0,58
39089045ADH,1491,1113,970,13,33,22,65,0,143
39003002AEO,406,294,281,6,6,1,0,1,13
39165083AFZ,1080,785,712,38,10,17,3,0,73
39165083AHE,1051,928,859,21,20,6,17,0,69
39041021ADK,1198,914,852,17,14,20,7,2,62
39041021ACU,1630,1183,986,21,19,5,141,0,197
39041021AFW,2262,1732,989,72,165,14,480,5,743
39041021AAA,1523,1211,678,76,112,25,314,1,533
39041021AEV,1465,1189,727,67,161,15,225,2,462
39041021ADA,295,222,208,0,8,0,0,0,14
39099050AOV,524,417,376,9,13,21,1,0,41
39099050ANG,1023,846,810,16,1,12,2,0,36
39099050AJZ,1067,920,823,23,57,9,6,0,97
39029015AAS,1163,896,845,10,7,12,6,1,51
39099050ANX,1194,988,934,17,3,20,3,0,54
39089045ABV,1568,1242,1141,24,47,21,15,0,101
39089045AEQ,1357,1068,1016,9,8,28,4,2,52
39089045ABR,1624,1278,1189,15,28,20,13,2,89
39089045AEO,1837,1451,1392,11,9,16,8,0,59
39007004AEM,807,678,621,17,16,12,5,0,57
39007004ACR,1115,762,733,2,13,9,2,2,29
39165083ADN,1003,745,708,8,9,11,7,1,37
39155078AIE,1321,1086,925,18,115,13,22,0,161
39155078AHX,1106,908,709,19,140,6,32,0,199
39029015AEO,977,787,753,9,0,17,7,0,34
39041021AFS,1932,1157,708,26,35,20,375,0,449
39041021AEZ,1105,723,483,18,35,12,175,0,240
39041021ADB,1587,993,653,26,85,3,226,1,340
39023012AEF,826,654,632,3,7,11,0,1,22
39023012AFF,976,740,675,8,24,13,8,1,65
39007004ADM,833,722,672,9,10,5,9,1,50
39007004ADV,975,769,673,28,7,22,21,0,96
39007004ADX,454,362,340,5,2,4,8,0,22
39007004ACB,972,756,705,8,16,19,1,0,51
39007004AAH,1298,981,829,46,85,16,10,0,152
39007004AAM,599,459,376,32,39,9,5,0,83
39007004ACX,687,522,430,52,9,20,0,0,92
39025013AEG,681,545,518,6,0,18,1,0,27
39025013AAF,1873,1355,1187,44,37,43,48,3,168
39025013AAM,1179,932,831,34,28,29,14,1,101
39025013AAD,1628,1226,1113,31,35,21,22,1,113
39025013AAE,2713,1880,1751,16,42,60,5,2,129
39025013AAI,1272,956,884,18,20,17,17,0,72
39025013AHB,963,733,683,8,4,23,2,0,50
39001001AAN,1987,1502,1417,9,11,54,4,0,85
39147074ABB,949,729,685,16,0,12,11,4,44
39165083ACZ,2160,1650,1577,9,16,33,12,1,73
39165083ADB,1609,1292,1206,14,20,42,9,1,86
39165083ADC,1251,1008,942,13,12,30,11,1,66
39155078AET,969,769,690,19,24,11,17,0,79
39155078AHR,923,769,720,9,5,25,6,0,49
39155078AKQ,1255,1064,1014,14,19,9,10,0,50
39155078AJW,1260,988,675,14,272,15,7,1,313
39155078AGE,1141,984,927,7,9,21,2,1,57
39155078AEI,1709,1216,498,26,672,14,9,3,718
39155078ACL,1496,1214,808,15,340,21,16,0,406
39089045ACM,2266,1721,1643,10,11,37,5,5,78
39089045ACL,1209,980,904,7,11,24,7,2,76
39089045AEC,1606,1281,1217,11,11,23,6,1,64
39089045AFA,1671,1244,1170,10,11,35,14,6,74
39049025AVA,1194,825,752,21,20,6,27,1,73
39049025AZR,1344,1025,893,22,62,7,37,3,132
39049025BKJ,1876,1705,1025,85,351,65,193,4,680
39049025BHW,2270,1818,1288,86,267,25,127,2,530
39049025BLB,2009,1850,1271,90,344,35,99,2,579
39049025BAU,1717,1205,1064,16,40,3,77,0,141
39049025BMO,1428,1005,640,60,103,16,180,0,365
39049025ASZ,1880,1486,1278,45,76,38,34,0,208
39049025AZN,789,634,593,13,9,13,3,0,41
39049025BDS,1571,1136,1014,21,44,8,38,2,122
39049025BNO,879,676,636,2,14,9,13,0,40
39049025ASW,1175,920,818,36,18,10,30,1,102
39049025AGA,1682,1460,429,47,969,20,13,3,1031
39049025BCF,1628,1151,975,31,38,14,73,1,176
39049025AUW,1540,1132,421,89,529,31,83,6,711
39049025AWV,1056,855,614,14,158,12,59,2,241
39049025AYJ,1032,739,594,21,92,12,26,0,145
39049025BMY,1103,789,195,42,535,16,20,5,594
39049025AZB,3255,1856,309,453,1094,13,29,0,1547
39049025ATA,1785,1349,1223,37,41,30,11,1,126
39049025AUA,1729,1270,1144,45,36,20,20,2,126
39049025BGB,1150,859,676,59,41,6,75,0,183
39049025BGU,1125,800,631,56,38,21,52,4,169
39153077ACA,1149,1062,427,30,579,15,12,1,635
39153077ADU,1588,1206,452,48,654,22,48,1,754
39153077AMK,1186,1023,896,20,54,21,28,0,127
39153077AZS,864,822,728,22,41,12,22,1,94
39153077BCO,1340,949,788,10,51,9,70,1,161
39153077BCP,1467,1051,805,27,69,13,128,2,246
39153077BAG,1444,1190,1061,15,36,21,41,0,129
39153077AKF,1665,1396,1102,31,98,24,130,1,294
39153077AKO,1415,1165,930,14,77,24,111,1,235
39153077ARP,865,703,629,19,25,15,13,3,74
39153077AMN,1042,860,822,9,2,11,13,0,38
39153077AVN,1340,1112,1047,12,21,20,15,0,65
39153077AWJ,1423,1089,993,12,41,19,16,0,96
39153077AWB,1801,1316,1169,25,40,31,40,3,147
39153077AVZ,1280,978,912,11,23,13,19,0,66
39153077ACZ,1036,779,49,8,703,19,5,1,730
39153077ADB,1177,919,80,17,804,18,5,1,839
39153077AYY,1068,809,54,5,738,3,9,0,755
39153077BCZ,1391,1168,1066,13,17,52,6,3,102
39153077AVI,1519,1199,1091,14,24,41,10,1,108
39049025APC,1408,1125,859,78,99,29,57,0,266
39049025AOY,1807,1322,840,189,205,45,63,0,482
39049025ADX,1455,1235,1068,40,59,19,48,0,167
39049025AIO,1213,920,577,37,248,13,43,5,343
39049025AEC,960,796,736,5,23,6,19,0,60
39049025AUQ,761,575,486,30,38,11,9,2,89
39049025AUP,1307,1031,668,47,193,24,97,1,363
39049025ATD,1436,1164,1085,19,19,13,25,1,79
39089045AFZ,2000,1340,1219,37,27,28,22,0,121
39089045AEG,2007,1584,1430,62,16,54,17,2,154
39089045AEF,1494,1211,1111,27,11,35,19,3,100
39153077AKG,1757,1574,1262,38,122,31,112,0,312
39153077BBC,923,719,534,5,123,6,39,0,185
39153077BDA,1164,803,466,19,244,7,68,0,337
39153077ANH,1102,867,647,16,122,10,71,2,220
39153077ANE,1586,1247,835,33,264,17,86,2,412
39153077AXI,1270,904,778,17,19,6,73,1,126
39153077AVY,1106,701,139,23,524,9,18,3,562
39153077BBE,735,604,497,11,69,6,20,0,107
39021011AAK,1526,1194,1053,22,72,42,4,2,141
39051026ABK,1262,1018,921,29,8,43,1,1,97
39051026AAZ,1929,1518,1389,74,17,30,5,2,129
39153077AZF,1440,1097,569,28,427,35,25,2,528
39153077AEQ,1518,1201,1033,15,78,25,44,0,168
39153077AZJ,1386,1132,984,21,69,17,34,0,148
39153077ASR,1249,1089,990,10,29,28,14,0,99
39153077AYZ,1297,1105,368,14,676,18,34,1,737
39153077ACY,1308,1149,673,20,420,11,17,0,476
39153077AQY,1259,1081,693,21,327,9,29,0,388
39153077BCI,1100,898,662,21,153,27,45,2,236
39153077BCE,1210,937,723,24,123,19,53,1,214
39153077AJW,1273,1023,915,10,58,23,5,0,108
39153077AJV,1375,1093,1018,13,25,23,6,3,75
39153077BAE,1387,1078,988,8,37,34,6,0,90
39153077AEG,1410,1125,972,25,73,35,16,0,153
39153077AIN,1548,1211,905,27,204,48,33,2,306
39153077AEH,1485,1207,993,29,124,27,15,2,214
39153077BAA,1596,1239,982,27,176,23,24,1,257
39153077ADT,1202,870,386,43,395,22,35,0,484
39153077AZM,1296,968,428,47,456,26,19,2,540
39153077AYT,2041,1778,958,37,689,24,71,0,820
39109055AAS,1697,1292,1191,32,24,18,28,2,101
39109055ACE,1268,1031,938,28,24,12,27,1,93
39109055AAT,1731,1327,1230,18,30,21,25,0,97
39093047ALK,958,871,809,18,22,13,12,0,62
39093047AHA,1257,987,892,28,25,11,23,1,95
39093047AHM,969,803,677,35,59,10,40,1,126
39099050AKK,1344,1077,846,57,123,36,26,4,231
39099050AMB,1262,1031,669,33,305,9,18,2,362
39093047ACN,1367,1144,1019,60,43,9,9,0,125
39025013ABC,1117,882,806,18,8,30,7,2,76
39007004ADD,1624,1179,1128,10,8,22,1,0,51
39007004ACW,818,650,577,17,9,30,4,2,73
39007004ACY,916,758,671,28,18,22,4,1,87
39007004ABV,766,606,532,45,11,10,2,0,74
39007004ABQ,705,532,474,16,10,16,6,0,58
39025013AFV,1590,1249,1172,11,26,18,12,2,77
39089045AEI,1175,863,809,27,11,14,3,2,54
39089045AFT,1730,1299,647,57,475,46,65,3,652
39089045AFS,1978,1499,921,36,292,17,228,1,578
39089045AEA,2120,1595,1513,13,16,38,10,1,82
39067034AAM,726,543,527,0,0,11,2,1,16
39067034AAE,1659,1324,1172,9,104,21,9,0,152
39067034AAG,1728,1394,1215,16,110,26,13,1,179
39175088ABL,1462,1131,1077,22,8,12,4,2,54
39087044ADE,780,590,558,8,6,17,0,0,32
39087044AAG,242,212,195,5,9,2,0,0,17
39047024AAO,1109,863,790,12,41,13,10,0,73
39047024AAN,1499,1221,1128,13,29,29,15,0,93
39151076AKF,1130,900,852,9,1,23,2,1,48
39151076ABH,997,661,447,48,116,34,8,1,214
39151076ALC,1942,1562,1383,42,71,50,4,0,179
39151076AAZ,2003,1418,851,157,379,83,6,3,567
39151076ABA,1048,799,421,62,282,45,5,0,378
39151076AIK,957,753,710,8,16,7,9,0,43
39151076AAS,913,753,677,10,36,12,6,2,76
39151076AAD,981,714,395,13,276,18,10,0,319
39151076AAQ,858,728,660,8,30,10,18,0,68
39151076AJB,1329,1096,1016,15,42,18,11,0,80
39151076AIO,950,759,728,2,6,9,5,1,31
39151076AOZ,1720,1387,1319,8,7,24,15,0,68
39049025AEK,1790,1416,791,51,479,28,64,1,625
39049025BNL,1183,941,460,44,309,23,115,6,481
39049025AJU,2192,1553,885,48,286,31,306,0,668
39049025BAG,1923,1404,1026,53,287,45,12,0,378
39049025BIQ,1657,1514,1003,59,403,32,32,1,511
39049025BAH,1523,1108,769,52,248,29,9,2,339
39049025AWK,1051,818,730,31,22,9,22,0,88
39049025BNG,886,810,579,38,113,8,71,3,231
39049025BCA,1264,1130,769,47,219,20,88,0,361
39049025BME,1445,1249,774,53,291,27,116,1,475
39049025BKI,1410,1051,753,30,82,13,168,0,298
39049025BAV,465,352,320,6,11,8,2,1,32
39049025ABN,691,554,119,20,404,8,7,0,435
39049025AHI,2200,1597,432,129,994,46,24,1,1165
39049025AJP,2646,2161,615,203,1283,36,48,2,1546
39049025BNS,784,593,465,19,75,4,33,0,128
39049025AHO,2610,1877,1123,213,478,45,55,6,754
39049025AGT,2507,1796,957,309,471,47,33,9,839
39049025ACO,1396,1051,650,145,191,31,45,2,401
39049025AMS,1987,1416,998,104,216,38,50,1,418
39049025AHP,3049,1930,662,183,1030,33,54,6,1268
39049025ACN,2644,1478,455,238,703,42,50,1,1023
39049025AHR,2408,1824,830,503,450,37,49,6,994
39049025AWZ,1914,1483,1178,70,156,30,67,8,305
39049025BDL,1869,1386,836,63,396,35,56,2,550
39049025AXC,1302,1055,943,26,56,12,18,0,112
39011006AAA,1465,1124,1082,8,12,10,13,1,42
39011006AAG,1553,1201,1138,20,8,10,16,1,63
39007004AAY,1154,836,612,95,103,23,3,3,224
39079040ABN,796,600,588,0,5,6,0,0,12
39093047ADQ,1198,926,782,76,52,6,9,0,144
39093047AKP,2610,2094,1947,52,39,45,6,0,147
39093047AKN,1341,1068,1019,15,8,15,6,0,49
39093047ACP,1833,1486,1077,121,238,32,27,1,409
39093047AHD,1139,924,839,27,15,25,13,0,85
39093047AGZ,1940,1502,1287,76,63,18,39,1,215
39093047AGO,1769,1452,1332,57,25,31,9,3,120
39143072ACP,562,453,394,32,20,0,4,0,59
39153077AYR,1301,984,174,18,785,12,2,1,810
39153077ABW,1356,909,144,23,721,21,13,2,765
39153077BAU,1198,952,898,10,10,17,5,0,54
39153077AWM,1365,1064,1004,7,17,9,11,0,60
39153077AWX,1232,985,884,21,21,28,34,0,101
39153077AZY,1470,1196,942,18,178,24,17,6,254
39153077AIM,1540,1227,952,27,199,29,17,2,275
39153077BBN,1190,960,901,5,8,22,12,0,59
39153077ATC,1248,994,958,6,2,18,2,0,36
39051026AAA,1878,1387,1305,31,1,31,10,0,82
39175088AAO,853,642,627,3,2,6,2,0,15
39131066AAS,915,657,637,3,3,13,0,0,20
39151076ABQ,1438,807,249,36,500,29,2,0,558
39151076AEB,1341,1107,970,26,81,14,7,2,137
39151076ABB,1106,991,637,19,304,25,9,2,354
39151076AMP,1837,1341,1196,33,65,22,13,0,145
39145073ACR,1071,829,789,5,0,28,1,0,40
39175088ABM,1086,856,833,10,0,9,2,0,23
39175088AAY,596,442,428,10,1,3,1,0,14
39089045ACV,1338,975,876,19,13,22,26,3,99
39079040AAC,1446,1081,1013,7,21,26,7,0,68
39079040ABC,1124,882,849,1,5,20,8,0,33
39089045AAJ,3513,2626,2242,40,214,95,20,0,384
39089045ADX,1916,1457,1364,13,32,28,2,1,93
39089045ABF,1435,1121,1008,26,34,36,17,0,113
39049025AEI,1968,1717,1376,72,161,29,77,2,341
39049025AWC,1334,1018,789,28,17,12,168,1,229
39049025AOA,1442,1252,906,60,118,19,140,1,346
39049025BJX,1163,956,747,59,40,15,78,2,209
39049025BHC,1979,1504,1319,56,40,24,63,2,185
39049025BNE,664,607,474,19,75,9,20,1,133
39049025BHZ,1622,1456,1119,68,149,11,97,1,337
39049025AQX,1661,1321,784,40,206,17,268,1,537
39049025BMM,802,652,564,3,28,6,44,1,88
39049025AKQ,1230,912,177,35,690,24,13,3,735
39049025AOT,2122,1480,396,116,915,26,46,0,1084
39049025AYQ,2009,1495,1056,66,245,23,97,3,439
39049025ALM,2459,1655,365,225,966,37,74,0,1290
39049025AOW,1488,1146,643,69,401,16,39,1,503
39049025AYS,942,707,643,18,16,10,14,1,64
39049025AUD,2582,1648,1267,46,64,24,241,1,381
39049025BGA,1865,1382,1102,41,75,13,145,1,280
39049025BKP,1305,944,832,21,34,8,48,1,112
39049025AUG,1898,1352,1067,43,47,26,166,0,285
39049025BJJ,1088,841,615,73,108,49,9,2,226
39049025AKH,1246,944,138,60,679,15,58,2,806
39049025AQA,1337,1122,832,57,130,18,80,0,290
39049025BNI,1244,1220,973,56,116,13,54,1,247
39049025ACV,1139,1071,869,57,77,12,48,3,202
39073037AAV,1042,849,811,4,5,17,7,0,38
39073037AAT,1445,1111,1070,1,9,13,14,0,41
39041021AFN,1712,1256,853,64,108,9,217,2,403
39015008ACR,1330,1023,967,8,10,24,3,1,56
39087044AAI,310,217,197,0,12,3,2,0,20
39087044AAK,321,241,213,2,15,5,0,0,28
39087044AAM,181,161,141,1,14,4,1,0,20
39023012AED,1706,1276,1195,1,25,32,5,2,81
39023012AGE,1971,1782,1586,23,112,14,34,0,196
39023012AEV,572,461,410,12,17,8,16,1,51
39041021ABB,1196,872,761,16,19,11,62,0,111
39023012AAH,1253,932,733,57,112,30,4,0,199
39151076ALP,1743,1430,1281,23,61,28,18,1,149
39151076ACG,2225,1652,1023,115,438,91,3,0,629
39151076AKT,1834,1485,1403,18,41,20,1,2,82
39151076AHC,1074,937,817,23,69,13,18,0,120
39065033ABE,2301,1772,1685,27,18,37,7,1,87
39065033ABH,874,683,647,7,5,13,0,0,36
39015008AAF,1658,1326,1264,14,10,28,2,2,62
39023012AEB,1528,1170,1106,11,9,20,6,3,64
39023012ADZ,2124,1717,1603,21,28,46,10,1,114
39023012ABK,1475,1257,961,62,140,7,87,0,296
39023012AAO,2159,1556,1196,90,209,52,5,2,360
39155078AJD,1166,1004,949,6,13,16,4,1,55
39155078AJK,1493,1108,1034,19,13,20,7,0,74
39155078AJU,1226,988,917,7,14,35,2,0,71
39155078AEL,2770,2424,1309,74,998,32,7,3,1115
39155078AGY,1234,988,900,11,34,16,25,3,88
39155078AGW,729,618,575,6,23,10,2,1,43
39145073ACQ,806,622,588,4,2,17,1,1,34
39145073ACU,1398,1079,1012,19,28,17,0,2,67
39145073ACW,899,705,676,3,7,8,4,2,29
39145073AAA,953,755,607,15,115,13,3,0,148
39145073AAC,1111,915,804,15,60,17,16,1,111
39145073AAB,1032,905,807,21,49,16,5,0,98
39145073AEC,668,521,490,14,2,5,2,0,31
39001001AAP,1774,1340,1272,9,9,44,4,0,68
39001001AAG,898,724,672,1,1,31,4,0,52
39037019AAG,984,757,696,7,18,23,6,0,61
39161081AAV,650,501,473,9,4,7,3,0,28
39161081ABF,1001,764,702,31,5,14,2,1,62
39161081ABO,768,586,555,5,6,8,3,0,31
39011006AAW,1231,924,821,27,20,19,34,2,103
39137069ABH,2160,1573,1473,64,8,23,3,1,100
39071036AAJ,2226,1677,1518,23,61,50,17,5,159
39023012AEK,1657,1244,1170,15,23,15,15,1,74
39023012ADF,1196,993,913,30,8,31,4,1,80
39169085ACE,1982,1625,1532,18,7,42,10,3,93
39153077ARK,1187,921,857,10,8,11,25,0,64
39153077ARD,1218,962,874,21,26,7,21,0,88
39039020AAW,1228,952,896,34,6,10,4,0,56
39039020ABT,1225,957,907,30,2,13,3,2,50
39039020ABO,707,540,477,38,2,8,7,1,63
39039020AAM,1408,1114,776,189,109,24,23,0,338
39039020ABK,1120,819,767,27,4,13,2,0,52
39153077AZI,1428,1202,1090,10,56,18,19,4,112
39153077AEF,1562,1274,1104,27,80,35,19,1,170
39153077AIG,1768,1235,697,21,412,26,68,1,538
39153077ABE,989,776,453,24,167,19,114,0,323
39153077ADD,1025,843,25,9,811,3,2,0,818
39153077AZB,1156,868,32,17,810,8,4,0,836
39153077AUF,1104,925,842,8,46,8,16,0,83
39153077BCS,1066,908,844,4,24,25,18,0,64
39153077BCT,1063,876,785,14,43,12,26,0,91
39153077AYA,1152,810,735,9,5,3,54,1,75
39153077BBB,1107,834,732,28,11,10,42,0,102
39153077AZD,1238,924,449,31,392,28,42,5,475
39153077BBW,1470,1142,1006,25,39,26,40,0,136
39153077APB,1384,1089,957,19,60,21,34,0,132
39153077AVH,1665,1304,1168,24,48,40,17,0,136
39153077AZU,1734,1404,1168,26,151,38,3,0,236
39153077ARS,1197,982,919,4,10,26,4,0,63
39055028ABI,1278,1051,1014,13,7,12,1,0,37
39043022ACX,1609,1279,1199,18,10,27,12,0,80
39055028ACO,1059,784,730,15,0,9,18,1,54
39055028ACU,887,743,695,10,8,4,10,0,48
39019010ABG,1157,949,910,9,5,15,6,2,39
39019010ABH,934,747,701,9,2,22,2,0,46
39019010AAY,1029,838,811,2,4,12,7,0,27
39055028ABT,1258,1048,973,20,15,26,6,4,75
39065033AAQ,529,423,397,10,5,6,3,0,26
39149075AAL,785,643,607,10,13,3,4,4,36
39149075AAF,1790,1367,1219,12,50,22,66,0,148
39133067ACG,1714,1378,1043,22,214,20,69,0,335
39153077AMC,1249,1016,863,22,54,21,52,3,153
39153077BAP,1153,940,855,20,22,21,22,0,85
39153077ALE,1320,1172,916,20,132,24,68,3,256
39153077AME,1461,1200,1048,16,80,16,31,1,152
39153077AYQ,1775,1245,457,113,299,21,358,2,788
39153077ABK,1434,1088,694,39,255,16,89,0,394
39153077AFK,1515,1117,777,24,250,34,34,0,340
39153077AZO,1377,1077,699,23,297,19,42,1,378
39153077AFL,1405,1060,620,33,339,44,51,0,440
39153077AZN,1591,1272,715,30,387,52,99,2,557
39153077ABJ,1839,1400,663,43,220,9,450,7,737
39153077ACB,1011,773,117,17,624,14,4,4,656
39153077ACC,1030,786,44,26,716,11,8,2,742
39153077BCH,1183,983,796,18,107,4,57,2,187
39153077AQV,1184,929,776,6,88,6,48,1,153
39143072ABH,1058,784,626,73,44,23,9,2,158
39143072ADJ,1010,785,723,34,2,20,3,0,62
39087044ABA,211,159,156,0,0,2,0,0,3
39087044ABP,204,171,164,2,2,4,0,0,7
39087044AAC,511,429,410,0,9,7,1,0,19
39015008ACK,694,542,515,1,0,11,6,0,27
39123062AAD,1531,1195,1039,80,24,30,13,2,156
39123062AAW,1272,1019,952,34,4,21,5,1,67
39123062ABC,927,836,817,9,0,2,3,0,19
39123062AAL,1387,1126,941,77,63,28,12,0,185
39123062ACL,1217,1028,925,71,11,5,10,1,103
39123062ABP,932,757,680,59,3,8,2,0,77
39133067AFQ,1192,951,878,14,12,17,17,0,73
39159080ABZ,1300,859,767,23,28,7,30,0,92
39151076ANC,849,685,616,10,32,16,7,1,69
39151076ALN,1932,1501,1384,17,44,29,11,0,117
39151076AOQ,1566,1323,1198,12,80,26,5,0,125
39151076ALO,880,688,624,22,17,18,2,0,64
39151076ABN,1754,1460,1208,19,198,19,7,0,252
39151076AOT,1215,968,902,12,14,24,3,2,66
39105053ABA,683,538,516,2,5,13,1,0,22
39105053AAZ,868,671,648,6,0,8,3,1,23
39105053AAF,897,703,675,3,3,17,1,1,28
39157079ADT,867,642,611,5,2,14,0,0,31
39151076AAW,2132,1562,1104,65,339,30,12,7,458
39137069AAV,1229,907,755,117,22,12,4,1,152
39161081ABK,665,483,461,4,2,8,4,0,22
39161081ABL,566,406,388,10,2,5,3,1,18
39161081AAG,768,556,464,31,35,14,4,6,92
39161081AAF,851,648,553,38,28,17,0,0,95
39161081AAS,592,484,451,14,10,0,2,4,33
39099050AKW,667,555,516,21,6,3,4,0,39
39029015AEZ,1206,896,841,8,14,21,2,0,55
39029015ABX,938,736,702,8,6,11,3,0,34
39029015AAL,1798,1385,1230,16,73,43,4,0,155
39029015AAK,967,759,698,3,41,15,3,1,61
39029015ABY,1528,1180,1124,12,6,25,4,0,56
39099050AOA,1076,876,811,8,4,28,9,0,65
39099050AAB,992,696,284,120,296,10,5,1,412
39029015AFE,822,610,570,7,3,17,4,0,40
39029015ADP,929,732,702,3,10,7,3,0,30
39043022AED,1928,1564,1039,82,413,40,10,0,525
39043022AEH,1901,1342,928,74,288,51,13,1,414
39055028ACK,2518,1511,1492,7,2,3,3,1,19
39055028ACL,1928,1279,1246,2,5,17,4,0,33
39055028AAB,1239,975,898,24,12,22,10,0,77
39043022AEE,1848,1341,897,81,322,42,13,0,444
39143072AAO,1133,843,556,154,91,43,6,0,287
39143072ACX,1523,1189,1095,38,9,29,6,2,94
39111056AAI,1253,1028,962,12,5,21,13,2,66
39111056AAG,957,728,708,2,1,6,2,0,20
39151076AEM,2225,1652,1434,42,106,55,14,3,218
39161081ABI,946,717,670,26,5,6,1,0,47
39011006AAM,783,588,556,11,6,15,5,0,32
39161081AAY,786,603,571,9,6,10,1,3,32
39161081AAL,779,625,573,17,17,15,1,1,52
39161081AAP,695,528,470,20,13,8,5,1,58
39011006AAC,962,717,684,15,4,9,4,0,33
39041021AGH,1041,756,629,13,24,2,87,1,127
39041021ACG,915,730,638,5,31,9,40,0,92
39041021ACF,1126,876,759,12,55,9,30,0,117
39041021AEE,1422,947,838,13,45,9,30,0,109
39157079ABY,1261,823,803,11,2,6,0,0,20
39157079ABX,681,492,471,6,2,7,4,0,21
39017009AJW,1331,967,811,17,55,3,75,0,156
39125063AAJ,1334,1022,959,22,17,16,5,0,63
39133067AAM,1242,950,879,19,17,16,9,1,71
39085043AFA,1664,1312,1215,22,30,28,15,0,97
39149075ABZ,1087,871,827,11,14,12,3,0,44
39149075AAZ,957,841,802,9,18,10,5,1,39
39149075AAS,1659,1200,1044,33,57,56,9,0,156
39149075AAB,1620,1239,1104,32,58,21,22,4,135
39149075AAY,1189,950,847,10,40,16,25,3,103
39049025BNB,896,791,577,40,119,15,45,1,214
39159080ABT,812,642,616,9,3,9,3,1,26
39159080AAZ,954,702,675,4,1,20,2,0,27
39157079ACX,958,734,709,4,3,9,2,0,25
39157079AAK,884,672,618,34,9,7,10,0,54
39055028ACE,1236,991,956,6,8,4,14,0,35
39055028ACB,1400,1153,1007,66,31,17,19,0,146
39055028ACR,1176,955,870,12,18,15,28,1,85
39041021AAO,1157,990,826,84,54,14,8,0,164
39023012AEI,1351,1071,1008,12,15,20,13,1,63
39023012AFQ,1260,1036,986,6,18,22,2,1,50
39023012AAJ,1309,1015,839,51,84,38,7,1,176
39173087AAS,1176,877,776,38,21,11,26,0,101
39173087ADV,669,540,508,14,4,10,3,1,32
39029015ABZ,1076,835,809,6,5,8,0,0,26
39029015AEJ,1354,1101,1039,6,22,24,9,2,62
39099050AFR,1069,789,105,76,599,17,3,3,684
39037019ABU,1286,978,927,18,6,11,3,0,51
39037019ABC,1086,853,798,29,5,8,5,4,55
39037019AAJ,1006,727,641,16,18,23,18,3,86
39041021ACD,893,720,612,11,44,13,43,1,108
39041021AFQ,729,577,487,11,37,7,34,0,90
39041021AAM,1520,1409,1083,72,152,16,77,1,326
39041021AAL,1157,924,758,38,65,32,18,8,166
39143072ADB,759,585,529,39,6,17,0,0,56
39023012AEG,1098,909,835,14,13,17,13,0,74
39049025ADA,2328,2283,1894,99,99,22,155,9,389
39049025BBM,1799,1431,904,178,289,32,43,2,527
39049025BBK,2033,1527,1030,304,111,56,51,1,497
39049025BBL,1158,914,734,79,53,38,7,1,180
39049025BBP,668,522,465,18,16,14,10,0,57
39049025APA,1469,1076,503,168,361,28,41,1,573
39049025ADM,2460,1610,177,101,1320,36,9,3,1433
39049025AAN,1657,1352,1068,52,169,28,19,2,284
39049025AAZ,2157,1568,695,153,651,46,41,0,873
39049025ASR,1352,1011,807,26,118,6,50,2,204
39099050AEX,1126,897,431,57,411,24,3,0,466
39029015AED,891,756,711,5,8,19,11,0,45
39029015ABR,1302,1035,899,5,100,15,7,0,136
39029015ABQ,487,386,339,2,21,11,1,0,47
39041021AAW,1721,1379,1189,65,59,37,22,1,190
39023012ABC,1345,1067,946,32,52,25,11,4,121
39041021ABL,1793,1288,1111,22,54,34,64,0,177
39041021AEY,1447,1049,776,31,28,10,197,0,273
39041021AFF,1672,1132,960,34,41,11,89,0,172
39041021ACA,1019,786,696,21,14,11,43,2,90
39041021AFV,1023,644,521,17,37,13,54,2,123
39017009AKO,1245,968,889,26,25,15,9,0,79
39017009ALX,1205,1033,956,17,26,15,9,2,77
39017009AKN,2187,1594,1290,41,118,43,102,5,304
39017009AFA,1817,1715,1244,80,110,11,272,1,471
39017009AED,1162,966,822,13,72,23,28,0,144
39017009ABH,1521,1246,934,28,187,19,62,2,312
39017009AAN,1305,1045,716,46,215,30,38,2,329
39017009ADB,1569,1191,949,92,103,28,13,14,242
39017009ADL,1711,1344,1235,24,41,35,5,1,109
39017009ADI,1307,1029,920,21,64,13,7,1,109
39173087AAF,1516,1317,1029,108,83,28,74,1,288
39071036ABL,1356,924,879,4,11,22,2,0,45
39161081ABJ,734,576,571,0,0,1,3,0,5
39161081AAE,638,498,463,16,8,7,1,1,35
39161081AAC,771,594,567,4,4,15,2,0,27
39011006AAB,987,696,658,15,11,13,2,0,38
39039020AAE,1578,1232,967,168,61,24,11,3,265
39039020ABJ,902,644,604,33,4,5,0,2,40
39039020ABR,1586,1231,1153,44,8,23,2,1,78
39065033AAN,1057,734,713,5,2,10,0,0,21
39065033AAJ,1489,1180,1105,19,11,28,9,7,75
39071036AAS,1499,1130,1087,8,12,22,4,0,43
39071036ABO,1542,1122,1051,8,13,43,4,0,71
39039020AAI,1693,1302,1053,199,27,27,4,2,249
39039020ABH,1140,901,810,55,11,27,3,0,91
39125063AAE,700,484,444,23,9,12,1,0,40
39125063AAX,978,705,656,37,3,18,1,1,49
39125063AAU,950,684,653,12,5,8,6,0,31
39039020AAF,1214,880,652,162,43,20,8,4,228
39051026ABF,1731,1318,1227,40,7,30,6,2,91
39051026ABI,1090,846,696,116,8,24,2,1,150
39051026AAE,1743,1339,1198,101,7,20,6,0,141
39051026AAD,1025,827,764,39,11,6,2,0,63
39153077AZC,1060,759,154,30,542,17,18,0,605
39153077ADV,1145,847,301,32,479,22,22,1,546
39153077ADO,1186,887,288,23,508,9,50,1,599
39153077AHC,1243,1016,854,6,71,4,68,0,162
39153077ARH,1161,937,853,24,23,2,22,0,84
39153077APS,1391,1047,685,27,247,21,70,0,362
39017009AIX,1508,1132,773,69,142,10,143,1,359
39173087ACR,929,716,657,33,8,6,3,2,59
39173087AAB,1535,1434,1142,98,95,22,71,4,292
39153077ALN,1240,941,679,37,161,21,40,0,262
39153077AMO,2078,1518,1250,20,70,32,133,0,268
39039020AAZ,892,677,630,26,2,18,4,1,47
39125063AAM,1676,1230,1148,40,8,33,0,0,82
39071036AAL,1276,1012,875,11,97,13,9,2,137
39071036ABF,1601,1268,1202,10,14,28,8,0,66
39125063ABD,1250,976,833,89,23,23,4,0,143
39125063AAO,1253,982,892,43,12,30,3,0,90
39153077BCQ,1465,1242,1152,5,28,30,6,2,90
39153077AFF,1489,1187,879,27,231,34,22,1,308
39153077AFO,1413,1165,931,17,132,29,44,1,234
39071036ABB,679,549,525,3,3,12,4,0,24
39153077BBK,804,634,559,6,13,21,26,0,75
39137069AAK,1675,1225,1101,102,0,15,1,2,124
39153077ALF,1213,981,913,8,15,17,27,0,68
39153077BAL,1160,971,883,35,13,13,23,0,88
39153077AWP,1450,1052,953,19,25,14,33,1,99
39153077BAT,1378,1045,976,13,13,25,7,0,69
39153077AJT,1394,1097,887,25,115,56,6,0,210
39153077AJR,1274,991,833,16,88,39,4,3,158
39153077ADY,1297,880,215,16,623,16,20,1,665
39153077AZE,1269,826,131,42,649,13,14,1,695
39017009ABT,1486,1099,887,61,113,36,13,2,212
39017009ABS,1362,1041,824,62,93,48,4,1,217
39017009ADR,1126,824,338,94,405,24,3,1,486
39017009AHK,994,812,766,13,3,17,5,2,46
39137069AAC,1427,1033,1005,20,1,5,2,0,28
39137069ABF,1634,1207,1182,14,2,7,3,1,25
39153077BAK,1336,1058,939,27,34,19,32,1,119
39153077AFS,1491,1139,861,21,208,24,21,0,278
39153077AWN,1209,975,898,9,15,17,25,1,77
39153077AWQ,1333,1037,970,8,18,23,18,1,67
39051026AAF,1348,1033,878,123,4,20,9,0,155
39153077BCL,1355,1044,951,12,18,9,37,1,93
39153077ALA,1167,944,875,16,18,10,15,0,69
39153077BAJ,1386,1111,908,27,81,26,59,0,203
39153077AKZ,1233,987,907,14,16,23,21,0,80
39153077AYP,1643,1292,808,59,164,18,233,0,484
39153077ABH,1940,1467,712,83,209,29,456,3,755
39051026AAK,1621,1261,1126,92,2,22,5,0,135
39029015ADB,1148,895,867,6,11,4,0,1,28
39071036ABC,1053,805,764,8,4,18,5,2,41
39031016ABF,1554,1233,1190,9,10,21,1,0,43
39031016ABI,2417,1809,1744,12,18,34,2,2,65
39031016AAK,967,707,668,1,14,15,4,0,39
39031016AAD,1165,991,904,14,34,23,17,1,87
39031016AAI,1409,1161,1113,10,22,5,7,0,48
39031016ABG,1324,981,944,0,2,32,1,0,37
39061031AOM,1518,1145,857,56,185,40,17,2,288
39061031ARJ,1524,1151,438,106,535,18,63,1,713
39061031BJL,1284,975,692,27,208,29,1,1,283
39061031AVZ,1546,1184,991,32,112,26,21,0,193
39061031AQE,1921,1488,896,67,482,28,11,0,592
39061031ADW,1925,1639,1441,37,66,12,78,1,198
39061031ATG,977,735,631,26,27,7,37,0,104
39061031AZS,973,756,674,32,12,12,22,1,82
39061031AEH,900,787,653,23,69,5,40,1,134
39061031AEM,1047,933,541,29,315,19,26,2,392
39061031AVW,1004,767,446,36,213,19,51,4,321
39061031BDI,506,390,333,9,16,10,17,1,57
39061031AYQ,1103,729,611,18,70,10,27,0,118
39061031AIU,584,451,375,20,42,3,11,0,76
39061031BFW,2004,1507,544,33,894,18,16,0,963
39061031BMR,1037,809,676,22,32,4,66,0,133
39061031BMT,1087,863,644,10,120,6,78,1,219
39061031BAM,1118,822,736,12,32,10,30,2,86
39061031BBN,1746,1337,803,40,422,38,46,5,534
39061031AZA,1614,1188,1112,10,9,14,34,6,76
39061031AZC,1584,1176,1063,27,30,22,24,0,113
39061031AUE,1757,1357,764,80,464,37,12,1,593
39061031ATN,1552,1170,1010,22,49,14,74,2,160
39061031BMQ,1690,1278,1148,23,32,3,63,1,130
39077039ABW,811,604,547,47,4,4,4,3,57
39013007AAF,1534,1227,1106,8,80,26,2,0,121
39013007AAX,686,554,542,0,5,8,0,0,12
39013007AAU,463,370,354,3,3,7,1,0,16
39061031AUO,1865,1370,553,30,725,47,27,5,817
39061031AIX,1179,995,411,39,511,23,20,1,584
39061031ABY,1731,1584,886,40,532,27,111,1,698
39061031BCG,1789,1439,1230,25,103,26,51,0,209
39005003ABS,1564,1217,1135,20,9,24,12,2,82
39013007ABD,414,335,323,2,4,8,1,0,12
39013007ABY,421,341,312,6,9,6,3,0,29
39127064AAX,833,662,617,4,3,33,3,1,45
39083042ABV,549,385,358,6,5,10,0,0,27
39083042ACA,860,684,674,1,4,4,0,0,10
39127064AAC,1565,1192,1155,3,10,20,3,0,37
39083042ABA,976,731,702,3,2,15,4,0,29
39061031AKZ,869,528,258,40,225,16,4,2,270
39129065AAE,1357,1033,950,11,36,15,5,0,83
39129065ACC,5268,4732,3229,67,1379,32,21,2,1503
39129065ACE,1338,876,767,29,32,31,14,1,109
39081041AAF,1487,1171,923,23,191,17,13,5,248
39081041AAS,1030,827,740,17,50,12,8,1,87
39103052AAU,1605,1259,1120,55,46,14,23,0,139
39103052AES,1558,1324,1228,37,14,18,24,3,96
39103052AEQ,1345,1092,1026,18,7,5,23,0,66
39127064AAK,1475,1052,992,11,6,29,2,1,60
39127064AAI,806,625,597,1,6,13,1,0,28
39127064AAG,860,692,665,0,2,21,0,0,27
39127064AAV,1356,1027,982,3,3,28,0,0,45
39009005AAE,1602,1595,1114,70,378,26,13,1,481
39103052AAQ,2004,1577,1391,47,53,32,42,0,186
39103052AGC,1619,1083,975,29,11,11,52,0,108
39103052AAG,1629,1208,1129,20,27,16,14,0,79
39103052AER,1551,1317,1234,22,5,11,33,1,83
39103052AEW,992,840,784,15,8,12,17,0,56
39063032ACE,1283,927,893,11,5,12,4,1,34
39063032AAW,876,724,588,62,32,14,27,1,136
39063032AAX,1113,858,786,37,18,16,5,0,72
39063032ABM,924,754,658,40,17,17,24,0,96
39103052AEJ,1651,1339,1281,15,9,17,0,0,58
39121061AAH,303,246,241,2,1,3,1,0,5
39083042AAX,679,651,527,45,17,3,38,0,124
39083042ACH,927,902,695,61,37,3,69,0,207
39083042ACG,607,595,462,40,32,3,29,0,133
39119060AAZ,1286,1012,955,2,17,29,8,0,57
39119060ABL,1103,931,864,2,46,7,13,0,67
39119060ACA,228,173,159,1,6,12,1,0,14
39119060AAO,1390,1122,994,12,76,14,24,0,128
39115058AAB,1059,853,800,3,25,20,4,0,53
39059030ABX,1258,909,874,6,1,15,7,0,35
39135068AAY,1007,785,735,16,3,23,3,0,50
39135068ABA,680,542,499,13,13,11,5,0,43
39135068AAM,842,644,623,4,4,6,1,0,21
39035018BCZ,1482,1111,655,257,170,37,18,7,456
39035018CIP,2427,1968,1299,187,309,41,124,2,669
39035018CIV,1917,1497,1277,98,65,10,35,3,220
39035018BTM,1312,954,395,17,517,15,9,0,559
39035018BTN,1624,1216,546,55,588,12,23,0,670
39035018BTG,2005,1415,569,68,756,23,5,0,846
39035018AYT,681,656,254,23,343,10,21,0,402
39035018AOD,1599,1531,398,67,578,13,481,1,1133
39035018CGX,1313,1045,672,128,188,17,38,0,373
39035018CGY,1287,1046,857,65,73,27,35,1,189
39035018CHG,1757,1527,1104,90,198,26,109,0,423
39035018AGJ,1461,1154,867,159,88,37,28,3,287
39035018CLB,1456,1185,1025,69,41,13,12,3,160
39035018CKV,1721,1373,1227,53,28,25,28,1,146
39035018AJL,789,606,27,1,571,1,1,0,579
39035018CWQ,1128,932,561,36,285,8,40,3,371
39035018CWW,1338,1047,707,38,247,14,37,4,340
39035018AHU,1102,867,31,4,819,10,2,0,836
39035018BJG,1434,1230,1035,74,82,23,26,0,195
39035018AZM,1256,1092,802,148,95,24,30,0,290
39035018BDY,1013,879,635,111,86,35,20,0,244
39035018BIU,1226,996,616,152,161,25,38,4,380
39035018BHA,1497,1190,677,160,220,17,118,3,513
39035018ATR,631,469,0,10,466,6,0,0,469
39091046AAM,1981,1466,1211,65,102,55,35,7,255
39091046ABS,527,472,458,5,4,4,0,0,14
39035018DBX,1070,901,810,16,34,3,37,0,91
39035018AVL,986,767,38,98,670,19,3,0,729
39035018CJU,1580,1263,1148,44,39,21,11,0,115
39035018CDD,1471,1208,1096,37,11,16,49,0,112
39035018CKL,1608,1318,1203,55,17,16,15,0,115
39035018CKM,1469,1251,1156,44,11,23,14,1,95
39035018CGF,1398,1101,988,14,12,9,63,0,113
39035018CDI,1755,1410,1278,54,29,16,36,0,132
39035018BMS,1190,941,90,18,807,29,16,0,851
39035018BMR,851,660,34,11,610,10,3,3,626
39035018CMD,1647,1332,1220,38,33,27,15,0,112
39035018CWG,2137,1814,1556,61,63,13,102,0,258
39035018BXN,1594,1307,1114,66,59,12,40,5,193
39035018BYQ,1214,988,692,28,213,17,43,1,296
39035018BWH,1272,1060,926,49,39,18,28,1,134
39035018AGF,1481,1299,856,208,101,21,117,0,443
39035018AGH,1601,1298,780,221,150,18,125,0,518
39035018AEU,1450,1266,1128,25,34,10,45,2,138
39035018AEQ,1206,949,902,5,7,4,32,1,47
39035018AET,1265,998,911,21,8,1,52,1,87
39035018CFK,1156,952,877,27,9,4,29,1,75
39035018CFI,1370,1108,1021,12,5,13,54,0,87
39035018CFL,400,306,264,17,7,4,15,1,42
39035018DAJ,1159,893,696,8,106,11,67,1,197
39035018DAH,988,790,567,10,124,13,80,0,223
39035018CGL,1111,946,891,21,7,12,10,0,55
39035018CGK,1706,1353,1237,22,24,14,43,0,116
39035018CGH,1304,1104,999,30,21,13,33,0,105
39035018AMI,1247,953,30,10,905,9,7,0,923
39035018ANF,1141,904,111,14,739,9,40,0,793
39063032ABP,1279,936,887,23,8,13,6,2,49
39035018CTE,1363,1150,598,35,479,16,32,0,552
39075038AAA,2421,1638,1607,12,8,9,4,1,31
39075038AAB,2125,1426,1407,6,2,8,1,2,19
39103052AFB,1651,1341,1147,40,42,26,74,0,194
39103052AFK,1107,818,786,4,3,8,14,0,32
39103052ADY,1211,962,916,8,1,11,14,0,46
39045023AAY,1459,1164,1073,15,23,38,8,2,91
39045023AAG,1639,1255,1164,15,24,35,8,0,91
39045023ADA,1188,947,894,8,6,16,17,2,53
39063032AAU,1532,1185,955,113,53,33,32,1,230
39035018BVP,1336,1158,1023,42,52,7,28,0,135
39035018BUL,1382,1093,480,56,505,14,39,2,613
39035018BUJ,1819,1380,654,52,630,32,24,2,726
39035018AEZ,1600,1201,1112,15,6,20,49,0,89
39035018AEY,1391,1013,884,25,15,12,74,0,129
39153077AUQ,1270,999,909,8,32,12,32,1,90
39153077AUM,1353,1081,997,21,28,9,24,0,84
39035018CQV,1039,849,139,21,679,3,11,0,710
39035018CQU,1499,1332,631,19,634,15,44,3,701
39035018CRE,1314,925,765,28,72,4,47,1,160
39035018BGO,1767,1253,586,259,326,28,68,1,667
39035018BBZ,1601,1238,671,347,194,22,16,1,567
39035018BAM,1250,1049,659,245,111,30,39,0,390
39061031ADC,2209,1690,435,27,1176,19,47,3,1255
39061031ACZ,1412,1057,134,33,884,18,5,2,923
39061031AVV,1911,1544,1314,38,119,41,26,4,230
39061031BAT,823,638,448,13,152,14,3,1,190
39061031BCS,1848,1377,727,89,502,38,40,3,650
39061031ADS,1503,1239,1058,37,79,22,37,0,181
39045023ACV,1770,1287,1223,13,4,32,1,0,64
39091046ABM,2153,1606,1517,12,5,30,16,0,89
39075038AAU,2415,1636,1578,16,7,25,9,4,58
39033017AAT,1066,901,863,1,14,18,6,0,38
39103052AAJ,1888,1514,1397,28,16,30,27,2,117
39103052AAL,2133,1784,1603,47,46,14,53,0,181
39103052ADN,910,748,706,6,3,16,8,0,42
39061031BAY,1812,1398,1264,26,62,24,22,0,134
39061031ALI,1916,1269,518,153,557,47,23,5,751
39033017ABT,696,558,545,3,0,7,1,1,13
39075038AAJ,1894,1467,1400,13,12,35,2,0,67
39063032ABT,1130,874,822,18,8,15,6,1,52
39063032ACM,975,690,648,20,13,3,3,1,42
39103052AFE,1332,1032,971,12,14,16,11,0,61
39135068AAB,1347,1004,949,11,10,27,4,0,55
39135068ABS,721,561,536,1,6,14,3,0,25
39033017ABU,1477,1180,1148,9,3,14,1,1,32
39061031AXE,1492,1164,1014,31,72,33,14,1,150
39009005ABR,1459,1154,1092,11,20,21,2,0,62
39009005ACK,954,749,710,5,10,20,7,1,39
39119060ABW,909,694,651,7,13,14,7,0,43
39091046AAL,1113,812,647,23,97,32,7,0,165
39091046AAJ,1478,1076,885,34,88,33,17,1,191
39091046AAT,1617,1277,1216,5,19,20,8,1,61
39091046AAR,657,499,486,1,4,7,2,0,13
39053027AAK,1710,1318,1273,7,6,18,0,0,45
39033017AAQ,1331,1048,985,13,12,22,8,0,63
39033017AAP,1359,1103,1054,8,8,21,4,1,49
39083042ABG,768,538,509,7,3,9,1,1,29
39129065AAM,1950,1486,1364,32,52,33,10,1,122
39057029AHY,805,633,580,8,31,3,6,0,53
39057029AHH,1047,869,668,50,103,32,28,0,201
39129065ABQ,1226,787,701,19,33,18,16,0,86
39129065ABU,1649,1216,1155,18,10,25,3,0,61
39061031AZI,1537,1164,1105,12,12,10,18,1,59
39061031BKI,747,597,569,4,9,13,4,1,28
39061031ATQ,915,653,527,17,21,4,86,0,126
39061031BBD,1815,1330,740,41,482,44,18,0,590
39061031AMG,1797,1485,817,22,569,28,43,0,668
39061031AMM,1734,1482,1184,31,187,34,38,2,298
39061031BBZ,2119,1611,802,74,674,26,38,3,809
39061031BBQ,1810,1309,756,82,392,45,42,8,553
39061031ASJ,819,610,552,9,8,0,37,2,58
39061031BHQ,1219,937,885,17,10,9,16,0,52
39061031AKS,1361,986,199,36,736,23,11,4,787
39061031BKA,927,708,592,15,56,34,4,1,116
39061031BLW,1311,1148,782,26,305,15,25,0,366
39167084AAN,1871,1641,1428,45,68,26,55,3,213
39053027ABH,1078,893,826,8,22,19,6,3,67
39053027AAW,959,723,682,3,6,21,2,0,41
39035018APT,499,402,15,8,373,9,3,1,387
39035018APY,1126,638,9,18,609,2,5,0,629
39103052AFH,1812,1415,1349,16,3,30,0,0,66
39103052AFI,684,526,513,5,0,5,2,0,13
39005003ACC,1547,1160,1129,9,4,9,4,0,31
39005003AAS,1602,1291,1155,34,56,26,23,2,136
39005003ABV,736,542,504,17,9,12,7,0,38
39005003ACS,1135,900,862,8,2,23,3,0,38
39135068ABP,1034,796,757,8,5,29,0,0,39
39103052AGD,1381,1031,962,18,12,10,20,0,69
39103052AEZ,1760,1295,1227,29,6,15,19,1,68
39103052AEY,1426,1082,982,21,26,22,17,2,100
39103052AAK,1891,1533,1412,19,22,30,20,3,121
39119060AAS,1256,950,855,5,50,20,8,0,95
39057029AAZ,1148,924,837,25,22,11,18,1,87
39035018ASN,510,370,40,13,305,10,4,0,330
39035018ARM,898,721,174,48,484,12,5,3,547
39139070ABI,1013,795,734,9,12,19,10,0,61
39139070ACJ,1978,1533,1434,39,12,42,6,2,99
39119060ACX,2361,2033,1831,37,86,30,42,0,202
39119060ACR,726,553,526,3,15,9,1,0,27
39035018BTO,1466,1109,532,25,508,9,39,0,577
39035018BAL,1925,1362,406,635,307,47,18,2,956
39035018BFF,2014,1556,721,400,345,54,86,0,835
39035018AWR,1245,927,90,25,819,4,1,1,837
39035018CHV,1635,1281,1115,62,41,32,29,3,166
39035018ALW,978,733,14,9,711,14,2,1,719
39035018AJA,1038,773,7,6,761,3,0,0,766
39035018AJD,953,758,6,16,747,7,1,0,752
39035018AXF,1214,890,373,78,426,22,2,2,517
39035018BAA,1171,1007,664,199,107,16,30,4,343
39035018AVG,1151,867,42,16,807,10,7,1,825
39035018CKW,2160,1753,1185,157,234,24,161,4,568
39035018ABK,1405,1122,834,28,115,3,127,0,288
39035018AEV,1585,1265,1184,20,10,11,37,0,81
39035018BAN,1697,1222,373,601,268,29,28,7,849
39035018BAI,1147,809,261,404,150,26,7,0,548
39139070ABC,1982,1529,1235,38,191,44,16,3,294
39139070ABR,1963,1527,1441,14,9,25,18,4,86
39045023AAH,1787,1235,1134,19,20,31,27,1,101
39045023AEE,1676,1327,1264,8,11,31,7,1,63
39045023ADN,1503,1147,965,20,91,31,26,2,182
39101051ABY,1433,1120,1040,17,20,14,24,0,80
39101051ABX,784,592,562,9,4,11,4,0,30
39103052AAA,1583,1278,1209,15,11,11,17,4,69
39103052AAB,1688,1355,1247,50,9,17,22,0,108
39081041ABM,1307,1083,1016,14,20,18,6,3,67
39081041AAA,1237,901,612,27,236,16,3,4,289
39081041AAJ,1370,1064,836,25,150,31,20,4,228
39081041ADG,436,322,304,1,3,10,0,0,18
39081041AAW,1250,1098,958,27,69,19,24,3,140
39035018CUU,1505,1230,988,58,68,23,90,7,242
39035018CUS,1682,1356,1197,22,29,7,98,1,159
39035018CUY,2317,1856,1102,111,176,15,444,2,754
39113057APK,2194,1709,1422,46,122,82,40,0,287
39113057ADO,1895,1525,1236,81,135,42,26,1,289
39113057ASZ,1061,842,711,12,59,13,27,0,131
39113057ARR,1472,1024,710,15,211,14,63,3,314
39113057AVD,1612,1325,1231,12,16,52,8,0,94
39081041ABJ,1366,1098,1040,2,14,21,13,0,58
39101051ADK,1130,898,848,10,5,21,10,0,50
39045023AED,1609,1335,1256,27,12,28,9,0,79
39139070ACY,1457,1095,1041,11,8,16,4,0,54
39139070ADB,816,620,579,4,28,3,4,1,41
39035018AOB,909,708,32,10,667,11,1,0,676
39117059AAX,1165,880,838,11,10,17,1,2,42
39117059AAD,900,708,676,10,5,15,2,0,32
39045023AFD,1587,1230,1157,6,27,28,6,2,73
39089045ADM,1433,1072,1007,9,8,28,10,1,65
39167084ACA,1121,920,878,4,15,8,11,0,42
39017009AFO,972,773,706,23,23,18,7,1,67
39017009ACI,1366,1044,895,37,67,34,8,4,149
39017009ACA,1381,1054,947,19,37,30,11,1,107
39089045ADQ,1023,843,787,14,20,6,8,0,56
39089045ABS,1927,1506,1352,31,57,36,16,1,154
39089045ABN,1075,867,783,16,30,16,17,0,84
39089045AEX,2435,1796,1479,50,82,46,139,0,317
39089045ABE,1250,1018,960,20,11,10,12,1,58
39173087AAM,1673,1350,1129,104,51,36,16,2,221
39173087ADQ,1577,1254,1184,24,3,21,0,0,70
39069035AAC,1553,1180,1107,49,10,4,6,0,73
39003002ADE,989,753,674,29,30,11,11,0,79
39003002ADF,1009,781,633,37,62,16,29,0,148
39003002ADI,1077,797,585,24,154,19,14,0,212
39069035AAI,976,780,711,46,12,1,7,0,69
39061031BHK,1690,1329,1094,36,156,25,20,2,235
39061031AQR,1691,1272,578,97,551,26,20,2,694
39061031AWW,1398,1223,940,31,116,16,120,5,283
39061031BKF,1765,1370,1319,3,10,20,16,0,51
39061031AYR,739,597,489,11,60,4,24,1,108
39061031BEV,1586,1171,1027,27,64,21,23,0,144
39173087AAO,1240,1059,874,53,69,36,29,1,185
39017009AAV,883,662,545,22,37,10,42,0,117
39017009ABZ,1196,958,834,35,52,25,20,1,124
39061031ALE,2611,1727,712,387,590,56,12,2,1015
39057029AFR,1047,919,732,11,153,12,7,1,187
39057029AHZ,1047,889,836,10,14,24,6,0,53
39057029AJD,727,513,436,5,52,8,11,1,77
39057029AIW,1477,1019,862,41,77,26,13,1,157
39057029AFJ,1076,810,665,26,70,22,14,3,145
39129065ABA,1129,832,748,12,22,38,12,0,84
39129065ABB,1952,1402,1298,28,34,36,8,0,104
39057029AED,927,747,620,32,62,16,13,4,127
39035018AEB,1897,1726,1338,104,194,36,57,8,388
39117059AAO,735,563,536,0,1,13,4,0,27
39117059ABB,938,593,575,5,2,9,0,0,18
39003002ADZ,1012,784,750,12,10,12,0,0,34
39003002ADY,915,715,679,7,14,9,1,0,36
39163082AAW,116,101,96,0,1,3,0,0,5
39061031BJE,2121,1614,1471,35,29,41,26,1,143
39061031BJA,1668,1310,1263,9,6,19,5,0,47
39061031BKG,1727,1371,1338,6,5,16,4,0,33
39061031BKJ,1407,1120,1043,8,33,28,4,2,77
39061031BJX,531,436,423,3,1,5,3,1,13
39061031BLM,1397,1093,716,21,321,14,28,0,377
39061031ASL,804,603,546,5,9,1,36,1,57
39061031AGZ,1283,999,424,37,519,7,27,2,575
39061031AHA,1589,1202,581,33,543,25,35,7,621
39021011AAE,1644,1247,1037,31,139,36,7,3,210
39027014ABQ,890,692,670,3,6,3,6,0,22
39095048ATR,1853,1260,1122,33,18,13,71,0,138
39095048ATQ,1648,1256,1058,36,26,15,114,1,198
39101051ADA,976,800,753,12,8,16,5,1,47
39101051ADC,1067,836,788,11,8,19,6,0,48
39101051ABJ,960,836,781,6,9,7,35,0,55
39035018DAO,1862,1481,1066,98,277,38,13,0,415
39035018BDS,760,540,224,188,110,9,10,0,316
39035018BFK,1647,1123,301,491,310,51,21,10,822
39095048AHV,1491,1059,693,84,260,29,6,1,366
39095048AUN,1457,1169,1024,77,37,31,8,0,145
39095048ATU,1200,965,842,46,29,22,22,0,123
39027014ABZ,1442,1097,1048,8,7,20,6,0,49
39095048ANZ,1955,1364,934,193,195,51,14,2,430
39117059AAV,1122,875,808,11,3,25,11,1,67
39035018BRD,1613,1223,414,20,758,31,6,5,809
39035018BQY,1561,1209,460,28,698,19,17,2,749
39093047AFN,1500,1101,604,228,266,29,6,1,497
39093047ADS,1590,1151,773,171,185,29,9,2,378
39093047AFF,1717,1381,665,551,153,28,1,5,716
39093047AEW,1432,1044,314,406,332,46,4,0,730
39109055AAK,1335,956,846,10,67,14,9,0,110
39109055ACA,1686,1322,1256,12,12,26,7,0,66
39109055ACN,816,582,558,8,1,10,1,1,24
39159080AAE,2221,1721,1266,86,69,37,274,1,455
39095048APP,1205,1053,846,34,132,17,25,0,207
39095048APX,888,767,607,18,129,13,5,1,160
39155078ADT,1175,961,782,16,123,24,10,0,179
39155078AAI,1279,1003,860,21,93,19,10,1,143
39155078AHJ,1367,1150,1087,24,13,11,5,0,63
39155078ABA,994,822,768,19,12,11,5,0,54
39151076AEF,1170,838,676,15,122,22,1,0,162
39151076AEE,1109,907,781,18,83,17,8,0,126
39151076AKZ,1882,1486,1338,26,68,30,7,2,148
39151076AHP,816,653,583,8,24,13,15,2,70
39151076AMU,1267,1065,980,15,32,11,24,0,85
39151076AET,1080,946,834,12,56,26,15,0,112
39151076AEI,1886,1360,816,62,435,35,10,7,544
39151076AEC,1127,920,741,20,113,43,2,0,179
39151076AEA,1648,1260,978,36,183,49,8,1,282
39151076AIU,1125,886,839,7,16,19,4,1,47
39151076AIQ,1879,1474,1399,16,15,30,3,3,75
39151076ADS,1156,991,932,10,12,15,11,0,59
39151076AJW,1311,1038,991,17,6,15,2,0,47
39151076AJQ,1314,1054,982,13,7,31,10,1,72
39151076AMA,1386,1114,896,25,143,35,5,1,218
39095048AAS,1109,899,833,13,7,13,18,0,66
39095048AUH,1209,953,684,40,187,17,25,2,269
39013007ACX,1837,1387,1331,5,14,27,4,1,56
39013007ADX,1037,833,784,10,12,15,3,0,49
39013007ACZ,1134,855,808,3,13,13,6,0,47
39139070ACP,1674,1221,1104,17,42,16,33,0,117
39095048AVK,1575,1142,965,37,45,5,79,0,177
39151076AIS,1328,1046,984,8,1,22,15,1,62
39151076AIY,1312,1029,938,20,26,17,16,2,91
39095048AFJ,1714,1409,948,51,292,51,75,0,461
39095048ARY,1611,1291,1206,37,15,4,8,1,85
39095048ARX,2047,1473,1316,45,35,13,35,6,157
39095048AED,1384,1034,789,73,143,31,5,0,245
39095048AIR,906,756,334,18,388,21,5,0,422
39027014AAJ,1569,1151,985,21,99,26,15,1,166
39027014ACG,739,537,477,9,22,4,21,0,60
39027014ABN,1020,765,730,8,2,14,3,0,35
39147074ABT,814,672,648,6,9,5,1,1,24
39165083ABS,1131,846,753,20,20,27,22,1,93
39099050ABZ,1204,843,90,188,570,11,6,2,753
39093047ABC,1731,1318,1237,29,12,12,21,0,81
39093047ABG,1744,1350,1212,57,33,16,19,1,138
39093047ABB,1820,1374,1253,37,5,35,36,1,121
39093047AKO,2189,1744,1597,45,29,48,9,0,147
39109055AAN,850,692,667,8,7,8,4,0,25
39109055AAE,1273,985,862,35,48,25,17,5,123
39049025AFB,1349,1056,739,63,203,56,18,8,317
39101051ABQ,523,406,378,9,6,12,4,0,28
39101051ABR,674,599,521,19,46,6,7,2,78
39101051ABF,1524,1098,965,33,77,18,1,2,133
39101051AAO,1199,879,759,32,49,25,3,2,120
39101051AAP,991,718,640,23,31,16,2,0,78
39101051AAZ,1173,875,765,37,48,18,4,1,110
39097049AAD,2141,1556,1231,52,224,42,8,3,325
39099050APM,1338,1140,1102,11,9,11,2,1,38
39139070ABU,1852,1426,1327,12,43,29,3,2,99
39049025AEL,1185,980,923,13,21,9,15,3,57
39049025AEM,1003,853,793,11,13,12,17,0,60
39049025AQS,1699,1228,591,79,335,10,212,0,637
39049025AQU,1856,1454,946,76,295,30,132,1,508
39049025AJY,1840,1393,305,196,821,26,63,1,1088
39099050ASP,1030,869,819,7,11,11,6,0,50
39099050ANU,960,788,747,11,8,10,4,0,41
39099050AIV,1192,933,890,15,18,10,2,1,43
39037019AAU,954,748,702,12,7,20,1,0,46
39171086ABC,1687,1300,1196,65,3,28,6,0,104
39171086AAA,2009,1560,1353,116,18,37,13,5,207
39151076AMC,984,821,731,15,38,24,5,0,90
39151076AEZ,900,744,681,12,13,15,21,0,63
39151076AFD,2000,1803,1495,81,123,19,47,2,308
39151076AJA,1539,1326,1265,16,4,20,11,2,61
39151076AIZ,1526,1195,1121,25,9,25,5,3,74
39151076AAP,1646,1427,1265,15,113,11,7,0,162
39151076AAR,823,665,616,11,24,6,7,0,49
39099050AJV,1225,963,916,12,1,15,3,0,47
39099050ABU,800,679,634,25,12,6,3,0,45
39099050AMY,996,814,766,10,8,3,26,0,48
39029015AAX,1319,1033,975,13,5,22,7,1,58
39099050AFS,1015,711,249,68,384,15,10,0,462
39089045ABM,1614,1366,1253,9,65,22,14,3,113
39173087ADS,1477,1172,1118,18,8,12,8,2,54
39173087ADR,387,290,268,11,2,5,4,0,22
39119060ABM,631,525,486,1,12,9,12,0,39
39057029ACS,1656,1218,1100,27,21,29,41,0,118
39057029ACR,864,667,604,12,7,31,6,0,63
39057029AAK,1131,874,742,24,28,6,67,1,132
39151076AOY,1639,1248,1148,20,14,37,11,0,100
39151076AOU,864,634,565,12,15,20,13,3,69
39151076ADJ,882,719,458,27,208,18,6,1,261
39017009ABM,1151,860,773,33,27,16,4,3,87
39057029ACX,693,536,505,15,4,2,10,0,31
39057029ACU,977,768,719,16,15,10,8,0,49
39171086AAP,1651,1295,1236,24,6,10,5,1,59
39049025AZF,998,794,659,50,41,25,24,1,135
39049025AKL,1723,1314,1130,28,113,33,11,0,184
39151076AMF,1770,1437,1195,38,156,24,23,0,242
39151076AHJ,1021,894,775,24,14,11,74,0,119
39151076ANM,1767,1394,1290,12,29,45,2,0,104
39095048AIW,1036,909,344,31,508,21,9,4,565
39095048AFO,1282,1091,808,32,195,22,24,3,283
39095048ACM,1685,1333,1137,53,80,20,51,0,196
39095048ACK,1618,1225,1090,35,24,16,54,2,135
39131066AAH,1175,915,871,2,19,22,4,2,44
39131066AAI,442,332,313,1,3,11,1,0,19
39131066AAN,1152,841,791,3,14,22,3,0,50
39131066AAW,1227,936,896,1,5,22,2,0,40
39095048AND,894,658,362,179,95,40,1,1,296
39095048AMZ,2021,1332,651,199,443,53,36,1,681
39169085ABB,1965,1643,1460,36,53,28,55,3,183
39169085ADQ,1260,1004,953,21,3,13,10,0,51
39163082AAK,1084,829,779,15,7,15,5,0,50
39033017AAN,1087,899,840,8,11,15,15,0,59
39003002ACY,1137,914,760,33,94,17,15,0,154
39003002ACZ,1106,861,490,24,321,11,10,0,371
39003002ACX,1039,885,736,31,94,5,17,0,149
39155078AAO,1222,947,755,40,112,40,5,0,192
39165083ACI,1068,787,698,23,28,15,25,2,89
39165083ABX,1035,742,658,12,15,13,40,0,84
39165083ACJ,1760,1324,855,50,102,9,295,0,469
39165083ABT,1418,1113,983,38,19,39,18,3,130
39025013AFT,1182,854,783,21,25,22,2,0,71
39025013AGO,670,553,528,3,7,4,3,1,25
39025013AFF,1137,940,819,23,50,22,33,1,121
39025013ADS,667,543,484,6,6,13,22,0,59
39025013AEA,1179,967,912,9,26,6,3,0,55
39025013ADR,1082,896,826,27,12,19,11,0,70
39025013AIA,936,817,764,4,11,8,17,0,53
39025013ADX,1185,971,917,17,6,17,6,0,54
39151076AGH,1395,1061,946,26,60,19,6,0,115
39151076AKR,1673,1313,1165,36,43,34,4,0,148
39151076ABE,2163,1565,733,69,700,53,10,1,832
39169085AAA,1947,1489,1233,91,83,31,55,0,256
39169085ADM,1927,1495,1415,40,6,9,12,1,80
39169085ADK,2211,1625,1511,64,19,15,12,3,114
39169085AAK,1407,1124,1038,14,14,40,12,1,86
39093047ADJ,1888,1598,1217,112,176,49,50,4,381
39093047ABE,1518,1154,1081,23,11,10,20,1,73
39025013AFQ,1143,885,769,25,29,17,35,0,116
39093047AKB,2595,1962,1838,41,23,32,21,1,124
39093047AEI,1493,1089,612,289,172,33,9,0,477
39093047AIZ,1947,1546,1386,81,13,23,30,0,160
39093047ABD,1845,1418,1311,31,14,11,37,0,107
39093047ABI,1774,1422,1333,35,23,16,12,7,89
39155078AEZ,1164,975,892,14,38,22,2,0,83
39155078AJF,946,737,711,3,6,17,1,0,26
39153077AMJ,1414,1066,990,18,22,13,20,0,76
39153077BCG,1275,1003,761,29,121,11,90,2,242
39163082AAS,544,409,389,2,0,15,0,0,20
39109055ACB,1606,1257,1208,5,8,13,2,0,49
39049025AFZ,1122,971,609,22,322,17,13,0,362
39049025BEM,1813,1210,632,50,339,10,190,1,578
39049025BMW,822,568,418,10,88,8,40,0,150
39049025AJQ,2005,1586,632,126,621,16,209,1,954
39049025AJS,2176,1558,718,38,402,19,385,2,840
39049025ARO,1868,1330,752,23,39,20,497,1,578
39049025AUC,1478,1073,927,31,32,24,52,1,146
39049025ATW,1293,1115,1024,5,13,5,72,0,91
39049025ACP,1605,1241,908,103,166,28,44,1,333
39049025AGQ,1587,1073,593,201,224,55,13,2,480
39049025AXO,1355,1056,653,188,199,24,8,6,403
39169085ACR,1279,845,768,18,14,32,9,3,77
39169085ABZ,1074,819,781,5,14,16,6,1,38
39087044AAX,505,428,395,2,14,16,0,0,33
39087044AAQ,289,230,215,2,5,7,1,0,15
39093047AJT,4761,4420,2665,137,1567,32,11,1,1755
39095048ALW,2152,1606,562,55,935,20,38,0,1044
39093047AIQ,903,733,673,27,15,13,0,0,60
39093047ACH,1848,1459,1221,81,104,27,24,5,238
39109055AAY,845,655,600,11,34,8,1,1,55
39087044ACB,835,654,601,11,23,9,2,0,53
39087044ACM,773,607,579,7,8,11,1,0,28
39087044ACR,1395,1060,1003,10,17,25,14,0,57
39143072ABL,684,527,326,116,65,34,6,0,201
39143072ADI,798,636,572,39,2,14,2,0,64
39019010AAE,1013,843,792,10,6,26,3,0,51
39019010AAC,1295,1101,1051,10,4,23,0,1,50
39019010AAZ,1022,786,749,3,7,11,7,1,37
39099050ANL,929,758,720,12,1,17,2,0,38
39029015AAP,2009,1543,1423,5,48,47,1,1,120
39095048AJP,1365,1097,742,63,268,13,17,0,355
39095048ACO,1287,1008,851,47,47,17,38,1,157
39095048ABU,1505,1180,1027,51,56,19,26,0,153
39095048APL,1430,1103,872,64,124,17,15,0,231
39027014ACE,789,632,588,6,11,15,10,0,44
39099050ASO,1138,929,808,26,80,8,6,1,121
39143072ABM,785,604,481,100,22,9,0,1,123
39143072ACO,740,622,544,47,15,8,12,1,78
39013007ABX,452,323,308,0,10,2,0,0,15
39099050APF,845,651,622,7,4,10,1,0,29
39093047ABH,1733,1306,1203,55,18,19,14,0,103
39095048ASU,1491,1247,1069,56,95,21,7,0,178
39143072ABA,1131,843,495,186,137,23,9,0,348
39049025AUT,576,478,291,12,102,8,66,0,187
39049025AWR,971,785,715,7,29,2,17,0,70
39049025BJD,2498,1871,1190,99,169,19,390,3,681
39049025AOV,1501,1199,715,76,348,10,47,0,484
39049025ALH,1458,1129,576,68,449,5,31,1,553
39049025ALJ,3060,2004,460,241,1125,27,174,4,1544
39049025AVM,1983,1475,1268,40,41,9,106,1,207
39049025AVR,1484,1072,938,24,13,10,78,4,134
39049025AVX,1033,837,749,9,15,16,42,2,88
39095048ASC,1364,960,825,15,44,5,50,0,135
39095048APR,1133,1004,864,42,75,14,12,0,140
39095048ACT,1189,874,449,60,339,31,10,1,425
39095048ACX,1738,1382,1170,77,76,42,11,0,212
39095048AAW,1778,1401,1164,147,38,30,20,1,237
39095048AAZ,1386,1111,901,121,60,16,13,0,210
39095048AMJ,1012,800,687,48,33,13,9,0,113
39095048ASM,1746,1331,891,58,312,41,15,0,440
39095048ARQ,726,583,529,20,23,6,2,0,54
39095048AKW,1994,1698,833,74,676,29,121,0,865
39095048AKK,1291,1033,264,52,720,6,11,0,769
39041021ABN,1559,1168,1017,35,33,20,54,2,151
39041021ABP,1179,878,706,63,39,19,40,0,172
39041021AFK,1518,1115,980,27,50,11,46,0,135
39047024ABH,1118,855,801,10,14,17,7,1,54
39141071ABJ,1695,1314,1262,5,5,22,7,0,52
39141071AAI,931,709,649,10,31,10,5,0,60
39141071ACP,969,755,724,7,2,16,0,0,31
39093047AHC,1353,1069,981,31,28,17,8,0,88
39093047AHH,1441,1179,1067,48,17,17,12,3,112
39093047AEG,1283,794,164,260,377,28,7,7,630
39025013ABO,618,495,474,3,3,8,4,0,21
39025013ABN,1039,803,766,10,5,18,3,0,37
39025013ADP,1570,1169,1067,25,27,21,22,2,102
39025013ADM,609,479,437,19,6,9,4,0,42
39067034ABI,640,485,465,1,1,18,2,0,20
39079040AAS,1155,865,832,3,5,20,1,0,33
39145073AEG,855,655,626,6,6,14,1,1,29
39153077AIQ,1602,1274,881,34,280,29,35,3,393
39123062AAU,1177,908,832,38,6,20,4,1,76
39147074ACL,738,572,560,2,0,6,4,0,12
39003002ACE,1695,1271,925,32,260,43,5,7,346
39175088AAD,1093,812,729,51,6,14,8,0,83
39175088AAJ,1362,994,916,42,7,12,4,2,78
39175088AAA,991,810,761,21,5,10,10,2,49
39067034AAA,327,249,231,3,3,5,2,0,18
39067034ABA,296,238,229,2,1,5,0,0,9
39131066AAR,1857,1420,1333,6,19,38,11,0,87
39131066AAE,795,617,582,10,10,10,4,0,35
39109055ABV,1585,1195,1151,6,6,23,1,3,44
39093047AFZ,2799,2137,1610,280,187,42,45,1,527
39141071ADA,1607,1259,1187,0,34,22,9,2,72
39141071ACX,1625,1265,1140,10,44,50,7,1,125
39043022ACN,256,240,233,0,1,2,2,1,7
39043022ADS,920,765,695,40,7,17,8,0,70
39043022AAC,922,815,799,6,4,6,2,0,16
39049025ALI,1970,1491,425,249,761,61,55,1,1066
39145073AAP,790,605,489,12,73,14,0,0,116
39145073ACC,762,586,565,5,1,15,1,0,21
39145073ACO,1058,816,760,6,3,40,1,1,56
39025013AHW,1328,933,825,21,27,22,31,0,108
39025013ACB,1544,1122,985,53,27,21,30,0,137
39025013ACF,1229,900,848,2,9,21,20,0,52
39025013ABJ,928,768,717,8,6,29,7,0,51
39023012AAK,1547,1191,1017,46,88,34,5,5,174
39023012AFP,2199,1675,1490,36,83,47,5,2,185
39041021AEG,1094,732,569,16,12,5,126,0,163
39041021ACQ,1531,999,834,17,17,7,116,1,165
39041021AGK,1477,985,689,21,29,15,230,0,296
39153077AQX,1633,1180,798,20,143,2,205,1,382
39153077AQL,1137,854,661,7,118,1,59,0,193
39141071ACC,1453,1123,1056,3,29,28,2,2,67
39141071ACB,1170,912,837,10,6,45,13,0,75
39141071ABX,2152,1606,1535,13,16,32,8,0,71
39141071AAX,901,758,650,4,75,18,6,2,108
39141071AAA,1336,1078,924,13,87,33,24,0,154
39113057ANU,1779,1372,1260,10,56,21,21,1,112
39113057AFC,1689,1195,716,167,255,62,8,2,479
39113057AZG,1099,1048,735,32,209,35,33,0,313
39113057AVA,967,729,675,10,1,18,8,0,54
39061031BCO,2004,1530,840,46,449,34,161,0,690
39061031BQL,1595,1208,927,61,174,17,12,2,281
39061031AUV,1419,1263,980,50,174,26,60,2,283
39061031ADB,1358,1148,673,49,381,13,34,0,475
39061031AFH,1473,1184,78,42,1046,18,28,1,1106
39023012AFH,1807,1396,1319,28,10,27,10,0,77
39123062AAM,1175,924,849,39,6,23,1,0,75
39141071AAL,883,673,591,11,43,19,5,0,82
39141071ACY,1403,1091,1020,15,22,33,4,2,71
39141071AAG,1172,973,864,7,73,21,7,0,109
39141071ACM,1718,1261,1063,21,123,33,20,2,198
39141071AAJ,897,748,656,14,49,11,2,1,92
39141071AAM,821,707,543,21,126,13,4,0,164
39171086AAF,636,492,457,16,3,2,8,0,35
39155078ADZ,1201,974,800,22,118,19,12,0,174
39155078AIG,717,607,563,7,18,13,8,1,44
39155078AAA,989,813,772,15,15,8,7,0,41
39007004AES,1376,1114,1056,16,6,22,1,0,58
39007004ABM,885,674,627,19,15,8,4,0,47
39007004ACA,653,550,511,5,10,12,8,1,39
39007004AEB,1158,881,836,9,9,9,4,0,45
39007004ACT,807,613,566,11,12,18,9,3,47
39007004ADP,731,577,536,12,11,15,2,0,41
39007004ACQ,913,639,602,7,6,17,0,0,37
39007004ADU,1015,773,730,8,10,23,3,0,43
39025013AHG,709,569,532,14,7,8,5,0,37
39025013AEE,786,633,595,9,6,21,2,0,38
39025013AEJ,903,670,620,15,7,9,9,0,50
39049025BJP,1059,752,614,22,49,10,57,0,138
39049025AJO,1735,1250,434,62,684,35,40,0,816
39049025BMG,1033,710,80,33,575,17,21,0,630
39049025AJL,1745,1127,82,48,981,7,26,2,1045
39049025BNF,1105,802,206,47,522,14,29,0,596
39049025BBI,1257,957,826,61,24,28,14,1,131
39001001AAS,1352,933,893,3,5,24,0,0,40
39151076AMT,1876,1529,1421,26,48,16,11,0,108
39151076AEJ,1709,1207,565,183,398,88,9,1,642
39151076ALM,780,647,597,2,26,10,12,0,50
39151076ADH,878,655,462,47,116,23,8,0,193
39151076ABM,1636,1122,764,53,264,32,9,1,358
39151076AJS,1888,1493,1436,19,2,27,2,1,57
39049025AQW,1751,1398,835,49,311,12,186,2,563
39049025AQV,1072,839,600,48,153,14,28,2,239
39049025BMZ,1528,1099,612,90,164,47,207,0,487
39049025AOI,1867,1275,730,124,244,31,145,0,545
39049025AKM,1193,896,423,34,400,22,15,0,473
39049025AHW,2102,1451,862,175,331,48,35,1,589
39049025ATC,1530,1149,989,57,55,27,15,1,160
39049025BNA,1016,703,626,11,35,16,15,2,77
39049025BHD,1762,1505,1218,47,50,17,163,3,287
39049025ABR,1329,1081,414,67,562,30,34,4,667
39049025ARH,782,568,495,17,1,9,40,0,73
39007004ACS,847,687,634,8,11,16,6,0,53
39007004AED,1232,1006,927,16,12,26,11,0,79
39007004AAJ,615,495,423,23,30,12,4,0,72
39049025ADT,848,671,574,37,15,16,34,0,97
39113057AGK,1110,895,75,7,799,13,2,1,820
39113057AAM,1444,1174,1027,31,34,22,51,0,147
39113057ASI,2808,2355,1455,160,594,56,92,4,900
39113057AWA,1110,893,776,37,49,20,15,2,117
39113057AVX,1234,1074,831,37,111,10,79,0,243
39113057AWS,1204,964,909,6,16,18,10,1,55
39015008ACS,1935,1512,1444,14,5,33,1,0,68
39037019ABS,1528,1146,1109,5,6,15,4,0,37
39171086ABN,1932,1417,1307,47,9,32,8,4,110
39171086ABP,2011,1585,1458,44,10,21,37,2,127
39021011AAT,1036,785,736,7,4,31,4,0,49
39025013AAA,802,643,588,17,9,11,17,0,55
39125063ABE,1482,1117,923,130,37,33,2,1,194
39125063AAY,1146,923,856,33,22,21,1,0,67
39021011ABO,1636,1235,1170,8,13,38,0,0,65
39123062AAP,1240,966,914,25,5,12,2,0,52
39055028AAR,1487,1023,982,15,4,11,1,2,41
39039020AAR,1574,1138,828,236,43,20,6,1,310
39161081AAU,1020,775,728,25,2,14,2,0,47
39011006ABK,507,389,370,0,2,10,1,0,19
39011006ABC,925,730,708,5,1,11,3,0,22
39049025AWT,1112,875,683,38,91,26,37,0,192
39049025AHN,1738,1324,921,197,159,40,31,3,403
39049025ARM,832,638,487,31,37,1,81,0,151
39049025AVH,968,704,617,13,7,11,46,1,87
39141071ABP,1039,762,700,8,15,28,0,4,62
39141071ACU,5938,5553,3523,102,1894,33,13,0,2030
39081041ACE,1307,965,841,15,91,18,4,0,124
39081041AAB,1109,819,491,30,267,27,3,0,328
39169085ACA,1674,1295,1242,13,7,22,4,0,53
39169085ACF,1423,1143,1066,14,12,23,7,2,77
39169085ACI,1268,1034,978,17,5,16,4,0,56
39133067AFP,945,754,691,13,12,14,15,2,63
39133067ABN,1300,973,818,26,77,33,7,0,155
39133067ADO,1125,908,827,9,23,21,7,3,81
39133067AGJ,1045,845,756,14,38,16,17,0,89
39085043AFP,1278,1030,949,29,19,15,14,0,81
39085043AHY,1702,1353,1272,5,17,4,35,0,81
39145073AEA,578,467,448,2,6,7,1,0,19
39145073ADY,975,760,721,0,4,27,3,0,39
39145073ACG,938,686,630,12,4,38,1,0,56
39145073ACH,857,654,636,8,3,5,1,0,18
39145073ADK,1070,836,796,12,6,14,7,0,40
39019010ABB,925,752,726,1,2,17,0,0,26
39141071ACA,1064,792,740,6,12,28,1,0,52
39055028ACA,1287,971,921,16,7,6,10,0,50
39055028AAV,1731,1363,1286,18,18,14,14,0,77
39055028AAH,1175,942,880,2,17,9,15,0,62
39055028AAM,1243,987,927,18,24,9,3,0,60
39049025BAZ,787,642,607,7,5,15,4,2,35
39049025BJT,2107,1514,994,164,204,31,130,2,520
39049025BBG,1540,1235,1086,61,41,37,8,2,149
39049025BCS,1549,1082,267,72,707,17,22,1,815
39049025APL,3613,3142,1802,161,230,30,903,4,1340
39049025APO,1409,1087,955,40,30,4,50,4,132
39049025ARK,1545,1108,931,22,21,6,111,0,177
39049025AVF,980,668,618,12,5,3,15,0,50
39049025ASC,1241,948,744,22,119,28,34,2,204
39049025BDV,1205,941,773,29,90,33,17,2,168
39049025ASL,1222,992,852,25,89,13,20,2,140
39023012AAG,2437,1837,1488,71,217,57,7,0,349
39023012ACM,1687,1244,872,48,248,47,17,2,372
39023012ACG,2194,1599,802,88,652,41,16,6,797
39023012ADD,1897,1380,1218,96,14,45,7,3,162
39023012ADG,1766,1311,1085,163,9,43,19,0,226
39023012ABD,1910,1661,1125,62,376,49,44,6,536
39041021AGI,1137,844,683,51,40,14,53,1,161
39041021ADX,1181,932,857,21,16,27,7,0,75
39041021AEM,1042,793,659,13,57,3,62,0,134
39041021ADD,1345,954,750,22,17,10,154,1,204
39055028AAN,1018,799,747,9,17,3,14,1,52
39043022ADC,1056,850,715,25,84,14,16,0,135
39043022ADD,1284,1018,925,24,30,22,4,0,93
39099050AQH,1659,1190,800,102,265,17,9,0,390
39099050ACL,1106,901,153,96,637,16,6,0,748
39093047AAU,2297,1653,1479,56,21,21,68,0,174
39093047AAV,1499,1136,1036,21,12,7,41,0,100
39093047ACD,1449,1271,1063,56,86,34,29,3,208
39093047ACG,1776,1458,1228,63,110,25,37,0,230
39093047ACE,1546,1284,988,71,193,19,17,0,296
39093047ABS,1848,1430,1073,95,196,30,21,3,357
39019010AAO,1343,1054,1003,10,4,24,5,0,51
39019010AAR,1731,1323,1254,20,16,23,3,0,69
39041021ADE,947,744,652,22,25,6,31,0,92
39041021AGJ,1494,1097,862,28,43,17,145,1,235
39023012AFE,1165,934,868,18,17,9,15,1,66
39137069ABE,1011,796,754,19,5,10,4,1,42
39109055ABD,1439,1106,849,59,141,27,18,3,257
39093047AAH,1492,1207,1125,39,12,11,11,1,82
39093047ABP,1493,1150,912,70,138,22,19,0,238
39093047ACF,1241,986,825,24,102,12,16,0,161
39109055ACL,1371,1063,998,9,14,29,4,1,65
39109055ACH,1575,1189,1144,1,15,16,7,0,45
39169085ABT,1199,872,820,13,9,19,10,0,52
39169085ABV,2053,1621,1534,23,12,36,6,1,87
39137069ABK,1038,763,749,7,2,4,3,1,14
39099050AJW,748,629,599,8,7,5,2,0,30
39093047AHY,1738,1387,1283,39,21,29,6,2,104
39111056AAR,837,694,679,1,1,10,0,0,15
39111056AAZ,1267,1020,985,4,3,19,4,2,35
39169085ACJ,1668,1274,1213,16,8,21,6,0,61
39169085ADT,1598,1277,1230,13,12,13,6,1,47
39151076AIF,1814,1399,1334,18,1,30,3,1,65
39151076AIN,1682,1245,1192,11,12,16,12,0,53
39151076AEW,1842,1492,1341,31,55,29,29,0,151
39151076AKV,1983,1540,1367,27,65,41,6,1,173
39151076AKO,1037,816,705,32,62,16,3,0,111
39025013ACC,911,761,685,12,21,18,16,3,76
39007004ADW,1313,1059,982,14,15,19,11,0,77
39007004AEL,873,778,702,15,22,16,14,0,76
39007004AEO,673,545,492,16,13,17,5,0,53
39007004ADZ,1544,1079,1044,8,12,11,1,0,35
39007004AEA,1533,1185,1128,10,15,19,5,2,57
39169085ADP,782,626,580,20,5,5,6,0,46
39169085ABM,2060,1729,1561,18,71,23,42,0,168
39153077AOJ,1141,934,832,20,40,16,20,0,102
39153077AOI,1172,958,841,23,36,12,41,1,117
39153077AOG,1235,990,882,14,28,28,21,0,108
39153077BBS,1318,1051,927,28,37,14,27,2,124
39153077AAE,1283,1167,871,30,224,16,20,0,296
39153077AAJ,1175,994,814,23,123,18,22,0,180
39153077ACE,1117,825,69,24,730,11,6,2,756
39153077AYW,975,745,182,25,537,20,0,0,563
39153077AGV,1321,995,465,14,505,9,11,0,530
39153077ACH,1457,1015,173,43,737,21,54,0,842
39041021AAU,1217,976,843,30,49,20,20,0,133
39169085ACP,1228,915,863,13,1,25,1,1,52
39037019AAK,1270,1050,992,14,11,17,12,2,58
39049025BMR,1601,999,218,80,669,11,29,4,781
39049025AOS,1988,1456,539,81,731,20,79,1,917
39049025BJS,1705,1180,165,59,818,10,130,0,1015
39049025AXM,2049,1414,383,139,847,22,36,2,1031
39049025BIJ,2122,1573,493,76,552,22,435,3,1080
39049025AKW,1641,1269,608,63,429,34,123,0,661
39049025AVL,1076,742,683,23,3,9,17,0,59
39049025AKS,1673,1335,244,118,852,23,103,2,1091
39049025BMQ,1103,794,423,20,298,18,31,0,371
39049025AZY,1358,1090,816,42,162,25,36,0,274
39149075ACB,974,721,676,7,8,20,3,0,45
39149075AAA,1774,1307,1206,15,40,24,7,0,101
39149075ABM,903,697,663,11,6,17,2,1,34
39133067ACA,1061,845,648,13,131,34,14,1,197
39133067ACV,2297,1773,1560,28,91,41,35,3,213
39133067AFM,1276,991,883,16,31,29,22,0,108
39133067AEL,1012,834,805,5,6,8,3,0,29
39085043AEB,1582,1341,1140,13,111,9,66,1,201
39085043AEI,1200,971,889,12,42,7,17,1,82
39085043AEJ,935,785,729,16,10,6,19,0,56
39065033ABK,630,486,474,1,2,5,0,0,12
39105053AAM,950,725,691,4,2,17,1,1,34
39105053AAL,427,310,292,1,7,7,0,2,18
39087044ACV,498,416,369,13,8,17,5,0,47
39029015ACZ,735,581,556,3,1,8,2,0,25
39029015ABL,1042,853,767,28,13,30,7,1,86
39029015ABB,1236,970,914,11,1,21,8,0,56
39173087AAK,1411,1145,1041,54,15,19,17,0,104
39017009AGY,1807,1423,1345,19,17,28,14,3,78
39017009AAX,1166,837,628,31,131,7,43,0,209
39017009AHC,547,385,362,6,2,15,0,1,23
39017009ALY,2460,1777,1589,44,48,66,12,0,188
39133067ADX,1414,1104,1035,17,11,19,7,0,69
39133067AEN,1525,1127,1058,6,11,32,9,0,69
39029015AEV,1242,1050,1005,8,7,14,2,1,45
39029015AAW,1190,941,892,7,5,17,10,1,49
39029015ABA,912,713,608,45,9,27,15,2,105
39029015AEW,1234,903,859,18,0,16,7,5,44
39029015AEL,990,779,754,3,7,8,1,0,25
39087044AAF,718,538,514,3,9,9,3,0,24
39087044AAO,448,352,325,0,21,2,3,0,27
39087044AAR,258,224,202,0,13,8,1,0,22
39113057AYJ,1817,1478,1115,65,156,24,115,1,363
39113057AHA,1356,1019,287,24,684,19,12,0,732
39113057AGG,1130,877,127,20,715,20,7,1,750
39113057AUE,955,775,589,33,124,16,9,2,186
39113057AUD,1859,1557,937,38,535,22,16,2,620
39113057ACV,700,514,84,15,412,8,5,1,430
39073037AAB,1837,1425,1353,11,18,26,7,1,72
39007004AEV,615,470,443,3,10,10,1,0,27
39007004AEW,804,665,640,1,1,16,5,0,25
39007004ACU,1735,1399,1267,55,12,31,11,0,132
39007004ABC,586,478,431,18,2,12,1,0,47
39007004ADC,829,659,624,10,8,7,2,1,35
39007004ABY,646,516,461,17,10,17,9,0,55
39165083ABE,1155,880,710,35,33,10,86,4,170
39155078AGH,950,727,703,5,7,2,3,2,24
39155078AGI,834,646,610,7,3,16,2,0,36
39155078AIA,1669,1393,994,48,333,20,9,0,399
39071036ABM,1449,1081,1020,8,9,31,1,1,61
39147074ACE,769,588,542,25,6,13,1,0,46
39161081AAN,600,432,383,25,3,17,2,0,49
39071036AAU,1088,841,810,2,5,21,1,1,31
39007004ACJ,757,609,556,12,17,11,10,2,53
39007004AEC,696,566,504,29,12,12,2,0,62
39065033ABM,740,601,569,4,11,12,3,0,32
39049025BDE,2163,1515,980,36,33,18,446,2,535
39049025ARQ,1803,1315,1161,24,16,13,91,2,154
39049025AMV,1096,911,716,43,62,19,72,1,195
39049025ABF,1017,741,149,19,545,36,6,4,592
39049025AKT,1175,937,294,56,546,42,13,0,643
39143072AAD,590,460,419,25,4,8,0,0,41
39157079ACR,1056,851,816,2,6,22,2,0,35
39157079AEA,986,783,741,4,11,26,0,0,42
39113057ABM,2650,1935,1352,283,226,55,25,2,583
39113057ABN,1321,1024,710,93,169,32,24,3,314
39113057AQL,1517,1106,67,13,1005,11,17,0,1039
39113057ARD,1444,1175,213,17,923,24,8,4,962
39113057AQJ,613,489,172,6,301,13,5,1,317
39113057AIO,1017,806,623,16,140,12,8,0,183
39113057AQU,858,735,72,10,637,14,3,0,663
39113057AKD,2130,1627,1229,77,216,57,47,0,398
39085043AGT,1661,1355,1242,35,35,19,11,3,113
39085043AGU,1447,1203,1089,39,46,18,13,1,114
39133067ABX,1515,1165,995,14,114,20,14,0,170
39085043ACJ,1787,1487,1347,28,54,30,15,1,140
39085043ACI,1842,1516,1328,44,78,23,43,0,188
39085043ACG,1718,1439,1352,20,11,18,24,0,87
39085043AGI,1782,1348,1227,24,32,27,14,3,121
39085043AGG,1152,921,835,35,7,19,8,3,86
39085043AFK,1209,904,831,8,15,14,24,0,73
39085043AIW,870,652,599,22,2,3,8,0,53
39133067ABS,1230,1098,951,18,79,25,11,2,147
39133067ABQ,999,792,654,24,72,17,5,2,138
39085043ADS,1674,1243,929,27,230,35,13,3,314
39085043ADU,1756,1468,1181,19,166,22,80,0,287
39085043ADT,1206,979,841,31,53,32,10,5,138
39085043AIP,1098,881,722,16,83,14,45,0,159
39085043AAW,1097,878,834,9,5,6,17,0,44
39085043ACH,1784,1472,1326,27,26,59,24,0,146
39143072ABZ,761,611,567,29,1,7,1,0,44
39143072AAE,1310,1059,977,49,14,5,3,0,82
39017009ADZ,1098,817,671,34,86,21,5,0,146
39017009AJU,978,759,595,91,31,24,16,5,164
39017009AAE,946,778,482,43,195,4,60,2,296
39017009AGB,387,273,256,2,7,6,1,0,17
39143072AAW,1143,907,704,90,83,22,5,0,203
39143072ACG,1313,989,876,79,12,22,2,0,113
39087044ACT,523,432,409,3,9,11,2,0,23
39087044ACS,833,642,620,6,6,6,4,0,22
39133067AGA,1197,982,925,9,5,23,0,0,57
39151076ABC,918,689,354,36,269,28,7,6,335
39151076AKD,1521,1214,1093,28,46,28,5,0,121
39151076AHV,995,764,704,10,12,20,3,0,60
39151076ADM,1278,960,935,6,1,9,6,0,25
39151076ADP,1178,943,885,24,8,18,3,1,58
39109055ACY,1583,1192,1109,11,11,35,11,1,83
39109055ACD,818,635,622,2,0,1,4,0,13
39093047AFV,1686,1339,874,265,175,25,14,1,465
39093047AFL,2186,1772,1076,317,342,59,15,0,696
39093047AFW,1181,939,598,182,137,39,3,2,341
39093ZZZZZZ,0,0,0,0,0,0,0,0,0
39093047ABL,1507,1289,1110,79,50,13,31,3,179
39099050ANA,1016,808,695,25,26,9,51,0,113
39139070ABT,1619,1249,1211,10,10,9,2,1,38
39139070ACU,1742,1372,1242,24,47,31,21,4,130
39017009AFP,1394,997,822,106,24,34,7,1,175
39049025BNN,849,653,428,32,150,13,43,0,225
39133067ACK,1149,946,867,14,17,30,11,0,79
39149075AAU,1211,909,833,6,35,17,9,2,76
39073037AAM,1689,1344,1263,7,6,46,8,1,81
39155078AKV,1184,939,871,12,31,18,0,0,68
39147074ACJ,1477,1143,1092,22,3,15,5,1,51
39151076AAF,2128,1571,1327,24,170,44,9,0,244
39151076AOJ,1678,1393,1333,10,11,25,7,1,60
39151076AAN,1152,960,881,10,42,8,12,1,79
39151076AMY,1030,866,804,10,35,12,6,0,62
39155078AER,1701,1476,1391,8,37,5,14,0,85
39147074ABX,762,607,585,9,1,3,5,0,22
39165083AHF,1839,1475,1160,53,102,34,122,1,315
39165083AFX,2125,1420,1152,37,70,27,133,2,268
39165083AET,1354,1025,941,29,17,6,29,1,84
39155078AGC,2451,1558,1515,6,13,15,3,2,43
39155078AKM,1064,874,795,18,30,18,4,0,79
39049025AMZ,1535,1374,867,102,100,19,298,1,507
39049025AVY,979,790,654,19,27,5,79,0,136
39151076AIE,1828,1367,1269,24,20,23,13,1,98
39151076AIC,1415,1089,1015,18,13,22,9,0,74
39049025BDP,1885,1309,532,30,47,9,679,0,777
39049025BGE,3185,2155,879,445,736,52,65,3,1276
39049025AWF,1209,908,762,20,10,3,103,2,146
39049025AOC,1449,1228,771,94,161,19,183,0,457
39049025ABL,1025,894,444,26,391,13,27,2,450
39049025AIP,1241,1026,782,47,145,15,27,1,244
39049025ALD,2191,1749,1056,121,444,36,87,3,693
39049025AAQ,1511,1195,643,68,423,34,26,6,552
39153077AEV,1518,1287,1082,18,128,33,30,1,205
39049025ATF,1946,1504,1397,24,57,21,7,0,107
39049025ATE,1499,1127,1005,24,43,21,14,1,122
39049025ADC,1322,1266,1053,52,56,15,87,1,213
39049025AEH,1189,1024,912,28,28,22,30,2,112
39049025ABA,1015,769,303,33,412,9,11,2,466
39049025AGD,871,663,417,43,173,20,10,0,246
39049025ALT,1260,1026,557,37,368,27,25,4,469
39133067AAQ,962,778,644,33,71,22,14,0,134
39133067ADV,1263,1037,987,7,9,8,5,1,50
39133067ADY,1035,808,761,2,3,19,13,0,47
39085043AHE,629,536,505,6,10,4,6,0,31
39085043AHC,915,720,674,14,7,15,6,0,46
39085043AHB,1430,1093,1012,32,17,15,2,0,81
39085043AFQ,1207,931,833,21,24,17,13,0,98
39153077BCU,1340,1056,960,14,50,5,25,2,96
39153077BBJ,832,713,640,6,20,15,23,0,73
39153077ATS,822,705,640,8,25,2,20,0,65
39153077AVX,1602,1216,951,27,115,9,108,0,265
39153077AEU,1594,1302,1061,12,152,28,35,0,241
39153077AER,1449,1171,1042,20,41,32,15,1,129
39153077AZZ,627,491,262,25,187,9,2,0,229
39051026AAI,1071,760,633,88,12,23,9,4,127
39113057AMD,1962,1462,1003,47,289,41,74,2,459
39047024ABE,878,633,532,57,22,19,3,1,101
39047024AAP,976,754,682,23,32,14,2,1,72
39049025BHO,1521,1167,838,79,137,18,94,6,329
39049025BGM,1406,1119,737,156,130,23,75,2,382
39049025ADB,1540,1496,1255,56,61,20,89,3,241
39049025BAM,997,768,715,18,14,6,14,0,53
39049025ABO,903,681,261,31,372,33,5,1,420
39049025AGZ,1094,1005,844,27,78,2,51,0,161
39049025AID,1758,1645,1279,120,106,18,123,0,366
39049025ADN,1056,721,66,40,606,20,4,1,655
39049025BGF,1729,1307,849,94,159,16,203,6,458
39049025ASB,1342,1055,668,43,308,22,16,1,387
39049025ARW,1582,1191,898,54,156,33,44,0,293
39049025AOJ,1492,1139,844,60,99,25,128,3,295
39049025AOG,1640,1253,919,108,93,21,112,4,334
39049025ANY,2258,1839,994,89,159,21,578,2,845
39049025AWB,1354,1087,809,26,26,11,211,3,278
39049025ABQ,1898,1321,169,62,1071,40,13,7,1152
39133067AAF,1594,1283,1072,29,110,7,41,2,211
39133067AAK,966,820,746,2,23,1,29,0,74
39133067AEG,1000,827,770,11,1,26,4,0,57
39061031AHF,3192,2929,1995,171,503,41,236,5,934
39061031AGY,1473,1186,692,37,398,15,34,3,494
39061031BGU,1560,1215,1150,14,19,13,14,0,65
39061031BNW,482,366,330,12,8,4,14,2,36
39061031AHG,3086,2855,2091,139,384,32,221,4,764
39111056AAT,420,335,328,1,1,2,0,0,7
39055028AAS,1412,1196,1111,21,22,22,19,1,85
39017009AGO,2147,1438,1135,54,98,38,124,0,303
39017009AGN,3334,2247,1849,66,141,30,155,0,398
39017009AEY,1841,1830,1521,81,95,12,128,2,309
39173087AAW,1065,827,753,32,13,25,10,2,74
39035018BJK,1142,912,618,89,138,23,54,0,294
39113057AIR,1221,988,871,0,71,18,19,0,117
39113057AIX,1066,925,689,7,201,15,16,1,236
39113057AKJ,2117,1673,1251,46,252,37,78,6,422
39113057ANH,939,758,659,20,24,12,38,0,99
39113057AUF,2151,1679,431,48,1179,23,14,1,1248
39113057AJN,1825,1422,1089,41,199,42,54,5,333
39113057AOG,1609,1355,1115,33,118,35,42,8,240
39113057AVP,1450,1247,1049,33,74,25,68,5,198
39133067AGF,909,719,670,14,8,25,3,0,49
39085043ABZ,1481,1154,1095,7,19,14,10,2,59
39085043ACC,1597,1281,1195,20,20,21,10,0,86
39085043AAX,1232,1015,932,10,29,10,25,0,83
39085043AIL,1621,1306,1181,35,18,33,34,5,125
39157079AAY,888,736,696,17,6,5,1,0,40
39157079AAT,1034,784,664,79,12,32,5,0,120
39035018AGW,1627,1370,1200,71,43,23,23,0,170
39035018BLZ,1763,1370,388,27,923,8,28,4,982
39035018BFX,1229,870,143,186,518,20,30,6,727
39035018CCB,1047,916,637,13,215,11,42,0,279
39035018CBE,1505,1213,489,30,616,6,59,0,724
39035018AVQ,899,678,14,14,649,13,4,0,664
39035018AUX,1169,989,70,26,886,23,1,1,919
39035018CUT,1919,1567,1361,63,19,17,100,3,206
39035018AAB,1252,962,905,31,6,7,14,0,57
39035018AAD,1555,1192,1083,42,11,21,29,2,109
39035018BVH,1643,1210,1075,16,22,9,85,0,135
39035018BLH,1565,918,522,9,344,5,16,0,396
39035018BLO,1460,1141,596,13,484,23,36,0,545
39035018CNX,1157,1024,456,18,503,7,38,2,568
39035018CNV,1590,1377,552,28,741,9,66,0,825
39035018AWN,1214,1037,575,22,429,11,4,2,462
39035018BKW,1214,892,292,25,552,13,28,0,600
39035018AUH,641,469,28,5,431,2,9,0,441
39113057AQR,1661,1298,232,35,1005,12,15,1,1066
39113057AHW,1063,715,89,6,607,20,2,1,626
39113057AQN,684,526,34,11,478,12,4,1,492
39113057AMH,1299,1035,912,37,42,20,14,2,123
39113057AVQ,2326,2012,1482,144,230,50,114,6,530
39113057AUK,1846,1585,732,20,796,13,19,2,853
39055028ACW,1052,851,812,8,2,16,3,0,39
39017009AEN,845,628,514,30,53,19,0,0,114
39017009AHY,439,354,341,4,1,1,5,2,13
39035018BSG,1711,1321,1172,51,48,16,16,0,149
39035018BSE,1632,1324,1226,34,34,18,22,0,98
39035018BCU,1521,1184,807,211,114,23,23,2,377
39035018CZW,108,81,53,12,14,0,0,0,28
39035018CNA,1568,1232,908,21,103,15,169,2,324
39035018CNE,1182,897,774,16,58,0,41,0,123
39035018BES,1275,1154,789,104,182,29,58,2,365
39035018BPF,1500,1305,214,27,1027,4,27,0,1091
39035ZZZZZZ,0,0,0,0,0,0,0,0,0
39035018BVM,1486,1177,1077,31,26,10,28,0,100
39035018BYC,1399,1334,978,75,198,13,69,0,356
39035018BXC,1418,1094,979,26,39,11,23,0,115
39035018BOR,933,790,382,11,385,6,0,1,408
39035018BWG,1311,1074,937,42,35,14,37,2,137
39035018BPD,1297,1062,432,20,592,15,10,1,630
39035018BEV,1300,1239,980,71,139,22,39,3,259
39035018AWZ,595,419,32,7,379,1,1,2,387
39035018BPK,932,785,208,28,499,4,18,0,577
39035018BPE,1289,1056,325,19,691,19,8,3,731
39035018BXV,1037,975,826,29,36,13,73,1,149
39035018BXW,1767,1693,1371,98,143,20,67,1,322
39035018BOK,780,619,484,11,101,7,13,0,135
39035018BOT,1399,1111,685,22,374,9,17,0,426
39035018AWA,985,942,175,11,754,18,6,0,767
39035018BPL,1100,904,619,39,237,7,12,0,285
39035018AAZ,1378,1049,977,25,11,10,20,0,72
39035018DEK,676,568,8,5,555,4,1,0,560
39035018BHK,1624,1250,755,184,269,35,43,6,495
39035018ALR,867,666,21,7,630,7,8,1,645
39035018BEA,1085,929,572,160,163,17,24,3,357
39105053AAK,760,634,622,3,7,2,0,0,12
39105053AAU,604,461,424,5,18,10,2,0,37
39105053AAP,608,509,496,5,3,9,0,0,13
39157079ABL,1184,942,878,12,14,18,21,1,64
39157079AAC,1245,1036,996,14,2,15,10,0,40
39157079AED,1501,1163,1119,11,1,22,9,0,44
39113057AWJ,1345,1003,810,28,107,20,41,2,193
39157079ABK,790,644,624,5,2,2,1,0,20
39085043AAK,1322,1062,985,16,7,23,15,1,77
39085043AAN,1547,1249,1148,26,29,21,18,2,101
39149075AAH,1568,1079,987,22,32,26,8,4,92
39149075AAN,2542,1825,1463,54,215,39,26,11,362
39149075ABC,820,598,590,1,1,1,1,1,8
39149075ABD,1180,883,855,7,2,3,3,5,28
39133067AAB,1544,1150,1040,15,28,14,47,0,110
39133067AAE,1575,1262,1025,17,73,12,122,0,237
39133067ABA,990,797,605,24,129,25,20,0,192
39133067ABO,903,757,663,20,51,14,8,1,94
39133067AFV,1508,1251,1162,13,40,23,7,1,89
39111056AAL,419,346,332,3,1,8,1,0,14
39055028AAX,833,651,613,10,9,7,10,1,38
39043022ABY,1232,1002,911,45,14,24,8,0,91
39043022ABV,855,751,692,30,3,7,13,0,59
39055028ACV,1162,950,898,25,5,7,6,1,52
39017009AKI,1804,1316,681,471,58,40,89,4,635
39017009AHM,1262,984,937,12,6,14,9,0,47
39017009AHJ,566,454,442,4,0,7,1,0,12
39017009AKU,1914,1347,952,145,208,58,4,12,395
39017009AFV,1063,820,691,31,53,11,34,0,129
39017009ALD,710,540,385,35,55,17,45,3,155
39017009AIA,986,790,737,9,18,10,7,1,53
39017009AHV,1528,1139,1097,3,8,24,4,0,42
39017009AHZ,1426,1053,985,7,8,32,8,1,68
39017009AAU,1386,1034,733,45,187,10,54,1,301
39095048ALS,1447,1037,647,102,266,30,3,1,390
39095048ASO,1820,1570,1260,67,169,38,36,0,310
39095048ATF,1731,1351,1028,71,172,40,46,1,323
39095048AAX,1617,1338,1119,100,82,33,5,0,219
39095048AAY,1491,1178,1082,57,10,15,9,0,96
39095048AFX,1997,1516,486,50,926,34,26,0,1030
39095048ARE,1835,1359,751,53,508,36,23,0,608
39095048ASQ,1716,1350,1130,40,110,11,48,1,220
39095048ABQ,2043,1642,1326,186,67,34,26,1,316
39095048AJQ,2000,1618,1100,43,309,19,134,0,518
39061031BAI,1322,926,828,20,12,2,49,3,98
39061031BAC,1504,1039,917,33,14,7,64,3,122
39061031AYZ,917,600,567,9,5,7,12,0,33
39061031AON,2590,1944,1126,160,591,54,22,1,818
39009005AAZ,756,574,536,5,10,17,2,1,38
39061031ACD,1368,1184,988,27,106,16,46,2,196
39061031AGO,1548,1432,1026,44,256,26,65,6,406
39061031AEF,1400,1190,1024,38,64,19,34,0,166
39061031ATD,820,599,541,11,18,3,21,0,58
39061031BLS,1849,1320,549,45,689,15,22,5,771
39061031AVH,1483,1146,841,52,188,39,20,0,305
39095048AHT,1591,1126,615,85,406,34,10,4,511
39081041AEG,816,669,637,3,3,14,2,0,32
39081041ACI,933,751,710,11,14,12,4,2,41
39061031AQQ,1145,780,143,29,596,11,2,0,637
39061031APQ,1416,1124,141,18,952,10,9,2,983
39061031BKD,1490,1212,1172,1,9,10,13,2,40
39061031AUI,799,607,259,9,317,14,7,6,348
39081041ACU,655,508,497,2,1,5,0,0,11
39077039ACL,519,403,379,14,5,6,0,0,24
39127064ABC,1215,896,869,7,4,12,3,0,27
39083042ABI,1406,944,901,9,3,10,2,2,43
39059030ABA,1253,1011,974,4,8,18,2,0,37
39059030ACB,754,565,544,6,3,4,0,0,21
39167084AAC,1694,1345,1204,12,55,43,16,4,141
39129065ABC,1448,1119,1032,10,24,42,12,0,87
39121061AAZ,312,247,241,0,0,4,0,0,6
39115058AAN,921,715,670,4,27,13,4,1,45
39013007AAP,967,738,667,15,31,6,21,1,71
39013007AAT,641,551,504,9,12,3,17,1,47
39013007AAS,640,539,494,10,19,8,9,1,45
39013007AAZ,695,604,573,0,21,9,1,0,31
39013007AAY,743,599,570,3,8,7,3,0,29
39049025AXN,1827,1406,920,186,250,45,7,5,486
39049025ALB,1649,1159,337,147,577,45,89,4,822
39049025AVI,960,716,632,25,15,10,28,0,84
39049025BMJ,954,660,498,39,57,5,57,0,162
39049025BIH,1539,1354,725,64,518,32,43,1,629
39081041ABZ,767,614,595,0,1,12,2,0,19
39081041ACB,1068,885,841,7,10,17,6,0,44
39081041ADN,800,601,526,12,21,16,5,0,75
39013007ABE,1211,934,912,2,4,11,1,1,22
39063032ABO,1515,1204,1026,83,52,22,11,1,178
39103052AFO,1172,937,891,7,4,20,6,1,46
39103052ABS,1525,1109,1062,14,16,6,2,0,47
39099050AKS,1214,962,860,39,44,13,9,2,102
39093047ALL,1009,967,902,25,15,9,7,2,65
39093047ALJ,819,553,491,9,32,6,15,0,62
39093047AGY,1760,1316,1200,43,27,28,14,1,116
39081041ADO,737,617,560,14,32,7,2,0,57
39081041ACA,991,815,761,18,11,12,0,1,54
39147074ABS,1059,859,805,10,4,15,20,0,54
39147074ABC,1456,1206,1151,15,8,10,18,3,55
39165083AEX,1447,1072,923,25,29,22,63,0,149
39165083ACU,1316,1070,983,18,31,13,15,1,87
39165083AEA,1950,1319,1157,36,42,26,35,1,162
39165083ADY,927,722,666,19,3,13,11,3,56
39155078AFQ,1202,1045,989,9,7,14,4,2,56
39155078ADL,1924,1525,1093,31,338,39,17,6,432
39147074AAY,832,724,661,28,15,10,13,0,63
39077039AAI,1457,1100,890,104,54,32,16,0,210
39099050AMV,1020,879,762,19,41,7,46,0,117
39099050ASW,1229,967,906,23,24,4,15,2,61
39099050AMZ,1221,992,935,11,3,18,11,2,57
39099050ATH,1382,997,929,14,7,2,33,0,68
39099050AAZ,880,656,589,15,10,5,29,0,67
39093047AHE,1036,908,850,11,20,6,9,0,58
39103052ADH,1494,1109,1029,26,1,24,22,2,80
39103052ADI,925,732,670,13,1,18,19,1,62
39077039AAV,1470,1084,940,69,34,29,15,1,144
39077039AAW,1392,1056,832,150,42,38,8,0,224
39121061AAA,755,492,474,1,3,9,3,0,18
39103052ACK,983,760,736,6,6,8,2,1,24
39103052AFF,1683,1215,1166,2,8,6,15,0,49
39103052AED,1395,1146,1059,26,10,25,5,0,87
39135068AAQ,946,759,746,1,3,9,1,0,13
39099050APE,903,741,700,8,9,19,0,0,41
39035018CNB,1394,1014,893,27,28,9,44,1,121
39035018AEP,1351,1065,998,10,10,4,25,1,67
39035018AGS,1253,1063,934,41,31,20,20,0,129
39035018ADN,1611,1234,1023,60,76,23,46,2,211
39035018ADP,1576,1325,1159,34,99,17,26,0,166
39035018CQK,1294,1074,272,29,750,7,19,1,802
39035018CRA,1727,1460,835,52,477,20,86,1,625
39035018ABG,1419,1116,759,28,199,6,106,0,357
39103052AGE,1906,1456,1364,21,20,36,14,0,92
39103052AFT,1140,926,864,26,8,8,17,0,62
39103052AFR,1216,956,883,16,6,27,9,2,73
39059030ACO,1122,834,802,5,5,14,4,0,32
39115058AAD,677,512,491,2,5,9,3,0,21
39035018AKF,831,617,5,6,606,3,1,1,612
39035018AKA,607,470,0,6,467,9,0,0,470
39035018CBP,1659,1270,1042,39,110,24,51,1,228
39035018AFG,1357,971,818,20,16,9,102,6,153
39035018AFU,1308,1067,962,11,4,4,76,0,105
39035018AJN,1073,815,236,59,499,30,4,2,579
39035018BAR,1101,907,520,243,95,22,41,2,387
39035018CTY,1164,925,528,21,360,7,8,3,397
39035018BUK,1540,1169,552,33,564,18,2,0,617
39053027AAY,1393,1024,978,3,8,27,1,0,46
39035018CYG,1440,1214,1124,42,6,1,29,0,90
39035018CYE,1446,1229,1138,14,30,13,34,0,91
39035018CYR,918,713,642,20,8,5,28,0,71
39035018CYW,1844,1602,1320,66,75,12,129,2,282
39035018CYT,1406,1068,885,52,49,7,62,1,183
39035018CYH,1383,1092,890,35,41,15,98,0,202
39035018BEY,1377,1220,692,126,343,24,46,0,528
39035018BEZ,1440,1281,994,92,141,24,35,1,287
39035018ARA,612,472,12,11,448,6,1,0,460
39035018AQW,601,469,18,23,424,11,2,1,451
39035018BED,1241,1048,594,160,279,15,11,2,454
39035018CNM,1811,1544,397,28,1080,24,31,0,1147
39035018BRE,1695,1080,39,16,1018,32,10,2,1041
39035018CEW,1974,1643,1266,98,149,16,86,1,377
39035018CEZ,1811,1446,1065,108,136,28,93,4,381
39035018DBD,1531,1459,1414,10,9,13,6,0,45
39035018AED,1646,1471,1322,16,71,17,36,0,149
39035018CDJ,1708,1372,1229,51,40,17,40,3,143
39035018DEC,1245,1041,959,30,20,7,25,1,82
39035018BLR,1690,1394,674,36,613,7,71,1,720
39035018CQJ,1194,943,582,31,296,16,42,1,361
39035018CRI,1375,1029,443,22,516,25,36,3,586
39035018CLO,1700,1417,1274,45,20,15,69,0,143
39035018CIR,1796,1533,1239,83,108,17,82,4,294
39045023ACN,1315,1063,963,18,33,34,3,2,100
39045023ADK,1748,1309,791,99,363,23,56,1,518
39045023AEQ,2563,1779,531,155,915,22,170,2,1248
39045023ABC,1467,982,665,42,212,19,50,5,317
39045023ABE,1925,1351,1033,39,183,38,69,0,318
39045023ABH,2089,1414,1012,77,206,46,87,1,402
39045023ADF,1344,1014,974,5,8,24,3,0,40
39045023AAO,1186,901,855,9,15,10,2,1,46
39167084ABN,1342,1085,963,16,71,26,7,2,122
39035018CSH,1293,965,558,19,95,4,290,4,407
39035018CSD,1596,1187,823,29,120,9,188,1,364
39035018CZG,1417,1167,1039,42,23,6,59,0,128
39035018DBI,1641,1343,1176,37,47,28,37,2,167
39035018DAE,1694,1303,1220,27,22,13,14,0,83
39035018BEG,1343,990,358,278,313,26,43,4,632
39035018BEF,1192,926,471,207,210,25,22,4,455
39035018ADU,1281,1044,960,23,27,13,15,1,84
39035018ADV,1244,1009,885,33,60,28,11,1,124
39101051AAA,1111,760,635,17,85,21,3,1,125
39035018DAI,1274,1011,805,20,109,8,66,0,206
39035018AUB,708,573,6,10,558,1,2,0,567
39035018ATZ,750,591,3,5,580,2,0,0,588
39035018CWS,1141,923,459,20,420,12,17,0,464
39035018CAJ,949,739,137,17,579,5,1,0,602
39035018AFM,1693,1320,1122,19,19,6,129,0,198
39035018ALV,822,631,3,3,623,3,1,0,628
39035018AZL,1655,1511,998,260,203,23,70,3,513
39035018AQM,848,640,2,2,628,8,0,0,638
39035018CPO,1684,1409,1243,50,47,12,58,2,166
39035018CPS,1456,1217,1121,16,20,9,45,1,96
39123062AAO,1358,1076,1002,32,7,27,2,0,74
39117059ABF,1156,919,888,10,3,12,2,0,31
39117059AAZ,789,631,604,5,3,9,6,1,27
39045023ADQ,1269,929,707,30,119,11,58,2,222
39045023ADP,1475,1123,858,22,178,20,53,1,265
39055028ABM,694,560,488,30,13,15,5,0,72
39055028ABK,889,714,660,10,5,15,7,1,54
39043022ADF,1506,1181,937,34,171,11,25,0,244
39035018CZJ,1297,1144,916,58,57,16,104,1,228
39035018CYX,1400,1282,1020,67,113,14,57,0,262
39035018AHA,1762,1377,1062,81,134,44,45,4,315
39117059ABE,754,581,554,11,1,16,1,0,27
39127064AAL,943,694,651,2,9,20,2,1,43
39033017AAY,1270,951,897,7,14,25,0,0,54
39057029AAF,1054,842,761,21,12,14,27,0,81
39057029AIH,645,498,439,10,16,12,19,0,59
39057029AIC,415,339,330,0,6,1,2,1,9
39101051ACH,1017,874,801,16,11,9,30,0,73
39057029ACT,1122,821,753,17,12,11,17,0,68
39057029AID,1792,1331,1016,61,139,17,87,1,315
39101051AAJ,1095,852,731,39,53,32,2,0,121
39129065ABX,1192,946,904,6,5,21,2,0,42
39057029AEB,1134,855,704,24,76,18,23,4,151
39101051AAS,647,486,429,10,22,16,5,0,57
39057029ACQ,940,739,657,21,16,14,19,2,82
39057029AHD,858,645,614,0,5,17,6,1,31
39057029AHE,261,196,183,3,5,3,0,1,13
39057029AAL,2487,2000,1379,116,168,19,320,4,621
39057029AHQ,700,555,516,2,8,20,7,0,39
39061031BMZ,1574,1314,1195,17,43,30,29,0,119
39061031AZM,1750,1299,1225,14,13,19,21,3,74
39025013AAN,1747,1262,1145,25,49,31,12,1,117
39007004ACG,1112,934,807,38,46,25,14,1,127
39025013AEP,1444,1190,1143,12,3,19,4,1,47
39079040ABP,687,531,501,3,6,14,4,1,30
39003002AFK,1145,843,780,17,13,11,10,2,63
39113057ALQ,1231,945,805,28,33,33,42,2,140
39113057AXU,1721,1375,1268,20,37,22,26,2,107
39113057AKR,1310,999,907,25,22,18,4,2,92
39113057AKV,1419,1097,940,39,50,57,17,2,157
39113057AKU,1402,1019,904,33,36,26,14,2,115
39097049AAB,2771,2045,1730,60,136,42,67,2,315
39073037ABB,1455,1109,1071,3,1,21,6,0,38
39139070ABP,1269,952,915,16,4,8,3,1,37
39147074ABI,645,464,405,47,4,7,0,1,59
39147074ABP,867,632,595,16,1,10,2,0,37
39137069AAP,966,730,713,2,7,7,1,1,17
39137069AAO,1063,832,817,7,4,3,0,0,15
39145073AEE,1047,804,772,4,4,19,3,0,32
39165083AAM,1444,1035,922,28,60,15,10,0,113
39165083AAK,1209,843,736,31,39,23,7,1,107
39165083AGX,2050,1457,1216,51,83,32,74,4,241
39165083ADF,1478,1110,1024,14,28,16,22,0,86
39165083AGA,1458,1027,957,7,14,18,21,5,70
39113057AJW,2160,1659,1248,39,276,30,49,7,411
39113057AJU,1809,1405,1071,79,193,33,41,4,334
39113057AHB,1393,1025,294,39,670,17,6,5,731
39173087ADO,1003,749,688,44,7,7,1,0,61
39017009AGU,1062,765,656,25,23,14,43,0,109
39017009AJJ,2203,1705,915,146,254,21,354,1,790
39017009AIU,1220,869,530,45,136,13,147,1,339
39017009AIJ,2118,1546,1053,38,185,8,245,2,493
39017009AEO,1237,899,644,80,161,20,7,5,255
39017009ALW,1455,1021,871,38,49,24,28,4,150
39017009AKM,1922,1356,1106,42,101,41,71,5,250
39017009AER,1517,1137,871,81,168,24,8,0,266
39017009AFR,1503,1138,902,32,128,22,46,1,236
39017009AFW,1076,890,762,30,42,17,31,1,128
39113057AKF,2398,1840,1321,80,333,31,62,2,519
39113057AFY,1487,1168,64,15,1074,20,2,0,1104
39165083ACS,1789,1271,1181,15,17,25,26,2,90
39165083AED,3924,3780,1765,76,1916,27,5,2,2015
39003002ACT,1329,1034,967,12,15,23,7,0,67
39139070ABQ,1228,967,931,14,10,11,0,0,36
39113057AVH,1918,1385,643,71,648,35,6,3,742
39113057AIV,1244,1028,788,17,170,22,23,2,240
39155078AJH,981,789,737,10,8,27,4,0,52
39155078AIZ,1066,873,804,9,12,21,0,1,69
39155078AEH,1386,1077,488,7,554,32,4,2,589
39093047AEH,1503,1050,382,387,298,11,6,3,668
39093047AJF,1772,1428,1288,55,17,33,32,6,140
39093047ACX,1689,1178,884,73,177,39,2,4,294
39099050AJY,1149,1021,883,29,34,12,55,1,138
39099050AOC,761,636,610,13,6,5,1,0,26
39109055AAB,1440,1020,871,25,88,39,1,2,149
39017009AKP,702,526,503,5,8,8,3,0,23
39017009AGP,1703,1122,801,44,163,20,93,0,321
39017009AKQ,1646,1243,1081,28,54,35,30,0,162
39017009AEL,1509,1191,991,62,99,32,7,3,200
39049025AOZ,1920,1415,848,288,226,29,33,3,567
39049025BHR,1628,1144,485,53,390,33,190,1,659
39049025ANQ,1419,1108,716,24,278,23,61,3,392
39049025AAP,1720,1561,1249,52,179,37,25,5,312
39031016AAQ,1054,830,774,3,29,16,1,1,56
39031016ABE,626,497,477,4,3,6,5,1,20
39113057AWO,1311,980,903,13,9,40,5,0,77
39113057APR,2206,1668,1385,118,94,48,26,3,283
39113057AEQ,1949,1425,1034,174,162,42,19,3,391
39113057AFA,1215,976,766,60,91,35,12,0,210
39113057AXW,1488,1153,1019,30,20,14,65,0,134
39113057AEU,1843,1476,1117,150,132,60,27,2,359
39031016AAE,1487,1085,1000,12,47,17,3,1,85
39031016AAG,1540,1189,1110,8,34,28,5,3,79
39023012AFG,1214,1000,924,10,37,16,13,1,76
39023012ADV,1117,899,832,14,14,21,6,3,67
39041021AES,1010,707,464,57,144,36,8,2,243
39041021AAN,1779,1338,1116,71,101,31,20,2,222
39003002AEF,991,758,697,9,16,11,25,0,61
39107054AAF,1550,1181,990,45,24,49,28,56,191
39107054ABF,878,706,636,20,26,16,9,3,70
39171086AAJ,1024,781,677,54,13,23,7,0,104
39023012UAF,1906,1508,1422,21,13,35,13,2,86
39023012ADQ,2065,1579,1508,13,17,29,7,1,71
39023012AFA,1760,1445,1323,19,47,22,11,4,122
39047024AAX,515,407,384,9,4,5,1,1,23
39049025BER,1125,1057,916,23,50,8,51,0,141
39049025ARJ,1059,787,668,10,10,5,86,1,119
39003002ACU,732,576,545,12,6,9,1,0,31
39155078ABX,1415,1108,961,22,60,44,7,0,147
39165083ADU,2049,1476,1322,53,30,51,19,1,154
39165083AGS,1128,805,721,31,18,17,8,0,84
39155078AGD,542,374,359,3,5,8,1,0,15
39155078ABJ,1431,1286,1107,20,111,9,36,2,179
39155078AKA,1527,1257,1146,20,26,40,10,0,111
39087044ADF,1242,964,924,10,3,20,2,0,40
39087044ACC,279,213,199,4,1,7,1,0,14
39087044ACE,1540,1260,1189,6,9,24,29,0,71
39087044ACJ,600,495,463,12,11,7,4,0,32
39087044ABE,566,444,426,5,6,7,3,0,18
39003002ADD,1055,855,766,21,41,9,13,1,89
39089045ADR,1296,1031,952,24,8,31,6,0,79
39141071ABS,1268,1040,1000,9,10,14,0,0,40
39141071ABT,1019,775,744,2,10,13,2,1,31
39141071ACN,1719,1366,1275,10,24,12,36,1,91
39165083ABB,1063,932,765,25,55,9,68,2,167
39025013AEN,1324,1015,959,8,7,23,9,4,56
39147074ACP,832,666,632,11,5,10,6,0,34
39165083ADX,1382,1105,959,18,77,24,17,1,146
39165083ABA,1443,1099,691,38,45,5,304,1,408
39165083AAU,911,718,582,29,26,8,76,1,136
39165083ABK,1388,1005,933,11,9,24,12,1,72
39165083AAJ,1131,890,791,30,44,12,18,0,99
39073037ABH,899,687,653,4,2,15,3,2,34
39041021ACY,1075,759,677,17,6,5,35,2,82
39041021ACV,855,621,557,14,20,3,25,2,64
39023012AAR,1432,1130,957,53,96,19,3,1,173
39089045AAY,1556,1282,1131,25,60,36,20,2,151
39041021ACI,1196,935,863,23,11,11,15,1,72
39041021ACL,1332,1030,964,27,4,15,16,0,66
39041021AGE,2368,1848,947,113,208,25,546,2,901
39041021AEC,2380,1847,1072,92,185,25,479,10,775
39041021ADW,924,724,698,7,5,8,1,0,26
39023012AFD,1293,1024,955,14,15,28,10,0,69
39025013AHF,1209,924,878,0,14,19,6,0,46
39025013AAG,1601,1196,1107,11,35,25,9,0,89
39089045ADO,1395,1076,1026,3,7,25,5,0,50
39089045ADE,1834,1422,1367,4,10,26,5,0,55
39123062ACG,768,599,555,11,3,15,6,0,44
39165083AFC,1130,887,763,30,44,32,24,3,124
39155078AFD,1354,1056,992,13,8,31,1,0,64
39155078AFB,1350,1106,1060,7,7,16,0,0,46
39089045ADV,1152,994,956,8,3,20,3,0,38
39067034AAL,517,444,434,2,0,3,2,1,10
39049025BGH,1639,1313,889,79,270,23,51,1,424
39049025BHU,1439,1185,874,48,204,14,37,0,311
39049025BLA,1577,1536,1066,62,44,11,351,3,470
39049025AZU,1698,1282,1068,19,153,23,24,0,214
39049025AFE,1623,1142,241,75,825,24,16,2,901
39049025AFC,1740,1266,466,116,649,39,19,2,800
39049025ATB,1203,875,732,29,41,24,46,0,143
39049025ATQ,1179,905,808,21,28,30,10,1,97
39049025ATM,2005,1500,1215,68,158,38,18,0,285
39153077APV,1140,917,811,9,43,21,26,2,106
39153077ADP,1162,847,523,28,257,22,34,3,324
39153077AYV,1007,861,566,27,228,16,24,1,295
39153077AYU,1062,894,571,28,221,17,60,3,323
39051026AAJ,2047,1575,1234,257,22,42,21,2,341
39153077AXV,931,716,652,8,7,8,39,1,64
39153077AOE,1152,981,894,17,26,6,27,1,87
39153077AUU,1149,1030,967,13,14,13,16,0,63
39073037AAL,780,612,569,4,1,24,7,2,43
39159080AAQ,1094,836,761,15,6,33,7,0,75
39153077ASW,859,784,737,4,6,20,7,3,47
39153077BBL,1052,884,834,6,8,16,9,1,50
39153077AWY,1196,1018,926,9,15,35,19,1,92
39153077ATB,1440,1146,1066,13,16,24,7,0,80
39153077ADA,1192,960,663,50,220,15,24,1,297
39153077AAR,1253,1124,887,16,170,22,33,1,237
39153077AAG,1111,960,870,15,30,12,33,0,90
39153077AAH,1612,1305,903,48,308,30,25,3,402
39153077AGW,1541,1385,938,48,336,10,43,1,447
39153077BAC,1481,1279,1075,7,146,29,12,0,204
39153077BAI,1205,954,834,19,40,26,30,0,120
39153077BAH,1178,948,850,11,41,29,16,0,98
39153077BBQ,997,736,634,10,48,14,33,0,102
39153077AJG,1438,1167,1051,21,48,21,16,2,116
39093047ABR,1913,1415,1169,71,121,34,14,3,246
39093047ABQ,2020,1590,1312,73,128,66,23,2,278
39093047AEN,1736,1427,737,380,292,30,13,3,690
39093047AEM,1811,1402,962,281,142,27,24,2,440
39093047ADI,1737,1430,1250,55,77,32,12,0,180
39093047AJC,1596,1316,1242,25,3,16,5,1,74
39093047AJQ,1293,1078,1020,15,3,26,8,2,58
39175088AAS,1409,1048,987,21,5,14,11,0,61
39175088AAQ,985,762,699,15,16,9,16,0,63
39087044ACI,1230,976,918,14,13,14,11,0,58
39087044ACG,1584,1282,1218,2,23,16,21,0,64
39151076AJJ,1831,1453,1391,15,17,17,8,2,62
39151076AED,833,674,610,7,29,16,8,0,64
39151076AJC,1341,1098,1013,13,42,26,3,0,85
39151076AGS,1494,1117,1005,14,27,21,48,1,112
39151076AGM,1411,1122,1019,19,36,8,29,0,103
39049025BIY,1985,1401,805,178,350,28,59,4,596
39049025AAK,1016,702,650,7,14,6,14,0,52
39049025AAI,1060,752,642,44,23,12,38,0,110
39049025AWO,1529,1137,1004,21,48,21,32,2,133
39049025BGR,1714,1222,810,87,246,17,62,3,412
39049025BGP,1566,1178,926,69,76,14,99,4,252
39049025BNJ,761,544,439,34,24,6,41,0,105
39151076AFK,1578,1309,1195,24,37,17,21,3,114
39151076AGR,753,639,604,11,16,0,6,1,35
39151076AFA,1471,1182,1072,21,47,25,19,1,110
39151076AFY,1915,1566,1295,50,153,48,4,3,271
39151076AHS,1102,878,830,8,10,14,9,0,48
39175088ABI,981,793,775,10,1,4,0,0,18
39131066AAQ,2428,1805,1722,11,16,45,9,2,83
39049025AVZ,1661,1226,1063,24,19,14,114,2,163
39049025BML,1062,807,655,25,86,16,27,1,152
39049025AWU,1120,955,753,25,116,27,45,4,202
39049025BLN,1566,1506,1104,92,104,6,192,0,402
39049025APN,1957,1781,1352,87,81,26,213,7,429
39049025AFY,1027,832,210,23,586,12,12,0,622
39049025BKA,1095,731,632,32,17,15,29,0,99
39049025BIX,1170,872,667,90,67,27,36,2,205
39049025AOO,2001,1467,1034,158,120,33,102,0,433
39049025AND,2091,1646,1237,75,86,27,214,6,409
39049025ABD,1267,942,280,43,609,24,9,0,662
39049025AEN,1145,1003,922,8,33,11,28,0,81
39021011ABW,1872,1440,1334,17,29,47,3,1,106
39041021ABA,1112,856,802,11,11,10,22,0,54
39023012AFX,1880,1481,1318,20,65,51,21,2,163
39023012AGD,1793,1416,1195,23,130,52,12,4,221
39023012AEY,1010,802,755,10,20,12,2,2,47
39041021ABD,876,645,556,14,38,12,20,3,89
39041021ABF,1240,907,771,22,59,5,44,0,136
39041021AGC,1100,818,694,19,43,5,43,2,124
39151076AAM,2206,1791,1607,36,83,34,19,1,184
39151076ACW,1510,1204,907,43,202,20,22,0,297
39151076AHO,920,820,717,12,35,15,35,1,103
39139070ABE,1000,799,770,7,8,9,5,1,29
39139070ACA,1052,828,722,14,46,24,5,0,106
39015008ACW,1179,942,902,1,2,30,1,0,40
39015008ABP,1083,769,721,4,9,23,4,1,48
39023012AAI,1324,1019,799,24,148,28,19,6,220
39155078AJL,1210,957,902,4,11,27,2,0,55
39023012ADP,1332,1052,971,8,21,29,18,0,81
39145073ACT,1108,860,822,5,4,25,0,0,38
39145073AAO,443,403,379,2,15,3,0,1,24
39145073ABG,724,586,530,10,25,14,4,0,56
39145073AAK,1462,1352,1150,49,130,20,15,4,202
39145073AAI,761,622,542,17,40,19,1,0,80
39037019ABF,986,731,698,4,9,9,1,0,33
39161081ABC,572,454,438,3,0,4,3,0,16
39011006ABL,1746,1372,1315,9,8,25,10,0,57
39011006AAH,1507,1184,1136,9,6,22,7,2,48
39011006AAI,1083,796,730,15,13,30,5,2,66
39137069AAU,1746,1371,1264,84,12,6,5,1,107
39161081AAX,636,484,467,5,3,5,1,0,17
39125063AAV,823,622,565,28,15,13,1,0,57
39153077ABN,1734,1387,664,34,411,35,242,3,723
39153077AYO,1878,1387,563,45,251,23,509,1,824
39153077AEL,1441,1200,1070,22,84,18,10,0,130
39153077AHN,1731,1454,1208,29,172,48,13,0,246
39153077AVF,659,552,514,5,10,2,19,0,38
39153077AVG,623,508,484,8,5,0,11,0,24
39153077ARC,567,483,470,2,0,0,6,0,13
39043022AEI,1562,1172,714,80,344,39,8,0,458
39055028AAF,2444,2136,1831,32,234,12,16,1,305
39055028AAG,1377,1046,960,27,15,11,18,0,86
39055028AAI,1798,1369,1265,20,27,11,45,2,104
39087044ACQ,1071,826,771,11,16,17,7,0,55
39043022ADO,1450,1199,1119,24,25,25,12,1,80
39085043ADY,1388,1078,931,8,117,4,16,2,147
39085043ADX,1553,1325,1153,32,79,17,29,3,172
39085043AIQ,1499,1166,1082,15,17,11,30,1,84
39133067AGB,1244,1053,1006,6,6,28,1,1,47
39153077AYL,1863,1357,442,70,265,17,573,0,915
39051026AAY,1369,1147,1096,17,5,17,4,0,51
39153077ANK,1032,855,747,10,74,13,15,1,108
39153077ABL,1645,1263,736,41,159,14,314,0,527
39153077BAX,1205,969,853,17,25,12,53,0,116
39153077BAW,1416,1113,998,28,17,0,67,0,115
39087044ABB,625,489,479,1,4,3,2,0,10
39087044ABU,386,298,287,2,2,8,0,0,11
39087044ABT,588,451,437,2,2,9,0,0,14
39123062AAY,1186,906,856,23,4,17,5,1,50
39123062ABX,1004,851,798,26,8,10,3,0,53
39133067AGG,875,742,714,9,6,12,3,0,28
39085043ABS,1515,1216,1148,23,14,15,12,1,68
39085043ABR,1555,1306,1240,26,14,13,6,2,66
39085043AAG,1337,1102,1013,20,16,18,23,1,89
39151076ANK,1695,1286,1117,31,77,18,28,0,169
39151076AND,1376,1037,903,20,73,22,12,0,134
39087044ACW,536,404,378,13,4,5,0,1,26
39087044AAD,375,270,246,5,9,3,2,1,24
39087044AAB,412,319,295,3,9,7,3,1,24
39105053AAG,733,600,566,8,0,19,3,0,34
39105053AAO,610,521,493,5,3,14,2,0,28
39105053AAR,761,614,570,8,18,14,0,0,44
39105053AAS,714,578,520,7,34,17,0,0,58
39105053AAT,733,558,532,2,14,10,1,0,26
39157079AAG,1275,1029,987,14,10,8,11,0,42
39011006ABQ,749,564,506,20,4,27,7,0,58
39011006ABP,759,600,581,2,0,10,2,0,19
39029015ADH,731,588,569,6,1,10,3,1,19
39029015ADD,956,719,697,2,4,9,1,1,22
39099050APG,505,391,352,6,15,14,2,0,39
39099050AHU,1101,857,622,42,166,18,12,0,235
39099050AHT,1393,999,802,23,149,21,4,1,197
39099050AAE,704,573,401,85,81,9,4,0,172
39133067ABR,985,857,780,12,33,6,14,3,77
39055028ABY,973,801,746,12,16,14,5,0,55
39149075ACG,1596,1199,1148,13,9,16,5,2,51
39151076AFO,1173,936,853,13,6,32,7,0,83
39173087ACQ,794,613,582,12,11,7,7,0,31
39173087ACO,1245,903,826,48,6,17,2,0,77
39017009AGR,1943,1287,1102,27,82,17,49,1,185
39017009AGX,1682,1137,954,22,70,13,64,0,183
39017009AKD,1133,917,870,4,4,21,4,2,47
39017009AKC,615,487,461,8,5,10,1,1,26
39017009ACR,1474,1089,824,115,108,36,3,2,265
39085043AFF,1852,1476,1356,26,49,15,21,3,120
39085043AFD,1804,1425,1301,29,46,20,26,4,124
39085043AFE,1334,1148,819,20,271,28,12,1,329
39085043AFX,1356,1049,943,30,24,29,11,0,106
39085043AFY,2107,1691,1566,29,24,33,17,4,125
39149075ACL,1250,913,888,1,4,14,3,0,25
39149075ACJ,833,618,593,8,9,8,1,0,25
39041021ACO,934,689,643,13,7,4,20,0,46
39041021AAT,1198,921,822,20,40,34,9,2,99
39041021ADO,1570,1215,1136,15,12,25,14,1,79
39037019AAX,1233,951,906,14,3,20,5,0,45
39023012ABZ,1217,977,775,21,120,26,24,2,202
39041021AAV,1109,780,699,26,17,24,14,3,81
39023012AGB,2047,1581,1461,15,40,48,12,2,120
39023012AAT,1828,1499,1244,90,126,33,12,4,255
39133067ADP,1963,1757,1390,61,168,33,106,0,367
39133067ACX,1519,1248,1110,18,44,22,45,0,138
39085043AHF,543,431,406,5,5,4,12,0,25
39023012AEQ,1470,1196,1104,16,22,34,9,0,92
39023012AEU,1031,826,759,6,23,19,6,0,67
39049025BJQ,1813,1317,923,98,125,25,149,3,394
39049025BIC,1106,808,78,12,670,3,49,0,730
39049025AVS,1208,904,806,17,11,14,51,1,98
39049025AHG,1581,1153,472,154,488,18,34,2,681
39029015ADG,1174,960,920,6,7,19,2,2,40
39029015AFC,1092,843,818,10,3,8,0,0,25
39029015ABE,2108,1589,1438,72,19,61,18,3,151
39023012ADK,1049,862,821,8,11,12,7,2,41
39023012ADS,1051,816,757,9,17,20,6,2,59
39017009ADD,1456,1118,1008,39,32,35,5,2,110
39017009ABV,1093,819,718,26,36,33,7,0,101
39017009AMA,2063,1673,1345,31,109,18,153,0,328
39017009AFM,2308,1549,1368,34,60,48,13,4,181
39017009ACC,1072,886,778,18,44,24,9,2,108
39071036ABT,1305,999,949,2,5,41,0,0,50
39039020AAP,1497,1128,878,160,47,23,3,0,250
39153077ALY,1247,980,873,30,19,21,31,2,107
39153077AZL,1291,1090,877,29,116,21,33,3,213
39153077AWH,1146,910,838,8,16,30,9,1,72
39153077BAS,1286,972,908,11,16,18,9,1,64
39173087ABA,1425,1108,994,35,30,12,29,2,114
39051026AAH,1645,1157,872,220,31,24,6,1,285
39153077ARO,536,431,409,1,8,8,4,0,22
39153077AWK,1713,1328,1128,31,75,25,52,0,200
39153077ACV,1168,943,142,24,764,8,2,2,801
39153077AMS,1273,1023,823,24,111,21,36,1,200
39153077BAQ,900,787,705,11,29,11,28,1,82
39153077AKV,1187,1008,915,15,35,21,17,0,93
39153077BCJ,1944,1395,985,29,161,13,198,3,410
39153077AUI,2341,1691,939,29,353,19,350,7,752
39071036AAN,959,717,656,11,26,15,3,0,61
39153077AWA,1341,1082,1012,15,11,24,7,0,70
39153077BAR,1305,1006,847,19,55,24,52,0,159
39153077ATF,1249,1008,942,10,3,30,8,0,66
39153077AVT,964,774,689,19,25,22,16,0,85
39153077BCX,1407,1155,1019,18,54,16,29,0,136
39153077AFN,1520,1133,596,22,393,35,88,2,537
39153077AFM,1740,1296,590,49,549,43,86,1,706
39153077AIP,1476,1074,512,36,480,36,21,0,562
39153077ARI,1194,929,850,10,13,9,33,0,79
39153077ARB,1190,999,890,9,24,6,59,0,109
39153077AKS,1132,896,828,14,11,24,20,0,68
39153077AKP,1113,976,854,6,64,18,23,0,122
39153077ARY,1459,1174,794,13,306,30,28,2,380
39153077ALH,1216,969,872,8,16,19,49,0,97
39153077APM,1343,1081,932,29,64,13,36,3,149
39153077APL,1280,1049,933,6,55,29,27,0,116
39153077BBZ,1269,1001,900,17,29,15,19,1,101
39153077APN,1248,947,860,9,24,8,42,2,87
39029015ACT,881,721,700,7,1,4,4,1,21
39029015ACQ,1175,898,865,10,1,7,5,0,33
39029015AEM,1204,1007,972,1,6,10,2,0,35
39029015ACD,1133,906,853,0,10,23,1,0,53
39099050API,1056,846,808,8,6,14,3,1,38
39099050ARN,1482,1135,816,52,232,29,7,1,319
39071036AAX,1718,1265,1211,10,9,16,4,1,54
39031016AAB,1688,1223,1100,18,58,38,8,0,123
39061031AID,1662,1216,124,28,1053,19,9,0,1092
39061031AQM,1604,1280,770,23,435,16,19,0,510
39061031BDJ,907,772,299,59,359,14,45,6,473
39061031AAS,2150,1678,1340,25,238,42,25,2,338
39061031AJO,2194,1892,1052,84,394,29,330,1,840
39061031BIR,1581,1256,1217,0,10,8,10,1,39
39061031AJR,1996,1776,1168,81,133,22,366,3,608
39061031AUA,2418,1685,577,23,1050,22,19,0,1108
39061031ARQ,1401,1125,290,65,719,18,46,1,835
39061031AKK,2187,1485,138,25,1300,8,9,1,1347
39061031ADQ,1270,1022,903,37,37,12,22,0,119
39061031ACF,907,847,753,18,25,12,37,0,94
39127064AAA,1465,1133,1101,3,3,20,0,0,32
39127064AAZ,842,676,659,4,3,8,1,1,17
39127064ABT,1040,909,878,4,9,10,3,0,31
39167084ABM,1200,935,893,4,14,15,5,0,42
39077039ABZ,1110,872,814,3,19,21,4,0,58
39077039ABY,1306,996,878,24,37,32,2,1,118
39077039ABO,1320,1082,1022,26,6,26,4,0,60
39127064ABB,862,688,661,4,6,12,3,0,27
39083042ACI,114,86,79,0,2,3,1,0,7
39129065ABV,1313,1030,983,5,6,26,8,0,47
39057029ADY,1347,1120,790,52,219,23,40,1,330
39057029AGW,311,248,236,5,1,5,3,0,12
39057029AHK,971,793,681,16,68,20,15,0,112
39057029ADT,1132,1011,796,28,127,29,41,4,215
39057029AJC,1401,918,710,34,33,12,110,6,208
39061031AXU,2636,1736,595,804,274,112,33,3,1141
39129065ABO,1471,1157,1106,5,14,22,5,0,51
39057029AGT,2152,1608,1343,43,50,23,150,0,265
39057029AEZ,902,713,574,24,74,28,10,1,139
39083042ABK,1095,862,808,6,10,26,7,1,54
39083042ACC,1010,817,742,18,18,27,10,0,75
39081041ADB,539,419,406,2,0,7,1,0,13
39083042AAG,1805,1374,1275,10,41,34,10,1,99
39103052AEC,1606,1049,994,20,9,13,3,0,55
39127064AAS,1367,997,944,10,4,28,3,0,53
39063032AAJ,1610,1439,1224,50,30,15,109,2,215
39063032AAG,1493,1227,994,90,78,26,32,0,233
39083042ABE,1598,1259,1209,4,11,24,4,2,50
39083042ABB,810,620,585,14,8,9,2,3,35
39083042ABD,1758,1388,1311,10,13,31,14,0,77
39119060AAE,1878,1458,1288,16,108,38,4,1,170
39119060ADF,1268,990,960,2,6,13,0,2,30
39083042AAW,340,266,256,5,2,2,2,1,10
39059030ACD,282,224,204,0,6,1,1,0,20
39135068AAV,451,328,304,2,4,11,3,1,24
39035018CTN,1273,1023,567,30,395,4,32,0,456
39035018BRP,1209,1075,863,76,84,11,36,0,212
39035018BRN,1163,983,874,29,41,3,29,0,109
39035018BBQ,1464,1074,449,323,267,38,10,4,625
39035018BBX,1356,1043,531,305,165,38,21,6,512
39035018BBH,1297,934,381,308,225,24,11,4,553
39035018ALD,648,487,0,9,481,7,1,0,487
39035018CXC,2973,2280,2032,68,124,9,53,2,248
39035018DBC,606,498,87,10,390,15,0,1,411
39035018DAW,804,673,38,10,618,15,4,0,635
39035018ADE,1019,859,94,24,731,28,16,0,765
39035018ACZ,1423,1202,164,23,1006,11,11,0,1038
39035018CMG,1928,1583,1356,80,67,30,53,0,227
39035018CMB,1627,1296,1153,68,50,20,8,1,143
39035018APV,524,511,179,75,290,9,21,1,332
39035018CRW,1709,1294,995,36,165,9,84,0,299
39035018BVD,1570,1283,1215,19,8,11,27,0,68
39035018CUR,1401,1111,1027,20,9,5,38,1,84
39035018AZH,926,714,249,237,228,23,6,4,465
39035018BJW,1165,1063,625,47,196,16,177,0,438
39035018AOS,778,645,24,12,616,11,2,0,621
39035018AKC,788,527,158,21,353,3,2,1,369
39035018AXQ,817,559,203,37,309,13,1,0,356
39035018DEU,891,651,49,27,559,15,15,3,602
39035018DEV,1321,971,41,10,899,9,13,0,930
39035018CJB,1692,1458,1305,65,21,16,54,2,153
39035018CIJ,1424,1106,921,97,52,17,24,0,185
39035018CWJ,1597,1196,993,29,26,6,122,1,203
39091046AAE,1885,1433,1304,33,44,19,24,2,129
39103052ACD,1311,1016,920,9,23,42,7,0,96
39045023AAA,1670,1249,1169,19,28,25,5,0,80
39045023ADW,1130,852,752,23,31,23,17,1,100
39035018AFW,1544,1202,989,66,77,22,46,2,213
39035018AFQ,1079,921,791,42,48,9,25,1,130
39035018AFV,840,591,403,35,109,10,35,0,188
39035018ADJ,1707,1471,1063,69,276,30,39,5,408
39035018BFL,1498,1036,425,274,300,45,51,2,611
39035018DAL,365,326,172,2,143,4,2,0,154
39035018DAM,323,257,134,2,78,0,35,0,123
39035018AQO,812,605,22,5,570,13,9,0,583
39061031ADA,1056,908,623,25,217,16,32,3,285
39061031AUW,1926,1511,1036,79,368,24,3,4,475
39061031BDE,2154,1566,881,49,547,56,52,1,685
39061031BBE,1332,937,224,6,697,10,9,0,713
39061031AAD,1491,1170,959,38,46,20,106,3,211
39053027AAE,863,697,602,16,43,23,14,0,95
39061031AXI,1517,1271,781,61,387,29,16,4,490
39061031AIE,1602,1299,543,26,653,18,49,1,756
39061031AEG,1430,1112,960,43,30,22,51,1,152
39061031AXR,1207,973,518,64,344,14,34,0,455
39061031AXT,1144,907,595,81,179,15,41,4,312
39061031AXV,1087,873,460,81,264,40,56,2,413
39061031BBM,1488,1241,1109,19,63,17,28,4,132
39033017ACN,740,595,574,2,2,8,2,1,21
39063032AAB,1267,994,845,71,31,13,31,0,149
39119060ABP,902,668,645,7,3,1,3,0,23
39135068ABC,1575,1188,1140,7,5,21,2,0,48
39033017ABG,951,732,701,13,2,14,2,0,31
39033017ABR,738,572,533,17,2,12,4,2,39
39033017ABX,459,359,352,1,1,4,0,0,7
39061031AFN,1395,1162,141,15,995,14,11,0,1021
39061031AFP,1185,993,100,19,867,8,4,4,893
39091046ABK,809,612,577,6,7,7,7,0,35
39127064ABH,1090,857,814,5,5,16,2,2,43
39033017ABB,1033,801,763,13,10,9,2,0,38
39061031AMK,642,535,343,20,150,21,1,0,192
39057029AFM,1168,907,796,17,60,15,11,1,111
39167084ABJ,1870,1471,1413,3,14,25,3,1,58
39103052ABX,1866,1497,1388,28,29,26,20,2,109
39103052AFZ,1411,991,890,21,20,16,20,0,101
39119060ACV,1175,918,881,8,6,13,3,1,37
39139070ACG,1445,1124,1056,8,17,29,2,0,68
39119060ACD,1731,1289,1214,7,26,22,15,0,75
39119060ACP,1135,915,857,6,30,20,0,0,58
39035018AWI,1230,917,168,13,717,18,3,0,749
39035018AXU,663,482,129,56,291,10,2,0,353
39035018CMO,1831,1483,1258,77,52,26,92,10,225
39035018CMJ,1652,1378,1241,51,32,12,24,0,137
39035018CMR,1707,1388,1055,136,123,26,61,2,333
39035018AXP,1000,749,294,65,370,11,8,0,455
39035018CBI,1723,1417,1064,25,198,17,116,0,353
39035018CBK,1088,1050,861,17,119,7,45,0,189
39035018CCA,2256,1744,861,33,370,33,460,1,883
39035018CWL,1580,1286,1127,36,32,14,72,1,159
39035018ADO,1989,1483,1137,59,168,17,117,1,346
39035018DBH,1323,1123,1068,19,25,5,10,2,55
39035018BQE,1183,739,26,4,707,6,0,0,713
39035018BSQ,1211,932,15,16,900,11,2,1,917
39139070ABV,1704,1274,1164,16,39,37,12,3,110
39139070ADC,1009,808,771,6,6,20,4,1,37
39045023AEX,2472,1749,1273,51,326,25,71,3,476
39045023ADT,1499,1080,940,12,74,20,19,0,140
39045023ACO,1740,1350,1312,8,4,6,3,1,38
39101051ABL,616,503,456,14,19,13,6,0,47
39101051ACK,476,399,386,3,1,1,1,0,13
39101051AAV,707,547,469,20,31,16,4,0,78
39035018AWV,1105,896,140,26,707,19,4,0,756
39035018BDC,1666,1392,953,169,205,27,45,2,439
39113057AJC,1590,1184,541,41,553,21,36,3,643
39113057AXY,1320,1099,831,30,143,20,69,0,268
39139070ACC,1108,907,837,10,23,23,4,0,70
39101051ABI,743,560,510,8,31,7,1,0,50
39089045ACP,2717,1965,1566,62,112,40,181,0,399
39089045AFV,2266,1635,739,32,591,22,251,0,896
39089045ADS,1460,1125,1047,20,14,24,8,0,78
39089045ACW,1192,934,888,7,8,12,13,2,46
39089045ACR,2865,2024,1658,41,96,56,137,0,366
39017009AJQ,1225,913,760,28,48,14,59,4,153
39089045AFU,2370,1709,742,59,431,33,442,1,967
39061031AWR,1005,753,513,19,181,20,22,3,240
39061031BIE,1422,1137,1071,13,11,16,25,1,66
39017009AIM,1512,1057,872,27,71,16,71,1,185
39057029AHF,655,514,473,8,13,10,5,0,41
39073037AAR,1331,1068,1023,3,10,27,7,0,45
39035018CCV,1476,1216,1037,55,43,15,52,4,179
39035018CCT,1256,1038,923,43,18,8,35,1,115
39057029AAT,663,527,426,17,28,26,30,1,101
39057029ABD,1399,1126,1015,27,12,15,51,0,111
39163082AAR,892,739,696,4,16,17,1,0,43
39061031BJZ,835,740,706,2,4,17,0,0,34
39061031AFJ,721,578,43,12,515,13,3,0,535
39095048ASS,1757,1428,1063,108,195,9,41,0,365
39095048ATV,1124,885,779,25,39,19,20,1,106
39095048AAV,1063,841,757,38,21,5,10,0,84
39095048ABG,1173,904,798,53,10,23,5,0,106
39095048AJB,1587,1105,673,105,287,17,13,0,432
39095048ATD,1854,1489,981,76,354,42,31,5,508
39095048ACP,1506,1238,1120,46,20,35,9,0,118
39095048AHB,961,848,352,51,413,17,20,1,496
39095048APU,1130,920,799,45,42,22,18,0,121
39095048AES,1392,949,232,71,643,20,1,0,717
39095048ATK,1206,973,895,31,19,21,5,1,78
39001001AAI,1986,1482,1426,2,8,29,4,0,56
39151076AMM,918,712,661,18,9,6,12,0,51
39151076ADU,1276,997,869,40,53,25,5,1,128
39151076ALW,1138,886,833,6,6,26,5,2,53
39151076AID,1055,812,760,17,16,8,6,0,52
39151076AJX,815,632,598,4,4,8,1,1,34
39095048AGD,1046,870,188,28,632,9,26,0,682
39095048AGO,1378,1162,871,64,167,27,28,1,291
39095048AAQ,1508,1176,1068,48,30,23,6,1,108
39095048APA,1631,1234,1004,73,113,33,16,0,230
39139070ABD,1325,988,911,30,18,32,6,0,77
39095048ARG,1044,827,658,57,86,17,8,2,169
39095048ALX,941,621,298,58,235,22,10,1,323
39155078AFE,1160,970,887,12,37,17,4,0,83
39155078AHE,1003,810,759,4,17,11,16,0,51
39095048ACJ,1274,998,910,37,15,20,9,1,88
39095048AHE,1041,786,79,21,686,16,4,2,707
39095048AGT,843,710,582,46,64,17,9,0,128
39095048AAP,2548,2026,1791,93,62,56,29,2,235
39005003ACM,2024,1506,1460,8,4,26,1,0,46
39165083AAY,1885,1267,733,47,80,10,394,0,534
39165083AAC,1649,1283,1202,20,29,20,8,0,81
39093047AEY,1503,1126,472,502,164,26,7,1,654
39139070ACM,1704,1395,1192,16,105,32,39,1,203
39101051ABM,690,531,493,5,24,6,3,0,38
39029015ADI,1165,912,874,9,5,10,5,0,38
39029015ADZ,1655,1350,1291,11,13,28,8,1,59
39049025AZS,1158,914,772,19,68,13,34,4,142
39049025ARY,1529,1115,861,18,170,24,48,0,254
39049025BCT,1778,1213,484,68,547,30,101,5,729
39099050AQS,1176,807,209,83,509,16,5,2,598
39099050APT,673,555,524,6,3,13,4,0,31
39021011ABY,1387,1095,1050,5,7,20,3,0,45
39029015AFF,1241,1012,932,7,24,29,2,0,80
39151076AGW,1662,1271,1169,18,12,14,58,0,102
39029015AFB,797,633,614,0,7,10,0,0,19
39119060ACW,729,559,529,12,4,9,2,1,30
39017009ADG,1057,815,702,31,45,28,12,2,113
39171086AAU,1973,1454,1375,26,5,27,7,0,79
39151076ADQ,1184,965,922,11,0,16,1,0,43
39095048AIS,928,664,180,32,442,11,6,3,484
39095048AIO,511,418,59,26,333,5,1,0,359
39095048APT,1225,1027,873,38,86,11,20,0,154
39095048AQQ,1163,930,783,23,79,12,30,0,147
39095048AFZ,1521,1304,782,39,396,14,80,0,522
39095048ATZ,2017,1531,1248,80,122,24,48,1,283
39095048AFG,1619,1338,1012,74,195,29,20,6,326
39095048ATE,1669,1265,946,90,184,43,4,0,319
39151076AGK,921,707,606,18,36,12,30,1,101
39003002AEQ,1357,1052,1014,8,6,15,0,1,38
39155078AIR,1199,1016,939,19,25,21,5,0,77
39155078AFN,803,666,653,0,5,5,0,0,13
39155078AKC,658,514,476,14,9,6,2,2,38
39155078ABP,1327,1133,1022,10,49,26,11,0,111
39165083AAZ,1313,896,639,52,54,9,144,2,257
39165083ABV,1765,1382,940,34,51,8,340,1,442
39165083AFI,823,623,554,19,20,13,17,2,69
39037019AAW,1047,801,760,10,7,23,1,0,41
39037019AAF,1017,858,818,8,7,14,6,0,40
39037019AAE,871,709,677,5,14,4,3,1,32
39049025BFS,1195,981,830,27,58,24,26,0,151
39007ZZZZZZ,0,0,0,0,0,0,0,0,0
39007004ABL,532,465,430,10,10,6,6,0,35
39151076ABI,1863,1478,1161,48,208,36,13,4,317
39151076ANF,925,758,660,16,38,22,13,0,98
39151076AMN,920,694,629,17,19,13,12,1,65
39151076AAH,1065,758,421,14,280,25,7,2,337
39169085ACV,1803,1297,1243,16,11,18,11,0,54
39093047ALM,2430,1778,1536,79,59,15,63,3,242
39007004AAB,851,691,618,21,28,15,2,0,73
39099050ARA,1414,1083,777,66,211,25,2,3,306
39093047AFX,1138,906,585,192,135,16,7,2,321
39147074AAO,1168,916,810,42,25,25,6,1,106
39049025ALR,1712,1210,274,188,634,19,114,1,936
39049025ART,992,717,572,25,20,7,89,1,145
39169085ACZ,1338,1036,978,11,10,22,3,0,58
39169085ADF,1688,1286,1209,18,5,24,5,1,77
39087044ACO,1328,1039,982,7,9,30,3,0,57
39093047AIF,1313,1078,960,54,21,16,15,0,118
39093047ADR,1676,1259,842,218,176,39,4,0,417
39109055AAO,1068,839,787,9,14,7,16,0,52
39093047AAT,932,711,650,17,8,8,20,1,61
39093047AKT,2121,1532,1059,156,240,23,79,1,473
39099050ASB,1460,1221,481,54,639,20,39,1,740
39109055ACJ,1046,797,771,7,5,5,3,0,26
39109055ABX,1688,1285,1166,17,24,16,51,2,119
39095048ACL,1933,1681,1397,82,144,26,30,4,284
39095048AGC,1364,1045,368,35,623,22,16,0,677
39099050ATA,1280,1047,940,27,41,11,28,1,107
39099050ANY,1295,1096,1062,4,5,18,2,0,34
39159080AAH,3543,3302,2694,43,525,15,18,2,608
39065033AAG,1929,1462,1360,29,13,41,12,5,102
39099050AHL,1218,998,889,31,66,10,8,0,109
39049025ATY,1984,1546,1283,45,61,16,124,3,263
39049025APM,1446,1018,755,85,89,18,72,0,263
39049025AEQ,2144,1661,1053,111,318,49,140,1,608
39049025BLC,1831,1601,1206,55,205,17,104,0,395
39095048ADQ,790,556,133,107,306,29,1,0,423
39095048ALU,1192,991,756,34,158,14,27,0,235
39095048AGZ,744,612,474,29,96,3,11,3,138
39095048AGN,1134,866,713,48,77,2,24,1,153
39141071ACQ,576,464,436,5,7,12,3,2,28
39093047AAF,1239,940,859,41,12,15,4,0,81
39025013AFM,2182,1869,1486,68,83,40,189,0,383
39025013AFX,1474,1287,1113,52,65,37,15,0,174
39025013ABM,1660,1195,1096,40,10,36,6,1,99
39175088AAK,706,517,496,7,2,10,0,0,21
39145073ACN,730,568,544,3,1,16,4,0,24
39123062ACE,781,656,607,26,5,13,3,0,49
39109055ACU,808,655,640,1,5,4,3,0,15
39047024ABB,1102,876,820,12,11,24,6,1,56
39155078AFK,1144,959,918,14,7,17,0,1,41
39055028AAL,1428,1060,989,21,16,10,26,1,71
39055028ACF,1354,1110,1023,18,33,13,9,0,87
39055028ACI,1129,949,909,14,8,7,3,0,40
39043022ACQ,1178,964,926,14,4,10,3,0,38
39041021AFR,1251,874,681,35,40,31,85,2,193
39041021AFA,1767,1126,807,11,67,14,220,1,319
39041021ADZ,1215,766,609,10,24,5,105,0,157
39041021AFM,1615,1044,784,20,60,5,168,0,260
39153077BCD,1304,1137,1020,16,43,24,28,0,117
39153077AQH,1201,946,777,20,91,26,25,0,169
39153077AQI,1219,991,848,11,71,17,45,0,143
39153077BBX,1425,1076,880,16,112,13,42,2,196
39153077AOZ,1357,1102,955,31,54,14,41,0,147
39153077AUE,1371,1040,660,23,266,12,81,0,380
39141071ABC,1292,980,870,4,62,35,6,0,110
39141071ACW,2066,1519,1381,11,64,28,28,3,138
39113057AVB,1518,1167,1092,11,11,44,3,0,75
39113057ATH,1613,1275,1198,24,2,24,13,3,77
39113057APA,1180,898,804,24,14,20,35,0,94
39023012ABF,1664,1236,902,53,242,25,9,0,334
39141071AAD,715,588,544,1,26,8,8,0,44
39165083ABU,870,719,656,25,9,1,24,0,63
39165083AEW,1568,1155,1036,27,28,25,25,1,119
39047024AAS,1482,1108,1064,13,8,18,3,2,44
39145073ACP,952,731,683,7,4,32,0,0,48
39007004ABG,1171,909,847,10,17,23,5,2,62
39049025ARN,907,648,436,14,29,6,167,0,212
39151076ACQ,878,717,621,6,65,7,6,1,96
39151076AME,1123,912,797,16,76,10,9,0,115
39151076ADK,973,786,485,24,234,25,8,0,301
39151076AIB,1237,955,908,7,6,18,3,0,47
39151076AMQ,1361,1105,959,17,99,20,2,2,146
39151076AHA,869,708,642,16,27,15,11,3,66
39049025APU,869,723,659,16,12,6,31,1,64
39049025AHC,683,621,500,31,38,14,21,0,121
39143072ADA,457,341,319,15,4,3,0,0,22
39049025AEA,937,710,641,17,14,20,17,0,69
39049025ADW,1008,823,748,19,27,10,19,0,75
39113057AOT,1261,1020,889,49,39,31,4,1,131
39021011ABF,1434,1129,1065,20,4,25,8,2,64
39141071ABH,322,252,246,3,0,2,0,0,6
39043022AAB,1288,991,884,30,25,30,13,1,107
39049025BGG,2273,1633,461,103,789,22,278,1,1172
39049025ALW,2647,1768,160,119,1356,18,132,2,1608
39049025AAW,1554,1081,333,45,676,24,15,2,748
39049025ADY,1059,878,818,17,19,7,15,1,60
39141071ABK,870,659,575,44,19,17,5,0,84
39141071ABF,1169,854,806,4,9,27,4,1,48
39141071ABE,878,655,608,6,15,18,3,0,47
39081041ACW,833,653,611,5,8,19,6,0,42
39081041ABO,232,189,173,0,3,5,0,0,16
39133067ABG,1166,1069,830,69,77,20,75,7,239
39085043ACD,1023,819,782,9,4,7,7,1,37
39085043AFO,1467,1159,1065,31,21,17,15,0,94
39085043AFL,1522,1245,1176,23,11,17,7,1,69
39145073ACD,782,623,601,4,1,14,3,0,22
39093047ACQ,1311,1114,892,70,118,18,23,1,222
39049025AZC,634,522,481,10,5,7,10,1,41
39043022AEL,1426,1147,870,53,201,32,6,1,277
39043022AEM,1885,1644,1436,48,126,26,14,0,208
39043022ADZ,1457,1029,494,41,472,20,10,0,535
39093047AKC,1835,1481,1395,26,15,29,3,0,86
39093047AFM,1076,837,609,134,77,16,8,2,228
39093047AGT,1716,1349,1228,43,28,21,28,1,121
39093047AGU,1624,1300,1177,43,12,33,32,4,123
39041021AGA,1015,689,509,9,22,2,144,0,180
39041021AER,2463,1686,981,31,56,20,591,0,705
39099050AHX,1229,1063,793,26,232,8,9,3,270
39109055ACK,1177,880,831,19,7,18,3,0,49
39093047AHX,1308,1091,1041,15,4,26,3,0,50
39151076AAB,1250,888,760,12,86,17,3,4,128
39059030AAD,1021,780,699,1,35,30,3,0,81
39059030ACI,981,780,736,7,5,23,2,0,44
39099050ASN,803,667,617,10,29,4,3,0,50
39007004AAO,972,778,484,156,107,27,5,2,294
39041021ABY,1371,1066,968,9,32,11,41,1,98
39041021ADU,1020,818,792,7,5,10,4,0,26
39025013ADV,1206,965,919,10,7,16,10,0,46
39025013ADU,1593,1249,1140,22,16,44,8,3,109
39025013AED,1887,1361,1230,17,43,38,26,0,131
39025013AHQ,1813,1272,1150,36,34,29,11,0,122
39153077BBI,956,753,660,16,18,6,47,0,93
39041021ABI,822,630,568,14,15,12,11,5,62
39037019AAI,1559,1311,1254,19,17,14,4,3,57
39085043ADH,1025,801,670,10,99,9,5,0,131
39085043ADC,1467,1204,1109,24,27,15,16,1,95
39085043ABH,1630,1338,1217,41,29,18,21,0,121
39133067AEE,1124,935,898,8,1,16,2,0,37
39133067ACW,1149,916,864,10,5,10,18,0,52
39065033AAZ,2010,1583,1417,47,28,32,41,1,166
39099050AJG,1021,844,743,11,54,27,6,1,101
39029015ADF,998,806,768,6,7,19,4,1,38
39099050ABJ,998,714,550,65,71,32,4,2,164
39099050AQD,887,694,569,34,59,20,6,2,125
39099050ASX,873,716,628,18,48,1,14,0,88
39017009AJL,1910,1505,983,71,193,24,240,1,522
39017009AAW,838,644,534,32,36,17,25,0,110
39133067ADJ,1204,979,928,14,11,18,3,0,51
39029015ACV,1144,921,868,13,11,10,10,1,53
39029015ADM,1086,904,863,1,9,18,2,1,41
39099050AAA,870,620,247,140,232,11,0,1,373
39099050ATB,991,794,729,15,20,10,17,1,65
39099050ATC,1093,930,822,31,37,2,34,0,108
39099050APJ,1474,1122,1038,26,15,17,9,0,84
39049025ATX,2152,1863,1456,141,108,17,129,0,407
39049025BMF,857,592,544,13,12,6,21,0,48
39049025BLF,1757,1330,881,55,268,29,102,1,449
39087044ACK,1289,1002,950,14,5,19,7,0,52
39087044AAH,214,151,123,0,17,5,6,0,28
39113057AYA,1866,1525,1126,50,164,22,155,0,399
39113057AWE,2178,1823,1150,85,270,35,281,2,673
39113057AVU,945,762,486,33,89,13,147,0,276
39025013AGC,1379,1154,1039,26,27,38,11,0,115
39155078AFX,1630,1311,1255,7,5,22,7,0,56
39155078AIT,1222,996,955,1,4,21,9,2,41
39155078AIU,1097,909,856,7,5,25,5,0,53
39147074ACD,595,469,412,35,5,14,2,0,57
39165083AEK,1574,1220,1155,12,16,26,3,0,65
39025013AER,1261,963,925,10,1,21,1,0,38
39007004AAP,771,547,378,75,81,6,0,0,169
39049025ANC,1994,1692,1216,98,146,24,209,0,476
39049025AKV,1841,1411,335,112,931,27,16,2,1076
39049025AHJ,1281,1034,166,60,792,21,12,1,868
39049025AIY,1002,900,442,23,379,8,48,0,458
39049025AQD,1489,1114,812,61,90,30,127,4,302
39049025AAY,2232,1693,718,54,855,60,27,7,975
39113057ASH,1521,1247,1138,27,50,27,7,1,109
39113057AMC,1294,1081,889,40,98,15,40,0,192
39113057AFX,1246,950,27,11,906,15,4,0,923
39113057AGO,1176,827,232,25,555,21,6,2,595
39133067ADG,1485,1116,1043,24,9,27,1,0,73
39085043ABT,1623,1319,1244,15,16,18,19,2,75
39085043AAP,1310,1040,974,16,23,6,17,0,66
39085043AEL,1279,1105,1026,9,25,11,21,0,79
39085043ABQ,1630,1339,1236,22,26,27,15,1,103
39173087AAX,1216,939,839,39,13,15,23,2,100
39017009AKE,646,502,491,0,4,2,2,2,11
39133067AFN,1400,1089,972,16,47,35,5,0,117
39085043ABY,1539,1259,1143,27,19,26,24,0,116
39085043AHR,1485,1226,1132,17,34,21,21,1,94
39109055ABS,910,704,658,11,4,21,5,0,46
39099050ANR,838,647,620,12,5,5,4,1,27
39099050AHJ,1281,1063,914,41,64,13,11,4,149
39017009AGS,1319,915,741,16,65,12,72,0,174
39085043AGB,1230,971,879,27,11,30,9,1,92
39155078AHI,1424,1207,1131,5,30,9,23,2,76
39155078AFT,1381,1101,1012,18,18,31,13,0,89
39155078ABN,1018,852,765,19,32,12,15,0,87
39165083AFN,1564,1040,892,15,35,8,71,2,148
39165083AFS,1639,1251,873,28,41,7,295,0,378
39165083AFU,1719,1285,935,31,82,15,220,1,350
39155078AHY,1232,1040,767,17,229,16,10,2,273
39157079ADS,439,316,297,8,3,8,0,0,19
39049025AFV,1268,962,784,23,122,18,18,0,178
39133067AEX,1233,999,952,19,3,17,3,0,47
39133067AFF,1499,1246,1108,13,55,45,6,1,138
39133067ABW,1222,953,742,19,161,30,5,1,211
39133067AFD,1159,916,825,13,25,27,7,1,91
39071036AAT,1361,1059,1026,11,4,12,3,1,33
39143072AAI,1172,900,803,64,8,15,5,2,97
39049025AOH,2369,1773,1033,213,176,25,315,2,740
39049025BLT,1451,1096,631,57,75,17,318,2,465
39049025BGJ,1881,1692,1127,38,502,29,20,1,565
39049025AVB,1095,821,725,9,11,16,47,1,96
39049025AON,1460,1044,841,42,54,27,65,1,203
39049025AWM,1254,993,853,45,45,29,25,1,140
39049025AUX,1751,1217,393,60,706,19,39,5,824
39049025AUZ,1308,1041,778,59,170,21,22,1,263
39085043ACM,1894,1176,490,400,265,40,10,1,686
39133067AEU,883,698,648,7,7,24,5,3,50
39153077AGU,1107,883,713,25,94,17,31,0,170
39113057AIQ,1167,938,553,18,307,29,43,0,385
39113057AYS,1523,1098,917,17,35,10,116,1,181
39113057AUJ,1707,1388,452,22,881,23,6,3,936
39113057AJV,1213,885,663,27,139,26,24,3,222
39113057ATU,1167,890,853,4,7,21,6,0,37
39113057APM,1911,1484,1313,43,53,31,32,0,171
39111056ABA,462,376,365,0,1,8,4,0,11
39049025ARU,1617,1146,910,23,21,7,170,5,236
39049025BBD,822,697,647,17,7,9,13,2,50
39049025ALU,1427,1184,577,46,518,14,21,1,607
39049025AAG,1321,968,825,38,42,21,39,0,143
39133067AAC,1272,1038,916,15,45,11,42,0,122
39133067AAN,1250,967,858,19,34,16,38,2,109
39061031AOT,2010,1527,535,55,913,16,23,2,992
39061031BHY,1815,1392,1080,20,223,23,44,2,312
39061031ANC,1436,1155,389,106,649,26,14,0,766
39055028ACD,1257,1009,958,5,23,5,1,0,51
39113057ASA,2121,1742,1527,45,121,27,20,0,215
39035018ASW,789,554,5,2,542,0,5,0,549
39035018BCS,1293,1095,795,200,64,30,18,14,300
39035018AGG,1526,1207,911,152,98,27,28,2,296
39035018ALU,887,694,3,7,687,3,0,0,691
39035018BMF,1734,1287,267,36,924,20,59,1,1020
39035018DAN,627,469,432,14,5,2,15,0,37
39035018CRB,1349,941,772,38,39,8,76,2,169
39035018CSR,1679,1286,1032,17,144,12,86,0,254
39035018CSM,929,669,585,5,17,1,54,1,84
39035018AJV,1624,1258,415,60,769,17,11,0,843
39113057AQY,2257,1723,924,32,732,41,6,2,799
39113057ART,892,787,710,16,44,10,14,0,77
39113057ALN,1071,810,724,30,17,13,17,0,86
39017009AEX,1513,1376,806,58,136,17,355,0,570
39105053AAV,548,408,395,0,6,3,1,0,13
39035018CYL,1313,1042,921,38,28,6,43,0,121
39113057AYQ,1040,867,716,30,36,33,44,1,151
39113057AYF,1318,1011,814,17,44,11,125,2,197
39085043ADO,1536,1268,1003,34,194,19,13,3,265
39085043ADN,1559,1305,1198,15,38,17,25,0,107
39133067AAJ,863,784,730,9,27,3,14,0,54
39133067AEV,1210,990,928,9,6,24,8,1,62
39111056AAV,831,686,672,3,3,7,1,1,14
39055028ABN,1149,873,841,6,5,1,2,0,32
39017009AGW,1665,1226,1036,45,71,21,37,2,190
39017009ALC,1691,1182,854,46,110,9,148,0,328
39017009AKG,939,767,713,14,9,24,3,3,54
39017009AHX,1333,1031,975,9,6,27,2,0,56
39017009AGG,195,147,136,0,2,6,2,1,11
39017009AGE,1134,891,859,8,3,12,5,0,32
39095048ACW,999,828,707,63,27,19,4,0,121
39095048ACR,1121,936,844,55,12,15,6,0,92
39095048AOY,1190,942,742,51,107,22,6,0,200
39095048APQ,774,643,527,14,65,13,27,0,116
39061031AWH,1084,842,774,10,15,23,15,0,68
39061031AWD,1758,1389,1043,47,261,24,16,0,346
39061031AOI,1661,1347,281,49,982,22,27,1,1066
39061031AOV,1788,1312,189,75,1028,23,14,0,1123
39061031AAH,1684,1257,1035,37,40,13,128,1,222
39061031BDG,215,173,108,4,52,2,9,1,65
39061031AGP,1354,1139,290,11,818,9,13,1,849
39061031BLK,1893,1398,676,55,596,26,35,17,722
39061031AVA,1920,1682,1450,57,105,13,49,2,232
39061031ART,1817,1377,251,267,731,26,124,8,1126
39013007AAO,810,594,505,21,46,13,6,0,89
39013007AAQ,552,468,442,4,7,1,5,0,26
39013007ABC,629,492,480,0,1,8,0,0,12
39127064AAH,1061,774,750,1,4,11,1,0,24
39049025AVT,961,716,642,11,7,0,56,0,74
39049025AKX,1460,1118,428,73,475,25,107,2,690
39081041ACX,1533,1280,1201,10,10,29,3,2,79
39081041ACV,412,347,324,2,2,13,4,0,23
39081041ACS,394,313,292,5,6,5,4,0,21
39103052ACF,1743,1565,1466,25,21,19,27,1,99
39063032ACV,1153,925,798,57,32,19,14,0,127
39063032ACW,1089,871,777,31,27,7,26,1,94
39099050AQX,1520,1383,1119,45,195,13,5,0,264
39081041ABV,673,536,414,8,103,7,2,1,122
39081041ADP,656,564,526,13,15,5,3,1,38
39073037AAZ,1509,1226,1189,2,1,26,1,1,37
39165083AGU,945,745,692,17,4,19,8,0,53
39165083AAO,2088,1649,1467,62,60,24,22,0,182
39155078AIC,1687,1330,711,40,518,29,27,0,619
39165083AGP,830,633,597,9,0,16,5,0,36
39077039AAM,1444,1075,971,53,18,21,5,0,104
39077039AAQ,1091,791,679,71,14,20,7,1,112
39077039AAG,1644,1186,1083,43,30,21,5,0,103
39121061AAN,443,344,324,1,0,18,1,0,20
39049025AEV,1757,1310,610,120,530,57,14,7,700
39049025AJF,1063,781,246,58,454,19,23,0,535
39049025AJZ,1963,1406,194,118,1070,43,18,3,1212
39049025ADZ,1322,1065,946,26,28,15,37,2,119
39049025BJI,1197,888,320,58,371,23,127,0,568
39049025AFH,1327,969,99,54,800,13,10,5,870
39063032ACU,1386,1167,1072,30,15,14,29,0,95
39103052ABL,1366,1210,1049,82,19,18,34,0,161
39103052AEO,1144,905,854,11,8,11,17,1,51
39077039AAR,1289,1000,795,129,34,31,16,0,205
39077039ACQ,990,775,722,25,6,16,3,0,53
39035018CJF,1261,1072,976,19,29,24,23,1,96
39035018ATT,725,559,2,2,553,7,3,1,557
39035018ATP,635,476,0,6,471,11,0,0,476
39035018BJI,1187,1020,771,64,130,12,31,0,249
39035018BJF,1342,1099,948,73,41,24,24,1,151
39035018BOU,1550,1137,404,14,688,22,18,2,733
39009005AAM,1106,1079,927,32,81,14,25,7,152
39035018BYW,1885,1580,1226,46,234,19,51,0,354
39035018BYR,1347,1111,917,24,120,7,39,0,194
39035018BYS,962,793,588,11,141,14,47,0,205
39035018CJP,1739,1493,1316,64,49,16,38,2,177
39035018AOL,925,578,5,18,559,15,4,2,573
39035018AOJ,1231,770,56,23,687,1,4,0,714
39035018CFJ,1409,1098,1030,11,5,10,39,0,68
39035018AAL,1342,1004,956,23,4,4,10,0,48
39035018AAQ,1217,863,836,11,1,5,8,0,27
39053027AAQ,989,796,753,4,18,14,5,0,43
39035018AJT,370,312,12,1,293,2,2,1,300
39035018AKD,783,609,7,5,597,3,1,1,602
39035018CYQ,1647,1318,1194,34,19,9,58,0,124
39035018CSA,1223,818,670,27,55,8,54,0,148
39035018BOA,882,680,7,16,662,11,1,1,673
39035018BNV,640,480,10,7,464,6,5,2,470
39035018BNW,928,729,11,7,701,16,2,2,718
39045023AAN,1296,968,906,13,22,9,4,2,62
39045023ABJ,1302,1010,774,42,141,30,33,1,236
39045023ADY,1098,852,645,28,136,12,33,0,207
39045023ADX,1127,851,646,37,85,13,62,1,205
39045023AEO,902,660,555,17,52,13,21,0,105
39045023AEJ,1503,1129,595,42,356,22,110,3,534
39045023ACQ,1099,870,836,1,14,9,8,0,34
39035018DCK,1044,838,779,16,17,13,6,1,59
39035018BJS,1468,1338,827,79,107,10,303,4,511
39035018CHL,1584,1281,1146,57,35,18,19,1,135
39035018CZA,1685,1343,1158,41,45,10,82,3,185
39035018CZP,1504,1163,1029,33,20,7,60,0,134
39035018CGS,1554,1252,1144,26,27,21,28,0,108
39035018BIW,1213,1032,858,68,74,14,22,0,174
39035018BRC,2109,1815,441,21,1325,27,13,0,1374
39035018BPZ,21,18,2,0,15,3,1,0,16
39035018BVR,1220,1014,911,39,27,19,17,3,103
39035018AVM,672,492,6,6,481,7,0,1,486
39035018AUT,678,526,12,12,507,9,0,0,514
39035018CGI,1480,1141,1086,12,7,1,35,0,55
39035018BTT,1908,1454,714,58,643,17,34,2,740
39035018BUZ,968,775,713,12,20,5,17,0,62
39035018BFD,1515,1140,438,290,393,34,16,1,702
39035018BFB,1510,1122,540,220,317,25,36,1,582
39035018ATV,462,339,7,2,327,6,0,0,332
39045023ADZ,986,730,622,7,62,7,30,1,108
39045023ACP,1126,878,818,7,8,33,4,2,60
39005003ACN,955,733,697,4,0,21,2,0,36
39005003ABB,1079,820,725,17,25,42,5,2,95
39117059ABD,1014,773,726,13,4,22,5,0,47
39045023ACR,1571,1246,1170,12,16,33,8,1,76
39045023ACB,1931,1430,1350,12,10,43,9,0,80
39117059AAC,1963,1542,1448,19,18,42,5,1,94
39061031BKC,1913,1307,1261,19,3,16,6,0,46
39061031BAX,1677,1259,814,48,326,31,32,11,445
39061031AGF,1436,1358,1217,38,39,14,48,5,141
39061031AYX,1383,993,914,22,26,17,11,0,79
39061031BMG,874,695,277,26,343,20,23,0,418
39057029ACD,1705,1192,1040,37,36,15,61,3,152
39057029AIE,1874,1318,1147,47,35,25,59,1,171
39057029ACV,995,800,721,14,14,16,27,0,79
39057029ACW,1010,831,702,24,30,17,45,2,129
39057029AFE,1200,925,805,23,45,34,13,1,120
39157079ABA,1055,793,727,19,11,27,3,1,66
39083042AAH,1956,1583,1439,31,52,38,19,4,144
39057029AAR,741,577,501,10,17,15,28,1,76
39057029AAE,928,722,663,15,7,10,18,0,59
39057029ABG,459,347,282,21,17,11,15,0,65
39061031BFN,1334,1103,886,14,104,9,81,0,217
39061031AVJ,1572,1280,1062,54,116,13,30,1,218
39025013AFC,1241,976,862,50,25,25,7,2,114
39025013ACM,712,600,574,1,2,10,6,0,26
39025013ABQ,1598,1319,1192,17,22,23,45,4,127
39025013ADT,979,803,736,8,16,24,7,1,67
39025013ADZ,1179,970,927,4,8,16,12,2,43
39025013AHN,1206,930,877,8,6,12,20,2,53
39025013AGG,1316,1003,909,22,5,42,10,2,94
39025013AHX,1256,874,821,5,13,7,17,0,53
39025013AET,1143,892,857,0,1,25,8,0,35
39025013AEW,1571,1154,1051,12,15,47,9,2,103
39025013AGQ,838,614,589,7,4,9,1,1,25
39025013AAV,1078,846,822,7,2,11,5,0,24
39025013ADF,1429,1127,1069,19,9,21,4,2,58
39117059AAJ,1218,913,881,9,10,10,3,1,32
39003002AFN,972,686,614,11,38,7,19,0,72
39003002AFT,1001,767,646,20,32,6,56,0,121
39003002AFO,911,714,605,11,65,11,19,0,109
39003002AEN,1380,1050,1011,12,3,7,0,0,39
39113057AMK,1036,837,757,12,42,17,8,0,80
39145073AAJ,796,549,365,4,142,22,6,0,184
39145073ACL,1167,920,883,6,4,20,1,2,37
39155078AAU,1293,1059,969,15,41,11,11,0,90
39147074ABU,517,394,374,16,0,4,0,0,20
39165083ADT,930,746,701,8,5,25,3,0,45
39155078AHT,908,718,668,8,13,20,5,1,50
39113057ABV,1073,831,497,40,245,17,23,6,334
39113057ARP,1067,871,766,37,32,20,14,1,105
39173087ABH,1616,1153,1016,40,26,13,59,1,137
39017009AIY,1499,1117,744,77,72,26,189,0,373
39113057AMF,1303,1038,816,35,128,27,28,2,222
39113057AOW,1595,1099,981,45,16,17,36,0,118
39113057AMO,854,715,659,6,15,9,21,3,56
39113057AIP,1990,1544,1169,15,305,13,33,0,375
39165083AGK,1581,1092,997,16,24,13,30,1,95
39165083ABL,1183,880,804,39,10,13,9,0,76
39165083AFO,1220,839,713,18,36,24,43,2,126
39165083AFM,1704,1151,444,54,80,9,559,4,707
39165083AGZ,1771,1149,675,42,50,20,363,1,474
39099050APH,788,630,599,9,4,10,3,2,31
39099050ABC,1089,817,732,30,11,12,27,0,85
39099050AAY,962,738,678,20,10,7,18,0,60
39093047AAK,1345,1095,928,50,20,36,45,0,167
39093047AAA,1620,1286,1146,88,20,15,13,1,140
39093047AAG,1001,774,661,59,17,16,15,0,113
39093047AGQ,1781,1356,1174,71,49,12,48,1,182
39099050ABO,742,589,529,18,21,14,5,0,60
39099050AQB,816,605,520,34,23,14,7,0,85
39099050APK,1113,910,863,16,8,11,1,0,47
39017009AHF,1583,1252,1177,6,14,37,8,0,75
39049025BMH,860,798,651,35,64,12,33,0,147
39113057AQT,750,658,317,15,323,9,5,3,341
39113057AWY,1167,869,647,9,174,9,27,2,222
39113057AIS,1299,1007,824,12,146,11,8,0,183
39113057API,2641,1797,1114,210,309,73,127,17,683
39113057ACE,1923,1509,1079,73,238,33,82,4,430
39113057ABW,1316,977,676,33,200,25,41,1,301
39113057AEC,1978,1709,1402,29,203,33,28,1,307
39031016AAY,2655,1866,1804,16,14,27,8,1,62
39023012AFL,1662,1293,1244,6,11,20,10,0,49
39023012AAL,977,762,641,21,61,33,1,1,121
39023012AFM,1481,1142,1069,5,9,30,12,0,73
39107054AAL,848,619,608,4,2,4,0,0,11
39107054AAD,1519,1218,1129,18,17,12,17,29,89
39049025APB,2247,1552,734,492,288,43,39,1,818
39155078ACV,1641,1280,959,26,245,39,3,3,321
39089045AAW,2557,2044,1877,23,81,30,21,3,167
39141071ABM,1382,1010,939,12,17,27,4,0,71
39165083AGG,1286,906,778,31,44,11,40,0,128
39165083AGW,1239,977,881,34,27,12,22,1,96
39165083ADW,1146,882,829,11,8,12,16,0,53
39155078AHV,843,709,686,3,2,14,3,0,23
39029015ABF,833,704,674,9,1,16,0,0,30
39025013ABY,628,516,468,10,17,5,15,0,48
39025013ABV,1113,769,663,25,41,26,5,0,106
39025013AIB,1744,1331,1218,22,29,38,13,0,113
39041021ACJ,1110,863,810,14,15,10,5,1,53
39041021AFI,2039,1285,1135,45,37,26,42,1,150
39041021ACC,1350,1040,870,27,82,16,36,0,170
39023012ABI,1393,1041,932,25,54,11,9,1,109
39023012ABH,1035,870,760,30,52,6,16,5,110
39025013ACU,2016,1553,1362,54,36,37,47,2,191
39001001AAR,624,510,489,4,1,14,2,0,21
39049025ANE,1129,940,799,28,65,13,41,0,141
39153077AEJ,1509,1256,1109,7,69,21,37,3,147
39153077AXH,1472,1173,995,16,30,17,99,3,178
39153077AXJ,1099,798,723,5,5,2,48,0,75
39153077ARR,1402,1081,998,12,22,7,25,0,83
39153077AXC,1152,831,753,13,19,10,28,0,78
39141071AAN,646,527,437,13,44,23,7,0,90
39141071AAU,915,690,599,9,53,18,11,3,91
39141071AAW,953,729,643,6,46,18,12,1,86
39141071AAC,1046,823,719,6,61,15,18,2,104
39153077AZA,1159,901,613,16,222,11,26,0,288
39153077ACW,1172,910,673,28,188,20,5,2,237
39153077AKW,1086,883,790,19,22,20,24,0,93
39153077BBR,912,736,692,10,11,14,5,0,44
39153077ANU,897,697,625,11,22,12,19,0,72
39099050AKF,566,492,457,15,8,5,3,0,35
39007004ABX,878,740,659,30,27,9,9,0,81
39007004ABT,844,688,588,50,22,16,5,1,100
39087044ACF,854,660,599,16,11,19,11,0,61
39087044ACU,267,216,194,5,6,2,3,0,22
39151076AGY,1810,1393,1264,14,42,14,57,1,129
39151076AOX,1428,1050,933,10,8,13,69,0,117
39151076AKG,1343,1049,1008,5,6,9,3,1,41
39151076AJL,1195,931,864,15,3,25,5,1,67
39049025ASG,1038,749,617,26,70,6,28,1,132
39049025AOU,2146,1600,790,85,564,24,75,2,810
39093047AFO,1572,1247,799,227,217,30,5,0,448
39153077ANC,1615,1251,1040,31,97,23,58,2,211
39153077BCR,1237,1093,1010,20,11,30,8,0,83
39151076AFF,1481,1245,1164,15,33,5,14,1,81
39145073ADT,838,663,622,2,3,28,2,0,41
39175088AAG,1188,974,929,23,5,9,2,0,45
39049025ATS,1742,1227,996,34,55,33,102,0,231
39049025APV,1204,1047,827,39,76,9,91,0,220
39049025AZT,1475,1112,914,22,89,13,58,1,198
39049025APX,1300,1113,914,32,36,20,119,1,199
39049025ARZ,1124,828,577,36,158,24,34,0,251
39049025AIE,1894,1778,1398,120,54,15,204,1,380
39049025AII,2254,2161,1723,96,154,16,165,5,438
39049025BBQ,599,442,420,1,3,6,12,0,22
39049025AFI,1189,889,62,30,787,25,1,0,827
39049025ACX,1207,830,111,63,648,17,4,0,719
39049025AWD,758,525,482,5,11,2,22,0,43
39049025AVQ,1160,833,741,14,19,3,40,2,92
39049025AHX,1219,900,388,181,296,20,15,1,512
39049025AWE,1867,1355,1188,25,17,12,102,0,167
39073037AAE,1738,1243,1155,14,25,40,7,0,88
39001001AAE,552,409,394,0,1,9,2,1,15
39041021ADT,659,533,501,14,0,10,4,2,32
39145073ACI,995,778,735,3,9,32,3,2,43
39161081AAI,615,448,395,22,11,17,2,0,53
39153077ALV,1147,943,782,9,39,21,87,1,161
39125063AAP,765,573,530,24,7,12,0,0,43
39153077BCW,1065,894,786,34,38,13,11,2,108
39051026ABJ,1436,1032,921,62,2,30,5,0,111
39051026ABH,790,542,479,32,4,15,3,0,63
39087044ABI,698,562,486,15,29,22,6,0,76
39087044ACL,428,327,311,3,1,14,0,0,16
39133067ACQ,1299,1002,935,11,6,39,4,0,67
39133067ACR,1265,999,944,11,0,30,11,0,55
39085043AGR,1019,778,723,20,7,9,8,0,55
39085043AGQ,1788,1409,1064,218,70,30,23,2,345
39153077AUS,1279,1021,951,19,24,3,17,1,70
39153077AUT,1134,1022,932,13,48,15,10,2,90
39153077AVC,1229,1125,1012,30,41,8,22,1,113
39153077AGT,1288,1061,822,34,161,26,30,0,239
39123062ABB,588,529,508,8,4,6,1,0,21
39133067ADQ,1269,1054,851,26,33,15,119,1,203
39151076AGE,1618,1348,1191,12,83,44,5,2,157
39157079ABF,1069,795,582,169,18,89,8,1,213
39157079ACF,1342,1031,1008,7,9,1,2,0,23
39099050AON,1643,1276,1195,30,6,18,18,5,81
39029015ADL,1114,915,848,27,21,8,7,0,67
39099050AHV,1174,960,846,34,39,15,12,1,114
39043022AEJ,1545,1173,811,45,275,28,7,1,362
39055028ABF,1045,876,793,31,17,8,29,1,83
39017009AFZ,1771,1339,953,23,207,17,133,0,386
39017009AEQ,1910,1523,1027,122,323,40,15,0,496
39017009AIQ,1154,898,669,35,82,6,106,0,229
39017009AIP,1380,1007,787,61,77,20,60,1,220
39133067AAD,1357,1082,1006,18,21,13,8,0,76
39085043AGE,1431,1203,1080,38,12,26,26,1,123
39085043AGA,1577,1271,1163,34,30,10,12,0,108
39055028ACQ,136,116,104,4,0,1,8,0,12
39041021ACR,990,747,639,14,13,14,64,0,108
39023012AAS,1409,1066,909,23,90,26,6,2,157
39023012AGA,801,634,582,9,15,21,7,0,52
39029015AET,1198,925,882,3,4,23,5,1,43
39099050ANP,922,739,711,4,5,14,2,0,28
39023012AAP,2086,1587,1150,81,288,53,24,3,437
39023012AEN,912,684,631,14,6,12,11,0,53
39023012ACR,387,376,348,1,19,7,0,0,28
39041021AGB,1689,1133,912,46,47,16,118,0,221
39133067AAZ,1503,1294,1034,50,129,21,61,1,260
39133067AAA,1280,999,880,35,33,31,15,0,119
39049025ALZ,1981,1157,17,4,1110,10,18,0,1140
39049025AXG,1169,913,830,16,29,9,17,0,83
39017009AKT,1399,1055,833,63,111,36,13,4,222
39017009ADK,863,710,638,4,54,15,3,1,72
39017009AEM,1313,1082,797,134,88,34,24,0,285
39039020ABG,1144,853,785,37,6,16,6,3,68
39039020ABB,991,734,641,60,7,23,3,2,93
39153077AAL,2215,1850,1265,82,439,34,20,0,585
39153077AHR,1759,1436,1114,16,245,42,19,2,322
39153077AKJ,1542,1251,920,21,174,27,99,1,331
39153077AXQ,1173,881,747,14,10,18,88,0,134
39153077AXS,1117,851,734,20,16,12,61,0,117
39153077AWV,1566,1160,1032,21,50,14,32,0,128
39153077AWU,1424,1129,1005,15,47,22,20,1,124
39153077ANA,1152,1028,909,19,69,7,23,0,119
39173087AEB,1424,1288,997,93,93,41,77,3,291
39153077AHB,934,777,626,13,93,7,36,0,151
39153077AGH,944,783,615,14,129,8,12,1,168
39153077AYH,1405,1244,946,61,125,22,93,1,298
39153077ARX,1466,1206,884,27,226,18,52,0,322
39017009ABX,1554,1107,966,29,47,43,11,2,141
39153077AMU,1215,1017,826,27,80,9,74,0,191
39153077AMY,1620,1336,902,36,327,10,54,2,434
39153077BBM,1195,982,934,10,7,12,1,0,48
39099050AKE,1220,978,764,48,133,24,11,0,214
39099050AKU,1036,870,774,39,36,5,14,0,96
39071036ABN,2045,1610,1490,6,22,71,6,2,120
39061031ALH,2148,1645,933,150,511,27,35,1,712
39061031BMI,1354,1011,354,37,600,32,12,1,657
39061031ASK,1196,890,695,17,18,3,150,0,195
39061031AGD,2134,1733,528,78,978,25,95,6,1205
39061031BHW,888,730,698,10,5,11,7,1,32
39061031BKK,1120,862,788,27,20,11,19,1,74
39083042ABC,697,573,546,6,0,14,5,0,27
39129065ABY,1195,959,905,7,6,23,5,1,54
39129065AAN,1257,913,792,27,37,30,4,0,121
39127064AAT,694,517,492,0,5,11,6,1,25
39009005ABV,570,443,413,6,6,10,8,0,30
39035018BWP,1250,1070,924,37,57,15,34,0,146
39035018AHO,1625,1343,1183,64,67,13,16,1,160
39035018AVP,1125,873,37,13,812,25,2,0,836
39035018CRY,1240,958,692,35,157,11,53,0,266
39035018CAG,1280,914,177,28,694,8,5,2,737
39035018CAH,1156,837,109,14,702,12,6,1,728
39035018CYJ,1275,1020,888,35,17,7,61,1,132
39035018CUV,1445,1241,1073,46,56,12,57,1,168
39091046AAQ,417,318,300,3,1,11,0,2,18
39035018CJG,1240,1010,939,30,4,10,21,0,71
39035018CWT,1364,1128,580,56,418,16,53,0,548
39035018AAI,1140,911,846,20,19,7,16,0,65
39035018AGB,1300,1070,833,145,42,22,46,2,237
39035018AXX,1098,926,734,112,62,11,9,1,192
39035018BBT,1278,1060,678,216,168,27,15,1,382
39045023ACH,982,781,731,16,0,25,6,1,50
39045023AEN,1725,1218,1067,27,75,15,21,0,151
39035018BPJ,956,726,230,15,468,10,8,0,496
39035018BWU,1321,1099,981,30,47,12,17,1,118
39035018CFG,1573,1318,1192,35,27,18,43,3,126
39035018CFE,1399,1114,1043,26,7,7,26,0,71
39035018CVD,1283,1021,910,23,15,15,47,2,111
39035018ADI,1681,1463,1191,55,168,27,26,0,272
39035018BBU,1220,990,717,148,96,11,23,0,273
39035018DCE,790,633,573,15,18,1,14,1,60
39035018DCC,802,677,607,15,30,9,13,0,70
39035018DCG,1015,829,665,11,90,14,44,0,164
39061031BBH,1843,1445,996,51,322,42,38,0,449
39061031APU,1501,1144,345,29,714,5,47,0,799
39061031BOL,1549,1169,248,84,795,33,31,2,921
39091046ACA,408,318,282,2,4,14,13,1,36
39057029AFF,748,563,416,11,103,28,6,3,147
39103052ACQ,2029,1591,1466,27,34,30,14,2,125
39139070ACV,1372,1015,957,6,19,17,11,0,58
39035018CKT,1918,1504,1277,98,54,33,38,2,227
39035018CLP,2031,1744,1416,65,123,10,122,0,328
39035018BVI,1559,1250,1144,14,19,15,41,0,106
39035018AWT,1070,820,141,12,665,3,1,0,679
39035018APL,978,946,669,52,31,14,179,0,277
39035018CIF,1637,1241,1023,98,65,32,22,0,218
39035018CII,1411,1087,935,61,42,20,27,1,152
39035018AQH,1337,1035,39,34,969,23,11,0,996
39035018AQE,948,788,49,16,721,11,7,0,739
39035018CRK,1415,1026,41,13,961,10,6,0,985
39035018AJC,1143,876,13,11,858,5,0,0,863
39035018DBY,1194,960,873,14,19,7,40,0,87
39045023ACC,2153,1599,1531,7,8,38,6,1,68
39035018AFL,1487,1208,1073,25,29,4,72,1,135
39035018AFK,1702,1327,1216,45,24,15,23,3,111
39035018AFH,1695,1345,1156,31,50,10,93,2,189
39081041ACO,267,216,200,4,1,6,1,0,16
39035018DCQ,954,828,71,25,737,11,12,1,757
39113057AEZ,1909,1431,1072,104,162,46,31,4,359
39113057AEN,1254,1001,790,67,97,33,23,0,211
39113057AEH,1280,1016,857,52,69,27,15,2,159
39117059AAA,1334,1002,947,15,3,20,9,0,55
39173087ADX,1810,1412,1217,100,22,27,20,1,195
39139070ABY,1999,1556,1427,24,52,36,6,0,129
39089045AFE,2276,1574,1495,10,6,27,17,3,79
39089045ADL,1927,1440,1343,12,34,17,25,0,97
39061031BKB,1499,1080,962,23,17,45,9,3,118
39017009AEU,1720,1569,1226,60,88,20,155,0,343
39049025AMO,2275,1680,1086,166,288,51,101,4,594
39057029ABC,836,657,571,11,10,14,38,0,86
39163082AAB,1120,861,815,4,8,23,4,2,46
39061031ACC,1699,1381,852,33,457,16,18,3,529
39061031BIZ,908,733,696,11,1,19,4,0,37
39061031AIT,1691,1292,225,70,968,26,13,5,1067
39095048AKL,748,526,20,22,482,6,5,0,506
39095048AKJ,549,423,20,7,381,8,2,0,403
39095048ARD,1734,1466,884,78,458,17,44,2,582
39095048ARJ,1639,1395,825,45,443,8,78,0,570
39027014ABW,700,518,497,11,2,2,0,0,21
39095048ABP,2024,1543,1308,153,29,30,18,0,235
39035018ANX,1529,667,8,19,646,3,4,1,659
39093047AFY,1247,1057,736,136,163,25,12,0,321
39099050AAM,1057,807,390,176,243,10,8,0,417
39155078ADA,1180,950,814,12,96,19,10,0,136
39155078AGO,1196,965,821,19,72,26,12,0,144
39155078AFA,1303,1059,987,15,16,27,8,0,72
39095048APK,1406,1110,884,88,100,24,9,0,226
39095048ADA,854,646,507,46,81,22,0,0,139
39095048ANS,1437,1063,760,194,70,35,9,0,303
39095048ARO,1378,962,505,51,377,10,37,3,457
39095048AEU,767,553,109,92,343,12,2,0,444
39095048ADZ,1182,920,790,48,35,26,13,0,130
39139070AAB,1221,972,852,23,36,22,36,0,120
39139070ACB,1135,887,845,5,9,21,2,0,42
39079040ABQ,1049,774,714,11,9,33,2,1,60
39099050AJM,1073,857,808,11,3,14,5,0,49
39151076ADX,876,738,687,14,22,4,7,0,51
39099050AOU,1070,869,824,20,7,0,9,0,45
39029015AAU,1089,816,753,8,6,28,6,2,63
39089045AFD,1419,1132,1039,51,5,29,5,0,93
39119060ACZ,1374,1055,992,6,42,18,1,0,63
39119060ADA,1108,861,788,4,53,2,1,0,73
39057029AEY,722,568,481,11,62,15,4,0,87
39095048AEV,1133,802,212,102,482,12,11,0,590
39095048AFV,1514,1210,345,59,777,25,24,3,865
39143072ACQ,1145,886,669,140,47,20,3,0,217
39151076AGT,1622,1342,1087,46,113,28,54,3,255
39015008AAA,733,521,507,1,1,12,0,0,14
39165083AAS,1376,1044,945,17,37,24,18,1,99
39147074AAM,1042,835,719,30,38,22,18,0,116
39025013AHH,1332,1129,1010,29,32,26,20,0,119
39037019ABT,909,617,603,7,4,2,0,0,14
39169085AAX,1651,1452,1307,27,45,19,43,1,145
39025013AAT,679,517,477,7,5,21,1,1,40
39155078AKG,1056,853,791,17,18,17,7,0,62
39155078AJP,1421,1165,1117,3,16,12,5,0,48
39087044AAS,461,359,333,6,8,10,0,0,26
39099050ANJ,1012,815,768,8,2,17,6,0,47
39095048AHW,2138,1529,828,111,530,53,22,2,701
39027014ABJ,1845,1404,1352,3,7,14,8,1,52
39143072AAM,1265,906,626,146,116,23,5,0,280
39143072AAQ,806,576,408,89,72,5,0,0,168
39099050AKG,893,736,637,33,46,15,10,0,99
39025013ABU,1037,759,688,22,7,12,19,0,71
39025013AAB,1766,1327,1236,28,18,13,16,0,91
39145073ADU,854,645,614,2,6,16,2,0,31
39145073AEP,477,396,368,3,7,12,4,0,28
39165083AFG,1561,1116,976,42,40,23,29,1,140
39165083AEP,1680,1255,1185,16,12,28,9,0,70
39165083AEN,1463,1115,1053,13,10,22,9,0,62
39165083ADR,963,765,724,13,6,15,2,1,41
39165083AGR,1307,881,809,14,14,11,31,2,72
39165083AFK,1036,696,636,9,9,3,30,2,60
39055028AAZ,1226,998,955,11,7,13,4,0,43
39145073AAX,1360,1019,906,20,35,47,5,5,113
39041021ACP,1382,946,840,16,17,8,65,1,106
39041021AFZ,721,498,434,19,13,9,23,0,64
39153077AOP,1410,1025,896,9,41,11,58,0,129
39153077BBU,1202,939,840,16,32,11,30,1,99
39153077AMM,1359,1045,922,15,27,14,51,0,123
39113057AOJ,1492,1177,1041,33,49,30,27,3,136
39113057AER,1633,1191,790,206,133,50,14,1,401
39113057AOZ,1131,797,716,26,14,4,35,0,81
39113057AJO,1663,1110,519,69,445,44,55,4,591
39113057AJP,1978,1525,1272,42,121,42,44,3,253
39049025AYN,1606,1146,810,45,233,14,37,1,336
39049025ANP,2266,1648,862,82,608,22,75,0,786
39061031AUZ,1318,1084,909,37,89,19,14,0,175
39165083AEC,1368,1042,956,15,41,7,24,2,86
39165083AEE,1119,1086,991,21,45,20,16,2,95
39165083AGB,887,708,516,30,11,2,147,0,192
39155078AHB,1542,1208,1085,21,57,29,9,0,123
39025013AHS,1219,826,758,19,7,11,26,0,68
39025013ACZ,1420,996,929,24,8,8,17,1,67
39007004ABF,1025,821,767,6,10,24,4,2,54
39049025AMY,2318,2074,1286,104,212,30,446,6,788
39007004AEU,668,467,441,2,6,14,0,0,26
39007004AAA,1068,871,796,43,19,10,5,1,75
39007004ADB,1038,837,793,18,8,15,4,3,44
39113057AXK,1775,1345,1123,30,66,15,103,0,222
39123062ABH,1207,977,877,58,3,24,13,0,100
39161081AAJ,801,575,510,35,13,10,11,3,65
39161081ABN,631,480,451,14,2,4,3,0,29
39049025BHF,1143,844,624,49,100,18,51,2,220
39049025BJY,1780,1520,1110,105,189,27,90,1,410
39133067AAV,969,773,659,8,62,22,20,1,114
39145073ACE,596,438,409,0,0,27,1,0,29
39145073ABR,955,738,716,1,3,17,0,0,22
39145073ADN,1217,978,926,12,9,23,3,1,52
39145073ADH,858,699,672,9,1,8,6,0,27
39145073AED,1223,964,939,6,3,12,3,0,25
39157079AAZ,1393,1126,1056,26,10,21,15,0,70
39049025BCK,1320,949,756,13,9,12,154,2,193
39041021ADJ,950,738,702,5,7,15,3,0,36
39043022ABX,771,595,568,11,1,14,1,1,27
39093047AEF,1976,1460,588,388,483,50,10,2,872
39041021ACB,1197,893,787,24,35,2,41,0,106
39041021AEF,1516,1160,1019,18,74,14,29,1,141
39041021AAE,1096,852,707,62,41,28,5,1,145
39041021AEO,833,628,548,9,33,8,16,1,80
39041021AFH,1311,1018,918,16,26,11,36,0,100
39093047AJA,1920,1584,1488,24,3,36,13,0,96
39025013AHK,753,586,550,7,5,13,4,0,36
39025013AFJ,1831,1324,1191,21,20,19,61,5,133
39041021ADG,1275,899,789,21,22,8,48,0,110
39153077ASG,1728,1372,1095,37,111,7,122,3,277
39153077ASH,1524,1269,918,33,133,8,170,0,351
39169085AAJ,1518,1110,1032,16,19,37,3,0,78
39169085ABA,1657,1391,1260,37,26,29,27,0,131
39085043AAI,1904,1596,1386,35,92,34,20,1,210
39099050AMS,1093,842,673,29,105,5,32,1,169
39017009AGV,2587,1874,1537,29,131,16,148,1,337
39017009AMB,724,541,469,4,23,9,30,0,72
39017009AKY,1267,931,786,13,49,20,55,0,145
39017009AJO,1357,1051,893,26,57,12,44,0,158
39017009AJP,1043,840,732,22,34,22,32,0,108
39017009AJS,1427,1133,1008,29,36,18,37,4,125
39017009AET,1666,1511,1259,59,60,27,98,2,252
39049025BFT,1127,903,679,15,119,21,60,2,224
39049025ARG,1823,1385,873,25,44,14,430,0,512
39049025BKF,997,693,502,15,28,3,134,4,191
39049025ARE,1556,1177,856,55,73,10,179,1,321
39049025ARB,1314,1008,688,89,111,15,105,0,320
39049025ARC,2333,1710,1067,294,182,47,146,9,643
39049025ARD,1582,1276,859,95,166,21,143,2,417
39087044ABD,1093,845,819,9,2,11,2,0,26
39113057AWF,1738,1401,1022,44,185,18,128,2,379
39113057ALL,2005,1622,1429,49,39,27,57,1,193
39025013AGE,791,660,629,5,8,11,4,0,31
39025013ADO,1157,824,768,13,12,22,3,0,56
39071036ABP,782,589,571,2,2,8,5,0,18
39025013ACY,1446,1049,978,25,6,17,14,0,71
39007004ADA,720,566,533,12,8,7,6,4,33
39049025AGY,1342,1256,1091,45,54,11,43,1,165
39143072AAY,883,708,449,101,139,10,11,0,259
39113057AXE,1171,894,669,7,152,19,29,2,225
39113057AAL,1057,833,726,15,28,26,41,4,107
39133067AAU,1054,845,690,19,96,10,26,0,155
39133067ADK,1147,934,900,0,4,16,0,0,34
39085043AFZ,1434,1121,1038,28,12,22,6,0,83
39085ZZZZZZ,0,0,0,0,0,0,0,0,0
39085043AHA,1829,1381,1137,173,27,32,13,1,244
39085043AGK,1587,1274,1133,54,43,35,4,0,141
39017009AAR,1425,1140,586,40,365,12,130,1,554
39173087AAR,1208,971,879,27,21,14,21,0,92
39173087AAN,1411,1173,1060,36,19,17,40,0,113
39155078AAR,888,686,636,5,17,17,9,0,50
39165083AFQ,1410,945,852,34,27,19,15,3,93
39165083ABM,1347,990,907,16,9,12,35,2,83
39165083AGL,1052,817,750,18,7,8,33,0,67
39049025AAL,2406,2053,1623,69,292,11,53,4,430
39133067ADF,931,730,690,2,2,26,0,1,40
39049025AIJ,1580,1271,548,90,531,36,92,2,723
39049025AIQ,1695,1264,645,209,349,29,32,5,619
39049025BIP,1905,1460,913,52,396,45,49,2,547
39153077AGQ,1015,847,409,21,374,31,22,3,438
39153077AZK,1931,1368,912,22,391,21,21,1,456
39049025AZJ,1888,1387,1180,53,68,46,43,2,207
39085043AGL,1391,1112,1022,35,26,12,8,1,90
39085043AGN,1551,1223,1121,25,19,23,11,1,102
39153077BBT,1213,999,911,17,18,3,51,0,88
39113057AWW,1006,779,457,14,274,13,21,0,322
39113057AON,1097,810,705,27,39,8,23,3,105
39113057AVS,1880,1545,1005,125,317,35,73,1,540
39113057AAT,1461,1156,1038,17,45,7,43,3,118
39113057APJ,1015,863,751,21,40,7,37,3,112
39049025AHM,1152,936,192,36,672,28,32,2,744
39049025AVG,1232,801,757,6,2,6,23,0,44
39049025AYR,1490,1148,1048,29,9,20,32,0,100
39049025ADH,1371,1273,987,72,95,14,109,7,286
39017009AJI,1313,999,772,29,86,7,92,4,227
39111056AAK,378,305,288,2,0,12,2,1,17
39061031BGJ,1280,986,889,17,27,22,29,1,97
39113057AIM,1298,1017,713,9,252,14,31,1,304
39085043AAJ,1409,1251,1086,22,76,21,28,0,165
39133067ADM,857,704,672,8,8,5,8,0,32
39133067AAO,1364,1005,785,18,145,24,31,1,220
39035018CSJ,1709,1286,927,25,134,8,193,0,359
39035018CWH,2132,1594,1306,42,41,13,184,2,288
39035018ATN,729,570,0,2,567,5,3,0,570
39035018AUG,2059,2053,1008,163,137,6,731,0,1045
39017009AEP,2217,1745,1306,121,260,40,13,3,439
39035018AQC,1045,819,29,7,786,5,0,0,790
39035018BUX,1137,922,841,9,24,3,36,0,81
39035018BVA,1195,916,803,20,42,11,38,0,113
39035018ABV,956,805,233,6,558,2,7,2,572
39149075AAT,1055,802,710,19,40,21,10,2,92
39133067ABH,993,902,748,21,69,12,44,0,154
39085043AIU,1589,1301,1164,39,26,10,58,1,137
39085043ABL,1034,850,805,5,4,6,22,0,45
39085043AAT,1576,1271,1209,10,2,17,23,2,62
39017009ABA,986,800,611,27,105,27,24,0,189
39017009AEI,1191,946,746,33,103,27,28,1,200
39061031AYH,1745,1234,1080,22,61,10,52,2,154
39061031BGR,1681,1403,1267,25,84,9,19,0,136
39061031BHM,1501,1282,1199,8,34,17,17,2,83
39061031AVE,1198,959,808,41,58,14,19,4,151
39061031BDH,480,394,276,6,79,12,18,1,118
39061031ANG,1393,1004,567,16,416,4,5,1,437
39167084ACO,1160,935,899,7,10,13,3,0,36
39167084ABQ,1171,936,888,4,13,21,7,0,48
39127064AAO,1489,1117,1065,13,2,24,2,0,52
39115058AAW,753,603,582,2,8,8,4,2,21
39127064AAF,939,710,663,3,4,25,1,1,47
39049025AVU,1123,861,757,32,6,16,52,2,104
39049025AVV,1199,930,820,14,14,10,69,1,110
39049025AJM,1803,1312,540,77,619,30,48,2,772
39049025BMK,3099,2096,255,212,1213,33,428,5,1841
39049025AIH,1050,1047,926,25,72,0,16,1,121
39049025BLL,2197,2191,1962,53,117,2,45,9,229
39049025BLK,3569,3567,3221,81,183,6,60,12,346
39049025ATT,1136,797,681,18,40,7,47,0,116
39049025AAE,1577,1077,971,16,35,10,32,1,106
39081041ABT,1134,952,841,15,62,17,11,0,111
39103052AAX,1476,1153,1015,43,36,28,15,1,138
39103052ACV,1706,1272,1212,5,17,18,20,0,60
39063032AAI,1249,967,853,25,19,5,60,0,114
39049025AZD,669,549,456,23,36,22,10,3,93
39049025AMG,2245,1580,1079,169,269,55,28,3,501
39081041ADU,395,307,276,7,4,10,3,1,31
39109055AAM,1405,1094,1014,3,38,28,7,0,80
39049025ADS,1603,1463,1234,49,122,34,30,2,229
39049025ALO,2242,1587,555,185,735,25,93,0,1032
39035018CUF,1220,1016,635,11,320,9,32,2,381
39035018BYX,1589,1282,1052,24,146,19,47,0,230
39035018CPD,1205,942,812,39,35,21,22,0,130
39035018BRU,1634,1285,1087,48,72,28,34,1,198
39035018BGD,1503,1141,607,283,199,36,75,6,534
39035018ARN,522,424,39,47,337,4,4,1,385
39035018BBB,1256,918,330,421,185,22,9,8,588
39035018CSZ,1688,1271,881,22,168,11,197,0,390
39035018BJT,1175,1087,706,17,249,7,94,5,381
39035018BJY,1385,1159,875,45,83,11,120,0,284
39035018CCN,1529,1299,1136,49,49,25,35,1,163
39035018CLK,1646,1370,1226,73,24,17,26,0,144
39035018CKH,1612,1337,1220,43,22,21,20,0,117
39035018DDX,556,440,2,6,430,3,3,1,438
39035018ABD,1399,971,770,26,79,7,91,0,201
39035018ABE,1463,1004,808,32,65,2,89,0,196
39035018CTS,1359,1130,629,22,444,8,21,0,501
39035018BCY,1278,902,521,151,181,24,20,1,381
39035018BDA,1598,1184,709,237,219,36,16,2,475
39035018CDZ,1670,1351,1159,73,47,30,54,0,192
39045023ABW,1588,1167,1119,6,6,25,6,0,48
39045023AEZ,1706,1153,470,55,498,29,106,2,683
39035018BHU,1358,1098,693,127,127,38,112,1,405
39035018BHS,1560,1234,711,211,178,23,98,3,523
39035018COK,1278,1003,919,23,3,5,51,0,84
39035018BVO,1193,988,876,42,49,8,9,1,112
39035018ABA,1460,1058,1011,14,12,6,9,0,47
39035018CMK,1469,1244,1115,64,31,19,21,0,129
39035018AWY,909,677,82,17,585,14,2,3,595
39009005ACD,318,248,242,0,0,6,0,0,6
39035018CCX,1258,1033,901,36,19,17,54,1,132
39035018BPN,1116,882,444,23,412,8,5,2,438
39035018CXD,1275,997,794,33,133,5,32,2,203
39035018CUJ,1016,791,252,44,482,29,21,0,539
39035018CNI,1489,1188,494,30,641,12,21,2,694
39035018CNJ,1128,849,117,17,700,7,8,2,732
39035018BSJ,1564,1286,1171,35,17,12,26,3,115
39035018COU,1593,1236,1141,42,19,5,24,0,95
39045023ADR,686,532,463,22,24,12,11,3,69
39043022ADN,382,379,328,2,49,0,0,0,51
39013007AAN,793,645,600,12,10,7,7,0,45
39013007AAW,1154,928,891,2,11,16,2,0,37
39045023ABD,1452,1007,789,17,138,6,54,1,218
39057029AIG,1041,774,715,20,7,7,19,0,59
39057029AAB,1137,859,779,18,17,18,23,2,80
39057029ADM,1071,834,703,14,70,18,23,4,131
39117059ABI,1226,959,927,10,4,10,5,0,32
39101051ACC,513,421,396,4,3,12,3,1,25
39101051ACB,436,345,333,8,2,3,0,0,12
39061031AMQ,1648,1307,492,41,764,28,9,1,815
39101051AAY,1609,1203,1057,40,69,30,2,1,146
39083042ABH,1093,822,771,10,9,14,8,0,51
39057029ADW,1155,884,731,18,88,30,9,2,153
39057029AAO,1772,1398,1041,39,83,8,207,3,357
39061031ARL,1695,1208,295,191,686,28,25,1,913
39061031BCC,963,741,507,21,193,13,12,0,234
39101051ABT,506,410,405,0,0,3,2,0,5
39003002AGB,1175,894,794,16,50,16,16,1,100
39113057AML,1469,1168,1089,10,22,18,24,2,79
39113057AMI,980,800,721,24,16,15,23,0,79
39011006AAL,1023,788,725,15,7,26,12,0,63
39113057AYN,762,590,520,10,9,15,33,2,70
39017009AHT,1497,1207,1128,6,10,41,7,0,79
39017009AHN,1131,880,832,8,7,25,8,0,48
39113057ASK,1553,1253,1031,41,132,15,34,2,222
39113057AKT,1187,954,693,35,164,10,56,1,261
39165083ADL,1080,844,809,11,5,6,2,7,35
39003002AGC,1134,893,838,8,23,11,6,2,55
39113057AEJ,1180,908,714,49,71,29,40,0,194
39113057AGS,1684,1222,332,31,834,38,5,1,890
39155078AHH,1508,1237,1135,24,47,3,24,3,102
39165083AAN,1416,1020,915,49,23,23,8,0,105
39165083AGM,1089,834,784,10,10,15,8,0,50
39017009AEC,1025,838,740,16,38,31,11,3,98
39049025AFK,733,559,48,31,483,16,6,2,511
39113057AWZ,1609,1222,783,21,333,43,49,2,439
39041021ACW,800,638,574,14,9,5,35,0,64
39037019ABG,688,520,503,16,2,0,0,0,17
39049025BBO,818,603,391,159,32,28,3,0,212
39049025APP,979,750,684,12,18,7,28,0,66
39049025BCD,1401,1063,705,44,209,33,64,1,358
39155078AJG,1464,1211,1138,15,17,26,2,0,73
39089045ABB,2357,1752,1581,21,79,50,13,1,171
39089045ABZ,2062,1503,1285,34,100,61,5,6,218
39165083ABQ,1403,1099,1029,14,17,11,28,2,70
39165083ABP,705,532,483,16,12,15,6,0,49
39165083ABD,1778,1371,954,57,56,17,294,1,417
39165083AGQ,815,626,608,6,1,10,1,0,18
39089045AAB,1617,1177,1021,22,93,21,10,1,156
39041021ACE,875,675,630,10,9,9,8,0,45
39025013ABL,1480,1019,912,33,22,24,15,1,107
39025013ABF,1712,1225,1129,32,6,32,20,1,96
39165083ACG,1174,857,632,32,19,12,159,0,225
39165083ACE,1042,814,633,21,72,6,75,4,181
39155078AHZ,1412,1143,718,72,315,12,37,1,425
39147074AAF,1468,1032,763,126,100,28,12,5,269
39131066AAB,1107,910,877,8,9,9,8,4,33
39049025AGU,1545,1168,820,99,192,34,33,4,348
39087044ABS,846,657,642,0,2,13,0,0,15
39151076AAJ,853,716,651,15,30,11,4,0,65
39049025ARR,1817,1415,1133,24,30,14,218,1,282
39049025AGN,2010,1422,816,180,317,54,63,0,606
39049025BDZ,1120,826,635,13,143,9,27,0,191
39049025BNT,864,628,586,7,9,1,16,0,42
39049025AKI,1465,1133,133,54,882,33,59,1,1000
39093047ADM,1180,938,694,62,117,28,26,2,244
39153077APC,1484,1193,1073,18,48,6,50,0,120
39153077ATV,806,656,572,5,31,20,26,2,84
39153077APK,1220,1063,929,11,59,10,51,1,134
39153077BBY,1436,1260,1035,30,100,12,79,1,225
39049025AAH,1001,697,614,20,31,12,20,0,83
39049025AYH,820,598,523,17,22,6,23,2,75
39041021AAF,744,583,505,5,37,24,2,0,78
39023012AEP,1046,790,721,15,19,27,4,2,69
39023012AER,1731,1388,1289,20,31,37,9,0,99
39151076AMX,1689,1324,1192,33,50,22,20,0,132
39161081AAZ,651,506,474,23,4,3,3,2,32
39071036AAO,730,568,531,4,12,10,7,0,37
39055028ABA,826,669,631,17,5,2,5,0,38
39085043ABI,1525,1335,1190,24,39,17,61,1,145
39133067AFX,1312,1073,1008,17,7,31,2,0,65
39153077AQC,1308,999,900,16,31,26,25,0,99
39153077AQE,1095,852,781,10,14,12,24,3,71
39153077AQZ,868,723,590,9,59,6,59,1,133
39153077ATZ,873,715,527,23,96,19,52,0,188
39133067ADN,1069,898,844,12,7,11,9,1,54
39001001AAY,1187,895,867,4,3,18,2,0,28
39151076ADY,1187,874,741,16,69,22,9,2,133
39133067AGK,2418,2246,1453,97,331,41,343,5,793
39085043AIS,1200,1126,1049,12,41,14,16,3,77
39085043AEC,1206,1092,932,12,99,12,32,0,160
39085043AIR,1589,1400,1289,34,33,20,12,2,111
39055028AAO,1407,1134,1074,18,11,12,4,1,60
39055028ABD,1060,826,792,13,3,10,6,0,34
39055028ABW,2427,1531,1492,11,9,7,3,2,39
39161081AAT,861,701,675,17,0,4,7,0,26
39017009AAO,1543,1218,624,133,370,16,86,2,594
39017009ALE,1433,1061,555,80,343,22,67,0,506
39017009AAC,944,774,633,21,77,8,33,0,141
39017009AHP,147,115,105,3,1,9,0,0,10
39037019ACA,564,355,348,5,1,2,0,0,7
39041021ADV,1256,956,919,7,8,13,6,0,37
39143072AAA,1305,985,918,29,6,11,14,0,67
39133067AGR,1291,1014,869,16,66,19,34,0,145
39085043AEZ,1422,1201,1036,19,119,10,11,0,165
39023012ADH,1201,986,909,29,10,33,4,2,77
39049025BND,1331,745,22,7,705,11,5,0,723
39049025BIF,1720,991,52,32,861,6,47,0,939
39049025BIG,2382,1871,445,117,1076,16,203,1,1426
39049025ADO,1186,796,82,65,648,23,8,0,714
39099050AQU,944,673,95,37,541,13,4,0,578
39041021AAD,1649,1249,1103,48,61,21,5,0,146
39017009AFL,931,655,574,13,22,27,8,2,81
39017009AFK,1732,1255,1201,11,12,18,2,2,54
39017009AFH,392,251,223,4,3,7,10,3,28
39153077AOY,905,713,594,10,55,16,39,0,119
39153077BBA,1084,779,705,16,17,10,29,2,74
39153077AYM,1774,1291,596,36,254,29,377,2,695
39153077AYN,1667,1285,885,34,169,28,168,0,400
39153077BCM,1189,888,736,24,58,13,47,0,152
39153077ARA,667,543,487,12,10,8,18,0,56
39153077AQG,971,795,711,13,18,20,25,0,84
39153077AGS,822,756,687,14,32,11,9,1,69
39153077ALQ,1156,922,835,11,26,18,25,0,87
39153077ALP,1499,1243,960,19,137,22,114,0,283
39061031AQG,1443,1082,446,15,588,8,18,1,636
39061031ADR,1061,889,749,43,40,13,40,0,140
39061031ASR,1614,1224,1035,52,75,40,26,0,189
39061031ARK,1375,1112,240,47,749,18,67,0,872
39061031BJM,2230,1735,772,62,829,28,32,2,963
39061031BKE,2033,1429,1379,2,8,10,11,0,50
39061031BER,1996,1520,1315,16,107,40,28,0,205
39061031BEW,1052,789,625,24,80,15,36,0,164
39061031ACJ,1663,1536,1262,32,145,11,72,1,274
39061031ATP,1522,1120,994,27,27,13,40,0,126
39061031ABC,1736,1380,1169,31,112,21,36,0,211
39061031AOQ,1016,763,415,60,254,19,7,0,348
39061031AUC,1548,1202,653,17,505,29,4,1,549
39057029AFC,1200,883,738,16,86,30,17,7,145
39083042AAM,1171,852,793,6,20,22,13,1,59
39103052ACJ,1373,1028,976,15,12,14,7,1,52
39119060ABY,1230,935,876,4,26,14,7,0,59
39035018BVQ,1389,1145,1030,36,34,23,21,1,115
39035018BJO,1488,1281,894,128,199,20,47,0,387
39035018ASR,703,502,2,0,492,4,0,1,500
39035018ASX,599,486,23,4,446,3,4,1,463
39035018AGX,1368,1139,1005,56,29,13,25,1,134
39127064ABA,800,636,616,3,2,6,5,0,20
39035018CJY,1385,1129,1038,44,5,11,20,0,91
39035018CQC,1303,1168,1096,17,11,8,25,2,72
39035018CQB,1403,1208,1108,29,15,6,38,1,100
39035018CEY,1756,1452,1136,89,87,35,100,2,316
39035018CTA,1766,1301,890,39,209,12,155,0,411
39035018BJX,1486,1259,941,131,154,8,113,1,318
39035018BQX,1139,884,106,18,753,18,6,1,778
39035018CHS,1857,1420,1234,86,47,9,28,0,186
39035018CHM,2137,1723,1427,145,85,41,31,3,296
39035018BXM,1539,1298,1144,38,63,19,27,2,154
39035018BDH,1383,1132,832,174,98,22,15,3,300
39035018BKM,1215,1026,816,31,121,13,36,0,210
39035018BKG,1368,1038,362,40,599,30,17,0,676
39035018BII,1214,975,889,40,13,9,13,0,86
39035018DAX,636,550,186,5,349,1,3,0,364
39035018DAZ,613,550,449,12,79,9,3,0,101
39035018COO,1355,1100,946,45,44,14,43,0,154
39103052ABW,1659,1260,1135,17,49,19,14,0,125
39035018CZM,1441,1218,1039,43,18,2,107,3,179
39035018CYZ,1430,1173,1043,15,42,10,66,3,130
39035018CKI,1369,1191,965,71,94,14,29,0,226
39035018CMZ,1170,907,763,7,31,0,94,1,144
39035018BXX,1369,1149,878,73,161,21,24,0,271
39035018BYH,1187,1068,763,66,173,20,57,3,305
39035018BXO,1391,1170,1013,46,78,14,11,0,157
39035018BXP,1653,1393,1198,53,74,19,39,2,195
39061031BMY,872,683,529,25,51,5,71,0,154
39091046ABP,1184,933,858,15,8,36,9,1,75
39061031AIV,1657,1402,631,24,721,16,16,0,771
39061031AIB,1097,853,393,47,401,11,11,1,460
39061031ADU,1210,1047,939,24,39,6,32,3,108
39091046AAS,749,567,522,1,4,20,14,0,45
39033017ABP,1053,883,848,17,8,11,1,0,35
39009005AAQ,615,525,451,20,17,5,29,0,74
39045023ABG,856,618,503,11,81,4,13,0,115
39053027AAN,2021,1519,1416,8,48,22,27,1,103
39083042AAL,1725,1298,1213,17,27,25,8,3,85
39061031BBW,1784,1402,1041,28,243,43,40,4,361
39061031AZO,1917,1413,1264,36,22,12,64,0,149
39061031BGC,831,633,494,12,102,16,8,1,139
39103052ADE,969,804,758,7,1,27,1,0,46
39103052AEP,1284,1072,1029,10,4,21,8,0,43
39103052ADG,1128,895,849,17,1,4,8,0,46
39035018DBG,1431,1115,1000,44,21,23,16,0,115
39035018BFH,2000,1442,568,524,328,35,18,4,874
39035018BNZ,1196,958,30,6,921,12,1,1,928
39035018BDF,1532,1218,870,197,121,21,14,5,348
39035018AQU,833,633,1,8,621,16,6,5,632
39035018ARC,810,561,13,7,540,7,0,0,548
39035018ALT,907,704,7,13,693,4,1,0,697
39035018CCH,1784,1605,1425,54,71,14,38,5,180
39113057AFE,2550,1824,1201,230,300,71,34,5,623
39113057AYC,1634,1272,1128,27,31,22,60,2,144
39017009AAY,1071,803,486,14,139,22,139,0,317
39061031BLA,1320,1109,762,39,258,20,34,0,347
39017009ACH,1755,1490,1396,16,24,24,23,0,94
39017009AJT,525,404,361,16,10,9,13,0,43
39017009AJZ,1338,1066,859,50,67,16,57,15,207
39163082AAE,323,251,241,1,4,3,0,0,10
39057029ADH,989,773,642,24,48,27,30,3,131
39061031BMV,1580,1190,639,41,148,17,336,3,551
39061031ATR,910,707,577,37,50,6,39,3,130
39035018BUA,1571,1196,544,31,580,15,26,1,652
39165083ACK,1478,1161,862,26,37,18,213,0,299
39095048ASZ,1833,1413,1029,74,256,21,51,0,384
39095048AFH,1200,1030,704,67,198,26,36,4,326
39095048AQO,1406,1121,886,52,146,30,13,0,235
39095048AGA,2273,2174,1100,156,603,24,291,17,1074
39095048AUW,1796,1329,1220,29,28,22,10,0,109
39151076ALD,1810,1436,1278,23,76,34,8,0,158
39109055ABL,1345,1081,964,11,49,29,18,1,117
39139070ABK,1110,881,842,16,4,9,10,0,39
39119060ADB,1615,1263,1173,20,38,13,3,1,90
39107054AAA,1523,1150,1087,17,12,15,26,0,63
39151076AHH,1238,981,868,13,57,16,25,0,113
39151076AOO,1255,974,830,30,44,24,45,0,144
39099050AKT,991,852,775,27,27,5,17,0,77
39099050AQA,803,576,466,51,27,28,5,0,110
39029015ABI,941,724,575,69,51,24,6,1,149
39037019AAB,871,725,684,12,1,10,15,0,41
39095048AFW,993,788,307,26,402,17,23,1,481
39095048AFM,1023,891,481,29,328,14,43,0,410
39095048AFF,1644,1313,849,57,357,31,13,0,464
39003002AEE,1138,981,844,47,52,8,17,3,137
39025013ABA,1537,1211,1125,13,4,41,5,1,86
39025013AEH,854,701,684,10,0,1,0,0,17
39151076AGV,1135,889,842,15,14,8,12,0,47
39151076AFB,1216,1083,948,18,45,11,46,2,135
39093047ABM,1683,1256,1150,31,6,22,34,1,106
39093047AAW,1817,1384,1283,23,11,10,42,1,101
39093047AAX,2125,1604,1482,39,35,14,12,1,122
39093047AHG,1189,961,856,39,21,25,13,3,105
39093047AHF,965,861,806,7,4,21,11,1,55
39147074ACQ,612,474,452,6,3,11,0,0,22
39153077AXX,1095,770,692,25,13,2,35,1,78
39153077AYI,1118,767,733,11,1,4,14,0,34
39013007ABB,330,222,219,0,1,1,0,0,3
39049025ASF,1038,829,699,13,79,11,20,1,130
39049025ACR,1488,1184,890,88,124,28,55,0,294
39169085ACT,1188,892,834,29,7,12,3,3,58
39109055ADG,846,598,538,11,6,9,21,0,60
39109055AAR,1085,824,769,7,9,15,16,0,55
39093047ABO,1753,1384,1222,38,33,16,68,3,162
39099050AND,551,475,396,32,35,8,1,1,79
39095048ADU,2037,1543,1108,94,280,50,17,4,435
39095048AIP,939,781,516,41,190,29,10,2,265
39099050AHP,1389,1099,979,17,66,13,7,1,120
39143072ABW,685,568,499,27,23,6,4,0,69
39143072ABO,632,509,458,23,13,5,10,1,51
39049025AGG,1259,945,513,57,220,15,145,0,432
39049025BNH,1274,898,375,84,346,12,77,1,523
39049025AGJ,1236,890,469,53,276,24,83,0,421
39095048AOO,1579,1179,881,165,80,26,8,3,298
39095048AFY,1666,1277,454,69,713,39,10,0,823
39041021ADN,1014,774,749,8,4,8,1,0,25
39041021ADF,1236,941,825,19,22,17,53,3,116
39041021AEB,1830,1365,875,46,113,11,303,5,490
39041021ADI,1916,1280,882,33,78,19,266,1,398
39099050ABQ,787,647,628,8,8,4,1,0,19
39025013ADD,1096,917,865,11,7,28,1,0,52
39055028ABL,1215,938,879,17,17,18,5,0,59
39055028AAT,1178,888,831,12,9,18,11,0,57
39049025BDT,1203,959,903,22,9,15,7,0,56
39145073ABF,496,394,365,5,8,2,13,1,29
39145073AAR,877,758,714,1,18,2,17,0,44
39025013AAS,1196,921,868,7,17,25,1,0,53
39153077AAP,1215,990,861,27,58,12,26,0,129
39141071ABW,1347,1031,991,4,9,17,7,2,40
39141071ABU,1292,1018,947,5,16,22,19,0,71
39113057AKS,1304,1044,892,43,45,14,37,2,152
39113057AFI,1197,780,23,14,734,8,6,4,757
39113057AHY,1199,931,70,17,834,17,8,2,861
39061031AJU,1431,1148,869,50,105,7,113,0,279
39147074ABG,690,536,501,10,13,7,5,1,35
39007004ACO,1149,944,891,10,7,20,4,1,53
39039020AAA,1698,1281,1069,138,37,31,7,0,212
39123062ABG,1227,1132,1084,7,9,18,8,1,48
39161081AAR,734,593,536,26,19,8,3,1,57
39081041ACN,1195,931,899,3,4,16,2,0,32
39133067ACO,1153,970,862,10,25,28,37,0,108
39133067AGE,217,173,159,4,3,3,3,0,14
39133067AAT,1649,1248,987,22,171,24,41,0,261
39145073AAY,1521,1118,1018,25,45,18,5,1,100
39049025AKU,1521,1105,229,66,777,37,13,1,876
39041021AEI,1688,1209,1011,34,36,8,97,3,198
39041021AFX,1451,1146,1029,24,26,12,59,0,117
39041021ABU,1067,828,735,17,25,12,42,0,93
39041021AGM,998,623,463,8,19,8,119,1,160
39041021AEW,1269,846,692,29,20,10,92,0,154
39099050AKV,1309,1004,841,55,82,19,10,0,163
39099050AHN,1162,990,917,20,33,15,5,1,73
39099050ACN,2107,1690,431,216,1031,31,13,2,1259
39159080AAM,1023,783,718,13,10,16,24,2,65
39151076AOW,1108,855,785,17,10,7,22,0,70
39007004ADR,1011,786,732,15,11,13,5,0,54
39041021ACK,1124,782,644,86,9,26,12,1,138
39153077AMH,1334,1059,929,12,39,26,41,2,130
39153077AZP,1093,845,440,25,340,25,19,1,405
39041021AEU,1499,1085,908,24,102,13,33,0,177
39041021ADQ,1089,744,703,18,12,13,2,0,41
39037019ABK,693,576,527,9,14,14,4,0,49
39171086AAI,1455,1159,1050,55,6,22,17,2,109
39049025AGB,850,712,384,23,290,13,11,0,328
39049025ACY,1281,705,55,34,604,20,9,1,650
39085043AGH,1653,1277,1186,32,10,19,15,1,91
39085043AIA,890,731,676,18,4,7,15,1,55
39029015ADY,1045,890,861,3,6,13,3,0,29
39017009AEB,807,693,542,20,63,6,49,0,151
39133067AEO,1576,1214,1149,9,8,28,3,3,65
39099050APY,891,691,681,0,4,3,0,1,10
39049025AUY,1515,1105,588,48,336,14,102,1,517
39087044ABH,888,724,690,2,8,16,0,0,34
39087044ABG,620,466,426,12,12,9,7,0,40
39087044ABK,683,531,496,6,15,8,1,1,35
39025013AHP,1124,894,766,25,22,22,60,0,128
39025013AGI,1511,1200,1111,32,12,27,12,1,89
39025013AAH,1845,1358,1223,35,38,32,12,4,135
39165083ABI,1492,1055,715,23,36,20,249,6,340
39165083AFV,1515,1028,826,25,25,14,128,3,202
39007004AAT,570,416,348,26,20,14,4,1,68
39049025AFS,1221,937,709,28,168,16,17,1,228
39049025AFU,1901,1309,341,223,699,48,32,0,968
39113057ARU,1061,842,727,15,51,27,18,1,115
39113057ARV,1688,1340,1211,9,56,21,31,2,129
39113057AWU,957,777,546,11,200,15,3,0,231
39113057AAF,2193,1556,1177,36,251,45,44,1,379
39113057AWQ,985,745,712,5,4,14,6,0,33
39113057AMY,1950,1545,1261,50,131,37,62,0,284
39017009ADS,1332,794,183,196,398,19,11,4,611
39017009ADW,946,627,313,88,252,4,0,0,314
39087044ADD,174,129,110,1,5,10,1,1,19
39085043ACA,1205,980,911,19,14,24,3,0,69
39133067ACU,1902,1490,1250,19,153,27,32,1,240
39085043AGJ,1283,1110,1050,22,7,12,6,0,60
39151076ANB,1199,972,886,20,39,16,7,1,86
39133067ABB,1199,1056,864,35,108,22,29,1,192
39071036ABE,1136,877,835,6,18,12,3,1,42
39049025AOP,1440,1046,877,33,57,8,60,0,169
39049025AAJ,890,760,671,11,51,4,22,0,89
39157079AEI,1078,891,839,6,10,20,1,0,52
39049025BFN,1367,1034,636,36,255,26,89,1,398
39133067ADH,1353,1124,1043,13,23,34,6,1,81
39113057AHR,664,530,462,15,24,12,13,0,68
39113057AHI,1240,910,37,14,857,3,4,1,873
39113057AWG,1312,1070,726,96,155,21,81,0,344
39113057AND,1424,1136,1029,21,31,19,33,1,107
39113057AHQ,1716,1423,1231,50,78,48,17,0,192
39133067AFE,1027,851,802,8,6,26,0,0,49
39049025AJR,1509,1231,695,48,363,31,107,0,536
39049025BIM,1088,847,272,35,517,20,19,1,575
39049025AZG,2116,1671,1555,29,33,39,14,1,116
39049025ANJ,2782,1957,439,242,1228,52,29,2,1518
39061031AOP,2067,1448,763,140,502,28,27,3,685
39017009ACG,1547,1198,1046,70,55,13,9,3,152
39113057AJG,735,554,437,13,60,14,12,5,117
39085043AAE,1522,1228,1131,15,28,25,22,1,97
39157079AEK,948,711,677,3,3,16,0,2,34
39035018AMU,646,506,9,3,491,8,0,0,497
39035018CAW,1064,824,108,8,704,7,0,0,716
39035018BUS,1208,912,787,6,26,3,88,0,125
39035018DES,2018,1468,54,8,1387,10,6,1,1414
39035018BJJ,882,751,573,88,52,15,18,3,178
39055028ABS,2044,1255,1237,2,7,7,2,0,18
39017009AAM,1055,819,719,38,26,22,7,0,100
39017009ADE,1329,1069,797,99,136,12,34,0,272
39035018BJM,1232,1070,826,81,74,9,74,0,244
39035018AIK,1083,863,4,2,856,3,2,0,859
39035018AXL,1083,829,324,61,433,14,4,2,505
39085043AED,1234,1052,860,27,129,13,20,0,192
39133067AEY,1353,1037,975,10,5,23,12,1,62
39017009AKW,83,66,61,1,0,0,2,0,5
39017009ABO,876,698,605,18,20,10,42,0,93
39095048AQJ,1416,1053,890,51,60,41,13,0,163
39095048AGR,1444,1133,970,51,82,22,7,0,163
39095048AGL,1085,868,619,34,196,10,7,0,249
39061031AUM,1625,1168,427,13,707,17,4,0,741
39061031BCB,1400,1225,1116,20,44,15,18,0,109
39061031BGM,1415,1085,943,21,75,20,10,0,142
39095048AEA,1907,1450,1104,63,224,38,11,2,346
39061031BLQ,1117,827,256,16,550,1,1,2,571
39061031APM,1674,1221,412,70,704,11,18,0,809
39061031BME,1748,1350,738,20,465,29,90,1,612
39049025AGO,1867,1310,731,207,320,46,25,3,579
39103052AAC,1856,1351,1196,37,22,25,55,2,155
39049025ASN,1054,762,610,12,88,19,36,2,152
39093047AHB,1586,1204,1092,52,22,14,21,1,112
39103052ADS,1389,1131,1077,8,12,8,12,0,54
39103052ABJ,1692,1354,1183,37,85,30,9,1,171
39077039ABN,1046,830,789,16,3,8,2,0,41
39035018ACY,1424,1128,73,8,1037,16,16,0,1055
39035018BIY,1365,1105,907,63,78,10,29,5,198
39035018AII,1090,836,12,19,798,12,4,0,824
39035018BDI,1480,1171,802,232,104,29,23,2,369
39035018CZF,1319,1052,873,18,33,18,97,1,179
39035018BDG,1511,1144,757,209,138,37,11,2,387
39035018ACF,1790,1530,601,21,878,11,18,0,929
39035018AXV,1066,788,329,87,367,7,0,1,459
39035018CIE,1540,1194,1025,76,48,27,26,3,169
39035018AVB,687,501,64,9,425,2,2,0,437
39135068ABK,1029,801,773,3,2,11,2,0,28
39135068AAZ,725,584,551,10,6,6,3,0,33
39035018CZE,1582,1369,1141,39,51,10,117,2,228
39035018CZO,1646,1208,1061,13,8,4,119,1,147
39035018BRS,361,308,248,23,13,2,21,1,60
39035018BRV,1408,1183,1076,36,13,15,35,2,107
39035018AYL,903,739,223,94,411,4,16,0,516
39035018AYJ,837,674,154,32,483,13,1,3,520
39035018CDL,1877,1409,1300,59,26,9,14,0,109
39035018CUI,1569,1274,372,23,837,22,22,1,902
39035018CGV,945,781,698,20,30,6,9,0,83
39035018CTZ,1291,960,330,25,593,13,15,2,630
39005003ACQ,1101,833,788,11,2,24,1,0,45
39117059AAH,976,743,711,3,4,16,6,0,32
39117059ABA,1033,733,702,10,5,18,2,1,31
39013007AAR,687,612,585,5,8,2,10,0,27
39057029AAD,1205,960,855,26,33,14,28,3,105
39057029AAQ,1221,958,845,21,13,15,63,1,113
39061031AXS,1922,1589,850,259,369,29,84,3,739
39057029AAC,1409,1157,933,28,57,13,114,1,224
39025013AHJ,563,554,534,6,6,3,8,0,20
39079040ABG,767,584,569,0,4,11,0,0,15
39139070ACS,1171,937,887,6,11,13,3,0,50
39015008AAG,799,595,556,2,2,23,4,0,39
39145073ADE,134,115,107,0,0,6,2,0,8
39147074AAW,1606,1437,1034,52,297,18,31,2,403
39113057ABP,1757,1307,864,208,185,45,21,1,443
39113057AEA,1133,934,803,20,58,26,18,2,131
39155078AHF,1546,1233,1051,25,75,26,40,0,182
39155078AFM,1257,1091,1035,8,25,9,5,0,56
39165083ABY,1194,866,742,39,25,19,34,0,124
39099050AKJ,1353,1100,942,43,77,9,15,0,158
39099050ASZ,713,564,504,19,20,9,16,0,60
39099050AKN,961,816,742,32,14,12,19,0,74
39099050AKM,1580,1267,995,79,82,23,70,1,272
39017009AJA,916,765,661,33,36,22,12,0,104
39113057AMZ,908,735,664,17,32,14,6,1,71
39049025BDY,1255,1082,750,20,259,11,40,2,332
39049025ASE,807,702,505,21,124,14,33,2,197
39113057AVZ,1967,1444,1141,50,134,30,94,2,303
39113057AYO,1736,1259,1134,43,33,17,42,1,125
39113057AAS,1127,1025,905,71,17,10,21,0,120
39023012ACA,1336,1157,911,28,180,14,22,0,246
39049025ACS,3094,2783,1689,258,424,55,382,7,1094
39155078AFG,1472,1202,979,16,165,29,3,2,223
39155078ABF,1626,1299,1133,29,98,22,14,1,166
39089045ABK,1878,1533,1415,20,60,13,25,1,118
39003002AFE,319,239,216,8,1,3,2,0,23
39087044ADA,457,352,334,0,1,16,0,0,18
39049025AMT,2085,1652,1139,102,326,50,38,0,513
39049025BLO,1305,1187,855,38,147,32,114,2,332
39153077AQW,1494,1226,627,21,415,15,136,3,599
39153077AUL,1355,1099,975,11,29,11,63,0,124
39007004ABB,2321,2205,1063,64,1055,9,5,0,1142
39087044ABM,1269,1099,999,15,61,25,1,1,100
39049025AQL,966,724,606,20,19,3,72,2,118
39049025BLZ,1322,883,196,73,550,16,67,3,687
39049025AGV,711,673,588,13,13,7,39,1,85
39151076ADV,1135,846,753,12,54,17,7,0,93
39151076AHK,1907,1357,1186,34,22,28,73,0,171
39089045ABT,1249,984,902,9,44,21,4,1,82
39049025BIV,1854,1209,672,48,337,21,131,5,537
39049025BLW,1365,963,550,48,265,27,78,1,413
39049025ARA,1186,907,779,22,18,8,74,5,128
39049025AOM,978,698,580,20,39,15,45,1,118
39049025APQ,1024,803,655,38,15,11,86,1,148
39041021ABO,1007,708,631,14,16,14,35,0,77
39041021AGL,1179,729,615,16,49,12,42,0,114
39151076AEG,996,814,768,7,8,15,10,0,46
39151076AKQ,1386,1108,993,27,41,25,16,0,115
39049025BLS,1557,1161,257,190,693,34,14,7,904
39049025AHD,1522,1115,319,108,622,20,58,0,796
39085043ADR,1219,1022,916,17,45,21,11,2,106
39087044ABJ,1105,894,813,12,48,16,1,0,81
39085043AAU,1754,1400,1333,16,11,20,10,0,67
39133067AGM,2326,2272,1762,77,349,22,67,9,510
39133067ABK,1212,1025,735,43,138,16,96,0,290
39085043AER,1981,1601,676,44,617,10,267,6,925
39085043AEM,1120,903,845,12,12,8,23,0,58
39029015AEK,1673,1341,1257,14,5,31,16,0,84
39023012ADI,1200,932,877,12,8,25,0,0,55
39041021ABM,1004,770,702,11,14,29,4,0,68
39017009ACL,1329,961,851,21,62,21,9,0,110
39153077AWI,1214,1032,946,15,29,13,24,0,86
39039020ABD,1015,762,704,31,5,10,4,2,58
39017009ADC,1415,1021,839,66,61,48,6,7,182
39153077AHK,1474,1228,714,28,439,28,17,3,514
39051026AAG,1457,1088,920,129,22,23,10,1,168
39061031BEX,1684,1263,1196,2,29,8,18,0,67
39061031BIX,2270,1593,1420,31,47,22,63,2,173
39061031BIC,1592,1112,1022,14,22,25,27,0,90
39057029AEA,1353,1088,753,56,207,44,27,1,335
39129065ABW,604,492,470,4,4,5,2,1,22
39103052ABM,1461,1146,1052,25,21,27,20,0,94
39129065ACD,1829,1274,1169,14,31,38,21,0,105
39129065ACB,475,360,331,4,7,10,0,0,29
39035018CWO,1310,1016,303,23,640,11,43,1,713
39035018BSM,1516,1173,1061,40,26,7,39,0,112
39035018CJJ,1391,1204,1071,32,23,19,56,3,133
39035018CJE,1266,1091,964,37,61,1,27,1,127
39035018BLB,1030,858,635,27,148,4,39,2,223
39035018BKO,1282,1080,745,33,251,10,38,1,335
39035018CWI,1335,1042,852,36,50,14,85,1,190
39035018AME,637,593,52,15,510,10,13,0,541
39035018CJI,1385,1166,1111,22,9,6,5,0,55
39103052ABP,1411,1040,927,28,23,28,18,2,113
39035018DCN,999,925,817,10,95,1,3,0,108
39035018BKY,1113,859,368,67,377,17,54,1,491
39061031ABN,1158,951,859,20,33,6,21,1,92
39061031ACH,1407,1158,731,14,395,6,15,0,427
39101051AAU,663,488,397,12,56,14,2,4,91
39129065AAT,1091,889,840,5,6,24,12,0,49
39061031ALF,1781,1236,567,119,514,38,10,1,669
39061031ARP,1255,903,154,129,580,15,39,0,749
39061031APY,1876,884,37,60,790,14,4,2,847
39103052AAW,2190,1721,1476,59,79,30,28,3,245
39103052ACZ,2033,1552,1420,28,15,18,54,1,132
39135068ABB,814,617,588,5,8,11,3,0,29
39103052ABQ,1878,1451,1315,40,44,24,16,2,136
39057029ABS,930,721,642,17,23,15,17,1,79
39101051AAQ,740,588,557,3,11,13,1,0,31
39117059AAS,1070,831,786,8,10,17,4,1,45
39135068ABD,1273,1009,966,5,9,28,3,0,43
39035018DEP,1137,910,34,20,846,15,10,0,876
39035018BBJ,1300,1011,466,251,287,43,12,4,545
39035018BGN,1010,896,353,80,411,27,37,0,543
39081041ABS,1215,988,884,8,43,29,6,0,104
39045023ABX,1536,1173,1105,9,14,30,8,0,68
39119060ABR,1052,810,763,5,12,18,0,0,47
39061031BCQ,1289,1008,829,19,86,28,40,8,179
39095048AHR,1484,1023,549,63,376,21,11,1,474
39095048ATG,1438,1194,976,22,68,13,111,0,218
39027014ABU,809,636,619,1,2,5,3,1,17
39155078AGU,1296,1108,1002,23,32,10,32,0,106
39155078AHG,811,626,575,14,15,5,14,0,51
39095048AFI,1480,1264,846,70,307,26,21,0,418
39151076AIX,948,729,690,9,9,7,5,0,39
39095048AAR,1430,1129,1027,44,20,17,13,0,102
39165083AFA,772,608,551,12,12,13,15,0,57
39165083AEZ,668,489,460,13,4,10,6,0,29
39027014AAB,1172,940,843,25,42,25,11,0,97
39027014AAA,1101,855,759,20,33,30,15,2,96
39029015AEH,857,709,654,19,12,9,11,0,55
39057029ADQ,1116,913,768,24,58,26,31,3,145
39099050AHG,1018,841,737,30,60,9,3,1,104
39165083AFH,2144,1629,802,50,97,19,635,5,827
39155078ABL,1285,1134,1011,23,62,12,19,1,123
39165083ADG,1834,1289,1150,27,33,29,47,0,139
39049025AXD,1374,1034,541,37,436,14,9,0,493
39093047AAB,1486,1177,1075,48,5,14,19,1,102
39007004AEP,630,505,453,11,21,4,10,0,52
39025013AGL,970,814,726,21,23,16,14,2,88
39093047AKU,2292,1531,1308,38,22,29,127,0,223
39013007ABA,830,646,610,2,20,9,2,0,36
39049025AHQ,1407,1056,715,156,106,41,57,2,341
39169085AAW,947,789,670,21,46,30,13,3,119
39087044ACD,869,691,659,1,9,16,2,1,32
39087044AAP,385,299,278,0,10,7,4,0,21
39099050ALB,1488,1127,884,23,165,15,31,0,243
39093047ACO,1691,1396,1197,88,69,22,19,1,199
39143072ABP,816,637,525,63,29,11,10,0,112
39143072AAR,817,607,528,40,19,11,3,1,79
39095048AQK,1182,946,828,41,35,12,20,0,118
39141071AAS,1547,1185,1039,20,84,30,1,2,146
39025013AFY,937,803,666,26,68,21,25,0,137
39165083AGC,1176,819,558,33,29,7,178,0,261
39155078AJJ,1028,862,828,6,4,15,1,0,34
39145073ADV,770,590,546,11,1,16,2,0,44
39041021AAZ,1061,711,663,5,14,1,20,0,48
39153077AUJ,1127,908,853,6,38,1,11,0,55
39113057ALJ,1410,1077,942,41,55,15,19,0,135
39147074ABL,286,205,196,3,2,5,1,0,9
39165083AEH,1856,1384,1232,34,47,27,35,0,152
39025013AFW,859,683,639,0,11,19,9,0,44
39049025AED,1309,1065,982,16,20,22,22,0,83
39049025AEB,1203,988,867,29,36,19,34,1,121
39049025ASP,847,633,505,27,52,8,44,3,128
39049025ACD,1877,1805,1472,39,88,12,195,1,333
39049025AVC,955,757,701,11,10,7,21,0,56
39055028ABJ,305,244,224,3,5,7,2,0,20
39109055ACV,857,683,656,5,2,12,5,0,27
39049025AKP,1123,849,179,64,583,36,9,2,670
39007004AAW,636,475,320,74,64,16,7,1,155
39169085AAE,2084,1661,1444,67,81,33,28,2,217
39049025ALP,1265,921,331,68,390,24,121,1,590
39085043AEF,1067,880,849,13,10,2,6,0,31
39085043AEE,1239,1043,971,21,18,13,11,3,72
39017009AKF,1042,852,793,3,10,22,19,0,59
39099050AMW,1490,1257,1161,21,18,8,46,2,96
39049025BBJ,1553,1140,968,62,48,42,18,0,172
39113057ACK,972,682,214,18,424,19,8,1,468
39113057ANF,1397,1122,949,43,69,26,35,2,173
39113057ANC,1160,923,837,24,32,19,13,2,86
39157079AAB,976,753,699,27,7,14,3,0,54
39085043ACB,1170,937,873,12,19,21,9,1,64
39093047AKZ,2336,1531,1364,48,33,6,64,2,167
39155078AAZ,824,657,625,7,14,3,6,1,32
39155078AFS,1459,1203,1126,15,21,15,3,0,77
39155078AHO,1431,1155,1059,7,25,44,6,3,96
39133067AFL,1380,1116,1066,3,10,14,7,1,50
39049025AOF,1289,1044,801,71,81,39,57,1,243
39113057AKZ,2190,1645,1411,35,98,34,63,2,234
39049025BLR,2007,1783,1093,226,363,21,75,3,690
39049025BHG,2174,1777,1069,262,374,47,48,2,708
39049025ABM,916,759,269,24,430,7,18,0,490
39017009AJY,960,773,709,14,12,8,21,1,64
39017009AEH,1063,906,740,44,103,6,4,0,166
39133067AGS,1212,970,876,24,26,20,19,3,94
39055028ABO,867,702,644,11,6,18,14,0,58
39113057AYP,1150,933,723,55,89,11,60,0,210
39113057AJB,1788,1425,1070,49,223,31,48,2,355
39035018DFF,1662,1365,1168,44,59,22,71,0,197
39085043AFS,1318,978,928,2,6,6,32,0,50
39133067AAW,1069,885,743,41,48,21,31,2,142
39017009AIO,1100,766,577,20,66,13,89,0,189
39159080ABQ,807,586,558,3,6,12,5,0,28
39017009ADY,784,642,601,4,22,10,2,0,41
39095048AQN,1461,1162,956,46,114,27,16,0,206
39095048AMG,1278,996,853,46,85,5,4,0,143
39061031BHT,914,676,640,9,9,7,6,0,36
39061031BLC,812,644,375,69,180,14,10,1,269
39061031AWI,1429,1136,1043,24,40,10,15,2,93
39061031ARC,1261,1025,929,20,43,18,15,3,96
39095048AQG,1519,1192,1034,55,49,38,16,0,158
39061031ALG,2218,1660,1085,84,403,51,31,0,575
39167084AAZ,1422,1206,1136,9,25,20,15,0,70
39167084ACD,15,13,8,1,3,0,2,0,5
39049025APD,2367,1799,1193,265,225,47,87,2,606
39093047ABN,1979,1574,1392,60,43,28,46,2,182
39049025BCC,1056,729,598,65,26,34,7,1,131
39049025BBF,1180,821,717,44,25,14,28,0,104
39035018ARH,723,533,0,7,525,1,0,0,533
39035018BNM,523,465,86,23,352,14,11,0,379
39035018BHC,1371,1148,974,52,59,16,53,2,174
39035018BJV,1541,1466,785,60,156,7,452,1,681
39035018BXF,943,804,716,26,25,4,29,1,88
39035018CQZ,1140,833,692,26,65,2,43,0,141
39035018ARZ,975,737,11,25,697,27,5,0,726
39035018ASS,656,547,5,10,528,13,0,0,542
39035018CYP,1139,903,791,24,6,1,72,0,112
39045023ADO,1042,789,660,2,75,5,38,2,129
39045023ADS,1414,1044,853,11,103,13,57,1,191
39035018CVQ,1616,1330,1182,25,38,22,47,1,148
39035018AEJ,1158,982,873,30,39,21,12,1,109
39035018BUQ,1045,851,744,16,34,5,47,0,107
39035018AAR,1132,864,819,12,5,10,10,1,45
39035018AVD,903,734,25,12,696,13,0,0,709
39009005ACS,1326,1320,963,52,283,14,17,0,357
39101051ABB,1726,1266,1146,15,77,22,13,2,120
39035018DCM,853,722,686,5,0,9,16,1,36
39035018CDU,1598,1369,1168,69,70,18,42,2,201
39045023ACZ,944,723,695,1,4,19,3,0,28
39043022ADB,1733,1412,1241,29,54,29,53,1,171
39043022AEK,1577,1183,720,52,380,42,3,2,463
39045023ACS,1363,1020,979,20,5,7,0,0,41
39057029AAX,887,676,590,15,12,22,38,0,86
39061031AQA,1686,1335,861,89,343,26,11,3,474
39061031AZU,1574,1199,1124,14,14,20,24,0,75
39113057AMM,1140,877,762,31,27,17,37,2,115
39113057AXQ,1427,1122,1000,23,30,14,52,1,122
39113057ALO,1622,1310,1126,34,85,28,32,0,184
39165083AHD,964,615,541,13,25,2,27,1,74
39165083ADJ,1253,1017,938,19,31,12,14,0,79
39017009ACD,982,764,647,17,73,13,8,0,117
39017009AFT,1391,1065,820,17,122,14,80,2,245
39113057ACC,2169,1619,1029,76,320,24,171,0,590
39155078ACG,1559,1230,841,23,305,30,3,2,389
39049025ATP,1464,1207,1095,50,23,30,13,3,112
39049025AJE,1396,990,335,56,572,11,23,1,655
39041021ACX,1366,968,880,18,9,8,51,0,88
39049025AQP,885,653,541,20,27,4,54,0,112
39049025AQN,1179,915,764,32,48,8,66,0,151
39049025AUJ,1881,1266,558,43,549,39,85,5,708
39141071ACT,904,689,637,11,25,14,3,1,52
39153077BBD,1152,936,737,13,109,15,61,0,199
39093047AGS,1853,1525,1322,74,42,32,25,1,203
39151076AOC,1121,860,822,5,5,19,2,1,38
39049025AOB,1083,876,652,29,57,9,127,1,224
39065033AAO,501,390,375,9,2,3,1,2,15
39153077ANG,861,714,624,3,42,15,14,0,90
39153077ANI,1065,859,786,2,38,7,20,0,73
39153077API,1280,1014,947,15,17,10,17,2,67
39055028ACG,918,771,745,5,8,6,7,0,26
39017009AGQ,2261,1634,1254,61,166,33,116,0,380
39017009AGM,2069,1387,1012,55,174,29,112,0,375
39085043AAO,1541,1262,1189,15,23,14,11,0,73
39133067AAL,1166,915,776,10,37,4,74,0,139
39049025BHM,2545,1944,1164,151,354,23,251,1,780
39071036AAI,1290,1048,919,12,69,17,16,2,129
39071036ABD,983,730,698,4,3,21,2,0,32
39153077AGP,1077,893,560,9,298,5,19,0,333
39153077ABI,1596,1327,637,25,264,36,364,1,690
39153077ATA,1185,896,848,8,12,13,4,0,48
39167084ACB,881,754,710,11,6,13,9,0,44
39061031AAY,2267,1764,1386,53,273,35,28,4,378
39061031ANV,1453,1175,233,84,808,26,36,1,942
39061031BDK,344,310,188,8,107,4,5,0,122
39061031BLE,1244,970,453,27,454,24,29,2,517
39061031BEJ,2163,1623,1443,19,89,32,29,1,180
39061031ABD,2190,1757,1388,78,193,38,41,5,369
39061031ANE,1251,1015,284,14,702,10,10,0,731
39035018AIG,1134,879,6,10,861,10,7,0,873
39035018AIO,1037,908,7,4,878,7,5,0,901
39035018ADF,868,673,209,17,445,5,0,0,464
39035018BXZ,1298,1122,773,70,224,22,39,0,349
39061031ATB,1115,814,702,16,58,6,31,0,112
39119060ADG,1430,1094,1034,10,22,17,5,1,60
39033017ABO,1119,870,821,10,3,21,0,1,49
39063032AAA,1465,1195,999,76,76,17,29,0,196
39061031ARM,1635,1180,284,169,675,18,40,8,896
39061031AXQ,976,744,246,37,399,9,53,6,498
39061031AXX,1160,948,302,48,538,27,51,7,646
39061031BIH,950,761,715,6,19,10,7,0,46
39061031BGP,1554,1337,1190,19,87,3,21,2,147
39061031BIP,1527,1213,990,17,164,20,16,0,223
39061031BCM,1423,1175,1114,6,24,17,12,0,61
39061031BNO,1671,1210,1076,18,29,10,67,0,134
39035018BON,1366,1051,325,9,687,15,14,0,726
39035018BOP,1453,1036,327,17,685,9,3,0,709
39035018ALB,1134,830,11,8,811,13,4,0,819
39035018ALQ,839,609,11,11,590,4,0,1,598
39035018DBK,1192,950,875,28,14,11,14,0,75
39035018AFB,1522,1126,1016,27,9,10,61,0,110
39035018AEX,1101,947,858,15,22,5,37,0,89
39113057AGZ,1077,797,108,15,660,16,5,0,689
39089045ACQ,2214,1652,1431,17,63,39,99,3,221
39017009AKA,1296,1010,877,34,32,21,42,0,133
39061031BDC,1888,1441,752,51,483,25,138,4,689
39173087ABK,1276,1048,916,58,35,19,18,0,132
39057029ABA,928,753,687,15,21,12,21,0,66
39061031BNR,2020,1534,1018,49,88,17,345,0,516
39061031ALR,966,718,247,28,440,4,0,0,471
39061031BAV,1428,1164,1113,2,9,10,28,0,51
39095048AFN,1555,1321,755,45,464,30,26,0,566
39093047AAS,1148,887,843,22,10,3,8,0,44
39095048ARH,1442,1151,450,62,596,22,21,2,701
39095048AJF,1217,885,524,71,275,14,8,0,361
39095048AJD,1412,1079,716,114,198,31,8,0,363
39139070ACE,1518,1269,1134,25,66,23,7,1,135
39095048AVJ,1135,852,723,24,65,4,30,0,129
39095048AGP,1098,952,610,52,266,9,15,1,342
39095048ANO,1302,870,529,135,197,22,2,0,341
39155078AEV,758,632,600,6,3,8,9,1,32
39095048AIL,1039,790,185,54,537,11,9,0,605
39095048AIM,975,762,155,22,579,9,3,0,607
39151076AFI,1114,875,784,21,40,10,9,1,91
39173087ACC,1193,922,840,50,2,20,3,1,82
39057029ADZ,1130,919,718,31,106,36,26,6,201
39015008ACP,1665,1305,1232,7,13,41,7,4,73
39165083AAQ,1504,1180,1020,77,34,21,21,0,160
39165083AFY,1816,1249,1143,21,17,32,25,0,106
39049025AQY,1345,986,838,35,34,15,57,7,148
39025013AAO,1874,1376,1210,51,40,45,27,4,166
39025013ABT,1008,771,738,6,8,3,16,0,33
39025013ACE,1708,1190,1000,40,69,23,23,2,190
39025013ACO,891,690,622,9,17,26,7,4,68
39093047AAQ,1640,1353,1257,48,9,7,34,0,96
39049025BKN,1318,992,843,53,32,18,31,2,149
39049025ABK,1436,951,141,28,754,23,6,4,810
39087044ABX,565,414,399,3,3,8,1,0,15
39109055AAP,988,809,761,8,24,2,8,2,48
39095048ATT,1491,1120,1005,33,38,7,25,0,115
39095048ALF,749,608,18,15,567,11,2,0,590
39025013ACQ,726,560,513,9,13,6,4,3,47
39165083AGO,2168,1575,1008,40,110,19,386,0,567
39041021ACS,1213,904,759,19,18,4,104,0,145
39141071ABY,1378,1047,964,20,18,33,9,1,83
39061031ANB,922,716,232,20,440,10,17,1,484
39049025AZW,901,683,597,14,36,16,19,0,86
39155078AFR,1491,1191,1121,19,13,14,12,1,70
39049025BBN,2140,1609,1004,333,230,57,20,0,605
39049025ARI,1500,1076,874,15,14,1,165,1,202
39023012ABE,1877,1293,875,29,355,31,5,0,418
39007004AEI,816,677,571,30,38,20,4,0,106
39041021AFC,1333,901,781,16,38,1,60,1,120
39037019AAC,908,759,722,9,3,4,14,0,37
39099050AHF,955,817,721,30,38,10,9,1,96
39099050AMM,1212,882,696,52,98,7,25,1,186
39133067AGH,616,481,401,10,50,18,3,0,80
39099050AHY,1100,875,694,32,130,17,11,2,181
39049025AXK,2024,1323,583,156,535,46,44,2,740
39151076AIH,1260,997,952,19,0,13,4,0,45
39017009AAQ,1233,920,650,58,173,20,11,0,270
39049025BFO,1066,839,756,32,18,5,13,2,83
39113057AUN,890,704,158,15,518,13,11,0,546
39049025AIU,1083,891,294,62,524,17,7,1,597
39049025ALA,2828,1941,221,176,941,16,621,4,1720
39049025AYO,1393,1037,842,50,99,27,21,1,195
39017009AFX,1117,849,741,23,42,19,25,1,108
39049025ANI,1141,906,396,46,424,24,20,0,510
39157079ADB,811,649,612,5,12,15,3,0,37
39157079ADC,1190,909,875,12,10,8,5,0,34
39113057AYI,1883,1348,1035,33,64,16,193,2,313
39133067AGL,1911,1828,1435,60,151,19,156,0,393
39133067ABE,2883,2847,2154,136,437,37,110,5,693
39085043AAA,1625,1356,1090,26,164,32,30,1,266
39095048AOC,1311,945,606,144,185,20,9,3,339
39061031BDR,92,78,53,2,23,0,0,0,25
39061031AZY,758,535,490,14,5,15,8,1,45
39095048AJA,1510,1076,737,71,259,23,3,2,339
39061031AUS,1130,879,148,35,669,11,22,0,731
39061031AQP,1980,1369,241,37,1032,16,31,1,1128
39103052ADA,2126,1676,1517,73,21,20,25,0,159
39103052AGA,2733,1831,1621,45,35,34,83,1,210
39103052ABZ,1434,1111,992,31,31,18,9,2,119
39035018BOB,850,677,24,7,650,13,4,0,653
39035018AQD,1181,1088,469,28,534,5,40,1,619
39035018APZ,997,802,86,21,487,19,205,2,716
39035018BPM,1180,922,514,28,369,13,5,0,408
39081041AEC,145,111,107,3,0,0,0,1,4
39081041ABL,961,821,751,5,32,11,11,0,70
39033017ABM,938,722,679,18,6,17,4,0,43
39045023ABV,1626,1219,1122,19,31,19,17,0,97
39035018CYY,1071,842,723,14,10,21,67,0,119
39035018DCO,1034,977,819,12,104,17,21,0,158
39035018BCW,1568,1196,739,277,147,31,22,2,457
39035018CNO,1053,890,323,8,528,8,23,1,567
39035018BLM,1271,977,414,42,501,16,17,3,563
39019010AAQ,1354,1081,1028,25,2,10,12,0,53
39045023ACY,1084,816,760,15,4,19,9,0,56
39101051ACX,876,658,624,11,3,10,7,2,34
39101051AAW,1481,1051,876,37,72,48,8,6,175
39045023ABK,1135,859,610,36,178,6,25,0,249
39057029AFT,1019,827,712,16,65,27,10,2,115
39117059AAG,990,740,695,6,5,20,2,2,45
39097049AAA,689,536,471,16,22,12,15,0,65
39097049AAZ,910,724,663,9,9,10,14,0,61
39139070ACD,1293,1035,945,6,53,13,12,2,90
39113057AAH,1392,1109,948,28,43,13,81,3,161
39017009AEG,824,669,587,16,39,21,6,0,82
39165083ABO,1254,946,875,33,7,18,8,4,71
39113057ATL,1448,1116,1030,15,8,35,25,0,86
39099050ABK,983,800,703,42,42,3,8,1,97
39113057AWR,1097,839,809,4,6,16,2,0,30
39113057AFR,1233,762,37,14,711,12,3,1,725
39155078ABG,1527,1321,1111,28,113,40,22,2,210
39089045ABJ,1287,1051,1007,14,12,3,10,0,44
39141071AAB,745,651,596,4,36,7,7,0,55
39041021ADC,1411,1077,947,34,38,13,36,0,130
39025013ACN,939,760,699,7,18,21,10,0,61
39049025ANW,1634,1394,999,64,97,23,200,0,395
39049025AEZ,1522,1165,684,102,304,31,27,2,481
39151076ADD,699,589,521,12,24,18,16,0,68
39151076ANU,907,720,698,5,3,14,2,0,22
39049025AXE,1234,958,858,30,21,22,15,0,100
39049025AWS,1020,824,743,11,39,5,17,0,81
39049025AWN,1157,863,798,9,34,7,13,0,65
39049025ATU,1473,984,740,37,163,24,21,0,244
39049025ALK,1315,1019,354,157,417,13,96,0,665
39151076AHQ,982,866,745,25,57,19,17,0,121
39149075AAM,1609,1262,1072,36,64,12,68,8,190
39085043AAB,1414,1160,1026,22,57,35,16,0,134
39085043AEU,1225,957,819,8,79,20,19,0,138
39049025AIZ,1819,1166,76,76,1004,13,12,7,1090
39133067ACP,1832,1528,1156,61,183,20,103,1,372
39153077BAZ,1227,897,773,18,28,18,49,0,124
39153077ASF,2204,1471,1029,39,85,6,296,2,442
39061031AUQ,1705,1341,540,28,749,33,7,3,801
39061031AJT,867,662,314,21,276,14,37,0,348
39061031AXJ,1686,1436,541,56,782,34,36,0,895
39057029ABB,776,646,525,19,21,6,72,0,121
39103052ACE,837,658,622,11,4,13,9,0,36
39135068AAH,911,779,731,5,3,19,16,0,48
39035018BHZ,982,757,465,116,136,28,31,2,292
39035018AST,756,565,25,3,527,9,10,0,540
39035018CJV,1333,1136,1022,29,14,11,52,0,114
39035018CVI,1241,971,865,23,34,6,44,0,106
39103052ABU,1738,1243,1140,20,33,18,19,0,103
39061031ARU,1724,1359,341,111,849,24,47,2,1018
39061031AMO,1478,1090,76,30,962,19,17,1,1014
39061031AYD,1862,1347,1106,27,141,16,52,0,241
39103052AEU,1328,1031,966,24,5,12,20,0,65
39035018BQI,1581,1207,499,26,662,29,8,0,708
39135068ABN,794,589,570,2,2,15,0,0,19
39173087AEC,778,707,541,60,53,23,32,0,166
39013007ABU,538,468,422,9,17,6,4,0,46
39095048AVU,2010,1395,1150,29,46,17,147,0,245
39095048ALM,896,701,100,15,581,6,0,1,601
39165083ACA,1488,1088,991,27,8,17,40,0,97
39095048ADX,1311,1023,834,68,59,36,20,3,189
39095048AEE,1419,1050,780,58,172,26,18,0,270
39057029ADK,879,736,655,8,39,7,17,2,81
39057029AAM,1070,866,754,36,14,25,39,7,112
39143072ACZ,211,168,158,5,1,0,0,0,10
39025013ACD,947,719,673,6,11,5,16,0,46
39025013ACR,1028,829,763,7,17,21,15,0,66
39025013AAL,1653,1207,1123,19,24,26,5,0,84
39025013ACS,1125,901,828,23,16,28,10,1,73
39095048ACN,1118,872,768,14,36,8,34,0,104
39095048AWA,540,462,323,21,108,7,8,0,139
39095048AFK,1054,841,619,30,161,11,13,0,222
39141071ABZ,1192,939,894,2,11,13,1,0,45
39153077ASZ,1204,978,932,6,2,26,2,0,46
39153077AMG,932,758,588,9,17,12,134,0,170
39141071ABN,1407,1031,962,6,46,8,4,0,69
39113057ALP,658,512,423,25,40,7,15,1,89
39151076ADF,984,775,501,30,219,11,7,0,274
39049025AVK,1214,890,657,21,16,14,176,5,233
39049025BMT,1358,886,361,43,363,28,115,0,525
39049025BJU,1462,937,602,106,168,34,39,0,335
39043022ADH,1504,1083,945,32,76,13,24,2,138
39173087ADB,1486,1147,1042,36,30,22,7,0,105
39007004ABW,686,564,487,36,11,12,9,0,77
39017009AAT,826,643,516,24,62,12,25,1,127
39025013AHO,651,497,473,2,8,4,7,0,24
39169085AAM,1185,929,883,16,2,19,3,0,46
39011006AAX,472,378,357,7,4,9,2,0,21
39007004ACM,664,540,500,13,10,6,6,0,40
39007004ACD,872,651,553,37,29,20,3,2,98
39173087AAU,1071,833,754,39,14,13,12,0,79
39153077AVK,1314,1105,1010,10,25,37,18,0,95
39049025BDO,1245,917,769,12,27,7,103,1,148
39049025BFV,1628,1052,897,20,55,6,64,0,155
39153077ARE,1530,1141,1058,21,3,7,43,0,83
39049025AFR,1426,990,201,110,663,18,10,0,789
39049025AIG,2517,2363,1863,142,98,18,246,5,500
39049025AIC,2537,2439,1599,171,229,26,419,2,840
39061031AIW,1674,1333,588,55,648,25,22,0,745
39061031AEL,1924,1532,1203,50,124,13,126,2,329
39061031APS,2131,1390,203,143,1014,20,26,2,1187
39035018ABQ,1520,1079,829,18,120,11,89,1,250
39113057AME,1432,1118,984,23,71,12,18,1,134
39085043AHX,854,664,637,9,5,3,8,0,27
39035018CVT,1615,1331,1158,24,30,11,107,1,173
39035018AAV,1675,1269,1199,22,17,7,15,0,70
39035018BQW,1739,1701,92,18,1604,18,4,0,1609
39055028AAA,1386,1136,1041,34,25,5,16,1,95
39095048AJV,1787,1444,879,60,425,26,58,0,565
39061031ANY,1418,681,40,24,615,12,2,2,641
39061031ANX,979,452,27,1,415,5,4,0,425
39061031BIN,943,767,734,8,4,16,5,0,33
39061031BGS,1005,881,825,11,17,9,17,0,56
39061031BKS,1158,844,450,33,303,21,35,3,394
39095048AQL,1143,902,629,60,161,32,11,1,273
39049025BNM,1607,1272,318,89,727,17,117,0,954
39049025ASO,1569,1203,896,38,204,8,54,2,307
39035018AVI,685,541,6,4,532,10,5,1,535
39035018BQV,1074,804,160,17,624,7,8,1,644
39035018CVY,1243,1072,1009,15,15,7,15,0,63
39035018ASD,693,534,4,9,526,1,0,0,530
39035018ASH,612,455,1,12,446,3,0,0,454
39035018CTW,1380,1052,367,38,616,15,31,1,685
39035018ANE,899,710,10,2,688,11,5,0,700
39035018CPI,1675,1528,1414,31,17,7,54,1,114
39045023AAS,1835,1469,1368,19,25,30,12,1,101
39055028AAP,779,635,593,6,5,22,6,0,42
39101051ACJ,425,333,299,5,10,10,6,0,34
39057029AAY,905,716,635,19,5,11,43,0,81
39007004AEK,735,635,570,25,14,14,3,1,65
39097049AAY,708,586,557,5,2,14,4,0,29
39113057AKB,1933,1461,1071,57,206,40,75,1,390
39099050ASY,949,738,537,30,138,15,4,1,201
39113057AJY,1021,813,498,13,240,14,42,0,315
39049025AOQ,1281,960,732,50,80,32,71,2,228
39029015ABJ,1392,1056,974,44,2,29,7,0,82
39029015ABM,685,560,518,9,6,11,6,0,42
39099050ANT,337,242,225,3,5,5,0,0,17
39049025AQC,2079,1597,958,165,282,50,117,2,639
39151076AOR,910,689,614,15,18,7,34,0,75
39049025AEO,957,827,744,26,19,14,19,0,83
39151076AHG,1725,1284,1219,9,9,19,13,1,65
39055028AAU,921,736,682,14,6,14,8,1,54
39133067ACH,1193,1034,788,35,139,10,53,0,246
39149075AAJ,1147,883,817,21,15,4,18,2,66
39157079AEN,739,555,523,3,2,20,3,0,32
39099050AJK,995,798,722,25,27,20,5,0,76
39133067ACL,1646,1259,1050,11,112,17,56,1,209
39017009AHL,1392,1084,1030,4,0,38,5,0,54
39173087AAT,1092,880,676,98,64,23,11,3,204
39039020ABS,303,220,210,5,0,6,0,0,10
39061031ASG,845,634,541,21,2,15,49,1,93
39061031BBP,2256,1694,1358,27,261,26,29,0,336
39061031APO,1021,792,409,27,337,22,5,0,383
39061031BGL,1521,1226,1027,10,131,24,29,0,199
39061031APK,1689,1314,829,54,390,30,25,0,485
39061031BBG,1698,1341,1161,25,99,26,22,3,180
39035018CMM,1782,1541,1060,109,254,24,105,2,481
39035018BRZ,1360,1084,989,33,12,10,22,4,95
39035018BSA,1328,1118,967,35,66,6,44,2,151
39035018BWI,1392,1119,1032,25,23,9,15,1,87
39035018CBT,1895,1452,1231,49,97,31,56,2,221
39035018BQT,973,821,156,16,634,14,9,0,665
39035018BQU,1129,941,205,6,723,7,2,1,736
39035018AFR,1269,995,878,27,14,4,64,0,117
39035018AFP,1112,864,763,27,13,20,40,0,101
39035018AUD,609,462,9,2,450,5,1,0,453
39101051ACW,581,478,444,11,4,12,6,0,34
39061031BNU,1990,1396,619,114,107,15,550,1,777
39061031BBY,1016,898,720,12,134,1,23,1,178
39035018CVN,1212,931,794,31,33,9,48,6,137
39035018CVP,1521,1167,1032,42,16,6,64,1,135
39061031AZD,937,717,656,14,18,5,18,0,61
39061031BEF,1326,1076,983,14,36,18,16,0,93
39061031AYW,1302,1104,1015,19,17,10,42,2,89
39061031BMS,1410,1038,819,29,73,6,99,1,219
39163082AAJ,411,294,287,2,0,3,0,0,7
39095048AKD,2776,2710,1800,338,433,33,88,21,910
39095048ANQ,1171,705,224,71,392,16,15,0,481
39095048AOB,1577,1103,762,184,120,41,6,0,341
39099050AOT,1125,920,875,26,9,3,5,0,45
39029015AEI,968,771,729,6,11,19,7,0,42
39151076AHD,1124,1069,955,21,45,16,28,0,114
39173087ABL,1108,864,771,43,19,12,6,0,93
39057029ADP,1159,882,789,28,33,27,8,0,93
39095048AEF,1099,867,731,52,63,13,2,0,136
39049025AKY,1185,933,533,72,214,28,115,0,400
39175088AAF,1152,895,838,32,2,14,4,0,57
39025013AEB,1390,1134,1027,25,21,33,21,1,107
39169085ABC,1104,869,762,26,45,10,19,1,107
39169085AAH,1187,936,830,29,61,13,8,2,106
39049025AES,1589,1215,629,56,393,22,114,0,586
39099050AKY,810,655,595,29,18,11,6,0,60
39099050ABB,894,729,686,13,4,5,12,0,43
39007004ABJ,468,375,349,3,8,4,5,0,26
39151076AGI,1479,1259,1024,31,117,8,76,0,235
39151076AHY,1176,885,847,7,7,13,8,0,38
39049025ADK,1818,1728,1325,77,100,23,188,5,403
39049025BMI,1177,875,369,62,406,19,22,4,506
39049025AMW,1315,1129,886,44,93,11,95,4,243
39049025AVD,864,600,579,8,3,1,8,0,21
39155078ACF,1828,1437,1018,27,337,48,13,2,419
39155078ADI,1742,1241,925,29,225,52,6,0,316
39049025AGH,1658,1219,559,72,489,21,95,2,660
39049025BEJ,1764,1230,583,43,292,29,302,0,647
39133067ABJ,712,599,529,7,29,16,18,1,70
39049025ALN,1648,1290,454,151,570,47,94,0,836
39035018BOM,1092,831,307,9,485,25,11,2,524
39061031BGY,1218,995,842,22,79,7,34,1,153
39061031AMY,1444,1101,460,41,556,21,21,1,641
39095048ARF,873,739,459,28,230,9,10,1,280
39095048AHA,597,512,362,26,110,2,8,1,150
39061031BEL,1250,986,944,6,11,7,16,1,42
39061031BFA,1244,1083,1007,12,45,11,8,0,76
39059030ABB,619,475,466,0,0,5,1,0,9
39165083ABC,1101,862,625,65,57,14,76,20,237
39077039AAX,1437,1124,1021,63,27,15,2,2,103
39103052AET,1077,898,810,16,5,11,33,0,88
39035018BHE,1388,1066,629,204,171,20,45,0,437
39035018BHG,1412,1062,646,173,181,39,47,6,416
39055028ABP,1188,960,916,8,5,19,8,0,44
39055028ABQ,1472,1165,1088,12,15,28,3,1,77
39013007AAV,433,350,340,2,2,2,1,0,10
39035018BJC,1263,1057,911,59,43,6,33,1,146
39035018BJA,1053,897,828,23,26,2,16,1,69
39101051AAN,888,665,605,9,31,6,4,0,60
39101051ABH,663,507,460,6,35,5,2,1,47
39061031AXA,1735,1384,1105,50,137,25,51,2,279
39025013ACA,1509,1367,1275,22,29,19,14,2,92
39003002AFR,929,727,609,21,67,8,19,0,118
39003002AFS,1081,786,697,18,30,9,24,0,89
39113057AAA,1504,1246,1009,39,139,21,36,1,237
39017009ACE,1376,1070,984,19,32,22,9,0,86
39113057AJQ,896,670,540,17,77,19,26,0,130
39139070ABZ,1355,1085,1005,13,34,15,6,0,80
39037019AAL,736,600,558,16,8,11,8,0,42
39165083AER,1354,1014,978,11,10,11,2,1,36
39025013AFB,1380,1069,980,24,16,31,12,0,89
39049025AKZ,2594,1710,207,142,698,21,649,2,1503
39159080AAB,1768,1253,1126,37,28,25,28,0,127
39141071AAR,912,728,639,10,53,20,6,2,89
39109055ABT,1269,1026,966,18,11,16,8,0,60
39049025AUL,706,527,300,17,167,8,36,0,227
39093047AKK,1702,1387,711,398,270,41,9,0,676
39153077BAM,1521,1161,926,17,153,23,34,0,235
39153077ALO,949,801,743,11,23,8,20,0,58
39049025AXX,618,452,404,8,8,1,28,0,48
39049025AEP,1219,1070,963,20,30,17,36,2,107
39151076ALJ,717,560,501,15,24,11,4,1,59
39145073ABD,989,644,589,0,44,8,3,0,55
39085043AEV,1818,1438,1303,33,51,21,23,2,135
39133067ABC,732,656,501,7,88,19,44,2,155
39049025AGR,1427,1225,1066,55,55,16,18,2,159
39153077AUA,879,699,565,27,45,19,32,3,134
39153077AQN,1260,1062,887,17,116,5,28,0,175
39153077BBG,620,519,400,5,77,3,32,0,119
39153077AOT,1176,913,830,11,40,5,21,0,83
39153077BBV,1199,937,839,17,19,14,38,1,98
39061031ATV,1182,953,854,14,18,16,53,2,99
39061031ANH,932,747,276,9,447,5,13,0,471
39061031AEI,1675,1235,1129,39,22,8,27,0,106
39061031AOU,2023,1336,584,175,494,57,31,1,752
39061031AOK,2239,1500,576,104,767,39,18,2,924
39061031ATU,1273,944,765,31,28,7,107,0,179
39005003AAF,763,620,591,8,9,5,8,2,29
39083042AAI,1086,958,911,15,5,11,10,0,47
39035018CVE,1341,1094,985,41,33,10,25,2,109
39035018CVF,1249,984,853,26,26,8,61,0,131
39035018DBN,1444,1050,978,21,16,7,19,0,72
39035018DAK,306,222,66,1,78,1,76,0,156
39035018DAF,129,94,90,1,1,0,3,0,4
39035018BFI,1640,1195,451,373,341,45,18,1,744
39061031ANU,1834,953,75,31,837,43,6,2,878
39103052ABF,1455,1181,901,53,160,50,15,1,280
39061031ARI,2022,1477,223,199,854,36,189,3,1254
39103052AAY,2539,2098,1892,61,46,41,41,3,206
39035018CDV,1425,1193,1030,46,48,20,52,0,163
39035018CGW,1127,894,812,35,9,7,20,0,82
39113057AGQ,1613,1187,194,57,924,17,8,1,993
39017009ABC,988,770,541,41,77,5,103,0,229
39089045AEE,1077,866,818,7,7,26,2,0,48
39061031BIJ,1993,1475,1350,29,64,31,11,1,125
39061031BEP,878,692,649,8,21,7,0,0,43
39095048AIZ,1505,1036,610,81,317,18,6,0,426
39095048AEC,943,778,547,43,165,13,3,0,231
39173087ADF,809,667,612,14,4,6,24,2,55
39017009ABI,1121,867,724,11,48,12,68,1,143
39049025BDX,664,555,400,15,93,5,46,1,155
39155078ABD,1178,977,880,10,48,16,14,0,97
39095048ABN,1199,984,860,43,40,12,12,0,124
39049025ALG,1732,1292,561,123,540,31,42,1,731
39049025APF,1900,1396,883,239,201,54,45,1,513
39093047AKV,1489,1120,1035,31,15,8,25,0,85
39025013ABI,816,651,609,5,3,25,1,1,42
39025013ABE,776,612,579,1,4,13,11,0,33
39049025AKD,1244,862,212,153,483,13,21,1,650
39145073ADG,1469,1119,1050,10,22,29,9,2,69
39151076AOS,1135,866,787,14,21,6,26,2,79
39151076AHW,1680,1289,1210,30,9,28,7,2,79
39099050AKX,771,610,458,25,102,20,11,2,152
39017009AAS,914,739,300,87,306,14,38,3,439
39133067ACE,1134,902,809,31,29,22,10,1,93
39153077AOS,1341,1017,926,14,23,6,43,1,91
39049025ALE,806,642,452,36,122,12,22,2,190
39017009AAL,1219,915,792,38,43,27,7,3,123
39049025ASS,906,659,579,8,46,5,14,0,80
39017009AJF,1189,1016,703,36,144,13,111,2,313
39085043ABF,1744,1410,1290,28,20,31,19,2,120
39035018DEI,984,760,16,10,724,5,2,0,744
39055028ACM,1142,867,837,11,1,4,16,0,30
39061031BMC,1250,1016,789,29,154,15,18,0,227
39061031BGV,1578,1220,945,16,117,24,112,0,275
39061031BLO,898,626,79,24,500,11,21,0,547
39165083AAV,1301,1030,769,73,61,37,94,6,261
39165083ADM,896,714,677,11,1,17,8,0,37
39049025AYK,502,371,333,8,18,2,6,1,38
39035018CGG,1935,1596,1238,50,81,27,191,0,358
39035018CNS,700,562,241,20,248,7,47,2,321
39035018CNQ,934,840,368,3,420,2,48,1,472
39035018BZX,1604,1304,331,13,946,11,10,2,973
39035018DCW,641,503,139,18,320,14,26,1,364
39035018DER,872,665,21,15,633,11,1,2,644
39035018ARV,835,665,21,18,635,11,2,0,644
39035018CVJ,1186,930,795,19,35,11,67,0,135
39057029AAG,1171,871,767,13,25,13,37,2,104
39025013AGD,1298,1054,917,31,46,29,31,0,137
39025013AFS,1456,1312,1126,29,89,27,51,0,186
39113057AXM,1078,889,775,23,42,17,37,0,114
39021011ACA,1051,807,754,8,12,22,7,1,53
39017009AHU,1002,764,728,11,7,14,2,0,36
39113057AJF,938,746,520,17,179,13,12,0,226
39087044AAV,666,540,503,1,18,13,0,0,37
39165083ACH,1614,1095,697,31,26,10,329,2,398
39165083AFT,1473,1112,722,26,69,17,278,1,390
39087044ACH,534,412,375,8,15,8,3,0,37
39151076AOV,1121,862,766,20,27,20,27,0,96
39049025AET,1096,915,846,23,6,6,30,0,69
39049025AUS,1366,1137,661,36,371,16,57,2,476
39049025BIK,1458,1293,781,23,467,6,24,2,512
39153077BCV,767,612,566,5,17,9,4,0,46
39055028ABX,965,757,723,5,5,5,8,1,34
39049025AUK,1224,976,618,23,217,19,96,6,358
39153077AOD,1148,951,863,18,26,9,31,0,88
39061031AAP,2187,1771,1361,10,350,30,14,3,410
39061031BED,1471,1190,1117,8,25,24,5,0,73
39061031ASQ,1583,1305,1155,25,33,5,79,1,150
39061031BQK,2217,2188,1714,105,243,18,97,2,474
39035018BFZ,1225,934,195,134,590,27,9,3,739
39045023ADU,1077,815,705,12,60,7,24,0,110
39035018BXI,1321,1064,963,26,44,22,7,0,101
39035018BYD,1519,1248,958,81,115,20,67,4,290
39061031AAM,1290,1041,900,18,29,6,83,0,141
39035018CET,1499,1201,1054,47,47,30,22,0,147
39101051ACV,998,802,764,4,5,9,16,0,38
39061031ABI,821,688,614,12,17,9,30,0,74
39061031BCW,1837,1404,1009,37,236,33,77,2,395
39095048ADY,1223,958,684,51,183,26,9,0,274
39099050AIA,891,726,548,51,96,32,8,1,178
39093047AGV,1843,1408,1263,59,29,32,15,0,145
39095048AUA,903,681,624,11,26,4,13,1,57
39095048AMI,881,695,557,60,37,18,10,1,138
39099050ASL,816,675,660,11,1,1,2,0,15
39023012AAE,1848,1356,1184,128,8,33,9,1,172
39145073ACM,658,506,494,0,3,7,0,0,12
39049025AER,1016,892,613,23,199,12,38,0,279
39099050AIB,1431,1248,935,69,199,28,19,7,313
39025013AFI,1746,1375,1240,25,30,48,29,0,135
39017009AKJ,739,587,486,20,31,10,36,2,101
39099050APS,834,699,668,17,7,6,7,1,31
39025013AFO,1409,1115,1003,44,21,19,14,1,112
39165083AEB,1103,846,782,16,14,15,8,1,64
39143072ABX,588,483,436,30,6,2,1,0,47
39133067ACN,1012,816,747,9,28,12,12,1,69
39049025BMD,1451,1173,756,43,313,28,45,2,417
39017009AGA,680,515,425,3,34,7,46,1,90
39017009AJD,2143,1421,611,131,171,31,496,2,810
39061031BEZ,1624,1277,1238,9,8,8,12,4,39
39061031BGE,1585,1218,921,76,192,11,12,0,297
39061031AEJ,1331,1031,944,33,15,2,21,0,87
39061031AZE,1455,1117,1038,9,26,14,19,1,79
39035018DCI,749,597,508,9,37,3,38,0,89
39035018ANB,876,640,7,3,617,9,3,0,633
39009005AAL,1225,1158,1023,48,60,15,11,1,135
39035018BZW,1682,1337,405,43,866,23,20,1,932
39035018DEJ,891,693,23,12,657,7,1,0,670
39057029AAH,810,653,585,24,2,16,23,0,68
39061031BKO,984,745,370,29,271,9,78,0,375
39017009AEA,924,695,635,10,37,10,4,1,60
39113057AGA,1273,883,30,1,848,8,2,1,853
39165083AEV,936,739,689,6,23,0,19,0,50
39007004ADH,726,572,549,4,0,8,0,1,23
39175088AAB,906,737,645,61,4,9,10,1,92
39161081AAH,732,527,453,33,18,11,2,3,74
39085043ADG,1113,813,698,17,67,13,9,3,115
39055028ABH,1138,928,884,17,7,8,4,0,44
39055028ABG,1274,1029,971,11,10,7,14,3,58
39041021AEN,1523,1045,899,21,60,8,43,2,146
39049025AKC,1238,993,472,40,454,28,2,0,521
39153077BBH,884,711,629,9,47,4,20,0,82
39099050ALF,990,835,732,35,46,8,8,0,103
39061031AUR,743,558,188,4,362,0,4,1,370
39061031AFO,659,483,38,6,430,12,2,0,445
39035018AES,1164,936,876,15,5,4,26,2,60
39061031BHJ,1176,940,877,3,29,10,16,0,63
39061031AQK,1843,1349,451,53,812,25,20,1,898
39061031AQC,2124,1447,287,36,1056,37,38,3,1160
39061031AQO,2070,1472,399,86,947,6,37,0,1073
39061031AQI,1055,787,270,14,489,14,2,1,517
39061031BFP,254,183,167,2,3,0,11,0,16
39045023ABF,845,641,575,15,29,14,9,0,66
39017009ALK,955,716,576,27,36,16,50,0,140
39061031AYV,1447,1060,1000,9,13,8,22,1,60
39095048ASH,1208,941,879,39,10,8,3,0,62
39095048AGB,1303,963,232,56,657,16,18,0,731
39151076AGU,989,807,720,15,33,15,25,0,87
39093047AER,684,540,451,55,28,10,4,0,89
39049025AFT,1104,933,482,50,373,13,11,0,451
39049025AQO,945,699,612,17,8,6,53,0,87
39145073ADM,908,717,667,5,21,25,7,1,50
39007004ABA,957,657,418,108,94,29,4,0,239
39017009AIN,1099,823,649,17,43,16,93,1,174
39155078AFW,1413,1099,1037,4,20,23,2,1,62
39085043AEY,1527,1244,1130,21,35,20,20,0,114
39085043AAC,1535,1290,1233,6,16,19,7,0,57
39095048AGM,1318,1117,379,49,659,29,14,1,738
39165083AFL,1522,1123,789,35,51,14,237,0,334
39099050AOY,1271,1038,994,18,8,8,7,0,44
39099050AAF,782,622,410,116,95,7,0,0,212
39135068AAF,727,558,527,0,9,8,9,0,31
39035018DAS,913,769,183,10,554,5,13,0,586
39035018BXL,1159,1120,874,136,96,14,6,0,246
39043022ADJ,1082,887,783,26,37,12,26,0,104
39057029AAS,882,709,644,22,4,12,22,0,65
39057029ABF,874,687,632,11,9,11,23,0,55
39113057AUI,1643,1368,288,34,1040,23,7,0,1080
39087044ACX,800,597,585,0,1,4,0,1,12
39165083AAD,1434,1088,992,8,39,29,14,0,96
39151076AGF,724,694,611,9,70,3,0,0,83
39049025BDB,462,371,316,10,33,4,7,0,55
39153077AUY,1471,1159,914,18,155,4,56,0,245
39153077AUX,1239,997,861,14,67,6,46,0,136
39153077BBF,939,739,572,13,90,5,53,0,167
39035018ASL,870,701,43,23,637,14,3,0,658
39035018CFT,989,769,703,13,30,12,13,0,66
39061031ADT,1366,1145,987,31,47,12,59,1,158
39057029ABH,977,767,668,21,23,12,44,0,99
39061031BBB,1604,1168,691,41,336,31,58,4,477
39103052AFV,920,739,696,9,14,4,9,0,43
39061031AJV,1411,1230,721,39,251,12,191,0,509
39093047AHI,1080,858,596,32,176,20,30,0,262
39165083ABR,1088,899,753,52,32,12,54,0,146
39057029ADF,1089,890,774,38,41,23,10,2,116
39099050AIC,1194,1023,762,48,188,14,11,1,261
39087044ABR,597,455,444,1,2,4,1,0,11
39099050AHE,1306,1114,918,53,110,21,7,0,196
39109055ABZ,843,616,577,4,4,3,19,1,39
39049025AHL,1240,960,103,46,810,31,6,1,857
39107054ABT,1222,887,875,7,0,0,0,5,12
39049025AVJ,838,593,561,12,4,2,16,0,32
39025013ABK,1349,1039,979,12,3,24,9,0,60
39133067AED,1315,1094,1023,14,14,22,8,0,71
39133067ACZ,1295,974,892,12,23,23,10,1,82
39099050ASR,1454,1225,1096,7,64,18,17,2,129
39099050APA,585,478,457,8,4,6,1,0,21
39133067AFU,1124,896,846,8,12,21,5,0,50
39049025AIK,1344,885,104,85,663,17,25,0,781
39085043AIO,1314,1065,988,4,15,16,33,0,77
39049025AST,1290,974,840,24,66,6,24,1,134
39017009AAZ,1091,861,650,18,84,13,99,1,211
39113057ABX,1419,968,472,16,430,9,36,1,496
39085043ABW,960,770,707,9,6,19,23,0,63
39061031BKU,746,622,341,25,228,8,21,1,281
39035018BVW,1452,1210,1082,54,41,21,31,1,128
39035018BDB,1425,1146,832,159,134,18,14,6,314
39035018ACE,1190,986,262,6,697,11,14,0,724
39035018BOW,1266,951,345,22,556,9,10,0,606
39035018COD,1463,1129,1024,30,29,15,26,1,105
39101051AAT,708,551,511,16,8,9,0,1,40
39023012ACB,1351,1113,938,16,138,10,11,4,175
39155078AFV,1203,961,917,5,6,8,1,0,44
39087044ACN,645,510,471,5,8,12,10,1,39
39087044ADB,747,581,565,1,2,12,0,0,16
39165083AFR,732,563,523,10,9,4,10,2,40
39087044AAN,278,239,223,6,2,4,4,0,16
39087044ACZ,483,403,386,1,2,10,1,0,17
39061031AYY,1811,1272,1172,15,25,6,49,0,100
39061031AOS,1781,1386,1009,68,269,33,16,0,377
39061031BGX,1695,1243,1167,18,24,16,14,1,76
39061031BET,1044,841,774,1,34,20,8,0,67
39061031BCU,1327,1038,648,40,278,17,45,0,390
39061031BMU,1601,1338,993,181,63,16,80,1,345
39035018CEH,1467,1144,1033,47,26,5,27,0,111
39025013ABD,1557,1218,1139,10,25,28,8,0,79
39061031BNS,858,597,461,20,24,8,86,0,136
39041021AEP,957,673,615,10,2,6,28,0,58
39133067ABL,1085,1010,673,24,149,13,158,3,337
39113057AYM,1467,1188,912,31,83,21,146,0,276
39113057AOK,1054,793,721,9,32,22,8,0,72
39113057AHK,604,404,21,9,373,3,0,0,383
39061031BHN,1386,1035,994,7,4,15,8,0,41
39061031ASU,795,556,518,17,8,2,10,0,38
39061031ACG,1228,1067,618,46,343,17,53,0,449
39061031ANQ,1756,1364,132,29,1195,8,9,6,1232
39035018BXK,1351,1099,937,29,62,13,52,0,162
39035018DFI,1736,1423,1362,8,4,5,38,1,61
39007004AAE,748,570,445,46,51,9,5,1,125
39049025AIF,1837,1837,1613,66,117,1,29,3,224
39049025BKU,682,682,610,22,40,0,10,0,72
39049025BKV,2151,2148,1888,90,128,0,30,11,260
39025013AFU,1667,1416,1185,71,86,40,40,4,231
39085043ABD,1099,886,840,8,6,7,23,0,46
39151076AHF,915,714,641,13,15,7,26,0,73
39041021AET,1344,1089,997,17,34,13,24,4,92
39061031BCY,1296,888,424,44,361,15,51,2,464
39061031ASZ,1422,1015,907,18,25,6,56,1,108
39061031ANA,1493,1232,594,10,582,23,17,0,638
39061031BCI,822,651,588,1,41,14,6,2,63
39061031AZF,1647,1298,1120,39,48,22,55,1,178
39095048AJC,1498,1141,820,73,204,30,15,0,321
39057029ADR,954,757,626,31,34,16,34,1,131
39145073ACS,1124,915,874,3,7,26,0,0,41
39049025ANK,2464,1812,474,285,957,60,23,2,1338
39043022ACA,969,774,712,26,1,13,6,0,62
39023012ABX,934,792,643,22,97,15,18,0,149
39017009AKZ,1206,871,683,29,76,8,65,1,188
39165083AFE,908,700,573,10,22,15,79,2,127
39017009AFU,1048,870,726,22,49,28,30,0,144
39049025AXL,1319,966,507,121,307,12,28,1,459
39049025AAR,1178,1048,931,34,43,3,28,0,117
39049025AQE,947,680,359,109,134,22,38,0,321
39061031BKM,1200,770,113,12,611,3,21,5,657
39061031BKP,720,597,490,0,89,8,5,0,107
39165083AAP,1396,1026,951,24,15,15,13,0,75
39099050AKB,959,760,682,26,22,11,15,3,78
39035018AHL,1467,1221,1088,39,25,15,55,1,133
39035018ACW,1076,912,63,14,828,6,18,0,849
39035018ARO,824,699,74,72,560,7,2,1,625
39003002AFU,1088,820,705,23,48,20,15,0,115
39099050ATG,1101,830,784,6,7,9,20,2,46
39049025BHP,1316,983,713,101,94,26,51,3,270
39061031APW,1799,1418,822,90,452,26,22,0,596
39039020AAB,1142,934,810,79,36,2,8,2,124
39025013AGA,1805,1352,1225,37,17,23,41,1,127
39049025AOR,1501,1067,895,43,43,22,58,3,172
39035018CEX,1300,1135,977,31,74,9,47,0,158
39081041ABU,1025,861,783,13,30,21,13,2,78
39101051AAC,872,697,621,21,38,8,8,0,76
39035018ABX,1004,841,350,14,457,3,12,0,491
39057029ADS,823,688,538,19,56,15,60,2,150
39057029AFK,1056,775,632,20,91,12,17,2,143
39165083ABF,965,727,577,23,59,15,29,9,150
39153077AQT,1453,1036,665,16,195,3,157,0,371
39133067ACD,1156,867,714,24,78,26,7,3,153
39085043AET,1558,1252,1153,24,31,24,11,1,99
39061031BMJ,919,698,338,24,254,10,70,0,360
39061031BIV,1112,870,818,4,13,8,16,0,52
39061031AFG,992,789,81,5,680,6,16,4,708
39061031AZW,1822,1391,1240,30,47,36,28,1,151
39035018BEW,1230,904,445,126,303,12,28,2,459
39017009AHW,2031,1328,1287,14,2,20,3,0,41
39169085ABD,1369,1087,959,33,33,22,22,0,128
39041021AAK,1623,1188,1022,45,86,13,14,0,166
39061031AZQ,1281,1003,898,24,26,8,43,0,105
39049025AUI,1328,1018,740,28,172,16,65,1,278
39017009AIL,1191,893,729,27,71,12,62,1,164
39017009AAD,1154,931,572,45,271,17,21,0,359
39099050AID,1059,889,783,30,63,7,3,0,106
39099050ASS,999,814,754,29,15,6,0,3,60
39113057ASF,1554,1229,1021,67,71,38,20,1,208
39061031AAN,1405,1095,699,29,62,8,301,1,396
39061031AEN,1882,1487,1333,24,56,7,53,1,154
39061031BAA,1807,1332,1227,21,30,24,26,1,105
39153077BCF,1171,914,685,16,158,14,47,0,229
39061031BHZ,849,623,591,5,5,14,2,0,32
39035018ARX,751,554,4,1,542,10,1,0,550
39035018CLH,595,491,419,27,23,8,14,0,72
39057029AFB,1169,888,785,10,56,29,10,0,103
39035018DBM,1455,1235,1063,45,74,11,38,0,172
39025013AHY,1061,798,747,7,11,3,26,0,51
39055028AAJ,1336,1054,1002,10,15,8,13,0,52
39017009ALG,1433,1106,937,18,90,12,35,4,169
39155078AGA,804,685,660,3,14,4,2,0,25
39113057ACF,1042,777,545,35,145,24,35,3,232
39103052ADF,1009,821,788,5,8,1,10,0,33
39035018CVK,1589,1249,1077,29,65,11,57,0,172
39153077AUB,921,753,566,14,87,15,76,0,187
39103052ADZ,1666,1336,1281,18,1,14,7,3,55
39035018ADW,683,605,536,12,29,6,18,0,69
39035018ACQ,925,763,140,12,594,4,10,0,623
39005003AAA,1106,942,886,6,16,8,26,1,56
39025013AHL,1050,879,810,10,27,9,11,0,69
39085043ABM,986,817,774,4,4,8,13,0,43
39085043AFU,216,189,180,3,5,0,3,1,9
39165083AFP,1436,1003,732,35,36,4,185,1,271
39113057AXS,904,715,655,18,14,14,13,1,60
39049025ADD,1172,1148,879,116,84,12,46,1,269
39049025ASQ,1099,834,704,10,52,4,58,1,130
39055028ACP,875,666,608,22,3,3,18,3,58
39035018CVU,1763,1331,1177,18,31,14,80,0,154
39089045ABO,1422,1203,1111,9,48,20,16,0,92
39025013ABH,1747,1172,1024,48,38,49,7,0,148
39153077ATW,824,683,635,6,4,13,17,0,48
39143072ABR,954,810,768,24,5,9,4,0,42
39061031AIC,1685,1269,163,26,1062,12,14,0,1106
39099050AKZ,723,620,525,2,82,3,4,0,95
39035018CFZ,1292,1045,972,21,15,3,33,1,73
39057029ADO,1067,799,669,26,65,29,11,5,130
39035018BFA,1518,1081,491,248,260,18,82,3,590
39061031BBK,774,601,410,4,111,12,64,0,191
39041021ABG,1076,822,693,11,57,12,46,0,129
39085043ABC,1381,1086,1008,21,9,10,31,0,78
39061031BLI,401,322,110,10,199,4,2,1,212
39017009AGF,1433,1076,1012,16,9,18,6,0,64
39061031ABL,1576,1278,965,34,215,30,29,0,313
39017009AAI,838,654,471,23,78,9,69,2,183
39095048AOV,1017,778,578,55,116,16,13,0,200
39035018DEL,882,667,22,17,633,5,0,1,645
39035018CVO,959,818,725,13,24,14,34,0,93
39165083ABZ,1252,913,809,36,33,13,27,1,104
39099050AKA,1030,905,714,35,103,9,42,0,191
39093047AFP,1595,1074,328,403,359,24,5,2,746
39095048ABL,1109,914,805,35,41,12,16,1,109
39049025BDA,838,609,545,9,21,12,17,0,64
39061031AJW,1140,885,59,28,794,17,1,1,826
39055028ABE,1062,887,844,11,10,7,5,0,43
39017009AME,1235,954,760,13,78,11,92,1,194
39099050AOE,910,721,694,12,3,1,7,0,27
39061031BIL,911,643,588,8,29,6,1,0,55
39055028ACN,896,680,662,2,3,4,4,0,18
39049025ASM,1117,882,632,35,159,8,43,0,250
39055028ACT,1116,912,854,20,11,11,11,0,58
39061031BDO,8,8,8,0,0,0,0,0,0
39061031BBT,601,487,345,9,76,10,47,1,142
39061031BDA,1726,1323,789,36,383,21,91,0,534
39049025AWQ,808,599,525,15,26,15,18,0,74
39017009AEK,2067,1510,918,314,252,39,13,2,592
39057029AFL,1157,913,709,3,168,21,7,0,204
39061031AJQ,1109,907,140,11,744,6,12,0,767
39035018AHN,1704,1367,1116,78,53,32,76,2,251
39049025ARV,1057,768,635,19,20,17,71,1,133
39061031ABM,813,627,560,22,21,5,20,0,67
39061031ASI,976,748,646,11,5,7,71,0,102
39061031BAG,874,611,562,10,6,11,22,0,49
39025013ACV,972,683,615,11,19,16,15,0,68
39049025ASD,1327,1096,754,50,197,9,84,2,342
39151076AHE,1043,824,713,9,52,10,30,0,111
39035018CBY,2064,1823,797,55,708,13,272,0,1026
39099050AOG,978,787,737,21,2,7,16,1,50
39061031AFK,1198,901,32,35,829,10,5,0,869
39165083AGE,2287,1614,959,44,94,12,508,0,655
39007004ADS,667,496,445,17,19,16,2,0,51
39035018BYF,1251,1027,696,64,186,27,64,0,331
39061031BMK,151,128,26,0,97,2,1,0,102
39061031BHS,888,707,677,1,14,6,11,1,30
39061031ABH,915,715,555,19,120,16,5,0,160
39061031ASO,929,694,646,13,11,10,15,0,48
39093047AAP,996,750,701,17,10,10,13,0,49
39061031AST,1070,788,730,14,5,27,10,0,58
39061031AYU,1350,999,897,12,21,24,43,2,102
39061031ARR,1210,923,150,72,655,11,40,2,773
39061031BHP,1723,1456,1351,12,61,9,17,1,105
39025013AFH,1453,1175,1113,12,5,14,23,0,62
39103052ACB,1536,1065,1004,21,14,13,5,0,61
39061031AYP,996,704,611,2,75,2,9,0,93
39035018AFZ,1175,1004,447,187,325,15,38,0,557
39087044AAW,364,298,263,4,20,9,0,0,35
39035018AZB,579,519,215,5,231,4,62,0,304
39061031BHB,1656,1290,1203,11,16,27,30,0,87
39061031AMI,2928,1744,281,147,1285,21,20,3,1463
39035018CNR,939,804,290,28,431,6,53,0,514
39061031AWE,1072,866,731,13,90,21,9,2,135
39035018DEO,1317,953,19,10,925,6,6,0,934
39061031BEU,1014,812,764,6,12,14,11,0,48
39061031BAK,850,635,593,15,14,6,11,0,42
39153077AUZ,220,217,87,3,123,3,0,1,130
39061031AJS,809,740,447,9,236,8,34,0,293
