GEOID,TOTAL_POP,TOTAL_VAP,WHITE_VAP,HISPANIC_VAP,BLACK_VAP,NATIVE_VAP,ASIAN_VAP,PACIFIC_VAP,MINORITY_VAP
1705700LS02,386,315,295,2,3,10,2,1,20
17169000802,817,658,594,22,25,10,10,1,64
17169000803,577,454,417,7,11,10,6,1,37
1710300AL01,510,393,361,18,4,5,0,0,32
1705700DE01,232,188,186,0,1,1,0,0,2
1705700AS01,740,575,553,9,1,6,0,0,22
1705700AS02,508,393,389,3,0,1,0,0,4
17003000104,540,437,138,4,288,4,1,0,299
1705700PT02,862,693,659,4,4,19,3,0,34
1705700PT01,1105,909,878,0,7,17,5,1,31
17095000301,406,314,285,8,10,4,2,0,29
1705700LS06,636,510,501,4,0,5,0,0,9
1705700CA10,839,658,631,4,4,13,1,0,27
1705700CA01,731,562,522,9,12,11,4,1,40
1705700FA05,879,694,672,5,5,6,2,3,22
17129000005,561,443,427,0,1,12,3,1,16
17129000008,708,558,548,4,1,4,1,0,10
17129000006,845,655,622,4,6,15,2,1,33
1702100TL04,1859,1489,1406,12,14,24,7,0,83
1702100SF03,683,537,492,11,5,20,1,0,45
1702100TL05,2037,1615,1557,19,2,30,5,0,58
1702100TL03,1122,900,834,15,7,10,23,0,66
17169000501,136,101,95,1,0,2,0,0,6
1705700WD01,345,291,279,2,1,4,3,0,12
17141000008,1663,1241,1083,76,25,37,8,2,158
17141000007,1449,1117,1063,18,13,10,13,0,54
17141000006,1616,1085,996,41,9,19,14,0,89
17141000005,1763,1355,1215,51,22,44,13,1,140
1710300AM01,848,686,637,19,5,11,8,0,49
1710300AM02,931,729,660,32,19,11,5,0,69
1705700CA16,1085,877,851,10,5,2,8,0,26
1705700VT02,259,205,196,1,0,6,0,0,9
1705700VT01,435,333,318,7,1,5,0,0,15
1703700SH01,1344,1061,998,34,7,14,7,1,63
1703700FR01,2231,1701,1490,124,21,49,5,3,211
1703700CO04,773,575,462,33,42,10,20,2,113
1705100LO01,881,691,677,3,1,6,3,1,14
1705100BG01,553,442,430,2,0,4,3,0,12
1705100SF01,559,430,420,2,2,3,3,0,10
1705100ST01,466,358,342,3,1,8,4,0,16
17065000301,386,299,292,1,1,5,4,0,7
17003000301,420,352,195,6,138,10,0,0,157
1705100RA01,1665,1261,1214,11,5,31,2,1,47
17065000401,514,383,365,3,0,14,0,0,18
17091Arom04,1528,1237,1051,69,85,20,6,2,186
17091Arom02,1793,1476,1164,125,136,28,7,0,312
17093SE0901,1810,1268,1001,178,50,30,16,1,267
17093SE0903,2816,1782,991,392,291,53,75,2,791
17093SE0902,2029,1292,782,273,189,30,39,0,510
17093LI0104,1159,840,464,305,46,26,6,1,376
17093LI0107,891,708,520,136,18,23,10,1,188
17093LI0106,1052,791,475,286,14,11,4,0,316
17093LI0101,1182,911,596,257,27,38,12,1,315
17093LI0105,1001,778,478,252,15,24,5,2,300
17091Sumn01,837,651,588,40,0,20,0,0,63
17091Yell01,1206,957,824,93,4,19,5,2,133
17091Pilo02,897,686,645,6,5,15,4,1,41
17091Pilo01,1082,832,778,26,6,15,7,0,54
1705100SM01,482,376,368,1,1,4,2,0,8
1705100PO01,235,186,178,1,0,7,0,0,8
1702100JN01,798,618,569,6,3,23,7,0,49
1702100LT01,3137,3004,2059,700,221,4,18,0,945
1702100PN03,1182,911,880,11,3,13,6,0,31
1702100MT01,912,720,691,3,2,15,3,0,29
1702100RM01,345,275,267,0,2,2,2,1,8
1717500WGOS,557,450,435,6,1,5,1,0,15
1719700JO30,2571,1907,864,772,221,58,22,0,1043
1719700LO24,1636,1163,206,385,561,56,11,0,957
1719700LO19,1709,1484,1224,145,77,12,23,0,260
17095000402,591,482,457,5,8,5,1,0,25
1702500BBG1,330,250,240,1,0,2,2,0,10
17129000012,1111,821,771,14,7,20,6,0,50
17129000014,1290,975,903,20,11,24,13,0,72
17141000021,1042,752,433,289,7,19,13,0,319
17141000046,947,757,709,17,4,10,7,3,48
17141000050,936,796,762,18,2,10,3,0,34
1719700JO29,2637,1925,609,948,342,70,11,5,1316
1719700JA02,1937,1592,1402,108,39,23,12,1,190
1719700TR18,1976,1496,782,323,333,37,55,0,714
1719700TR19,2901,2130,785,596,630,31,88,2,1345
1719700TR16,1970,1684,1150,246,218,32,57,0,534
1719700TR17,2078,1620,1369,132,60,21,23,0,251
1719700TR10,2207,1682,1172,313,86,43,82,1,510
1719700TR11,2144,1797,1396,198,139,30,37,1,401
1719700TR21,2303,1591,1270,137,98,22,50,0,321
1719700JO36,1778,1328,299,368,641,42,9,1,1029
1719700JO34,1805,1343,312,429,577,36,11,0,1031
1719700PL33,1867,1502,1075,299,56,34,37,1,427
1719700HO10,2433,1828,1622,123,25,22,38,0,206
1719700HO13,2682,1920,1648,148,47,17,52,0,272
1719700HO01,2055,1601,1411,116,16,24,15,2,190
1719700JO27,1542,1064,244,542,271,40,10,2,820
1719700JO31,2200,1604,703,648,215,48,19,4,901
1719700JO33,2012,1553,848,520,152,49,10,1,705
1719700JO25,2080,1681,836,492,299,46,41,1,845
171670CA001,1518,1157,1099,19,4,25,3,1,58
171670WD005,1131,902,778,19,79,15,5,0,124
171670WD006,1275,1034,808,29,141,35,10,0,226
171670CP021,651,538,424,9,78,13,14,0,114
171670CP048,972,632,104,12,495,23,8,1,528
171670CP087,1429,1193,613,29,507,26,7,0,580
171670CP076,1289,945,395,23,499,17,16,2,550
171670CP083,807,602,299,17,268,13,6,0,303
171670CP084,1210,942,636,27,247,27,9,0,306
171670CP023,970,617,88,4,507,7,1,1,529
171670SP003,807,659,589,13,35,14,5,0,70
171670SP002,1193,919,730,18,145,22,10,1,189
171670SP001,1365,1051,781,16,207,30,12,0,270
171670CP026,743,560,434,12,88,21,11,0,126
171670CP051,1097,913,628,26,197,17,37,1,285
171670CP040,598,490,406,14,42,14,13,0,84
171670WD010,987,775,699,13,26,15,20,1,76
171670CP020,1577,1175,931,36,35,4,155,0,244
171670CP022,1458,1149,1058,20,26,7,33,0,91
171670BH001,178,140,132,0,0,3,2,0,8
171670CP031,684,538,451,6,48,6,21,0,87
171670AU004,1109,833,800,6,3,15,0,0,33
171670AU003,1326,963,874,15,13,43,5,2,89
171670AU005,1132,886,840,9,8,26,2,0,46
171670CL003,1396,1032,938,15,18,36,6,2,94
171670CL004,1061,822,764,12,13,14,13,0,58
1719700CR09,1890,1517,1083,159,228,32,24,1,434
1719700CR03,2608,2014,1177,337,455,54,10,0,837
1719700CR08,2156,1670,984,143,480,46,14,0,686
1719700CR01,2346,1812,603,127,1048,36,12,0,1209
1719700CR04,1915,1516,751,154,539,40,31,5,765
1719700CR06,1910,1555,855,146,532,24,20,0,700
1719700LO05,1950,1584,1408,105,11,36,16,0,176
1719700LO04,2392,1809,966,625,111,60,64,1,843
1719700WE01,2124,1738,1572,90,1,53,7,0,166
1719700PL21,1857,1399,1020,219,56,49,62,1,379
1719700PL32,1958,1495,1030,259,146,24,48,1,465
1719700LO03,3024,2221,937,1028,194,85,63,0,1284
1719700LO02,2980,2326,1218,710,228,50,147,0,1108
1719700LO17,1927,1536,1372,83,15,32,26,2,164
1719700LO11,2090,1709,1448,178,44,32,9,1,261
1719700LO12,2119,1696,1401,182,21,53,39,0,295
1719700FR11,3162,2150,1743,99,161,25,108,0,407
1719700DU33,2465,1935,1057,525,246,60,79,2,878
1719700DU32,3387,2491,1378,824,129,98,106,2,1113
1719700HO05,1501,1194,1050,76,19,10,45,0,144
1719700HO04,1983,1553,1353,101,7,25,67,1,200
1719700JA01,1961,1574,1330,154,53,21,9,1,244
1719700DU37,2655,2003,1117,734,84,85,29,1,886
17083000901,526,433,414,10,0,7,1,0,19
17141000013,1633,1250,732,447,57,46,6,1,518
17141000017,1566,1162,640,445,37,63,9,3,522
17141000037,1003,826,769,35,12,10,4,1,57
17141000002,959,774,721,26,5,16,3,0,53
17141000003,823,628,604,8,3,11,0,0,24
17093OS0305,847,638,390,204,30,19,4,1,248
17091Kank03,2473,1848,1034,214,555,40,17,2,814
17091Kank02,2950,2330,1252,335,688,44,14,2,1078
171670CP089,1197,1086,620,16,385,14,50,3,466
171670CP075,804,621,269,20,327,10,13,0,352
171670CP018,882,713,611,8,58,10,13,1,102
171670CP008,1161,882,672,24,161,20,9,0,210
171670AU001,1234,947,890,19,6,18,7,1,57
171670WI002,1169,888,859,6,4,11,6,0,29
171670BA002,1597,1138,1055,15,21,8,37,0,83
171670CP066,1449,1033,949,9,19,7,45,1,84
171670CP029,842,681,563,16,42,21,31,0,118
171670CP067,894,663,611,4,26,6,13,0,52
171670GA003,1016,799,746,11,23,5,3,0,53
171670CP016,1138,924,851,14,45,11,1,0,73
171670CP030,1244,1023,902,21,67,21,15,0,121
171670SP004,543,455,390,4,40,12,3,0,65
171670CP059,1003,824,699,12,82,7,18,1,125
171670CU001,721,570,529,0,18,7,12,0,41
171670CU002,845,671,641,8,11,16,4,1,30
171670CP090,1264,1035,898,30,46,10,48,0,137
171670CP069,1856,1553,1213,41,114,10,169,0,340
171670CP091,1482,1191,1089,32,33,8,30,0,102
171670CP063,1340,1128,986,6,43,15,72,0,142
171670GA001,1147,890,851,10,5,12,11,0,39
171670AU002,1156,869,811,18,7,20,3,0,58
171670DI001,828,674,653,2,2,13,0,0,21
1710300PM02,1033,827,771,19,4,3,19,0,56
17141000052,363,285,278,3,0,5,0,0,7
17133000005,645,525,497,12,8,6,1,0,28
17133000015,824,630,583,9,4,22,8,1,47
17133000022,983,809,773,7,1,15,7,0,36
17133000014,1019,765,734,6,2,7,7,0,31
17133000028,952,752,702,11,3,22,8,0,50
17133000021,907,730,696,6,3,12,3,3,34
17133000010,929,721,683,4,6,12,8,0,38
17133000030,1183,907,872,8,1,10,13,0,35
1705100BW01,412,306,305,0,1,0,0,0,1
17043004049,918,724,462,80,95,12,75,1,262
17043004048,1078,947,532,162,136,10,91,1,415
17043004093,791,612,474,33,30,7,56,2,138
17043004128,514,414,271,52,36,7,43,3,143
17043004002,767,629,401,55,40,14,130,1,228
17043004071,1667,1363,751,182,259,26,167,0,612
17043004054,1259,975,563,161,65,28,161,0,412
17043004028,794,621,490,50,21,8,45,0,131
17043004099,947,690,481,107,32,17,49,2,209
17043005009,651,475,405,32,11,3,22,1,70
17043005065,799,587,518,25,11,5,22,0,69
17043005023,1032,769,585,55,25,11,88,1,184
17043005003,1395,1224,962,74,48,8,132,4,262
17043005020,878,737,627,33,18,16,47,0,110
17043005127,659,457,396,15,8,11,24,0,61
17043009054,889,708,399,217,24,29,43,0,309
17043009094,1306,901,328,423,59,27,84,1,573
17043002089,829,651,475,106,27,21,39,1,176
17043002043,1005,793,559,126,32,16,70,0,234
17043002018,774,632,456,51,13,8,103,0,176
17043002009,1541,1137,505,288,59,19,280,3,632
17043005088,661,552,476,20,13,4,36,0,76
17043005099,523,417,362,20,5,3,26,0,55
17043005024,959,717,473,54,61,16,119,0,244
17043005081,967,672,498,43,41,10,73,3,174
17043005086,1241,1054,615,90,189,4,148,0,439
17043002082,1785,1420,615,280,135,26,360,2,805
17043002060,1293,1031,614,155,100,25,140,2,417
17043002053,1671,1264,485,242,133,15,384,0,779
17043007044,782,586,400,51,15,3,112,2,186
17043007030,887,692,551,51,9,6,68,5,141
17043003101,699,595,390,30,11,12,156,0,205
17043003153,630,514,331,41,23,4,125,1,183
17043003116,716,567,434,25,16,4,84,0,133
17043003024,1013,849,684,44,18,6,97,1,165
17043003152,670,529,382,90,14,6,38,0,147
17043003081,1571,1309,995,124,90,10,90,4,314
17043003135,792,677,442,29,30,4,175,2,235
17043003127,879,701,559,69,11,14,51,0,142
17043003048,773,583,521,29,6,1,23,0,62
17043003019,930,739,529,112,28,13,65,1,210
17043004022,1003,725,574,42,21,15,62,1,151
17043004030,1014,783,670,43,27,8,31,0,113
17043004020,993,765,641,47,33,8,33,0,124
17043004064,818,658,465,52,42,14,75,1,193
17169001201,570,468,453,4,5,8,1,1,15
17003000201,240,189,108,3,73,6,2,0,81
17133000009,892,721,700,7,0,8,0,0,21
17133000024,738,607,562,14,4,16,6,0,45
17133000008,815,693,642,17,16,10,8,2,51
17133000001,1510,1092,1018,15,20,5,14,1,74
1703700DK08,1539,1207,957,87,83,26,62,0,250
1703700DK03,1533,1196,819,175,74,39,97,2,377
1703700SY10,1388,1047,885,58,62,26,20,0,162
1703700SQ01,2717,2087,1901,101,18,27,16,4,186
171670IL001,1212,920,880,6,0,19,3,3,40
1703700MA01,1557,1180,1006,96,29,27,7,3,174
1703700DK21,1247,975,781,87,53,19,31,3,194
1703700SO01,2006,1519,1378,76,6,41,10,1,141
1702100AP01,1345,1051,984,13,15,17,12,2,67
1702100SF01,1186,961,916,3,8,24,0,0,45
1702100SF02,696,543,518,3,3,8,9,0,25
17201001005,1368,1036,762,126,81,14,53,0,274
17201001002,1396,1114,741,196,103,26,54,0,373
17201000202,2158,1538,758,309,371,49,54,1,780
1720100Rs05,1840,1345,1025,140,70,29,75,1,320
1720100Rt03,2785,2121,1523,349,148,65,16,2,598
1720100Ha21,1575,1273,1160,31,25,12,28,3,113
1720100Ha15,1713,1433,1271,49,27,17,41,5,162
1720100Ha04,1061,819,745,23,15,22,11,0,74
1720100Ha19,1038,854,778,26,13,23,3,1,76
1704500EL01,707,571,550,2,4,3,2,0,21
17091Arom01,1591,1220,732,209,260,12,12,0,488
17091Nort01,936,712,673,20,1,10,0,0,39
17091Lime04,1105,861,783,32,14,21,12,1,78
17091Lime01,921,741,685,19,7,14,2,0,56
17091Pemb02,931,756,69,96,583,15,1,0,687
17093OS0339,2121,1421,716,168,185,29,343,1,705
17093OS0337,1808,1335,694,168,294,17,157,1,641
17093OS0304,2161,1513,898,173,195,18,224,1,615
17093OS0325,1349,994,885,66,14,11,12,0,109
17093LI0801,771,604,553,40,4,2,3,0,51
17043005008,895,691,593,32,26,5,34,0,98
17043005032,1614,1504,1124,150,189,12,40,4,380
17043005091,721,567,527,2,6,10,21,0,40
17043002079,1318,1056,687,199,57,12,101,0,369
17043002054,696,569,414,72,14,18,60,0,155
17043002093,931,719,580,57,11,11,65,1,139
17043005037,1066,760,667,33,9,9,34,0,93
17043004009,1186,919,588,133,109,27,62,0,331
17043004032,1314,953,374,98,79,10,376,0,579
17043004078,749,576,389,22,5,8,144,0,187
17043004061,670,518,353,61,38,0,68,0,165
17043004112,1018,752,442,119,43,6,145,0,310
17043004107,753,554,422,18,7,7,99,0,132
17043003126,842,595,262,70,18,19,241,2,333
17043003144,956,738,548,41,12,6,135,1,190
17043003058,908,710,480,52,7,9,164,1,230
17043003041,1256,1006,810,91,39,16,58,0,196
17043003124,1109,854,563,73,20,9,182,5,291
17043002040,1316,986,355,387,106,24,119,4,631
17043002100,1151,880,436,231,117,16,87,1,444
17165000201,1064,826,726,4,64,16,5,0,100
17165000101,972,725,694,5,3,23,2,1,31
17165000404,1046,789,734,16,9,20,2,0,55
17165000406,614,508,474,10,1,15,1,0,34
17165000501,1106,846,811,6,6,18,5,2,35
17165001001,1083,871,836,9,6,15,4,0,35
17165000604,1036,818,714,8,48,25,12,0,104
17095001001,950,734,712,9,5,7,3,1,22
1702500PLX1,520,405,392,2,2,4,0,0,13
1702100PR01,425,330,320,0,5,4,0,0,10
1702100PN05,902,671,640,4,6,11,5,2,31
1702100MQ01,346,288,275,5,2,2,3,0,13
17115512001,751,558,536,6,0,10,4,0,22
1702100TL08,1301,1027,979,7,12,27,2,0,48
1702100TL06,1323,1034,981,20,7,11,13,4,53
1702500SON1,337,270,255,4,2,5,2,0,15
1719700JO37,1868,1443,622,261,542,37,6,0,821
1719700JO35,1938,1601,600,441,543,31,11,1,1001
1705100WH01,496,399,385,1,2,9,3,1,14
1705100KS01,517,391,382,3,0,4,1,0,9
17141000029,552,455,409,18,10,9,3,0,46
17141000009,962,730,621,64,24,12,7,1,109
1704500SY02,407,344,333,1,0,7,1,0,11
1704500SY01,541,442,432,0,1,6,0,0,10
17083000102,956,788,751,9,6,14,4,1,37
17185000010,1025,744,719,8,2,8,3,0,25
171670NB001,1609,1168,1107,10,8,23,10,2,61
171670CL002,1552,1132,1038,11,39,24,7,1,94
171670CP078,1092,867,650,24,158,25,7,0,217
171670CP064,1147,708,88,7,602,15,4,0,620
171670GA004,906,746,692,9,16,8,17,0,54
171670CP079,1049,743,228,23,487,11,4,0,515
171670CP068,1231,946,646,28,227,38,18,1,300
171670CP055,1013,851,744,34,45,3,22,1,107
1720100Ro52,1625,1312,1134,64,53,24,18,1,178
1720100Ch01,817,708,632,51,8,7,3,0,76
1720100Ch04,910,747,642,55,5,17,21,2,105
17201000209,928,812,708,56,18,10,11,0,104
1720100Rs02,1329,1020,952,17,12,4,21,0,68
1720100Rs14,951,693,619,7,12,15,32,2,74
1720100Rs08,1772,1236,1114,61,13,13,26,1,122
1720100Rs04,1201,891,799,32,21,25,16,0,92
1720100Ro01,563,466,419,23,16,7,4,0,47
17201000906,1699,1485,1129,132,180,24,21,0,356
17201000704,1666,1245,504,228,493,32,5,5,741
1720100Se01,839,656,629,14,1,9,1,0,27
1720100Ow03,626,533,471,11,31,11,3,0,62
1720100Ow02,976,822,730,29,29,13,13,0,92
1720100Ha02,2875,2169,1821,152,89,59,27,5,348
1720100Ro04,1800,1430,821,275,286,58,13,4,609
17201001303,1603,950,113,180,633,39,6,2,837
17201001301,1895,1116,177,154,776,30,6,1,939
1720100Ro02,1788,1421,1089,194,78,51,9,2,332
1720100Ro07,699,534,304,138,70,26,1,0,230
17141000022,727,535,511,7,2,9,1,0,24
17141000024,910,692,661,17,1,5,4,0,31
17141000033,482,401,389,5,2,2,2,0,12
17141000010,183,162,155,0,0,4,2,0,7
171670CP082,1359,1011,911,6,43,16,26,0,100
171670CT001,984,769,735,8,5,14,6,0,34
171670CP081,1493,1145,1010,17,62,41,12,1,135
171670TA001,161,127,117,4,1,4,0,0,10
171670CP100,1029,851,674,17,63,6,84,0,177
171670CP014,1966,1820,1179,178,290,64,126,14,641
171670CP037,1474,1235,1062,17,65,16,76,1,173
171670BA001,920,730,686,12,7,8,10,4,44
171670WD002,294,243,218,4,14,1,8,0,25
171670CP097,844,673,551,10,71,20,27,1,122
171670CP036,1001,805,690,18,66,14,13,0,115
171670CP098,946,749,619,16,41,20,46,0,130
171670CP099,1199,969,787,30,112,10,15,0,182
171670CP073,1153,866,339,16,496,19,7,2,527
171670PA001,880,692,649,7,2,21,8,1,43
1702100PN02,1936,1524,1472,13,6,15,13,3,52
1702500HRT4,929,701,647,16,8,17,14,3,54
17129000011,1094,865,819,12,9,19,4,0,46
17129000007,541,428,404,7,3,5,4,0,24
17129000010,839,697,664,1,9,12,1,0,33
17129000013,794,692,671,5,2,8,4,1,21
1702100KN01,198,152,143,1,1,3,0,0,9
17083000702,995,780,747,10,5,17,3,0,33
17083000701,1623,1269,1182,36,10,30,6,1,87
1703700CO06,2296,1551,1078,216,175,28,44,1,473
1703700CO07,889,677,608,54,7,8,5,0,69
1703700CO01,2482,1867,1410,316,68,54,20,1,457
1703700SY06,1356,1080,867,98,60,22,28,3,213
1703700SY03,1458,1141,1053,42,3,19,16,0,88
1703700SY07,1864,1325,1135,64,43,24,50,1,190
1703700SY11,974,691,602,28,6,19,35,0,89
1703700SY09,1899,1373,1224,73,24,30,28,4,149
1703700VI01,275,199,180,5,2,9,0,0,19
1703700PP01,345,270,261,3,1,3,1,0,9
1703700DK16,1557,1160,656,399,63,49,17,1,504
17201000305,1677,1493,855,135,466,32,16,2,638
17201000306,1847,1543,994,125,375,29,26,4,549
17201000505,1752,1202,238,502,442,27,16,4,964
17201000303,1826,1394,753,216,395,21,27,1,641
17201001102,2433,1715,700,307,537,47,164,2,1015
17201000703,1655,1183,483,226,447,45,6,0,700
17201000903,1624,1155,477,124,529,11,13,1,678
17201000301,1436,1109,883,83,77,17,54,0,226
17201000204,1645,1315,1028,122,113,18,34,1,287
1720100Du01,1284,964,923,9,11,17,5,0,41
17201000205,1703,1278,796,211,230,19,39,2,482
17201000206,1694,1289,889,182,154,48,16,1,400
17201001402,1338,1166,955,73,72,29,46,0,211
17201001403,1765,1396,962,173,98,18,142,0,434
17141000044,1009,826,776,22,7,14,2,1,50
17141000043,688,513,470,15,9,6,6,0,43
17141000047,970,782,746,12,2,15,5,1,36
17141000027,1098,875,802,27,8,11,14,0,73
1703700CO05,470,404,389,10,1,3,2,1,15
1703700AF01,901,719,619,39,36,16,9,0,100
1703700KI01,3492,2688,2329,222,34,78,20,3,359
1703700GE02,2919,2233,1718,425,23,44,23,0,515
1703700DK20,1174,940,751,118,61,25,10,0,189
1703700DK18,735,562,412,109,23,23,4,1,150
1703700SG01,447,353,322,18,6,7,1,1,31
1703700DK07,2058,1562,1029,333,103,60,47,4,533
1703700DK12,954,750,590,79,43,4,35,0,160
1703700SY05,970,790,705,41,18,14,8,0,85
1711100Gr10,898,665,586,35,11,7,16,0,79
1711100Nu11,824,619,533,24,6,12,29,1,86
1711100Al68,2006,1514,1119,91,56,13,227,0,395
1711100Al63,1933,1524,1170,108,42,19,173,0,354
1711100GW02,3345,2579,1438,834,167,65,90,3,1141
1711100Mc29,806,644,547,52,13,24,7,0,97
1711100He01,1471,1116,943,133,7,22,3,2,173
1711100Nu17,1686,1315,1139,97,6,25,37,1,176
1711100Nu20,1221,905,790,30,3,19,52,1,115
1711100Mc02,1108,892,791,67,5,9,18,0,101
1711100Bu01,1525,1216,1066,99,10,19,17,0,150
1711100Nu14,1523,1193,1000,66,25,9,84,2,193
1711100Al04,1257,972,812,73,12,24,41,0,160
1711100Nu01,1701,1386,1242,73,18,20,25,2,144
1711100Mc14,1824,1377,1083,172,38,11,51,2,294
1711100Mc32,1105,896,664,191,8,17,19,0,232
171670CP025,1374,1222,968,28,108,12,103,1,254
171670CP057,1046,867,719,17,84,19,15,1,148
171670CP093,1407,1147,837,29,187,18,80,2,310
171670PA002,1159,876,840,6,10,14,1,2,36
171670BA003,1476,1050,871,19,71,39,43,0,179
171670WD004,595,496,436,12,36,7,1,0,60
17149002202,476,364,345,1,0,16,0,0,19
17149001201,265,203,196,4,0,3,0,0,7
17149000801,967,744,712,6,9,13,2,2,32
17149001301,1386,1036,965,27,12,19,1,0,71
17119000802,445,365,341,7,0,10,4,0,24
1711700ST02,889,718,666,9,8,15,10,2,52
17119001318,1168,984,855,25,32,56,12,2,129
17119001315,1125,961,882,21,35,10,8,1,79
17119001325,964,781,665,46,25,17,12,2,116
17119001405,853,689,540,24,84,27,11,0,149
17119001415,1492,1288,1009,15,142,6,105,0,279
17119001408,1664,1284,1022,26,163,21,49,1,262
17119001414,941,766,666,14,62,6,17,0,100
17119001913,970,777,717,18,6,17,1,0,60
17119000801,1251,1009,934,21,4,33,10,0,75
17049000203,1095,818,777,14,4,16,3,0,41
17049000201,1277,953,910,9,1,22,5,0,43
17049001501,1194,891,866,6,1,10,6,0,25
17139000401,665,505,469,8,8,18,5,0,36
17139000402,892,662,640,5,3,14,1,0,22
17139000602,910,693,666,4,1,13,2,0,27
17011004001,880,682,642,15,9,14,1,1,40
17011004002,717,559,547,5,1,3,0,0,12
17139000101,712,551,518,3,8,18,0,0,33
17139000704,705,604,586,7,0,1,2,0,18
17011024001,142,122,119,0,0,3,0,0,3
17011017001,873,680,643,12,3,13,2,0,37
1704500PA10,881,692,657,8,4,9,1,0,35
1704500PA09,548,421,399,4,1,9,2,0,22
1704500EM01,573,434,419,4,3,5,0,0,15
1704500ED01,452,346,345,0,0,0,0,0,1
17119000702,585,459,391,50,2,12,0,0,68
17119002302,1384,1022,751,24,169,30,33,3,271
17119001917,1255,954,897,17,16,19,3,1,57
17119001909,1436,1177,964,30,107,45,12,2,213
17119002005,681,576,509,20,19,17,5,1,67
17119001404,1392,1083,896,45,102,17,21,3,187
17119000904,1612,1191,1077,32,12,32,21,1,114
17119001326,634,536,463,12,27,6,16,0,73
171670RO003,1076,811,773,14,6,16,2,0,38
171670CP095,1424,1060,951,19,30,23,15,1,109
17185000006,1238,921,864,7,8,27,12,4,57
17185000014,610,478,463,2,0,10,0,0,15
17185000004,469,352,326,12,2,11,2,1,26
17201000602,1826,1426,877,397,78,54,43,0,549
17201000806,2424,1675,735,419,417,43,79,0,940
1720100Ro56,1621,1281,1075,103,47,38,22,0,206
17201000107,1492,1265,990,77,98,21,69,4,275
17201000106,1707,1372,962,149,119,12,130,0,410
1720100Ro13,1737,1507,1172,138,103,24,74,1,335
17119002406,1648,1391,1166,27,165,22,14,2,225
17119001805,1274,1057,898,55,50,31,17,2,159
17119002225,1010,829,708,35,54,11,18,0,121
17119000501,1495,1103,1037,12,9,28,8,2,66
17119001312,1384,1099,951,20,84,14,19,5,148
17119001330,1038,900,642,44,158,25,20,0,258
17119001704,1002,704,338,328,13,40,0,3,366
17119001702,620,499,288,37,159,9,6,0,211
17119001313,747,567,344,100,96,18,7,1,223
17119001902,409,321,303,2,7,9,0,1,18
17119001907,1218,958,855,13,47,23,11,2,103
17119001802,981,729,673,12,14,22,2,1,56
17119001803,779,623,583,10,7,10,11,0,40
17119000601,1094,848,782,22,9,22,5,0,66
17119000602,1153,888,832,10,4,28,6,3,56
17119000502,1415,1117,1005,35,13,38,12,0,112
17119001903,944,747,636,21,57,30,5,1,111
17011017002,550,433,411,8,0,4,5,0,22
17139000703,1314,1007,951,13,6,18,9,0,56
17011013005,518,402,377,15,0,3,6,0,25
17011006001,379,261,251,3,1,3,2,0,10
17011002002,213,164,153,4,0,5,1,0,11
17095000701,530,415,396,1,12,7,1,1,19
17095001301,1118,902,867,10,6,8,5,1,35
17095000003,1069,884,778,38,57,10,5,2,106
17095000401,545,455,426,12,4,11,3,1,29
17095000001,1101,982,889,33,33,13,11,0,93
17095000805,763,617,562,21,6,14,13,1,55
17095001201,379,318,307,1,0,3,0,0,11
17095001101,450,387,368,5,2,12,1,0,19
17149001601,219,176,170,0,0,4,0,1,6
17149001202,250,195,182,4,3,4,0,2,13
17149000701,564,453,427,7,1,7,0,1,26
17149000702,746,552,527,9,5,3,3,1,25
17073000501,447,336,322,6,3,2,0,1,14
17093FO0401,806,612,543,38,6,20,4,0,69
17093FO0402,875,666,632,23,3,8,0,1,34
1709900MS01,2909,2615,1350,239,993,33,6,0,1265
17149000101,124,98,96,0,0,1,0,1,2
17009000902,295,227,220,2,2,3,0,1,7
17149001303,1255,1032,942,37,22,15,11,2,90
17149001304,802,626,595,9,0,17,3,0,31
17073000802,1408,1079,978,36,15,32,15,2,101
1706300AS04,2966,2028,1571,339,56,45,29,2,457
1706300AS05,2781,1829,1390,283,80,28,37,3,439
1706300GA01,1454,1154,1052,63,5,18,10,0,102
1720300CZ01,488,363,337,0,8,10,3,1,26
1720300CZ02,604,449,427,4,6,9,4,0,22
1720300CZ03,584,450,422,8,2,7,0,1,28
1720300KS01,441,373,358,3,1,10,2,0,15
1720300ME03,1011,718,680,6,6,10,7,0,38
1720300EP02,628,503,492,2,4,4,0,0,11
1720300ME05,843,644,618,8,7,7,0,2,26
1720300WO04,937,720,658,13,8,14,25,0,62
1720300WO05,1029,757,695,18,8,13,15,1,62
1720300WO06,956,702,640,20,10,19,12,0,62
1720300OL02,1340,1072,936,40,52,25,26,2,136
1720300MT01,1062,718,697,4,3,7,4,0,21
1720300WO01,887,635,600,14,8,5,7,1,35
1720300WO02,679,515,484,5,10,2,5,0,31
17165000202,1244,990,829,19,110,24,1,2,161
17095000004,976,767,667,36,46,10,11,0,100
17095000006,923,697,553,62,59,19,5,1,144
17095000014,1769,1353,1080,81,142,35,20,0,273
1704500PA06,515,409,395,3,4,5,2,0,14
1704500RS02,688,554,527,0,4,18,2,0,27
1704500PA01,774,624,589,13,3,11,4,0,35
1704500PA14,838,668,629,8,10,12,9,0,39
1704500PA15,510,435,420,8,1,4,4,0,15
1706300AS03,1378,1022,832,103,29,25,26,1,190
1706300ER02,842,678,614,27,6,9,15,1,64
17073001601,763,593,557,14,7,11,3,1,36
17073001103,1220,915,837,28,9,23,11,0,78
17073001101,1005,753,722,13,1,4,3,0,31
17073001102,749,567,533,11,6,17,0,1,34
17019TO2000,2521,2015,1505,81,136,16,220,50,510
17019CRI000,337,269,256,2,5,4,0,0,13
1702100MA01,1760,1389,1348,0,1,18,10,0,41
1702500LOU2,728,561,543,7,1,10,0,1,18
1702500LOU1,940,732,689,16,5,14,0,0,43
17129000004,1026,756,725,5,6,11,7,0,31
17129000003,1189,848,778,12,17,32,1,1,70
1702100BC01,516,387,369,1,3,11,0,0,18
17131000302,607,451,408,15,9,10,4,1,43
17131000301,1042,827,794,18,0,10,2,1,33
17133000002,996,699,656,17,4,13,1,0,43
17133000037,855,692,633,16,6,23,11,1,59
17133000023,974,771,727,8,3,18,4,0,44
17133000013,698,560,522,5,1,20,5,0,38
17133000036,877,689,645,16,8,12,1,0,44
17133000003,842,618,600,8,0,6,3,0,18
17133000035,991,731,675,19,4,20,5,1,56
17133000025,759,569,547,8,0,8,6,0,22
17133000020,1233,932,893,6,6,15,7,1,39
17133000004,813,619,575,14,7,13,6,1,44
1706300VN01,666,494,450,34,2,8,10,0,44
1706300GD01,353,293,256,19,4,0,13,1,37
1706300MR02,1671,1343,1034,195,50,19,33,1,309
1706300ER01,1566,1289,1183,55,9,26,19,0,106
1706300SA05,921,690,612,46,9,15,5,1,78
1706300SA02,1082,853,669,141,20,20,8,0,184
1706300BR01,2161,1500,1324,110,8,38,17,0,176
17131000401,637,498,471,12,4,11,0,0,27
17131000805,746,600,565,16,3,9,5,0,35
17131000806,387,314,301,3,4,7,2,1,13
1705700OR01,1145,935,909,4,1,13,9,0,26
1704500PA04,431,335,309,4,17,4,1,0,26
1704500PA03,732,595,562,13,1,10,8,0,33
1720300MN02,947,763,735,2,2,13,1,1,28
1720300RK01,473,376,363,4,2,7,0,1,13
1720300GR01,474,350,346,1,1,2,0,0,4
1720300LN01,265,199,189,1,2,6,0,0,10
1720300PN01,375,270,251,6,3,5,2,0,19
1702500HOS1,362,286,270,1,2,9,2,0,16
1702500CLA1,1166,905,882,2,2,14,3,2,23
17011012001,152,116,110,5,0,1,0,0,6
17011015001,916,749,708,13,8,6,6,0,41
17011015009,1020,834,794,12,13,2,8,1,40
17011015006,1197,1045,974,27,7,11,20,3,71
1703700SY02,1426,1071,911,59,51,13,30,0,160
17131001301,644,514,491,5,4,8,0,0,23
17011015003,1186,914,811,39,10,27,19,6,103
17139000301,1008,637,623,8,1,2,0,0,14
17011015002,1044,865,808,21,13,10,12,0,57
17011016001,704,532,505,6,4,13,3,0,27
17011015007,1055,811,719,38,8,24,24,0,92
17011015004,1052,849,760,47,12,18,8,0,89
17139000601,722,536,497,7,2,26,0,0,39
17011018001,477,395,375,4,7,6,0,0,20
17011001001,410,329,310,10,2,0,2,0,19
17011022001,196,146,138,4,2,0,1,0,8
17003000102,257,230,74,4,151,0,0,0,156
1720300RK03,907,689,660,11,8,6,2,2,29
1720300RK02,1029,761,749,4,3,4,0,0,12
1720300OL03,1186,889,851,4,11,8,5,0,38
1720300CR02,732,534,520,0,2,5,3,0,14
1720300PL01,1163,827,799,12,2,8,3,0,28
1720300OL04,983,702,664,11,6,13,1,0,38
17091Kank04,2570,2088,1483,201,342,38,12,2,605
17091Kank06,1229,903,608,114,158,17,10,2,295
1706300HL01,256,196,183,9,3,4,0,0,13
1706300BR02,1285,1026,949,29,12,30,2,1,77
1706300GR01,991,793,761,17,1,8,0,0,32
1706300AS07,2121,1504,1238,177,50,24,21,3,266
1706300MA01,293,229,212,8,3,4,3,0,17
1706300AS06,2744,1813,1463,188,69,48,39,6,350
1704500RS01,821,668,627,10,7,13,3,1,41
17095000002,1057,837,707,40,61,30,8,0,130
17095000016,1343,1095,964,57,40,22,14,0,131
17095000804,769,555,520,12,8,13,6,1,35
17095002001,282,229,218,6,3,1,1,0,11
1719700WH22,2822,1972,685,187,241,19,849,2,1287
1719700WH19,1765,1309,601,125,181,6,401,2,708
1719700DU14,2135,1722,759,292,324,17,333,2,963
1719700DU09,1644,1288,556,174,265,15,278,2,732
1719700JO15,3579,2453,521,1680,230,118,13,2,1932
1719700JO07,1978,1346,203,493,651,34,5,1,1143
1719700JO14,3498,2496,104,2246,137,136,8,3,2392
1719700DU24,1700,1377,658,252,324,37,133,1,719
1719700DU16,2275,1716,747,370,348,40,232,1,969
1719700DU23,3064,2278,726,352,503,36,675,2,1552
1719700DU15,1895,1449,714,253,307,17,162,0,735
1719700CH03,2104,1623,1424,115,15,43,17,0,199
1719700CH02,2360,1857,1644,112,24,29,23,1,213
1719700WH14,2232,1556,1080,64,43,6,343,1,476
17073002502,995,824,748,39,23,7,9,0,76
17073002009,1308,967,589,146,209,14,5,0,378
17131001001,365,293,285,3,0,4,1,1,8
17031820026,2182,1657,992,171,36,8,465,5,665
17031820058,2144,1797,995,118,58,19,617,3,802
1706300MZ01,1503,1070,998,44,5,14,1,0,72
17131001501,382,298,291,4,1,2,1,0,7
17131001401,1179,933,882,17,0,26,0,0,51
17131000802,811,600,588,1,3,1,5,0,12
1719700NL15,2138,1598,1497,56,11,4,20,0,101
1719700FR12,1526,1249,1149,36,10,20,29,0,100
1719700FR13,1601,1275,1154,53,31,14,28,1,121
1719700PL02,2568,1769,1162,233,155,36,197,1,607
1719700HO17,2153,1685,1488,87,39,13,49,1,197
17031860059,1214,973,833,62,25,7,49,1,140
1719700FR22,1698,1447,1243,48,113,8,26,0,204
1719700FR16,2468,1863,1463,116,138,31,108,1,400
17149001401,360,281,274,0,0,5,2,0,7
1710300DX19,1128,892,824,27,18,12,10,1,68
1710300NA01,480,361,327,21,4,6,3,0,34
1710300AS02,521,382,335,15,14,9,2,0,47
1719700JO13,3271,2325,156,1853,307,100,6,3,2169
1719700PE02,2235,1770,1575,97,36,46,14,1,195
1719700WL01,1793,1452,1231,135,26,26,19,2,221
1719700PE01,2130,1670,1493,107,18,30,14,1,177
1719700WH26,2814,2216,1689,160,168,27,179,0,527
17011008001,659,539,498,25,8,6,0,0,41
17011013009,837,673,569,79,3,12,1,0,104
17011013004,558,435,395,22,3,6,3,0,40
1706300BR03,1515,1140,1044,48,5,26,2,0,96
1706300FE01,1257,987,894,57,3,9,9,1,93
17149001501,1205,876,833,14,4,17,2,1,43
1719700WI01,2145,1716,1546,72,23,55,8,3,170
1719700WI03,1988,1527,1387,65,9,40,10,3,140
1719700WI02,1825,1563,1398,73,49,26,15,4,165
1719700LO23,1800,1380,821,410,114,26,15,1,559
1719700LO15,4789,4242,1079,927,2123,39,145,2,3163
1719700DU28,3484,2537,600,1172,510,70,224,9,1937
1719700DU22,2920,2195,814,887,325,66,167,5,1381
1719700PL28,2432,1789,1106,382,199,32,80,4,683
1719700PL35,2118,1524,960,276,222,28,47,3,564
1719700LO09,3071,2644,1750,417,342,31,124,2,894
1719700LO01,2079,1957,1739,79,81,16,45,6,218
1719700LO10,2265,1755,1505,179,14,35,16,0,250
1719700LO16,2448,1928,1561,221,60,48,29,1,367
17043009061,1047,703,599,43,10,7,40,0,104
17043003091,915,763,515,60,68,3,119,1,248
17043003150,1365,1059,523,172,239,5,117,0,536
17043003104,616,466,376,29,24,9,34,1,90
17043006043,3605,2556,666,109,256,17,1502,5,1890
17043006065,1752,1321,514,252,253,12,281,1,807
17043006068,931,713,389,129,103,17,93,1,324
17043006085,1194,880,336,63,115,14,341,0,544
17043006090,1183,891,313,86,143,5,337,0,578
17043008032,2025,1361,125,1103,76,68,60,2,1236
17043008003,1418,1019,288,645,49,63,17,2,731
17043002090,1003,733,305,37,9,8,379,1,428
17043002034,1148,974,632,162,70,17,106,0,342
17043002072,556,492,294,60,36,10,96,2,198
17043002057,1778,1500,504,436,374,19,171,0,996
17043002059,772,605,438,49,21,1,94,0,167
17043002087,932,713,343,57,42,11,272,2,370
17043002074,755,612,428,37,21,2,126,0,184
17043002065,1237,1018,624,106,36,21,237,3,394
17043006078,1313,896,292,72,119,6,411,2,604
17043006055,970,690,376,58,43,5,214,2,314
17043006063,1071,755,221,53,51,5,411,7,534
17043006049,667,498,302,12,11,1,174,0,196
17043006070,1088,774,454,52,50,15,212,0,320
17043003017,1030,703,648,24,2,3,22,1,55
17043003003,1142,922,778,21,12,6,95,1,144
17043009111,1864,1649,957,139,195,24,341,2,692
17043009064,804,658,496,29,16,2,110,0,162
17043009093,752,709,411,45,35,1,217,1,298
17043009131,519,504,386,17,18,3,84,1,118
17043004034,783,625,552,30,14,11,18,0,73
17043004015,1091,876,745,58,14,15,47,0,131
17043003117,866,664,486,79,27,20,63,1,178
17043003060,1016,859,638,68,37,4,117,2,221
17043003062,656,513,406,66,14,12,15,3,107
1719700WH08,1851,1375,1037,69,26,12,217,1,338
1719700WH06,1842,1341,1052,68,50,29,140,0,289
1719700WH07,1861,1367,1000,56,36,5,267,4,367
1719700JO19,2289,1740,1046,408,235,22,28,1,694
1719700JO12,3263,2336,595,1417,302,65,30,8,1741
1719700DU08,2243,1686,578,363,596,29,147,0,1108
1719700DU05,1623,1298,743,230,204,19,112,0,555
1719700DU04,1953,1548,922,117,232,11,255,0,626
1719700FR03,2315,1771,1376,106,98,19,165,1,395
1719700FR14,2042,1609,1374,132,39,18,34,0,235
1719700TR13,2610,2186,1859,148,107,18,50,1,327
1719700TR15,2011,1595,1270,177,96,13,45,1,325
1719700TR07,3466,2524,1560,482,306,30,143,6,964
1719700TR01,4279,2917,1520,835,426,119,98,6,1397
1719700TR14,1679,1356,1187,88,39,9,19,0,169
1718300DC15,1158,872,413,70,366,31,8,2,459
1718300DC21,1187,898,609,52,222,18,5,0,289
1718300DN01,885,710,632,26,18,13,7,0,78
1718300VA01,1001,777,755,4,2,10,3,0,22
1718300GT05,1013,782,733,13,12,17,6,0,49
1718300DC24,977,732,381,25,303,11,12,0,351
1718300GT03,1038,774,720,7,22,16,5,0,54
1706300GL02,957,790,723,26,5,14,5,2,67
1706300MR03,1327,1022,800,161,15,17,17,0,222
1706300MR01,1414,1085,894,132,12,17,11,0,191
17081001301,1087,844,768,12,20,35,11,2,76
17081001502,668,527,495,1,2,24,1,0,32
17049001105,893,690,626,23,14,13,12,0,64
17049001107,917,721,667,18,5,18,12,2,54
17049001109,834,646,589,21,17,9,8,1,57
17049000501,1275,1013,958,8,7,17,8,0,55
17119001417,1737,1194,1064,22,62,25,24,7,130
17119002208,815,584,475,35,48,13,2,0,109
17119002209,728,599,454,67,52,14,3,2,145
17119002210,627,486,319,67,80,5,5,0,167
17119002102,612,438,238,15,156,12,9,0,200
17011013003,1202,998,833,128,16,11,10,0,165
17139000705,790,604,557,11,15,14,1,1,47
17011023001,658,535,487,18,7,13,7,0,48
17149000601,522,424,403,0,3,14,2,2,21
17073001501,1143,865,812,23,5,4,15,1,53
17073000801,1439,1135,1060,31,9,19,9,0,75
17043001023,1042,838,608,142,16,12,62,1,230
17043001046,1300,1028,851,105,28,9,30,0,177
17043001018,1025,876,672,90,7,8,100,0,204
17043001061,779,655,512,86,7,9,45,3,143
17043001054,935,740,521,71,8,9,130,0,219
1719700JO10,1821,1416,899,408,77,36,12,1,517
1719700JO11,2603,1932,799,822,254,49,43,0,1133
1719700FL01,922,725,664,43,4,14,1,1,61
1719700TR09,1829,1425,904,293,189,20,31,2,521
1719700TR05,1675,1435,1126,154,103,26,24,0,309
17127000011,298,227,215,2,2,8,0,0,12
17127000010,460,347,326,2,10,2,2,0,21
17127000006,752,592,508,5,51,19,3,0,84
17127000009,905,748,674,22,14,29,4,1,74
17091Kank11,3657,2774,1174,654,889,50,28,3,1600
1719700PL31,2215,1635,1138,322,103,34,53,0,497
1719700LO18,2389,1850,1434,242,98,9,45,0,416
1719700JO05,2526,2004,364,435,1197,42,13,2,1640
17081001401,813,598,569,1,15,11,0,0,29
17081001405,1295,1136,1002,11,54,17,39,2,134
17081001601,1128,847,803,9,3,15,8,0,44
17165000601,813,609,513,22,45,12,13,1,96
17127000007,982,733,631,10,62,19,3,1,102
17019CH4000,4242,3163,1947,126,269,27,778,2,1216
17019SOM000,988,792,627,32,73,31,22,2,165
17019CC0600,5101,3806,1512,673,1172,118,429,5,2294
17019CC1200,1836,1673,1151,105,202,31,171,4,522
17019CC0100,2266,1683,202,180,891,36,403,2,1481
1718300DC23,1107,750,346,39,348,10,15,0,404
1718300DC08,620,473,276,46,115,19,17,1,197
1718300DC11,3260,2742,992,382,1318,25,22,0,1750
1718300DN10,664,585,489,16,57,14,4,4,96
1718300DN04,686,575,546,5,8,8,3,0,29
17019BFO000,295,217,204,4,0,5,2,1,13
17019CC3400,4379,3268,1876,176,669,44,499,2,1392
17019HEN000,1033,791,550,61,157,12,9,0,241
17019CC1700,4205,3228,1440,324,814,71,584,9,1788
17019COL000,219,174,156,4,1,5,7,1,18
17019CC2500,963,785,641,39,50,12,30,0,144
17019CC3800,2368,1783,1192,61,106,9,365,2,591
17019CC3900,2405,1943,1275,135,196,11,316,1,668
17019CH2000,2551,1861,1246,61,131,10,393,4,615
17019CC3300,1869,1443,1108,48,132,19,145,0,335
17019CH5000,2456,1872,1396,62,154,31,220,0,476
1720300EP03,1038,759,693,14,14,27,8,1,66
1720300EL04,895,678,634,12,18,12,4,0,44
1719700TR12,2094,1647,1021,333,244,41,24,0,626
1719700TR02,2951,2174,1133,564,368,38,104,1,1041
1719700JO16,2410,1727,464,648,601,38,22,1,1263
1719700WH34,3635,2496,1334,350,273,44,495,4,1162
1719700WH33,2853,2008,978,326,313,44,372,0,1030
1719700WH31,2359,1643,889,209,246,18,303,3,754
1719700WH02,2636,2210,1563,66,80,19,484,3,647
1719700WH32,2905,1971,962,232,205,21,558,3,1009
1719700WH11,5172,3314,1214,137,171,19,1751,5,2100
1719700WH12,2465,1709,769,61,107,5,763,4,940
17093OS0338,2013,1447,915,133,140,15,239,2,532
1719700WH01,3918,2729,1723,261,248,18,473,4,1006
1719700DU13,3293,2745,1231,485,619,42,386,5,1514
1719700DU12,2038,1583,672,481,317,32,96,1,911
1719700DU29,2548,1729,823,279,323,22,299,4,906
17043004059,1020,791,595,30,17,2,147,0,196
17043004077,1656,1304,689,107,141,9,353,2,615
17043006091,1194,961,471,73,90,6,317,1,490
17043006021,1274,991,528,86,66,15,300,2,463
17043006057,1185,880,390,87,73,12,322,0,490
17043006036,838,637,462,21,24,5,115,0,175
17043006066,966,753,594,34,19,5,93,0,159
17043005082,627,460,406,17,7,3,26,0,54
17043005074,769,626,503,33,32,8,35,0,123
17043005085,830,640,534,18,25,9,44,0,106
17043005130,555,387,351,10,2,1,21,0,36
17043002066,692,590,522,29,11,5,24,0,68
17043002013,899,689,599,44,6,6,30,1,90
17043007004,1103,874,568,99,27,8,167,2,306
17043007015,1252,932,423,167,76,21,247,0,509
17043007053,1257,989,573,142,25,15,234,2,416
17043007021,842,677,481,38,18,2,133,0,196
17043008006,578,447,400,36,1,1,6,0,47
17043008041,837,596,217,358,16,16,3,0,379
17043008012,1602,1237,583,580,19,56,31,1,654
17127000013,881,678,602,7,36,26,0,0,76
1710300DX20,3331,3119,1298,449,1338,16,25,1,1821
1710300SD01,982,782,724,22,14,10,14,1,58
17165000401,1188,932,885,10,15,21,2,0,47
17165000405,1093,868,821,13,3,15,2,0,47
17165001201,373,277,268,3,2,3,2,0,9
1719700PL04,1502,1024,481,259,222,21,59,1,543
1719700JO24,2205,1627,641,499,446,53,20,1,986
1719700PL34,1816,1345,837,262,200,39,31,0,508
17083000408,336,271,254,6,0,6,2,0,17
17073002401,933,752,720,16,4,6,5,0,32
17073002402,684,537,490,17,7,7,4,4,47
17073002001,724,563,447,77,22,16,1,0,116
17073002002,1036,801,662,93,34,8,1,0,139
17073000401,244,190,184,2,1,0,0,0,6
17073000201,1205,930,889,26,4,9,4,0,41
17073000901,1246,998,949,29,8,3,2,1,49
17073000806,1068,798,767,10,6,5,6,2,31
1711100Nu24,1570,1255,1085,111,9,25,20,2,170
1711100Al02,1156,906,750,118,8,19,11,0,156
17043002007,956,738,502,85,10,5,132,0,236
17043001064,1093,915,647,30,10,8,219,0,268
17043001022,1076,770,579,53,12,2,116,0,191
17043005030,1039,775,541,65,41,12,129,3,234
17043005119,509,409,254,38,18,7,97,0,155
17043009035,1177,869,718,57,14,15,53,0,151
17043009004,1726,1508,1105,210,108,7,57,4,403
17043009006,947,804,743,32,11,3,15,0,61
17043009015,1297,1046,856,70,22,9,78,0,190
17043009041,723,526,461,23,6,5,26,0,65
17073002101,1176,927,880,16,7,11,3,0,47
17073002201,847,672,642,9,7,11,1,0,30
17073000601,1694,1301,1194,50,10,28,6,0,107
17073000604,1047,839,743,52,14,25,3,0,96
17073000605,1555,1181,1056,84,12,20,7,0,125
17065000803,1129,896,849,11,10,17,6,0,47
17065000802,929,732,687,9,15,21,3,2,45
17065000801,819,617,589,8,8,11,4,2,28
17131000801,791,598,568,14,7,4,6,0,30
17043009019,716,572,449,58,16,7,41,1,123
17043003143,510,403,280,26,8,7,86,0,123
17043003066,868,712,560,49,10,5,92,2,152
17043003070,569,502,445,24,1,1,32,0,57
17043003103,906,662,382,32,12,5,230,1,280
17043004122,722,589,395,61,56,5,68,0,194
17043004036,949,763,602,62,52,7,40,1,161
17043009057,982,788,708,41,6,7,27,0,80
17043009080,1068,825,713,56,12,13,29,1,112
17043009051,1262,989,814,112,11,11,27,0,175
17043009087,1173,878,530,243,48,27,46,1,348
17043009067,1278,958,575,268,65,31,44,0,383
17043002050,1592,1208,320,296,89,40,487,1,888
17043002095,788,599,200,100,19,8,273,3,399
17043002022,1436,1118,343,166,46,20,566,2,775
17043002097,870,683,206,231,78,9,167,0,477
17043002042,1102,855,387,166,39,18,255,0,468
17043001030,826,664,449,119,21,9,64,0,215
17043001069,1070,857,406,204,79,17,164,1,451
17043001040,1070,822,518,119,12,18,168,1,304
17043001028,757,551,368,73,15,24,83,1,183
17043001008,993,699,585,65,13,16,27,0,114
17043001034,1324,1092,446,524,46,50,59,2,646
17043001013,1055,820,583,158,22,27,44,3,237
17043009070,944,688,574,57,5,10,27,0,114
17043009007,694,487,440,20,0,4,19,0,47
17043005045,904,617,567,13,4,8,17,0,50
1719700PL24,1853,1499,1171,218,52,60,14,0,328
1719700PL23,1858,1483,1018,287,112,30,40,0,465
1719700PL17,3008,2095,1131,560,237,47,143,2,964
17073002003,953,720,608,74,31,7,1,0,112
17073001901,248,213,205,2,2,4,0,0,8
17073002301,413,334,328,0,3,1,2,1,6
17073002403,1095,830,780,19,17,10,5,2,50
17119002304,1225,846,296,14,522,15,6,0,550
17119002313,953,765,539,4,205,8,10,0,226
17119001923,1361,1097,956,27,82,22,6,2,141
17119001924,935,764,713,9,7,16,5,2,51
17119001927,594,460,402,9,14,16,6,1,58
17043008034,988,718,424,157,50,24,92,3,294
17043008036,1142,943,586,129,101,16,116,3,357
17043002035,1662,1225,295,495,90,36,345,7,930
17043002031,1666,1337,775,347,52,37,159,3,562
17043002085,996,815,529,126,30,12,125,0,286
17043002099,1304,962,293,317,205,26,137,1,669
17043007047,885,699,179,62,32,17,419,1,520
17043007049,1038,850,651,132,6,20,34,0,199
17043007007,1012,883,703,86,27,10,61,0,180
17043007056,771,608,441,25,7,3,127,0,167
17043007001,957,753,636,37,9,11,59,1,117
17043007003,567,473,373,25,5,3,65,0,100
17043007048,975,785,664,61,10,16,34,0,121
17043007008,713,611,457,37,15,7,96,0,154
17043007035,778,573,386,28,7,6,144,0,187
17043002101,1485,1125,599,274,88,25,146,2,526
17043002005,981,808,542,147,21,7,89,1,266
1719700PL13,3154,2249,1641,222,203,49,121,1,608
1719700PL10,1905,1551,1347,111,23,25,42,2,204
1719700PL14,2056,1544,1106,237,106,23,79,3,438
1719700JO02,1526,1262,781,267,165,34,31,0,481
1719700JO26,2180,1596,676,661,218,46,22,0,920
1719700NL13,2204,1645,1455,98,26,21,26,0,190
1719700NL12,1961,1510,1358,93,15,16,18,0,152
1718300NW01,833,668,636,10,11,4,6,0,32
1718300NW03,1186,912,824,23,29,15,18,0,88
1718300DC07,697,579,468,14,38,9,51,1,111
1718300DC16,624,549,383,9,92,4,55,0,166
1718300DC06,1012,925,765,27,92,14,26,0,160
1718300CT01,1065,780,744,13,5,9,4,0,36
1718300CT02,1070,823,774,6,22,18,1,0,49
1718300CT03,970,734,711,1,3,15,2,0,23
1718300DN06,823,655,605,16,21,6,6,1,50
17049001101,851,623,610,4,3,4,4,0,13
17043009122,745,634,222,29,4,1,378,0,412
17043009105,555,438,259,28,11,4,132,0,179
17043009049,912,716,398,91,113,7,102,1,318
17043009112,1271,1070,628,104,106,42,206,2,442
17043007026,669,550,426,32,5,3,79,0,124
17043007057,961,762,537,100,30,25,79,0,225
17043007017,859,662,507,58,25,13,70,0,155
17043007042,1160,823,548,94,37,10,123,0,275
17043007023,890,703,531,50,7,3,114,0,172
17043007034,792,669,253,44,33,3,340,0,416
17043007064,1134,890,531,77,47,13,225,1,359
17043007041,615,481,296,30,8,2,149,1,185
17043007024,840,663,405,79,16,8,155,0,258
17043003068,701,601,418,24,23,7,123,0,183
17043009113,878,744,581,90,13,14,49,4,163
17043009073,703,538,453,42,6,6,30,1,85
17043009027,668,555,428,65,26,9,35,0,127
17081000401,1329,1012,981,4,7,10,2,0,31
17081001201,1191,843,788,8,6,35,5,0,55
17081000201,400,326,320,1,0,2,0,0,6
1711100Al41,1720,1383,1106,174,39,26,37,1,277
17163000CN2,707,604,307,32,240,14,10,0,297
17163000CN7,1460,1272,646,164,427,48,6,1,626
17163000B15,962,723,252,16,431,16,6,3,471
171630ESL24,377,319,12,1,306,3,0,0,307
17163000CN8,1035,734,184,510,25,24,6,0,550
1716300CT17,767,570,139,11,407,19,0,1,431
1716300CT11,866,587,160,12,404,2,5,0,427
1716300CT15,1005,684,303,8,356,14,3,1,381
1716300CT16,855,571,100,12,453,5,0,0,471
17163000SL4,1114,880,760,20,38,42,2,1,120
17163000ML2,1803,1465,1391,19,8,24,15,2,74
17163000ML4,1258,1003,918,17,9,27,17,1,85
17163000ML3,758,640,597,17,3,18,3,1,43
1716300ESL4,1353,948,43,14,892,15,3,0,905
17163000CT1,595,474,8,3,458,8,3,2,466
17163000CT3,1087,810,87,17,701,9,2,0,723
171630ESL25,822,622,0,6,621,8,0,0,622
17163000CT7,713,434,6,1,423,1,2,0,428
17163000SL3,890,669,567,25,34,31,7,1,102
1703900NI01,492,378,358,3,1,10,2,1,20
1703900CL08,511,418,382,16,3,10,2,1,36
1703900TE01,1266,987,952,10,8,8,6,0,35
1717500ELMR,311,257,247,2,0,3,2,0,10
171670RO004,1064,793,737,4,15,15,16,1,56
171670RO005,1178,875,826,10,7,8,9,0,49
171670RO002,872,694,648,5,16,14,7,2,46
171670CP074,548,446,330,5,92,6,13,0,116
171670WD007,731,613,566,13,21,6,3,0,47
171670WD001,723,589,543,9,5,2,18,0,46
171670FC004,989,741,676,9,12,19,19,0,65
171670FC002,1735,1260,1196,11,22,12,12,0,64
171670WI003,1151,878,845,11,8,9,3,1,33
171670WI001,1131,868,801,12,7,21,16,3,67
171670CP085,1198,985,781,32,75,6,94,0,204
171670CP044,1054,850,634,28,131,10,44,0,216
171670CP077,811,535,126,11,397,9,0,2,409
171670BA005,1617,1157,1063,16,28,6,38,1,94
171670GA002,1179,948,899,7,10,15,5,1,49
171670FC001,823,652,620,0,9,10,2,0,32
171670FC003,1076,880,831,6,8,14,10,2,49
171670IG001,549,447,437,1,3,3,0,0,10
171670LO001,1109,830,776,10,8,16,7,0,54
17155000103,653,514,475,16,3,10,1,2,39
17155000104,854,679,587,61,5,18,2,1,92
1718300DC01,861,655,527,30,79,17,6,0,128
1718300DC27,674,545,451,15,55,6,18,1,94
1718300DC02,907,689,553,35,80,13,5,0,136
1718300DC31,688,573,449,22,86,7,13,1,124
1718300LV01,209,155,145,0,4,4,1,0,10
1718300DC13,1116,778,334,64,355,15,6,2,444
1718300MC01,760,610,580,8,0,17,1,0,30
17065001101,129,86,84,0,1,1,0,0,2
17019CH3000,2120,1792,1491,45,96,23,130,2,301
17019CC3700,3647,2645,1503,126,672,44,316,3,1142
17019CC3000,2559,2013,754,80,957,38,203,1,1259
17019CC1800,2232,1811,1036,83,526,35,121,0,775
17019LUD300,1705,1379,833,179,315,22,28,0,546
17019RA5000,2440,1825,970,395,380,66,28,3,855
17019RA6000,2168,1441,730,169,486,58,47,7,711
17019CN0700,1310,1226,638,111,99,22,345,4,588
17019EBE000,623,473,444,2,10,12,1,1,29
17019KER000,183,134,120,3,7,1,0,0,14
17019CC0900,2665,1971,556,213,1128,41,58,5,1415
17019SJ2000,2382,1684,1606,32,4,19,13,2,78
17019SJ1000,1882,1407,1329,17,23,20,12,1,78
17019SJ3000,1333,990,925,15,1,23,12,0,65
1715100EDVL,760,603,578,7,3,13,2,0,25
17065000804,773,608,577,6,4,4,6,0,31
17019RA2000,2093,1381,680,175,475,47,29,4,701
17019AYE000,421,337,315,8,5,7,2,0,22
17163000B24,1279,1023,764,28,195,18,14,1,259
17163000OF2,1623,1246,902,52,203,24,45,9,344
17163000B16,1356,1045,459,29,520,25,15,7,586
1716300SC20,1076,883,666,35,116,12,56,0,217
17163000B13,1455,1201,442,33,702,16,18,3,759
1716300SC25,1958,1477,714,29,631,24,71,4,763
17163000B12,1242,894,375,18,483,19,3,1,519
171630000B6,1899,1659,920,121,567,23,24,4,739
17163000SC9,1281,1088,876,29,129,36,14,5,212
17163000B14,1302,1091,614,29,422,23,10,0,477
17163000B19,932,758,496,39,200,18,11,0,262
17163000SC4,933,744,582,26,95,22,12,2,162
17163000CS4,912,749,538,15,177,12,3,0,211
1716300CS17,1323,998,762,116,65,37,12,4,236
17163000CS5,2107,1651,1302,87,202,38,20,3,349
17163000CS8,1159,946,675,26,170,22,30,0,271
17163000OF3,1052,809,644,46,70,18,31,1,165
1716300OF18,1063,904,668,14,171,14,29,3,236
17201000302,1396,1095,823,119,88,33,55,2,272
17201000203,1240,952,824,47,36,16,23,0,128
17147000504,1950,1484,1373,23,15,32,22,1,111
17147000501,1269,1014,968,11,2,13,10,1,46
17121012001,1571,1233,1190,5,3,19,9,1,43
17121007002,376,304,288,5,1,13,0,0,16
17121003011,1316,1014,927,16,26,27,12,1,87
17163000B18,943,686,462,19,180,19,6,1,224
17163000SV2,4835,2865,1871,282,466,75,156,21,994
17163000B26,2862,2002,1151,97,628,37,96,8,851
17163000SV1,3022,2358,1692,137,330,59,149,21,666
17163000CN3,486,401,33,14,354,2,5,0,368
1716300CT10,741,603,18,1,580,5,3,1,585
1716300CT12,1106,736,13,7,709,7,3,1,723
1703900DE01,428,356,344,6,0,3,3,0,12
1703900HA01,310,262,259,0,0,3,0,0,3
1703900CR01,479,368,364,0,3,1,0,0,4
1715100WBST,739,618,540,21,30,16,7,2,78
17185000011,485,386,374,0,0,8,0,0,12
1703900WI01,122,99,98,0,0,1,0,0,1
17081001109,1188,907,550,34,313,16,1,1,357
17081001104,919,617,396,27,164,18,8,5,221
17081001106,980,700,312,9,356,25,7,1,388
17147000101,735,617,573,8,5,15,2,1,44
1703900CL02,460,363,324,22,4,8,0,0,39
17081001103,1086,828,673,26,85,21,13,3,155
17119001703,1509,1250,1106,53,38,29,10,1,144
171670CL005,1163,945,885,14,14,20,7,1,60
171670CP041,1113,898,681,29,148,26,12,1,217
171670CP047,975,760,708,6,28,9,5,0,52
171670CP012,1100,896,739,16,105,23,9,3,157
171670CP035,985,823,711,19,72,11,10,0,112
171670CP061,1182,952,606,40,256,29,29,3,346
1711100Gr20,3073,2132,1633,248,52,43,165,2,499
1711100Gr21,2050,1541,1332,72,7,18,102,2,209
1711100Do11,2026,1559,1341,123,21,24,30,2,218
1711100Do13,1488,1139,739,350,33,17,9,0,400
1711100Al21,1369,1041,790,179,13,25,40,0,251
1711100Al67,1439,963,852,23,4,11,65,0,111
1711100BU03,1752,1337,1215,65,9,18,11,0,122
1711100Mc12,1019,798,644,106,4,24,16,4,154
1711100Mc05,891,680,560,76,8,16,12,0,120
1711100Nu12,1510,1219,1063,103,4,28,13,0,156
1711100Nu16,764,584,528,39,3,10,7,0,56
17185000009,783,599,577,4,0,8,2,0,22
1719700WH15,2274,1625,680,97,73,14,755,1,945
17083000801,761,634,594,9,5,19,2,1,40
17083000101,1240,1058,905,38,60,11,29,5,153
17083000802,276,223,210,5,0,5,1,0,13
17083000406,846,699,648,9,14,20,2,1,51
1703900CL05,1484,1222,1133,56,12,12,5,6,89
17121003016,723,562,505,9,28,9,9,1,57
1711100Se02,1621,1263,1133,77,11,11,26,1,130
1711100Mc34,1785,1423,1260,66,11,31,42,1,163
1711100Mc10,2088,1665,1435,172,12,25,14,0,230
17163000CN1,1259,871,198,654,4,62,3,0,673
1716300ESL3,940,551,3,5,543,12,2,0,548
1716300ESL2,925,706,8,5,692,5,3,1,698
1716300ESL1,1820,1179,22,4,1141,16,5,2,1157
171630ESL14,836,599,5,4,588,5,0,0,594
171670WD011,750,638,528,23,41,34,8,1,110
171670CP062,1079,924,717,34,136,18,17,1,207
171670ME001,982,746,710,10,6,10,3,1,36
171670ME003,816,649,614,9,1,10,2,0,35
1719700NL07,2906,2118,1920,84,32,29,49,0,198
1719700NL02,1830,1410,1260,82,17,31,18,2,150
1719700FR25,1658,1289,1213,52,9,8,4,0,76
1719700FR21,1735,1334,1189,62,29,12,34,0,145
1719700MO05,2090,1528,94,50,1394,23,2,0,1434
1719700MO02,2390,1838,344,123,1318,46,38,1,1494
1719700MO04,2157,1792,1114,142,442,31,64,1,678
1719700HO02,2165,1719,1568,93,4,13,24,1,151
1719700WH10,1983,1422,924,68,35,8,365,1,498
1719700CH05,2307,1664,1394,171,24,41,22,0,270
1719700CH01,2060,1543,1398,60,31,35,12,0,145
1719700CR11,1622,1364,1051,149,132,22,13,3,313
1719700PL22,3146,2416,1768,338,155,55,119,3,648
1719700FR06,1898,1497,1316,99,34,20,24,0,181
1719700FR07,1841,1493,1276,109,38,17,43,0,217
1719700TR20,2278,1702,1326,175,137,18,40,1,376
1704100TU03,1256,1024,966,22,2,14,19,1,58
1712500PN01,139,106,106,0,0,0,0,0,0
1712500MA02,1056,838,806,8,0,13,7,0,32
1712500HV05,651,541,503,14,4,12,2,0,38
1707900SM01,341,245,234,2,0,2,1,1,11
17101000023,685,577,540,12,13,8,5,1,37
17101000018,473,364,326,4,20,8,4,0,38
1719700WH03,2608,1946,1032,88,130,13,689,5,914
1719700WH04,3833,2898,1524,202,314,23,825,1,1374
1719700WH05,2615,1925,976,74,87,16,759,4,949
171670CP038,1600,1270,998,48,48,5,163,1,272
171670CH002,1320,996,840,42,57,19,22,1,156
1719700NL01,2228,1591,1230,202,111,28,15,1,361
1719700NL09,2118,1611,1379,166,19,19,20,0,232
1719700NL03,1815,1376,1205,88,33,18,28,0,171
17019CC0800,3335,3215,1681,380,235,25,834,9,1534
1712500MA01,1193,892,847,10,6,18,6,1,45
1712500FC01,464,361,343,1,3,13,3,0,18
1712500HV06,746,611,594,4,1,9,0,0,17
1712500HV04,857,693,659,12,1,19,2,1,34
1712500HV03,667,514,483,2,3,23,0,0,31
1712500LB01,237,199,191,1,2,7,0,0,8
17163000SM2,1019,813,762,14,4,13,6,0,51
17163000LB3,674,526,479,10,14,14,4,1,47
17163000LB2,1262,981,628,61,213,54,29,2,353
17163000MR1,1163,880,841,9,13,8,0,0,39
17163000LZ1,958,737,699,10,7,22,2,1,38
17133000006,1385,1065,1019,17,4,24,2,3,46
171630000E1,758,575,535,10,10,15,1,0,40
17163000NA1,1269,996,931,15,16,19,5,1,65
17163000NA2,1293,1019,950,12,13,26,7,4,69
17133000026,771,605,579,11,2,8,3,0,26
17133000012,1563,1180,1111,9,5,24,20,1,69
17121014003,832,633,558,18,13,17,7,1,75
1712500HV01,807,648,601,6,5,19,6,0,47
1712500MC02,698,566,542,7,5,7,2,0,24
1712500SH01,493,389,374,4,3,7,0,0,15
1711100Al49,946,740,666,40,2,11,11,0,74
1711100Al51,1621,1255,1040,119,43,10,37,1,215
1711100Al54,1266,1013,840,93,15,9,52,0,173
1711100Al46,1225,910,816,55,10,7,17,0,94
1711100Al08,1299,1030,882,102,7,16,21,1,148
17155000301,1223,994,934,33,2,12,6,2,60
17155000102,872,701,624,49,8,11,9,3,77
1711100GW01,1397,1010,836,117,6,34,15,2,174
1711100GW05,2125,1647,1383,170,16,51,14,1,264
1711100Al65,1684,1307,1177,76,10,19,25,0,130
1711100Gr27,1470,1158,1034,42,26,8,37,0,124
1711100Gr15,1170,1159,1124,11,5,2,14,0,35
1711100RL01,3035,2265,1896,282,18,66,27,0,369
1711100Ma01,1795,1448,1194,182,21,34,16,1,254
1711100He02,856,704,621,44,8,19,2,0,83
1711100AL01,924,735,511,164,11,10,42,2,224
1711100Mc28,690,551,497,40,2,3,4,0,54
1711100Al34,1464,1100,783,235,25,40,23,2,317
17121015002,715,543,496,3,12,24,8,1,47
17121014001,905,713,620,21,42,11,9,0,93
17121014009,1133,823,746,11,15,29,12,2,77
17149000401,417,329,317,0,0,10,2,0,12
17181000120,815,644,599,13,5,14,4,0,45
17181000111,837,644,612,10,2,8,5,0,32
17181000115,721,592,496,68,4,18,12,1,96
17181000110,1323,1033,845,139,18,47,4,4,188
1704100GA01,1292,954,916,13,3,17,1,1,38
1702900SH01,312,241,232,1,1,4,0,1,9
1702900LY03,1101,878,738,37,51,35,13,1,140
1702900MT19,1068,886,803,21,23,25,5,1,83
1711100Nu08,906,747,630,73,12,16,4,1,117
1711100GW03,1943,1458,1201,151,7,65,20,4,257
1711100Mc09,1089,833,719,65,8,17,12,0,114
17031027035,1273,1077,737,160,61,12,105,2,340
17031027021,957,875,622,34,104,5,110,0,253
17031820008,655,463,367,30,35,8,31,0,96
17031760005,2364,1810,862,636,77,50,223,0,948
17031760007,2159,1702,771,633,74,71,217,5,931
17031754004,1911,1475,1064,99,181,24,92,1,411
17031820064,2167,1709,943,103,90,17,561,7,766
17031036021,2354,1679,107,1444,114,81,44,12,1572
17031036005,2007,1454,95,1195,156,96,18,0,1359
17031037026,1444,1115,27,422,666,28,13,2,1088
17031029036,1033,784,1,229,554,18,1,0,783
17031890014,2550,1845,212,1548,78,78,18,1,1633
17031890059,1081,869,302,125,385,15,51,1,567
17031017029,1120,847,3,23,825,5,1,0,844
17031017024,1045,816,12,34,771,8,2,1,804
17031017027,1098,842,6,37,799,16,3,1,836
17031015012,3190,2286,173,1972,35,111,118,1,2113
17031014025,1743,1172,61,1080,14,78,20,0,1111
17031820060,2374,2074,1234,120,138,27,571,3,840
1720100Du02,1046,865,793,31,9,12,5,1,72
17201001203,1695,1260,679,203,319,39,17,1,581
17201001204,1395,1088,626,131,285,37,27,4,462
17201001404,1811,1373,766,289,218,40,69,1,607
17201001405,1951,1570,978,208,270,28,90,2,592
17059000702,715,555,518,10,8,13,4,3,37
17059000501,115,91,91,0,0,0,0,0,0
17059001001,168,119,114,0,4,1,0,0,5
17123003001,1172,906,802,47,18,33,11,1,104
1720100Wi02,1296,993,916,24,32,11,8,0,77
17201001101,2428,1762,698,449,479,59,111,0,1064
17201001104,2195,1631,760,420,376,59,57,1,871
17201001103,2576,1714,531,441,568,61,162,3,1183
17201001006,1548,1159,696,199,155,26,87,3,463
17201001004,1537,1171,741,182,178,39,46,0,430
17201001007,2394,1863,1103,211,429,29,117,7,760
17201001003,1734,1327,774,248,210,26,65,0,553
1720100Ro32,1979,1669,1198,125,177,24,152,4,471
1720100Ro33,1053,854,695,53,55,11,38,1,159
17201000408,1154,952,714,52,96,10,73,0,238
17201000104,1461,1191,869,64,116,11,126,1,322
17201001302,1688,1125,258,214,645,34,10,0,867
17201000706,1431,1010,222,113,657,21,2,0,788
1720100Ro28,629,498,433,31,16,13,5,0,65
17201000601,2099,1536,890,339,176,43,90,3,646
17201000503,1816,1203,324,300,550,30,20,1,879
1720100Ro27,1503,1242,987,143,68,38,5,1,255
1720100Ro54,1684,1349,1131,94,53,38,19,0,218
17201001207,1742,1259,824,146,209,16,51,0,435
17201001202,1555,1323,888,71,327,14,20,0,435
17201000101,1235,1005,866,58,47,9,24,0,139
17201000105,1845,1514,900,255,121,24,226,0,614
1720100Ha05,1584,1238,1060,64,42,44,28,1,178
1720100Ch03,1621,1276,1007,122,44,33,69,0,269
17201000905,1551,1237,670,143,390,26,19,0,567
1720100Rs12,1404,1079,936,58,38,22,24,0,143
1720100Rs01,1483,985,807,53,40,29,51,2,178
1720100Rs13,1366,1020,844,72,53,28,22,2,176
1720100Pe03,1235,944,892,13,15,8,4,1,52
17031810008,1169,839,743,32,8,5,44,2,96
17031810016,1903,1288,1155,43,4,5,65,2,133
17031810009,1416,1022,941,22,3,7,38,2,81
17031029015,1060,861,12,145,700,22,10,1,849
17121015003,810,601,570,10,8,17,3,0,31
17065000701,450,340,326,2,5,3,1,3,14
17001020006,1012,812,758,7,18,9,17,1,54
17119001420,1064,829,698,32,56,23,20,0,131
17119001427,1754,1389,950,330,46,25,38,3,439
17119001422,380,306,248,6,18,7,24,3,58
17119001002,2045,1471,1339,39,44,20,14,1,132
17119001003,1060,876,793,9,22,30,3,1,83
17119001806,1294,1046,903,48,30,40,15,0,143
17119001804,1231,960,870,26,29,17,6,0,90
17119001308,1641,1304,1062,56,131,34,7,2,242
17119001316,1383,1093,882,43,116,28,7,3,211
1704500PR01,222,185,179,2,0,3,0,0,6
1702900CH06,1445,1130,987,29,51,53,3,3,143
1702900CH12,1421,1203,1008,64,78,26,19,1,195
1702900LY04,1110,962,904,8,26,7,16,1,58
17123007001,326,258,241,4,0,4,5,0,17
1720300CL01,630,506,488,7,5,3,2,1,18
1704500YA02,188,156,143,1,6,4,1,0,13
1704100BW01,620,498,467,23,0,5,0,0,31
1702900AS01,1158,953,920,5,7,17,5,0,33
1702900HB01,1161,882,828,34,9,9,3,0,54
1702900MT06,1214,934,836,24,49,20,2,0,98
17059000401,171,145,142,2,1,2,2,1,3
17123011001,1113,867,823,14,9,12,3,0,44
17121014008,1768,1347,1288,7,6,26,5,0,59
17121014005,595,488,465,1,8,11,3,2,23
1705700EL01,135,105,104,0,0,1,0,0,1
17043002052,1503,1188,424,303,41,21,408,6,764
17043002076,941,718,263,255,24,14,178,2,455
17043002094,1051,763,260,293,24,9,191,1,503
17043002023,878,671,182,226,51,15,207,3,489
17043001062,943,699,593,46,16,8,31,6,106
17043007040,893,726,550,46,19,4,103,0,176
17043007033,1057,780,520,17,11,6,230,0,260
17043007058,664,519,383,60,12,9,61,0,136
17043006034,1270,910,503,212,108,10,72,3,407
17043006095,707,516,445,17,7,3,42,0,71
17043006026,585,418,351,21,13,6,24,1,67
17043006076,1276,933,267,70,87,4,485,1,666
17043006054,1721,1205,520,75,65,6,543,4,685
17043006038,967,726,329,29,33,4,326,3,397
17043003149,868,700,604,38,8,6,46,3,96
17043003079,678,534,441,33,15,7,41,1,93
17043004066,971,777,595,29,18,10,119,1,182
17043004108,849,762,629,52,31,10,37,0,133
17043004060,1968,1890,1475,121,151,23,107,0,415
17043003140,826,698,575,45,15,8,51,1,123
17043003092,692,581,494,10,5,2,62,0,87
17043005036,938,783,642,41,54,3,37,0,141
17043006069,1054,763,312,60,103,1,282,0,451
17043006073,1376,1079,514,167,182,19,210,0,565
17043006051,1269,890,384,77,128,15,285,7,506
17031041002,1026,751,658,64,5,1,17,0,93
17031041013,1362,1030,801,98,19,20,91,3,229
17031041033,1016,786,583,109,14,15,71,1,203
17031820027,2484,1931,642,208,313,20,773,2,1289
17031031039,1267,1018,291,607,72,43,48,2,727
17031038021,1573,1202,581,486,45,44,100,1,621
17031038033,1747,1349,667,568,34,39,90,4,682
17031038032,1473,1182,780,308,17,34,59,3,402
17031045017,1376,1169,792,256,30,14,85,4,377
17031050010,2428,1743,723,227,171,32,610,8,1020
17031036019,2010,1524,393,947,127,123,75,0,1131
17031890005,1394,1149,29,113,997,21,16,2,1120
17031890033,1382,1151,38,134,961,10,20,0,1113
17031022021,1511,1165,29,393,749,28,5,2,1136
17031027015,987,714,10,211,500,11,1,0,704
17031028032,1172,842,24,56,760,13,7,1,818
17031027014,797,603,30,36,549,6,1,3,573
17031011007,3452,3223,987,479,654,17,986,7,2236
17031025027,2036,1894,974,229,180,23,509,3,920
17031011002,211,186,48,38,91,2,6,1,138
17031011033,1462,1216,501,185,185,14,342,0,715
17031014027,1843,1393,215,1065,33,101,83,1,1178
17031020020,2421,1664,54,1425,186,137,8,3,1610
17031020017,2050,1367,37,926,417,53,12,9,1330
17031758005,2119,1646,559,245,709,42,113,5,1087
17031810029,1332,938,757,59,13,3,94,1,181
17031810025,1156,769,707,13,1,2,37,0,62
17031027019,1293,956,45,438,487,25,6,3,911
17031027022,859,637,12,242,402,14,4,3,625
17031032016,1289,1061,779,170,19,13,78,2,282
17031870054,1472,1159,978,94,20,10,54,0,181
17031760031,1593,1235,595,380,55,31,209,1,640
17031760042,1793,1492,1045,134,48,25,242,3,447
17031039042,925,654,514,49,1,0,83,0,140
17031039015,1336,1059,675,101,12,7,258,0,384
17059000601,853,650,626,0,4,11,6,1,24
17121009002,582,477,455,2,3,14,0,2,22
17121003006,667,530,294,11,86,7,129,3,236
17133000031,841,647,584,24,11,17,6,1,63
17133000016,734,633,599,11,0,15,5,0,34
17123004002,1097,847,804,6,2,17,14,1,43
17123004001,1461,1167,1095,18,8,26,7,2,72
17123005001,520,427,407,2,5,8,1,1,20
17101000006,1282,972,940,7,9,12,2,2,32
17101000004,1049,803,754,4,23,11,3,1,49
1705700CS01,561,437,416,3,0,12,4,1,21
17119000907,1286,997,885,30,36,31,10,1,112
17119001916,1713,1334,1227,16,23,34,15,0,107
17119001328,942,741,667,21,21,15,13,0,74
17119001311,1386,1169,1011,71,51,23,14,3,158
17119001319,915,725,644,26,38,10,8,0,81
17119002213,1324,979,653,96,182,44,5,6,326
17119001706,1680,1270,925,79,209,31,26,0,345
17119002218,1585,1260,983,86,128,50,12,1,277
17119001707,1459,1133,918,100,72,33,13,0,215
17119002303,1249,987,852,29,81,22,5,0,135
17119000104,1414,1108,1060,8,7,27,7,0,48
17119002221,923,769,677,33,20,17,11,1,92
17119002223,1176,943,822,42,34,26,13,1,121
17119002324,720,584,485,24,66,14,2,0,99
17119002321,1662,1390,1095,33,205,30,20,2,295
17047000302,219,178,176,0,1,0,0,0,2
1702900PG01,1227,991,939,5,5,17,12,0,52
1702900MT05,1027,810,708,10,71,13,5,0,102
1702900MT04,956,744,690,14,19,3,11,0,54
17019MA1000,3718,2507,2260,73,35,32,88,4,247
17019MA4000,3652,2622,2385,53,38,47,86,5,237
17047000401,438,316,311,0,2,3,0,0,5
17019SID000,1709,1298,1216,16,20,17,16,1,82
1719700FR09,2159,1649,1320,112,89,6,108,1,329
1719700FR04,1969,1507,1357,57,27,15,39,1,150
1719700RE01,2379,1801,1585,115,28,34,16,0,216
1719700PL03,1880,1427,1121,129,61,22,89,1,306
1719700PL09,3025,2312,1710,222,232,36,120,4,602
1719700PL15,2002,1535,1211,158,58,21,77,0,324
1719700PL16,1837,1520,1229,176,64,33,12,0,291
1719700TR03,1707,1379,1185,123,13,42,10,1,194
1719700TR22,949,714,618,54,19,19,4,0,96
1719700NL20,3727,2528,2288,116,38,26,40,1,240
1719700WH30,2592,1898,1404,186,115,19,171,0,494
1719700WH29,2796,1889,1433,173,103,24,150,7,456
17043009036,833,625,556,23,7,1,29,1,69
17007009002,655,480,389,49,12,7,20,2,91
17007009001,3262,2307,1874,298,36,50,30,0,433
17007003001,3427,2532,2153,186,60,36,84,1,379
1719700GG02,2016,1602,1374,123,59,28,15,1,228
17107000401,312,239,230,4,4,2,0,0,9
17107000802,1282,1034,945,22,27,17,19,0,89
17107001302,400,317,301,2,5,9,1,1,16
17107000804,1315,1005,867,28,59,30,6,0,138
17121015001,683,495,454,3,9,19,6,0,41
17121003001,554,397,173,8,200,7,2,1,224
17121005001,844,690,662,6,0,13,4,1,28
1704100CA02,1453,1117,1041,22,16,24,3,0,76
1704100NM01,1024,827,773,25,10,14,1,0,54
1704100MN01,210,172,166,4,0,2,0,0,6
1702900LY01,1225,954,872,23,7,12,20,0,82
1702900CH08,1588,1295,1172,34,52,26,20,2,123
17001008001,514,394,376,6,2,4,0,0,18
17001007001,573,453,435,8,3,5,1,1,18
17001014001,1379,1030,985,14,4,18,2,0,45
17001003002,898,666,636,6,8,15,4,0,30
17001023032,1232,929,832,18,42,15,7,1,97
17001023034,749,582,563,4,5,2,4,0,19
17001023033,1059,807,719,24,32,20,11,0,88
17001023035,887,694,645,14,21,7,3,1,49
17007006003,2665,1866,1056,621,92,63,62,5,810
17007006001,767,604,505,75,6,16,6,0,99
17007001017,2853,2253,1694,447,41,52,41,0,559
17007001008,2166,1497,668,695,93,66,10,6,829
17007002001,2132,1720,1152,470,44,40,16,4,568
17007001009,1156,859,584,231,12,24,10,0,275
1711700ST05,1225,957,889,20,8,20,6,1,68
1711700ST03,1345,1039,986,7,6,24,4,0,53
17123006001,1270,996,952,12,11,18,8,5,44
17123002001,1564,1234,1112,60,16,29,12,1,122
17123009001,890,719,685,11,3,3,6,1,34
17123001001,332,283,276,3,1,3,2,0,7
17123008001,419,343,330,3,2,11,0,0,13
17119002203,920,709,632,21,26,22,9,0,77
17119002205,1317,1017,839,43,86,20,10,0,178
17119002204,1008,761,695,23,23,5,12,0,66
17119001424,1015,789,700,11,38,7,23,2,89
17119001425,1255,1049,829,46,125,19,26,0,220
17119001901,1378,1058,953,24,34,28,12,3,105
17119001912,1254,993,894,18,32,23,12,2,99
17119002002,398,327,288,0,18,6,7,0,39
17119001801,1001,811,720,22,20,24,14,0,91
17119001506,956,731,608,29,38,26,14,3,123
17119001501,1262,978,921,3,20,18,14,0,57
17119001919,1221,959,896,18,11,17,13,0,63
17119001914,914,751,681,21,15,19,2,0,70
17163000MR2,1097,862,820,4,7,19,3,0,42
17107000801,1243,964,868,22,31,25,12,2,96
17107001204,717,566,541,4,2,4,13,0,25
17107001207,844,715,659,11,26,14,4,1,56
17113002002,1182,836,802,11,3,17,2,1,34
17113COB025,1493,1105,877,42,62,6,114,0,228
17113COB044,1841,1313,1022,33,69,22,164,0,291
17113COB040,2865,1891,1301,49,114,26,388,1,590
17113002402,1121,806,779,15,4,10,4,1,27
17113002801,914,692,629,9,21,16,8,0,63
17113002401,2271,1626,1534,23,7,29,21,3,92
17113COB002,1267,924,786,44,66,12,17,0,138
17113000501,672,560,482,39,20,17,5,4,78
17113COB052,1265,972,846,47,45,8,24,5,126
17113COB035,2348,1705,1318,78,245,27,42,6,387
17007004001,871,696,661,12,1,13,2,2,35
1703900WE01,640,498,467,2,4,18,4,1,31
17163000FR1,1623,1296,1198,32,20,32,12,2,98
17163000FR3,1898,1482,1378,28,13,27,11,4,104
17163000FR2,1539,1225,1153,17,13,32,5,5,72
17163000MS2,2601,1904,1574,64,162,31,45,12,330
17163000MS3,2852,2061,1725,79,160,45,52,5,336
17163000MS1,1851,1407,1209,54,56,36,35,5,198
1711700ST00,260,212,207,1,0,3,1,0,5
1711700WM00,263,202,190,0,2,7,1,0,12
1711700NW01,341,278,263,0,2,13,0,0,15
1711700NW02,279,214,211,1,0,2,0,0,3
1700500TM02,290,213,201,3,1,5,3,0,12
1704100AR01,987,743,522,196,4,11,10,1,221
1705300PA01,160,140,124,7,0,7,3,1,16
1705300BN01,861,696,612,52,7,22,5,1,84
1705300MA01,267,211,206,2,1,1,0,0,5
1705300PT04,845,613,534,29,8,27,4,2,79
1705300PT07,1203,943,882,10,14,17,4,1,61
1705300PO01,551,399,368,16,1,10,1,0,31
1705300LY01,516,397,365,20,13,4,4,0,32
17107001101,3115,3012,1603,289,1060,20,11,0,1409
17107000101,652,516,499,2,1,13,1,0,17
1710500OW01,320,236,218,5,2,11,2,2,18
1717300OC01,793,629,618,2,1,7,0,0,11
1717300CS01,364,303,289,0,0,9,2,0,14
1710500FR01,1408,1020,927,69,9,15,6,2,93
1710500DW04,1321,1055,988,27,11,22,4,0,67
1710500DW01,1076,876,803,35,3,24,3,1,73
17107000601,1216,926,904,6,0,14,2,0,22
17107001206,1421,1133,1004,26,55,28,16,0,129
1714300LI07,1174,941,789,33,79,23,8,0,152
1714300LI08,1220,929,713,65,115,19,6,4,216
1714300LI06,984,761,676,38,31,15,1,0,85
1714300LI04,987,808,739,22,18,17,7,0,69
17185000008,1721,1422,1193,8,4,9,204,4,229
17185000016,161,123,117,0,0,2,2,0,6
1710500EP01,366,266,252,4,5,4,2,0,14
1710500SW01,612,462,437,11,2,14,1,0,25
1710500RD02,1009,820,752,31,16,8,7,1,68
1710500RC01,514,398,383,13,1,4,1,0,15
1710500SN01,246,186,167,15,2,3,2,0,19
1710500NW01,704,557,538,10,5,2,4,0,19
1710500DW03,990,777,689,35,16,19,8,3,88
17097Wes382,1029,775,664,21,4,10,70,0,111
17097Wau348,2312,1751,436,962,242,83,105,2,1315
17097Wau349,2350,1840,421,692,524,51,177,3,1419
170970Ela95,1780,1397,1124,44,26,1,191,2,273
170970Avo18,2966,2206,857,1199,70,126,42,13,1349
17097Gra136,1473,1149,874,192,34,29,21,4,275
170970Avo26,2741,1924,544,1276,70,88,23,2,1380
17107000301,476,365,352,3,1,7,4,1,13
17107001001,503,414,395,5,9,3,4,0,19
17107000806,1147,908,843,15,17,10,17,1,65
17107001501,608,476,456,5,5,8,1,1,20
17107001701,415,319,296,8,2,8,0,0,23
17097Lak166,2283,1662,961,446,83,46,146,0,701
17097Mor211,1360,1061,924,59,14,10,57,1,137
17097Wes389,1322,1051,935,49,12,6,51,4,116
17097Wau341,1310,1054,842,162,7,21,27,2,212
17097Wau338,2228,1775,1151,517,23,79,41,2,624
17097Lak155,1580,1272,1012,118,53,20,60,7,260
17097Fre108,1046,1043,1011,13,1,2,14,2,32
17097Fre106,1879,1328,685,296,70,25,249,4,643
17097Ver265,942,712,523,31,24,6,129,5,189
17097Lak161,1387,1051,857,124,16,29,33,1,194
17097Lak156,2114,1702,1351,136,110,18,75,0,351
17097Lak160,1586,1179,859,121,70,18,103,3,320
17115516003,862,762,690,20,24,19,5,0,72
17017000410,886,700,642,52,2,4,4,2,58
17017000817,306,252,242,1,0,3,5,0,10
17017001113,522,407,368,17,10,6,4,2,39
17017000916,208,159,151,0,1,3,1,0,8
17115511004,920,668,592,12,32,14,9,0,76
17115511002,3482,2590,2448,24,29,32,40,3,142
17115511001,2811,2173,2050,20,19,29,33,1,123
17115516001,1377,1118,1048,9,25,20,12,1,70
17115501002,1886,1701,1090,75,449,22,51,6,611
1710500RD01,1014,810,737,34,8,22,7,1,73
17031890007,419,407,335,20,52,4,0,0,72
17031890013,2693,2049,408,1437,150,92,72,0,1641
1717300FB01,420,346,334,1,0,7,1,0,12
1717300HO01,383,290,287,1,0,1,0,0,3
1717300WI02,485,395,383,4,3,4,0,0,12
1717300WI01,910,703,669,4,5,16,1,1,34
17177001804,1353,1001,624,68,259,26,10,1,377
17177001812,1407,1143,913,52,153,21,8,0,230
17177001805,1294,922,455,130,314,23,8,1,467
17177001801,1128,831,471,39,291,25,9,1,360
17177001803,1228,910,279,97,497,40,10,2,631
17177001806,1224,892,561,91,209,24,9,2,331
17177001811,1333,967,737,52,148,8,13,0,230
17177001301,1195,972,919,21,18,9,4,2,53
17177000901,384,304,289,5,4,1,3,0,15
17135000901,860,710,686,12,4,8,4,0,24
17135001601,827,622,587,9,5,9,1,2,35
17135001603,582,440,417,9,7,5,3,0,23
17047000202,730,564,545,1,5,7,2,0,19
17047000601,922,754,721,13,4,7,0,2,33
17047000801,138,112,109,1,2,0,0,2,3
17047000201,387,295,288,1,1,5,0,0,7
17031940010,2936,2214,809,1292,65,86,52,1,1405
17031018017,1276,954,56,516,386,45,3,0,898
17031018029,1257,947,77,475,384,35,19,0,870
17031880005,1109,885,748,75,17,7,41,2,137
17031880027,1951,1524,1110,248,79,16,69,0,414
17031860041,1200,972,845,49,16,10,45,0,127
17031860074,866,683,610,30,10,1,25,0,73
17031930054,1788,1403,597,80,25,8,703,0,806
17031007022,1105,852,28,170,656,28,7,0,824
17031007025,1269,974,37,246,694,20,3,0,937
17031010004,1395,1016,44,538,445,22,2,1,972
17031007018,1374,1159,22,25,1113,18,3,2,1137
17031740004,1756,1449,916,299,21,27,198,0,533
17031950109,1433,1038,30,182,817,14,9,3,1008
17031970006,2815,2211,1677,314,101,37,77,1,534
17031970067,1118,891,704,105,29,12,33,2,187
17031810032,1240,839,720,48,9,4,51,0,119
17031050005,1021,708,514,73,41,0,71,0,194
17031050001,1287,847,578,86,42,13,131,0,269
17031050002,804,583,276,80,61,5,160,0,307
17031960019,1580,1169,1005,56,23,8,61,1,164
17031800077,2264,1808,1288,227,37,25,243,1,520
17031740001,1115,825,694,52,10,4,62,0,131
17031016026,884,633,1,88,550,7,5,0,632
17031016027,979,637,7,69,576,9,1,0,630
17031016036,853,652,11,43,597,5,2,1,641
17031790064,1703,1310,615,585,49,64,39,6,695
17031790030,249,199,122,64,1,6,4,1,77
17031940012,2672,2004,1181,685,40,65,75,3,823
17031940004,2519,1936,1206,581,31,46,101,1,730
17031940020,1728,1323,561,667,44,35,54,0,762
17031930073,1972,1495,935,115,39,24,396,1,560
1705500BE02,1324,1019,952,24,8,23,6,0,67
1705500TY05,595,478,460,5,0,12,1,0,18
1705500BA01,551,452,427,4,1,14,2,0,25
17031042010,2519,2410,1388,167,146,5,673,3,1022
17031042042,3776,3601,2077,285,150,27,1026,3,1524
17031042009,2741,2608,1445,227,252,28,634,3,1163
17031042033,2635,2518,1547,218,240,32,477,16,971
17031010026,1717,1232,87,928,215,52,6,2,1145
17031010029,1806,1317,169,1088,66,73,11,5,1148
17031010031,1612,1157,97,978,89,73,8,5,1060
17031010022,1159,819,57,712,47,54,2,3,762
17031730006,2307,1829,209,549,1049,58,11,3,1620
17031757006,321,308,146,35,23,11,95,6,162
17031710016,1593,1224,384,156,662,23,16,1,840
17031710022,1756,1332,482,97,730,25,16,2,850
17031710038,2873,2220,223,237,1760,40,18,2,1997
17031710041,1264,1014,100,53,865,18,4,3,914
17031770011,1948,1548,1372,90,19,14,41,0,176
17031770010,1346,1054,962,42,15,5,16,4,92
17031770009,956,781,704,50,6,1,17,2,77
17031970080,1656,1265,422,283,541,18,29,1,843
17031790060,3741,2747,271,1902,547,118,15,5,2476
17001002001,836,647,616,6,5,15,6,1,31
1719500MP04,1144,905,841,34,6,11,9,0,64
1719500FU02,811,619,575,20,5,10,8,1,44
17161000501,1413,1107,1027,33,9,17,9,0,80
17161000909,1569,1137,587,229,280,25,32,2,550
17161000913,679,520,333,61,73,20,32,1,187
1719500FE01,561,427,408,5,2,0,3,0,19
17177001810,1471,1169,920,82,127,24,18,0,249
17177001809,1479,1286,1087,22,129,8,29,1,199
17177000301,1229,1053,999,19,18,11,10,1,54
17097Ela102,1709,1277,1123,31,5,3,103,0,154
17097Ela105,2099,1693,1452,62,23,17,140,0,241
17097Ela104,1501,1039,910,43,11,4,75,0,129
17097New225,1098,882,756,59,36,9,22,0,126
17097New226,839,650,424,124,52,17,35,2,226
17113COB027,1278,1007,869,36,55,25,16,2,138
17113COB019,1355,1087,814,80,136,26,26,0,273
17113COB017,1314,1044,739,92,155,40,14,1,305
17113000802,952,780,727,24,8,13,5,0,53
17123006002,1057,850,812,10,8,13,2,0,38
17031044014,1427,1306,973,90,51,11,178,1,333
17031044020,1882,1787,1326,181,77,29,176,0,461
17031820062,1110,900,355,118,69,11,345,1,545
17031002026,1495,1186,854,112,150,10,72,1,332
17031002020,1766,1554,1220,92,39,10,183,1,334
17031032013,1776,1496,1085,176,60,20,161,3,411
17031002022,1391,1029,848,73,36,17,68,2,181
17031030014,2048,1498,156,1234,86,89,40,2,1342
17031031015,1311,1057,251,718,63,56,43,0,806
17031031031,1066,855,262,526,38,33,36,1,593
17031031003,1329,1038,219,759,47,56,27,1,819
17031940002,1631,1196,421,709,35,48,23,0,775
17031940017,1540,1136,444,619,44,66,24,1,692
17031890048,1715,1340,75,493,755,51,15,1,1265
17031940016,2205,1720,565,1054,37,109,40,2,1155
17031760013,1412,1102,413,523,51,39,110,5,689
17031760004,2822,2079,713,1019,180,105,171,16,1366
17031760027,4998,3955,1785,249,251,42,1644,4,2170
17031001002,1441,1176,439,578,141,46,28,6,737
17031026007,959,822,415,307,60,28,45,2,407
17031026034,971,830,373,361,71,13,32,1,457
17031001017,1395,1135,523,418,109,40,94,5,612
17031026037,1299,1016,356,544,85,38,39,0,660
17031820012,1391,1099,455,125,137,8,376,4,644
17031820017,2188,1670,844,164,135,21,516,4,826
17031820045,1043,826,457,68,63,5,235,2,369
17031046012,1298,1185,767,168,172,27,66,1,418
17031046020,1246,994,393,112,403,33,72,3,601
17031046025,1224,1064,581,151,250,15,70,1,483
17031960013,1358,1064,911,49,7,12,72,0,153
17031960054,1630,1353,1162,73,11,18,89,1,191
1717300HE01,530,427,413,3,1,7,1,0,14
1717300AG01,442,341,336,0,0,5,0,0,5
1717300RI01,819,613,603,3,1,4,2,0,10
1717300TH01,955,743,723,2,2,9,1,0,20
1717300SH05,818,640,628,3,5,2,3,1,12
1717300SH04,706,579,557,7,6,5,3,0,22
17135001106,1247,916,873,12,7,14,6,1,43
17135000101,516,410,396,4,1,7,1,1,14
17135001001,354,266,254,1,3,6,2,0,12
17097Shi246,1605,1365,1126,93,69,5,77,3,239
17097Gra131,1632,1285,912,239,69,38,35,3,373
17097Gra132,1851,1452,1079,288,21,40,33,3,373
17097Gra129,1123,903,766,81,14,25,10,2,137
17097Gra135,1648,1291,963,225,28,32,36,4,328
17097Ver251,1847,1370,1012,67,29,6,252,0,358
17097Ver264,1403,1042,801,28,12,5,188,0,241
17097Ver252,1525,1247,1068,31,17,8,109,1,179
17097Lak149,916,730,626,51,26,23,6,2,104
17097Lak150,1519,1206,931,170,36,11,48,3,275
17097Lak145,1402,1101,931,115,25,14,20,3,170
17097Lak146,1283,942,774,75,32,15,39,2,168
17097Wau356,3733,2820,535,1285,825,166,173,4,2285
17097Wau357,2957,2145,240,1404,413,137,53,4,1905
17097Fre121,1029,799,532,223,8,15,29,1,267
17097Fre119,1247,984,752,164,16,18,27,3,232
17097Wau376,2964,2023,135,1421,447,52,10,2,1888
170970Avo36,1833,1408,895,193,104,22,182,2,513
170970Avo49,1321,1016,812,70,25,11,96,1,204
17013000007,900,757,723,14,5,10,5,3,34
1719500CO04,915,669,548,83,18,19,0,0,121
17031710004,1953,1435,177,359,894,24,8,4,1258
17031710012,1874,1360,189,278,873,26,4,9,1171
17031730011,1600,1275,39,70,1164,8,1,0,1236
17031730003,1450,1149,54,136,965,30,2,0,1095
17031900047,2020,1545,124,94,1313,17,19,1,1421
17031900007,1110,987,428,44,439,7,61,0,559
17031770012,2457,1740,1502,103,24,12,101,0,238
17031023038,971,741,342,389,11,20,1,2,399
17031023004,1040,822,358,447,7,49,12,1,464
17031023022,1203,969,500,422,17,35,16,0,469
17031039005,1188,923,442,220,20,24,235,3,481
17031039008,1652,1288,404,453,33,38,406,4,884
1711700CN03,1439,1143,1067,2,27,22,10,0,76
1711700CN02,1093,871,793,24,31,12,8,1,78
1711700CN04,304,262,238,2,8,6,5,0,24
1711700CK03,902,700,662,4,2,17,1,1,38
1711700CN06,1019,820,756,11,15,27,6,0,64
1711700CN05,1261,1030,902,10,66,23,30,5,128
17031800006,1801,1451,1049,260,29,35,96,0,402
17031780011,2057,1625,1041,484,49,36,50,4,584
17031740020,1554,1244,974,188,12,32,55,1,270
1719500GE01,756,602,541,35,5,13,4,1,61
1719500CL01,438,367,345,11,0,2,3,0,22
17031820057,1982,1525,952,116,19,8,432,2,573
17031820037,1938,1518,660,175,144,37,533,6,858
17031760019,1406,1068,557,68,38,29,394,1,511
17031700004,2063,1622,962,30,11,6,605,0,660
17031930035,981,745,468,85,20,11,163,0,277
17031910002,1239,860,702,46,44,11,55,0,158
17031016014,1035,717,2,158,571,9,3,3,715
17031016031,1038,763,4,113,646,9,4,1,759
17031016005,1009,708,10,170,542,8,3,0,698
17031009030,768,575,0,16,557,3,1,0,575
17031009020,737,587,0,3,585,1,0,0,587
17031950014,1476,1145,299,262,581,38,1,0,846
17031950060,892,710,11,106,595,11,1,0,699
17031017011,690,516,4,106,404,12,2,1,512
17031017032,904,667,4,95,572,14,1,0,663
17031005014,803,650,19,6,603,7,17,1,631
17031007003,992,790,9,15,765,4,3,3,781
17031005006,1113,919,13,14,880,10,15,4,906
17031047008,1271,895,726,105,14,13,43,2,169
17031047014,1220,859,637,95,29,15,82,1,222
17031019029,1112,834,661,139,16,19,17,0,173
17031019033,1058,754,692,47,1,4,6,0,62
17031019008,998,740,678,43,7,10,0,0,62
17031032027,1740,1289,916,82,62,8,222,2,373
17031032030,1509,1017,768,77,15,7,134,2,249
17031032040,1411,1066,836,95,21,7,101,0,230
17031026032,1036,861,550,214,48,10,49,3,311
17031026028,1181,980,653,194,49,26,67,2,327
17031027043,1222,841,89,50,652,11,39,0,752
17031007014,1424,1081,24,26,1025,19,8,0,1057
17031007013,1573,1417,19,49,1345,29,8,0,1398
17031007021,1074,864,39,80,742,27,5,1,825
17031757005,1673,1227,997,61,60,3,90,1,230
17031014006,1255,898,44,835,9,50,13,5,854
17031014010,1468,1082,98,807,30,80,151,0,984
17031014011,1402,1007,29,954,17,84,13,8,978
17031710003,1654,1161,249,305,603,39,10,3,912
17031008031,802,625,6,4,613,6,0,0,619
17031008015,1124,858,3,12,845,6,2,0,855
17031006013,691,547,10,12,528,4,0,1,537
17031016015,1170,825,6,102,713,14,2,3,819
1718900BO01,392,319,307,3,0,4,3,0,12
17031039006,1752,1373,518,586,57,59,210,6,855
17031960036,1773,1375,1146,91,13,14,104,0,229
17031850011,1412,1054,555,84,378,11,38,0,499
17031029013,1372,1038,16,157,875,13,1,1,1022
17031036022,2362,1634,70,1505,54,82,16,4,1564
17031036025,2792,2035,99,1887,52,121,12,6,1936
17031850014,1341,998,790,53,67,18,61,3,208
17031800033,2817,2149,414,206,103,20,1342,3,1735
17031800075,1226,1058,789,56,6,4,195,3,269
17031029030,1763,1523,390,566,490,38,49,2,1133
17031029023,1310,1081,432,432,175,22,53,3,649
17031036003,1423,1085,177,768,108,93,38,1,908
17031029038,1872,1502,482,821,166,79,46,2,1020
17031840015,1739,1383,987,249,26,22,122,3,396
17031780040,2176,1641,530,987,46,83,71,1,1111
17031780004,2820,2148,644,1377,57,100,74,0,1504
17031890012,2546,1939,434,1360,94,77,64,0,1505
17031005015,1340,1089,266,90,569,18,171,0,823
17031005021,1367,1204,499,100,368,28,249,4,705
17031890061,1475,1294,535,142,513,19,106,0,759
17031020037,459,353,5,19,333,9,3,1,348
17031020035,2173,1072,0,16,1061,11,6,1,1072
17031020029,1236,1041,9,32,1002,16,3,1,1032
17031980001,5079,3453,165,3073,209,323,19,11,3288
17031850005,1568,1108,838,73,125,23,62,3,270
17031024023,1354,917,64,39,805,14,9,2,853
17031024031,1195,877,22,60,797,9,0,0,855
17031024006,1038,798,18,51,723,7,5,0,780
17031024003,1422,1057,37,164,860,20,6,4,1020
17031890067,1767,1591,882,154,410,42,99,4,709
17031001036,1389,1233,857,201,40,17,114,2,376
17031001003,1504,1312,942,196,33,25,111,0,370
17031001035,1645,1430,895,351,51,26,118,5,535
17031001040,1502,1376,716,436,146,28,75,1,660
17031037036,1101,819,6,195,614,14,3,2,813
17031037015,1301,955,20,239,700,11,5,5,935
17031029033,741,598,27,48,519,3,4,3,571
17031029021,1956,1483,7,51,1426,10,3,0,1476
17031029016,1337,977,8,37,948,9,0,0,969
17031950033,1164,877,33,29,815,4,0,2,844
17031014007,2394,1696,188,1435,11,101,60,1,1508
17031027040,1594,1335,806,208,229,19,85,1,529
17031810015,1814,1344,1016,53,18,5,241,1,328
1711700MO01,501,382,361,3,2,7,2,0,21
1711700MO06,482,407,376,7,3,12,0,0,31
1711700CK04,223,185,174,1,3,2,1,1,11
1711700CK01,260,203,194,3,1,1,2,0,9
1711700GD02,1400,1091,1003,9,16,53,4,2,88
17031040030,1052,823,507,91,35,5,193,0,316
17031040029,1351,1062,554,161,45,14,305,1,508
17031047027,1158,940,733,93,21,12,75,0,207
17031047013,1167,1005,686,162,46,15,105,2,319
17031047040,1110,880,644,109,31,17,80,2,236
17031047021,1104,899,622,160,41,22,71,5,277
17031820042,1855,1475,531,189,60,18,698,5,944
17031040014,1983,1646,724,367,89,26,453,1,922
17031040001,1881,1532,711,283,58,21,472,3,821
17031040037,1644,1346,438,440,229,83,223,0,908
17031032022,1554,1280,804,330,78,35,56,1,476
17031870029,2135,1631,1004,72,36,12,507,1,627
17031870037,1986,1441,757,83,31,15,547,3,684
17031960059,1833,1423,933,135,34,13,301,3,490
17031041035,1298,1013,807,115,4,15,62,3,206
17031041021,1197,997,763,126,37,11,57,3,234
17031041022,1217,962,781,128,13,15,31,0,181
17031780046,1779,1411,635,687,21,36,80,0,776
17031780043,1464,1148,504,528,40,27,70,2,644
17031005028,1297,1085,63,21,999,20,6,0,1022
17031005010,1468,1111,11,17,1074,17,10,3,1100
17031041025,3148,2443,1787,315,133,26,216,1,656
17031007005,1249,1010,28,13,964,11,16,0,982
17135001201,412,315,303,3,0,3,4,0,12
1718900BE01,581,448,421,9,2,7,6,1,27
1718900IR01,1181,945,909,9,11,6,3,0,36
17121003009,694,535,484,12,15,11,3,1,51
1703900SA01,957,759,712,12,6,20,3,1,47
1703900SA03,283,232,225,1,0,5,1,1,7
1703900SA02,1036,812,771,7,12,12,3,2,41
17113000101,877,688,649,5,5,19,5,0,39
17113002601,2006,1442,1259,16,42,27,89,2,183
17113COB036,1499,1068,879,22,43,8,106,1,189
17113COB043,1962,1349,1098,48,58,14,123,1,251
17113COB050,669,519,387,7,38,10,73,0,132
17113COB006,2455,2062,1315,150,515,61,32,6,747
17113COB009,1927,1584,1089,122,329,25,28,5,495
17031010023,1216,912,127,733,34,67,9,3,785
17031010014,1501,1180,245,898,29,78,6,0,935
17031010035,1062,836,253,538,30,44,11,1,583
17031010013,1576,1204,55,878,266,42,11,2,1149
17031010033,1510,1073,115,902,50,50,8,2,958
17031890058,1266,953,29,240,680,25,15,1,924
17031024017,1254,947,50,39,843,17,2,4,897
17031008026,1147,891,1,22,878,4,1,0,890
17031024004,1056,729,8,17,707,21,3,3,721
17031024020,979,707,5,23,676,8,1,0,702
17031028015,295,218,0,10,212,1,0,0,218
17031034014,1031,800,1,24,776,7,0,0,799
17031034009,983,716,7,30,672,4,1,1,709
17031008006,764,630,0,14,618,8,5,0,630
17031008029,858,686,2,6,674,5,8,1,684
17031008011,764,604,1,6,597,7,4,0,603
17031028034,2540,1882,158,345,1365,32,28,10,1724
17031024007,884,699,116,413,145,45,31,3,583
17031028019,1221,1058,303,267,169,45,317,1,755
17031024016,6833,6248,570,1820,3807,84,65,4,5678
17031025023,1630,1359,237,978,93,62,56,2,1122
17031025017,1502,1327,388,705,162,57,80,4,939
17031011003,1291,1117,478,436,78,37,112,2,639
17031025012,1282,1077,278,695,53,54,47,6,799
17031011017,1706,1454,614,414,55,50,350,0,840
17031011011,1697,1331,397,307,73,32,554,0,934
17031012009,1541,1205,180,568,17,52,439,1,1025
17031025028,1746,1512,337,1027,76,68,83,0,1175
1718900NV04,1187,920,862,14,7,23,11,0,58
1718900NV03,1195,944,905,16,4,10,7,2,39
1718900PK01,541,426,407,3,0,3,2,0,19
1718900LG01,550,461,446,4,1,6,2,0,15
1718900PL01,456,375,366,2,1,6,0,0,9
1714300PE74,1796,1152,779,25,42,6,293,1,373
1714300PE73,1557,1249,898,44,120,19,153,1,351
1714300KI01,982,786,730,12,17,6,19,3,56
1714300PE75,1708,1380,1059,45,122,18,116,0,321
1714300PE71,1098,892,711,41,74,3,63,1,181
1714300PE72,1185,946,700,46,129,15,60,0,246
1714300PE76,1033,755,593,19,95,10,30,0,162
1714300KI02,936,728,696,9,8,8,5,1,32
1714300PE55,1060,843,557,63,176,20,40,0,286
1714300PE69,1013,843,591,23,57,13,156,0,252
1714300PE68,1391,986,537,40,344,15,52,1,449
1714300PE77,1995,1605,837,39,201,22,494,0,768
1714300PE66,1639,1356,852,59,286,24,134,4,504
1714300PE95,1907,1282,932,36,55,14,236,0,350
1714300KI03,1179,918,778,31,77,22,9,1,140
17135001801,575,448,436,1,4,3,1,0,12
17177000802,980,840,783,17,16,11,8,0,57
17177001815,1062,777,625,18,94,16,16,3,152
17177001813,1454,1133,952,51,89,14,25,1,181
17177001103,529,420,413,2,1,0,1,0,7
1711700BM00,633,521,508,5,2,4,1,0,13
1711700SP01,672,544,526,4,4,7,1,0,18
17013000002,594,463,434,3,1,24,3,2,29
17013000004,1170,931,895,6,3,18,8,1,36
17013000005,314,230,225,1,0,4,0,0,5
1705100LA01,844,625,596,6,0,14,3,0,29
1705100VA06,1057,827,780,10,15,10,4,0,47
1705100VA05,535,420,389,8,8,12,1,0,31
1705100LG01,632,466,457,1,0,5,2,1,9
1717300RO02,827,658,635,8,2,9,3,0,23
17177000201,1362,1013,968,25,1,9,5,0,45
17177000501,1352,1054,1006,16,14,11,4,1,48
17135001701,309,253,239,1,0,10,2,0,14
17135001301,1126,870,833,7,3,16,6,1,37
17135000801,818,593,550,8,6,13,6,0,43
1705100VA09,661,473,439,12,2,8,5,0,34
1705100VA01,356,268,265,1,0,2,0,0,3
17121014007,1290,1033,969,7,8,29,9,3,64
17121009001,983,792,736,7,20,21,2,0,56
1707500DO01,1244,931,742,151,8,25,5,0,189
1707500IR01,512,419,407,3,1,7,1,1,12
1707500CR01,567,465,434,16,6,11,5,2,31
1707500SH01,656,528,479,20,9,6,4,0,49
1707500SH02,583,445,402,17,4,11,0,0,43
17097Ver283,1567,1179,783,42,29,1,312,0,396
17097Gra127,1461,1216,1057,94,18,29,16,2,159
17097Gra130,1474,1252,1016,154,45,31,15,6,236
17097Wau344,2136,1593,422,896,167,92,90,5,1171
17097Wau343,1044,823,359,379,52,19,27,0,464
170970Ela96,1554,1143,971,74,6,10,79,0,172
17097Gra134,1586,1261,1078,121,19,29,14,2,183
17097Gra133,1429,1215,1102,49,12,19,27,4,113
17097Gra137,1751,1402,1079,166,55,34,78,3,323
17097Wau355,1349,1040,477,389,118,34,37,2,563
17097Wau346,1714,1350,571,637,79,46,40,4,779
17097Wau347,1126,874,341,381,126,43,14,0,533
17031820063,1855,1435,718,149,73,15,479,5,717
17031032042,1422,1063,813,151,23,6,67,0,250
17031032009,1450,1116,724,217,64,17,99,1,392
17031032038,1420,1100,762,156,70,19,100,0,338
17031030010,1998,1501,210,1227,50,105,29,2,1291
17031030005,2135,1546,163,1275,32,102,74,11,1383
17031033025,1918,1577,713,631,84,27,157,1,864
17031046016,1296,1200,769,162,126,38,124,0,431
17031046002,1220,1107,605,147,228,16,115,1,502
17031046005,1794,1631,1199,175,88,29,137,0,432
17031046010,2150,1995,1533,213,123,34,114,2,462
17031044031,1431,1307,1052,127,52,33,51,4,255
17031040033,1013,864,591,109,43,17,105,0,273
17031040022,1358,1130,644,271,61,13,150,0,486
17031045029,1084,894,657,160,19,14,64,0,237
17031045028,1148,946,656,186,22,22,84,2,290
17031033003,2278,1905,813,719,108,72,245,0,1092
17031033027,2265,1886,587,826,135,77,322,1,1299
17031980010,3419,2469,156,2247,53,206,28,2,2313
17031980032,2806,1955,105,1798,57,87,12,0,1850
17031035003,1572,1196,336,681,123,56,45,1,860
17031035008,1341,1107,455,561,68,55,34,1,652
17031035005,1148,923,321,466,76,40,66,1,602
17031035017,1233,1056,565,319,94,23,69,0,491
17031035001,1438,1199,468,522,78,56,123,1,731
17031960005,1447,1200,866,84,74,8,161,1,334
17031045033,944,735,364,173,10,21,178,2,371
17031045034,1483,1159,596,309,22,41,208,4,563
17031870015,1654,1316,886,125,49,30,223,2,430
17031870057,1722,1468,1128,119,29,9,173,1,340
17031870046,1447,1161,897,82,10,22,147,5,264
17031830043,1498,1191,783,14,13,5,370,0,408
17031830050,1794,1458,942,46,27,9,383,1,516
17031830013,1131,887,609,39,7,6,222,2,278
1717300MO01,880,698,674,6,9,4,3,0,24
17007001022,1302,980,794,117,20,15,30,1,186
17007001016,2795,2094,1771,189,55,39,21,2,323
1717300RD01,456,356,349,3,1,4,1,0,7
1718900NV01,1106,858,775,25,34,13,13,1,83
1718900DU01,338,286,279,2,0,1,0,0,7
1707500MD02,1398,1093,950,65,28,33,18,0,143
1707500MI01,979,761,721,24,2,11,1,0,40
1707500AU01,1040,795,742,12,8,20,4,0,53
17031030007,1617,1225,393,692,48,59,110,6,832
17031030023,2154,1748,611,925,122,74,90,4,1137
17031030018,2320,1829,578,1065,103,82,72,8,1251
17031930016,3015,2321,1191,294,184,40,640,1,1130
17031930041,1702,1343,753,259,70,25,238,0,590
1717300RO01,1120,885,855,7,3,13,3,0,30
1717300SH02,384,304,280,8,3,4,2,0,24
1719300HA28,273,211,196,4,4,6,0,2,15
17031850032,1073,876,448,105,284,12,36,3,428
17031950008,1864,1424,70,42,1307,12,7,1,1354
17031950088,1094,891,29,38,827,2,4,5,862
17031970014,1765,1351,351,692,276,47,10,3,1000
17031010007,1318,973,87,798,91,39,6,4,886
17031010006,1199,901,133,684,74,40,19,3,768
17031970032,892,699,503,57,116,14,12,1,196
17031970084,1431,1128,838,214,43,15,25,0,290
17113002301,969,747,691,15,4,25,10,1,56
17113003006,761,628,573,16,21,4,14,0,55
17113003014,2970,2750,2070,170,284,33,196,1,680
1711700PK00,566,457,440,3,2,6,0,0,17
1711700BT02,757,627,588,13,1,16,1,0,39
1711700BH02,696,563,512,5,6,25,4,0,51
1711700BT03,1994,1593,1512,17,13,30,5,2,81
1711700SO00,440,346,328,0,3,9,4,0,18
17031800030,2865,2220,1969,131,20,14,72,0,251
17031037005,999,768,1,113,659,17,1,0,767
17031037029,1003,744,12,150,603,6,2,2,732
17031960025,1761,1281,1024,134,13,18,109,0,257
17031041038,1149,900,667,146,17,13,70,0,233
17031041030,1109,855,642,142,22,30,42,0,213
17031870023,802,655,584,8,4,2,55,0,71
17031960088,3075,2447,975,913,64,53,473,2,1472
17031960001,1933,1715,1167,221,39,28,272,1,548
17031029017,1400,1041,10,295,740,18,3,0,1031
17031041023,1298,1043,830,115,23,14,67,1,213
17031740007,1369,1107,917,52,9,4,107,1,190
17031740005,1903,1435,1177,73,37,9,127,2,258
17031025010,1587,1307,914,88,62,10,223,1,393
17031025003,2888,2691,1464,235,228,20,688,4,1227
17031028008,1220,962,617,75,83,10,182,2,345
17031025031,2414,2064,1543,126,80,8,289,0,521
17031025016,1789,1533,1165,55,41,7,254,2,368
17031028028,1300,1135,522,108,133,19,359,3,613
17113COB048,1188,1069,737,40,78,9,196,1,332
17113003025,2342,1868,1628,56,77,23,89,2,240
17113001801,1283,946,895,16,8,15,6,2,51
17113001401,1543,1214,1110,31,24,21,24,2,104
17113COB007,2595,1850,974,187,602,51,38,2,876
17161001015,959,752,423,52,179,16,86,1,329
17161000818,1196,908,630,156,74,21,23,2,278
17161000723,1051,824,628,108,61,23,11,1,196
17161000717,1549,1204,829,196,103,36,43,0,375
17161000721,913,768,588,69,70,13,26,0,180
17161000810,1451,1175,683,243,214,29,23,0,492
17161000806,1293,980,502,362,75,31,23,0,478
17161000902,442,312,84,36,167,4,25,0,228
17161000705,1004,758,583,81,43,14,31,0,175
17161001101,826,672,624,17,18,6,3,0,48
1719500ST12,1396,1126,887,165,53,17,2,0,239
1719500HO01,1018,811,718,64,8,11,7,1,93
1719500NE01,424,324,308,7,1,3,1,0,16
1719500ER01,1076,809,786,6,0,8,4,0,23
1719500CO07,1019,852,665,104,22,20,8,0,187
1718700TO01,900,681,634,15,11,13,6,0,47
17031780032,2053,1660,911,657,15,60,73,0,749
17031755004,1362,911,105,292,482,32,37,1,806
17031031032,1558,1158,125,979,71,84,12,2,1033
17031030019,2991,2154,151,1902,81,117,34,0,2003
17031031028,1625,1221,99,1075,37,74,25,1,1122
17031031021,1488,1073,83,930,53,82,14,5,990
1701500RL01,916,710,659,17,11,10,8,0,51
1701500FD00,799,687,664,1,4,8,4,0,23
1701500CS01,568,471,455,13,0,6,1,1,16
1701500SM00,350,285,274,9,0,1,0,0,11
1701500MC03,493,409,395,6,1,0,2,0,14
1701500CS02,971,722,679,23,6,4,7,1,43
1701500MC01,580,495,464,12,13,2,2,0,31
1711700NP01,845,660,633,4,0,14,3,0,27
1711700VD02,1314,1000,953,14,4,16,5,1,47
1718700CO01,439,374,351,8,6,1,2,0,23
17161000301,632,514,478,7,5,15,2,0,36
17161000711,1449,1191,935,109,80,19,46,0,256
1710500DW02,887,681,631,16,2,10,7,1,50
17043005063,943,725,572,57,13,12,57,3,153
17043001009,1171,905,490,350,33,34,29,0,415
17043001029,1049,859,594,161,15,18,84,2,265
17043001065,946,774,510,139,7,15,107,2,264
17043006001,788,599,519,41,8,7,22,2,80
17043002008,1251,1101,927,56,48,0,59,0,174
17043002010,1211,948,693,131,19,12,103,2,255
17043002029,1063,865,707,76,14,14,62,1,158
17043005120,720,540,287,64,14,7,177,0,253
17043005016,835,621,550,23,5,3,32,1,71
17043005026,2137,1608,661,381,117,27,419,0,947
17043005042,937,719,536,76,36,24,47,1,183
17043009009,1197,936,743,112,25,15,44,0,193
17043005011,842,606,540,33,7,6,15,2,66
17043005059,953,625,591,13,1,8,7,0,34
1718700SU01,505,390,362,8,3,10,6,0,28
1718700HA01,334,276,262,9,1,1,6,0,14
1718700SG01,383,300,292,2,1,1,4,0,8
1718700KE01,380,321,314,0,2,2,2,0,7
17031034039,839,602,4,20,581,12,1,0,598
17031034027,813,651,3,16,638,8,1,2,648
17031005005,1433,1040,29,45,970,8,11,1,1011
17031005013,1353,1014,23,21,967,13,7,0,991
17031017033,931,683,4,158,529,25,3,0,679
17031017019,869,614,3,107,507,20,1,0,611
17031017031,855,639,0,91,549,11,1,1,639
17031018028,1192,909,282,463,161,45,5,0,627
17031970072,1388,1114,628,151,314,13,14,1,486
17031013001,1046,831,313,486,12,39,6,0,518
17031013026,1380,1062,332,650,63,59,23,0,730
1719900HE16,613,522,486,4,0,13,6,0,36
17043001032,830,712,484,99,11,8,111,0,228
17043001002,2706,1861,356,1398,60,81,44,3,1505
17043001036,1127,876,362,411,17,31,84,1,514
17043004021,1310,1043,703,127,110,19,93,1,340
17043004097,842,707,421,22,27,6,226,0,286
1714300PE31,1019,698,278,61,340,9,10,1,420
1708700VI01,553,447,409,19,9,9,2,1,38
1719900CO02,549,430,411,5,0,5,4,0,19
1714300PE32,1394,994,345,142,425,9,66,0,649
17043001041,1435,1164,636,429,21,37,65,0,528
17043001053,1570,1268,699,431,18,51,121,7,569
17031015021,602,466,3,120,354,12,0,0,463
17031015017,803,598,11,123,462,20,8,0,587
17031006028,929,683,8,25,652,4,1,1,675
17043007039,2784,1936,669,962,114,35,186,0,1267
17043009124,502,480,429,5,13,0,30,0,51
17043009022,1034,871,601,85,54,14,122,1,270
17043009023,661,473,456,11,1,4,5,0,17
17043009133,865,644,603,6,6,3,21,0,41
17043003086,885,711,571,72,10,2,52,2,140
17043001042,860,693,518,126,14,11,36,3,175
17043001048,2299,1655,335,1177,64,79,75,1,1320
17043006046,1073,770,358,51,30,4,321,3,412
17043006080,834,585,331,23,20,4,200,0,254
17043006071,803,586,384,32,23,1,144,2,202
17179001913,1263,956,878,15,6,36,8,1,78
17179001916,1303,1030,961,20,6,17,11,0,69
17179001910,1004,802,745,9,7,12,26,2,57
17179001901,1911,1434,1306,28,16,47,13,0,128
1705500BE01,1339,1076,1015,11,14,19,6,0,61
1705500BE07,1099,868,799,12,13,22,13,3,69
17043002088,980,737,260,323,19,37,124,2,477
17043002027,1244,983,423,426,25,27,99,1,560
17043002019,880,718,630,47,4,5,28,0,88
17043001060,937,808,622,101,9,32,66,0,186
1717300SI01,726,547,535,2,2,3,4,1,12
17031752003,1747,1272,169,299,760,43,68,8,1103
17031754006,1867,1720,1103,85,150,18,354,2,617
17031031038,1417,1036,71,935,30,61,8,1,965
17031031002,1205,920,97,776,45,32,19,2,823
17031038040,1231,980,552,313,32,33,79,3,428
17031038011,1115,888,547,261,21,19,51,3,341
17043003109,738,673,574,28,17,4,53,1,99
1710500AM01,781,596,566,12,0,13,1,0,30
1710500PT10,1260,966,911,25,22,9,4,1,55
1710500PT06,1013,796,740,18,10,14,7,0,56
1710500PT08,1160,888,774,59,31,21,0,0,114
1710500PT05,1058,796,699,47,20,25,5,0,97
1710500PT02,1482,1146,976,84,44,17,10,0,170
1710500PT09,2551,2345,1268,288,747,17,37,0,1077
17001013001,579,429,425,0,1,2,1,0,4
17001022003,971,777,721,8,6,15,10,1,56
17001023002,1089,948,841,9,64,29,2,1,107
17113003027,1174,878,772,28,24,13,33,0,106
17113000502,1963,1554,1314,123,51,43,19,7,240
17113COB013,2233,1717,1051,379,230,39,21,8,666
17113COB011,1673,1364,989,57,131,22,160,1,375
17113COB020,1683,1434,1074,74,126,17,138,1,360
17113000201,280,201,195,0,4,2,3,0,6
17031022013,2410,1728,52,1631,28,158,15,0,1676
17031027032,1045,862,182,97,514,8,59,0,680
17031027017,1216,952,197,89,634,10,44,2,755
17031810011,1794,1231,1123,39,2,7,52,1,108
17031760044,2067,1583,1142,241,85,55,90,2,441
17031037021,1477,1079,39,596,458,29,7,0,1040
17031037027,1105,832,16,154,659,13,11,7,816
17031037020,1195,879,7,178,688,10,7,4,872
17031027050,1090,787,19,38,732,8,7,2,768
17031027030,663,520,45,58,412,3,5,0,475
17031011032,617,531,332,68,27,11,104,1,199
17031011034,597,561,183,38,33,4,307,0,378
17031011029,1450,1147,519,237,23,25,357,1,628
17031011023,756,631,241,120,2,7,262,0,390
17031028010,1665,1293,402,120,440,9,336,0,891
17031028018,705,535,36,5,367,4,120,0,499
17031017010,1383,1067,4,31,1048,12,6,1,1063
17031790069,1476,1108,1024,50,12,3,11,2,84
17031880029,1323,1029,901,66,20,15,31,0,128
17031930032,1878,1481,1108,130,47,14,175,0,373
17031002006,1509,1397,949,235,71,16,140,8,448
17031027037,1182,1057,523,86,339,17,80,4,534
17031032033,1390,1182,852,167,51,6,111,0,330
17031027006,1511,1252,612,74,477,17,88,0,640
17031755001,1715,1263,144,308,803,54,16,2,1119
17031029004,1229,956,18,213,722,6,10,0,938
17031029025,1045,854,4,145,702,3,4,0,850
17031830012,2109,1564,1336,58,14,17,122,1,228
17031800047,1671,1324,809,348,19,25,140,1,515
17031800049,1462,1193,717,209,29,16,235,3,476
17031890090,2056,1564,1190,283,28,53,34,2,374
17031021029,893,773,1,29,750,5,2,1,772
17031021013,1007,812,7,24,786,6,5,0,805
17031021048,878,714,2,18,695,9,4,0,712
17031021052,922,725,3,16,708,8,0,1,722
17031720063,1667,1261,91,53,1084,22,20,1,1170
17031720029,1632,1236,53,47,1128,12,21,1,1183
17031720008,1005,737,36,25,658,11,10,0,701
17031950034,1865,1399,49,55,1296,10,5,0,1350
17031950087,1750,1313,47,59,1219,7,4,1,1266
17031950040,880,677,21,19,628,9,2,0,656
17031950010,1891,1414,165,434,813,17,3,2,1249
17031950012,1594,1156,130,423,601,17,0,0,1026
17031015016,2213,1583,44,1350,176,47,6,3,1539
17031790047,1163,854,763,43,14,16,14,0,91
17031021041,851,684,4,6,673,2,1,0,680
17031034046,550,424,0,9,411,11,6,0,424
17031034052,558,461,0,16,449,3,1,0,461
17031021037,708,607,3,11,593,5,2,0,604
17097Wau329,3854,2498,1752,320,95,40,287,6,746
17097Wau330,1781,1239,1030,72,23,13,88,2,209
1705500GD02,1263,995,951,17,6,17,2,0,44
1705500SX02,998,793,748,17,6,14,4,0,45
1705500SX03,1087,866,808,11,4,22,4,0,58
1705500FR04,1731,1370,1289,22,10,35,11,3,81
1705500TY04,1392,1071,1029,7,10,21,0,2,42
1705500TY02,1556,1240,1172,6,10,31,4,1,68
1705500FR01,1891,1539,1456,24,9,32,13,0,83
1705500DE05,984,765,707,5,5,33,6,1,58
1705500NR01,456,330,322,2,4,1,0,0,8
17177001807,1182,908,619,52,194,33,6,0,289
17177001802,1348,969,659,67,232,16,9,1,310
17135000403,851,680,634,8,2,25,4,0,46
17135000401,1453,1230,1065,21,114,10,4,0,165
17135000601,386,291,275,7,0,0,2,0,16
17135001004,796,605,572,6,3,9,11,1,33
17001015001,407,298,292,1,2,4,0,0,6
17001006001,595,471,446,4,3,12,4,0,25
17001005001,747,564,541,4,2,8,3,1,23
17177000701,1391,1101,1034,24,14,21,6,1,67
17043006048,891,611,353,57,61,8,128,0,258
17043006075,1274,1035,532,153,211,22,125,0,503
17043003059,959,739,560,48,11,1,117,5,179
17043003119,668,556,322,17,10,5,208,0,234
17179000202,565,419,391,6,4,10,4,0,28
17179000203,2958,2681,1890,151,534,84,8,2,791
17179000204,2032,1620,1528,16,12,35,21,2,92
17179001909,1093,876,821,22,5,20,2,0,55
17179000401,1069,801,748,10,9,20,1,0,53
17179000402,865,641,605,4,10,12,4,2,36
17043004127,546,426,207,11,5,1,197,1,219
17043004069,395,333,210,21,8,0,90,0,123
17043004109,647,481,294,7,10,3,171,0,187
17043004051,790,642,442,17,22,2,157,0,200
17043004076,721,572,426,19,19,3,104,0,146
17007009003,1214,877,615,182,30,31,17,0,262
1703900CL07,923,717,646,47,4,11,5,3,71
1703900TU01,751,606,573,13,2,12,3,0,33
17031970088,1174,890,461,283,129,16,19,1,429
17031970008,2126,1624,737,350,485,31,53,0,887
17031970081,1231,976,814,102,28,10,25,2,162
17031730001,2478,1797,225,976,579,45,14,3,1572
17031880039,1500,1142,968,74,5,0,85,1,174
17007001012,1925,1458,937,395,53,48,39,0,521
17031890039,2070,1620,273,645,649,43,56,0,1347
17031016002,1727,1186,29,616,542,64,4,6,1157
17031016007,1767,1193,32,729,440,51,5,3,1161
17031860017,1170,964,675,80,147,13,48,0,289
17031950051,1341,1001,460,218,300,23,11,4,541
17031900046,2074,1499,23,39,1425,11,18,0,1476
17031720004,1546,1250,765,187,236,16,54,0,485
17181000104,1312,1142,956,21,104,16,14,1,186
17181000105,811,617,544,32,18,12,2,0,73
17113000701,922,709,676,16,4,13,2,0,33
1711700VD04,588,475,448,6,7,7,9,0,27
1711700VD01,761,603,565,5,4,14,4,0,38
1711700VD03,676,558,545,4,0,7,2,1,13
17097Ver272,1537,1140,736,34,22,16,333,1,404
17097Lib185,1531,1146,976,49,12,8,86,2,170
170970Ela92,1874,1434,1046,224,36,38,104,1,388
170970Ela85,1332,1042,833,77,17,13,95,0,209
170970Ben51,1328,1047,763,128,56,29,44,0,284
17097Zio414,1774,1413,700,374,271,44,34,5,713
170970Ben56,1212,988,748,127,62,21,28,1,240
170970Ben59,2327,1771,480,738,417,70,110,5,1291
170970Ben58,1538,1205,601,421,118,54,26,3,604
170970Avo24,2731,1991,475,1365,89,137,27,0,1516
170970Avo19,1887,1390,619,502,192,46,62,4,771
170970Avo20,1728,1278,586,580,45,62,34,7,692
17097New229,1168,983,825,102,13,22,22,0,158
17097Shi234,4003,3185,1482,497,727,61,427,33,1703
1709700Ant9,2176,1449,1044,153,73,31,135,8,405
1709700Ant6,1636,1262,1076,111,34,17,19,0,186
170970Ant13,1655,1158,874,79,60,17,118,2,284
17097War313,1708,1340,719,181,153,31,256,7,621
17097Lak154,2361,1703,1309,181,56,16,150,0,394
17097Lak159,1915,1398,770,414,80,44,106,1,628
17031013007,1330,961,187,752,16,60,1,0,774
17031900005,1225,1054,163,26,848,9,14,0,891
17031710006,780,489,29,49,402,11,13,0,460
17031710029,737,556,9,22,525,7,2,2,547
17031710010,521,388,4,1,381,0,2,0,384
17031047010,1394,1245,892,187,59,27,106,1,353
17031047005,1281,1099,754,158,93,23,75,1,345
17031045021,1257,1002,648,244,28,8,87,1,354
17031045022,1360,1078,671,226,21,24,145,3,407
17031970030,1960,1520,1075,327,67,42,35,1,445
17031940011,1888,1469,874,514,26,36,50,0,595
17031016004,1479,1074,11,335,739,33,4,1,1063
17031016006,1011,736,11,188,541,9,5,1,725
17031019038,746,651,223,22,391,12,12,1,428
17031019010,908,676,403,38,214,17,10,0,273
17031019018,761,544,373,38,127,16,10,2,171
17031019056,775,625,363,49,204,17,10,0,262
17031820061,2516,1974,957,203,119,25,689,1,1017
17031800051,2360,1928,971,255,77,14,627,2,957
17031800001,2224,1823,823,443,17,36,533,3,1000
17031890053,2121,1499,27,402,1083,19,10,1,1472
17043001007,853,672,414,201,10,15,39,0,258
17043001051,895,758,620,82,3,13,46,1,138
17043006086,1128,806,348,177,205,21,56,0,458
17043006088,921,704,386,153,74,17,80,0,318
17043006040,960,670,379,153,56,25,82,2,291
17043006052,977,662,274,218,111,20,47,0,388
17043006087,724,529,313,123,47,15,47,0,216
17043006044,1162,887,433,44,94,19,306,2,454
17043006059,1258,948,448,190,151,21,157,0,500
17097Ver259,3106,2290,1329,136,66,13,727,3,961
17097Ver250,1630,1244,862,65,21,9,287,0,382
17097Ver263,1470,1275,967,34,18,0,247,0,308
170970Avo50,1461,1097,784,112,59,21,122,1,313
17097Fre110,680,478,388,37,7,7,37,4,90
17113COB046,1631,1184,777,258,107,36,5,2,407
17113COB026,1079,731,392,87,225,17,2,0,339
17113003018,2784,1861,1356,56,72,15,360,0,505
17031900051,1532,1215,116,23,1056,23,6,0,1099
17097Ver287,1597,1273,1090,43,18,8,105,0,183
17097Ver286,3061,2380,1346,127,63,11,822,0,1034
17097Zio412,2302,1701,514,605,502,96,35,3,1187
17097Zio415,1878,1457,582,457,395,37,10,2,875
170970Ben60,1490,1199,653,309,174,49,40,3,546
17097Ver269,1675,1203,943,54,12,8,186,3,260
17113001502,1508,1145,1075,21,8,30,11,3,70
17113001501,1239,970,926,9,12,20,2,1,44
17097New228,2629,1986,533,539,464,44,442,8,1453
1714300LI10,883,685,633,12,14,16,12,0,52
1714300PE60,1116,889,504,48,286,18,35,0,385
1714300PE26,1091,853,431,62,327,18,18,2,422
1714300PE61,1239,989,538,26,378,9,33,5,451
1714300EL01,957,727,690,7,4,13,6,0,37
1714300EL02,706,525,487,14,1,13,5,4,38
1714300EL03,855,647,613,10,11,5,3,1,34
1714300HO02,876,688,641,9,9,13,9,0,47
1714300HO01,953,758,725,2,9,7,3,0,33
1714300LO01,982,784,751,6,10,16,6,1,33
1714300LO03,1038,815,761,13,8,16,8,0,54
1714300PE35,1089,772,263,93,403,10,6,0,509
1714300WP04,1115,871,636,36,155,17,18,0,235
1714300PE19,1045,866,663,56,101,23,35,0,203
1714300PE64,1443,1285,857,35,360,10,20,1,428
1714300PE65,656,576,373,13,171,1,14,3,203
1714300PE57,930,744,546,13,154,14,9,1,198
1714300PE37,1250,915,459,133,304,17,9,1,456
1714300PE39,882,689,532,19,111,15,5,0,157
1714300PE38,988,841,708,30,57,24,19,0,133
17031019048,1226,956,26,34,896,12,4,2,930
17031034017,1032,830,2,19,807,11,3,0,828
17031019042,632,546,206,31,290,7,19,1,340
17031970036,1596,1336,706,299,241,16,87,1,630
17031940007,1335,988,432,485,18,44,50,2,556
17031013022,914,706,411,278,10,14,6,0,295
17031950063,916,682,144,140,399,11,4,1,538
17031880036,2030,1701,1440,139,55,28,45,2,261
17031880014,920,734,594,80,24,3,24,1,140
17031880013,1281,1024,840,83,23,12,52,2,184
17031880010,1367,1118,990,55,21,6,34,0,128
17031720030,1419,1115,853,129,88,21,30,1,262
17031720053,1120,824,563,108,137,16,4,2,261
17031860073,1859,1570,1219,102,119,9,117,2,351
17031032031,1441,1174,864,152,36,25,105,1,310
17031860064,1853,1394,1244,72,18,17,47,2,150
17031860018,1682,1324,1115,82,15,10,93,0,209
17031034005,739,586,0,12,578,11,1,1,586
17031034010,756,589,4,6,577,4,0,0,585
17031039043,937,740,571,86,8,16,70,0,169
17031039045,879,643,484,72,12,8,63,0,159
17031008022,768,590,7,9,580,4,1,0,583
17031008047,667,564,6,16,547,10,2,0,558
17031720014,1761,1308,345,779,173,47,4,0,963
17031720045,1712,1221,45,726,367,44,86,2,1176
17031720055,1743,1322,244,776,298,52,7,4,1078
17031720043,1773,1296,347,644,276,44,21,1,949
17085001801,832,718,701,8,6,4,0,0,17
17161000906,1124,886,544,61,253,11,14,1,342
17161000908,567,408,254,47,95,8,8,1,154
17161000811,1382,993,682,215,80,20,9,2,311
17161000611,1232,926,549,260,100,18,2,0,377
17161000724,1156,954,811,67,36,19,15,0,143
17161000708,1008,825,663,56,28,5,70,0,162
17161000612,1626,1241,832,152,176,20,67,0,409
17161000614,1625,1383,1026,169,107,34,52,1,357
17161000615,1372,1040,786,123,94,20,17,1,254
1719500CO06,1113,888,778,69,18,8,5,1,110
1719500CO10,1152,938,825,68,4,24,2,2,113
1719500FU03,1495,1199,1107,39,14,18,8,0,92
1719500HU01,351,293,278,7,3,4,0,2,15
17031027005,1127,873,54,351,465,39,17,0,819
17031027003,992,707,45,244,418,15,4,0,662
17031027034,927,696,16,112,570,4,1,0,680
17031037013,1155,869,17,334,535,23,4,1,852
17031029014,1042,827,8,44,781,12,2,0,819
17031029028,1323,1041,9,47,984,15,1,0,1032
17031980015,2506,1884,182,1478,181,105,53,2,1702
17031980021,2730,1979,159,1725,81,156,17,1,1820
17031034037,704,549,7,16,528,5,0,0,542
17031034028,792,590,5,17,561,10,4,1,585
17031034041,712,527,4,11,518,2,6,0,523
17031034032,902,718,10,10,698,9,3,0,708
17031034047,962,689,0,12,683,5,3,0,689
17031034019,1184,848,23,35,790,19,3,2,825
17031034013,945,713,8,28,679,17,1,0,705
17031013019,1959,1459,76,1285,86,100,17,1,1383
17031013041,1641,1176,90,1028,56,73,8,2,1086
17031016016,914,672,1,115,553,12,2,2,671
17031016024,513,400,3,92,307,1,1,2,397
17031970015,2500,1921,1081,386,393,48,49,3,840
17031970070,2017,1620,1171,287,87,32,49,1,449
17097War312,1504,1179,845,87,53,9,169,3,334
17097Shi231,2804,2019,107,816,1043,55,41,2,1912
17097Ver280,1507,1111,781,34,10,4,269,1,330
17097Ver281,2245,1685,910,100,60,17,578,3,775
17135001104,640,501,459,19,3,9,8,1,42
1705300SV01,479,374,349,7,3,13,0,1,25
17031970016,2059,1664,1246,292,56,36,49,8,418
17031970098,1528,1277,885,136,84,9,161,1,392
17031970061,1435,1128,857,212,29,9,11,0,271
17031710042,940,746,186,49,505,16,1,0,560
17031710050,1014,780,247,24,453,10,43,3,533
17031950020,1118,882,529,103,228,20,10,1,353
17031950082,1271,1028,633,184,204,10,2,0,395
17031950123,793,626,83,57,482,7,8,0,543
17031950090,1038,815,73,50,696,14,1,0,742
17031950080,967,785,120,29,633,3,2,2,665
17031950026,1274,1008,276,152,567,17,8,2,732
17085002102,755,581,544,17,2,11,0,0,37
17085002101,732,589,579,2,0,7,0,0,10
17047000501,324,261,258,3,0,0,1,1,3
17031037033,1306,1019,6,140,880,10,1,1,1013
17031037014,1198,914,13,314,584,26,12,1,901
17043001033,2225,1776,682,636,299,61,149,1,1094
17043001021,1596,1344,778,473,49,33,41,1,566
17161000607,761,612,534,37,33,1,2,0,78
17161000807,1218,879,512,258,87,33,3,2,367
17097Ver247,3142,2384,957,225,125,33,1034,4,1427
17097Lib195,3268,2409,776,1373,54,104,189,1,1633
17097Lib188,2757,2069,664,1270,51,94,69,5,1405
17097Ver275,1665,1228,858,27,8,6,325,0,370
17097Ver274,1419,1048,745,22,5,8,261,2,303
17097Wau377,1977,1271,61,478,717,48,13,4,1210
17097War327,4528,3204,432,1589,360,117,803,3,2772
17007001021,931,732,656,45,7,1,16,0,76
17007008001,485,387,355,23,0,3,4,0,32
17161000201,1733,1307,1245,28,5,18,2,0,62
17161000401,705,563,534,9,8,7,4,1,29
17161000609,688,542,464,42,15,7,11,1,78
17161001402,1526,1217,1116,41,11,28,6,1,101
17161001401,1761,1450,1369,27,20,26,4,0,81
17161001301,1017,783,731,12,8,10,9,0,52
17161000101,874,687,648,8,7,13,0,0,39
1719500CO03,721,553,412,86,19,13,8,1,141
17043003136,616,536,396,56,27,9,52,0,140
17043003128,869,711,436,84,108,7,62,0,275
17043003095,842,673,524,26,9,1,115,0,149
17031756002,928,641,563,23,29,7,17,0,78
17031810033,1543,1070,884,66,21,5,82,3,186
17031033016,2340,1929,702,998,84,120,142,3,1227
17031035004,1373,1083,395,510,46,25,125,0,688
17031751002,1849,1750,1065,83,175,1,409,0,685
17031752001,3069,2579,1520,209,278,37,521,1,1059
17035000801,325,257,239,0,3,12,1,0,18
17035000302,1211,970,921,18,8,20,3,1,49
17035000401,1332,963,935,7,0,12,5,2,28
17035000501,555,437,422,2,1,10,3,0,15
17153001001,532,418,316,6,86,9,5,0,102
17153000601,626,512,422,1,72,10,1,1,90
1710900MC12,664,509,445,15,24,14,14,0,64
1710900MC03,1835,1650,1152,101,242,25,145,5,498
1710900EM01,1261,935,815,23,32,19,44,2,120
1710900MC01,812,626,517,25,43,16,29,2,109
17043009069,658,526,434,56,9,6,26,2,92
17043009084,845,548,485,27,5,12,15,0,63
17043005057,800,573,503,20,11,4,34,2,70
17043005028,750,518,475,22,3,6,13,0,43
17043005096,949,663,590,26,4,8,33,1,73
17043005012,776,544,458,31,1,5,30,0,86
17043008033,941,749,599,80,31,23,20,0,150
17043008031,1210,876,552,198,34,14,69,0,324
17043004086,839,649,327,61,152,9,106,1,322
17043004119,659,524,404,12,16,1,91,2,120
17043004129,882,633,209,64,174,8,189,1,424
1710900MT01,448,354,339,4,2,4,2,0,15
1710900MC06,1417,1036,836,13,135,29,16,2,200
1701500EK00,197,165,159,3,1,1,0,0,6
17097War303,1188,904,450,262,127,21,54,2,454
17097War302,1252,962,485,328,75,21,55,2,477
17097War304,903,760,476,163,70,23,45,2,284
17097War300,1860,1492,647,379,319,41,134,5,845
17097Lib182,1256,924,811,37,8,15,45,1,113
17097Ver248,2461,1771,773,442,62,63,470,7,998
17097Lib186,1490,1125,962,84,11,13,51,4,163
170970Ben54,1439,1181,836,179,88,43,44,3,345
17097Zio403,1957,1406,358,511,432,44,92,2,1048
170970Cub74,1316,1023,910,42,8,11,48,0,113
170970Cub72,1072,787,711,13,4,7,42,0,76
170970Cub71,1235,913,800,27,19,10,61,0,113
170970Ben57,1285,1045,516,245,174,15,102,2,529
170970Ant10,1142,933,848,30,14,13,18,0,85
1709700Ant7,1627,1249,1052,119,25,13,37,6,197
170970Avo47,1733,1355,961,171,85,32,125,0,394
170970Avo44,1632,1225,854,188,45,16,104,2,371
17097Wau345,2210,1599,269,1132,159,121,33,5,1330
17071001101,227,198,191,3,1,1,1,1,7
17043003030,858,658,577,48,7,2,23,0,81
17043003029,1132,813,669,41,10,9,81,4,144
17043007009,981,812,640,66,18,5,89,0,172
17043002045,971,895,805,59,10,19,15,3,90
17043007037,1003,762,568,70,31,4,75,0,194
17043007019,1119,849,477,146,75,8,146,0,372
17043002073,1226,1051,670,129,69,24,178,0,381
17043009068,1343,1142,905,131,44,19,46,3,237
17043009005,708,560,478,51,14,9,3,1,82
17097Wes383,1076,766,667,21,6,8,57,1,99
17097Wes386,870,653,559,26,7,11,43,1,94
17097Wau371,3410,2674,283,1764,613,140,23,2,2391
17097War293,1730,1330,861,164,118,22,166,5,469
17097War294,1139,914,633,120,63,32,83,2,281
17097New227,1097,897,697,139,33,13,20,3,200
17097Fre115,1694,1319,975,133,10,11,192,12,344
17097Fre118,1141,866,546,64,25,13,215,3,320
17097Ver282,1621,1226,837,57,23,7,301,1,389
17097Lib168,990,683,481,24,13,3,153,0,202
17097Lib169,1352,966,764,37,17,19,122,0,202
17113003030,1228,1219,780,166,221,15,49,1,439
17113COB029,1110,917,638,69,149,21,45,3,279
17113COB028,992,798,699,19,58,14,7,0,99
17113000401,541,430,410,3,2,11,5,0,20
17113002701,238,170,167,1,0,2,0,0,3
17113001701,905,635,594,15,11,6,7,1,41
17113003023,1804,1477,972,179,241,20,73,0,505
17113003024,1739,1379,865,46,401,25,28,0,514
17097War322,1531,1205,934,87,69,13,107,2,271
17097War296,1520,1179,552,264,258,20,100,5,627
17097War325,2061,1571,626,234,202,19,480,3,945
170970Ela90,1398,1015,881,67,2,12,47,3,134
17097Mor215,1373,1083,937,72,21,9,35,1,146
17097Mor219,1243,956,828,57,8,2,52,0,128
17097Wau369,2046,1551,208,924,305,53,101,2,1343
17097Wau370,3283,2368,177,1910,207,145,38,12,2191
17097Lak152,1302,969,833,83,18,14,24,1,136
17097Ver267,2291,1590,659,68,26,10,822,3,931
17097Ver276,1891,1343,697,54,13,7,573,1,646
17097Ver268,2487,2140,1706,95,40,12,276,0,434
1718700MN10,1047,748,528,105,70,18,22,4,220
1718700MN12,1107,899,790,46,20,16,18,0,109
1718700MN11,1083,922,701,102,90,8,21,13,221
1718700MN03,796,650,552,41,30,3,27,12,98
1718700MN08,638,461,282,136,34,13,2,1,179
17097Ver255,1343,1092,722,63,17,8,282,1,370
17097Wau362,2583,1871,240,1163,338,60,141,1,1631
17097Wau368,2267,1606,365,844,311,51,71,1,1241
17097War326,3232,2286,303,1484,215,104,271,8,1983
17097Lib183,1492,1101,954,82,7,6,47,1,147
17097Lib187,1501,1065,920,49,17,6,66,0,145
17097Lib181,1680,1306,1129,40,24,7,96,5,177
17097Lib180,892,663,550,48,6,4,44,1,113
170970Cub70,969,752,666,22,13,6,41,1,86
170970Ela88,1402,1177,954,76,43,7,95,0,223
170970Ela87,2230,1759,1339,234,30,15,133,1,420
170970Ela78,1278,929,797,36,9,10,72,0,132
17097Fre111,2786,1849,1513,124,31,10,161,6,336
170970Ant11,1200,986,899,50,16,12,7,1,87
17097Lib179,1656,1346,1178,75,18,7,55,3,168
17097Lib176,1559,1164,1049,42,25,9,26,3,115
17097Lib172,1882,1522,1236,101,42,14,124,1,286
17191000201,618,462,450,3,0,8,1,0,12
17191001402,383,273,254,4,4,5,3,0,19
1714300PE01,1513,994,346,56,565,25,7,0,648
1714300AK01,1025,767,731,18,1,4,10,0,36
17031820023,1720,1305,737,100,139,6,323,1,568
17031820018,884,734,391,67,53,12,207,5,343
17031800027,740,551,503,35,1,3,9,0,48
17031780010,2254,1794,1077,584,62,30,71,5,717
17031860037,1303,1079,920,73,22,10,48,2,159
17097Lib191,1253,914,556,37,29,7,284,4,358
17097Lib196,686,491,274,11,1,3,200,0,217
17097Wau364,2782,2080,327,1391,300,160,55,5,1753
17097Wau365,2649,1916,117,1533,205,138,50,2,1799
17097War299,2084,1392,358,529,410,41,88,3,1034
17097War298,1830,1381,703,249,291,27,135,2,678
17177001202,451,333,325,0,0,4,1,0,8
17177001201,288,234,225,2,1,5,0,0,9
17177000801,1115,930,899,9,0,7,8,0,31
17135000301,747,595,570,5,4,13,3,0,25
17135001101,893,739,711,6,4,5,5,3,28
17177001808,1354,1135,963,69,81,15,14,1,172
17177000401,654,540,483,21,16,8,3,3,57
1701500MC02,890,730,677,28,6,11,3,6,53
1701500WD00,292,230,221,2,2,5,2,0,9
1701500WN00,317,278,272,2,4,1,1,0,6
1701500YK00,2739,2455,1582,209,598,65,10,1,873
1718900OV01,1679,1304,1241,9,9,27,4,5,63
1714300RI05,1255,976,761,40,135,19,20,2,215
1714300RI04,1140,880,743,31,68,22,17,2,137
1714300PE53,930,687,549,38,55,10,32,0,138
1714300PE52,1074,845,611,34,138,14,47,0,234
1714300PE59,1688,1453,839,33,499,16,56,0,614
1714300BR01,1208,934,865,15,14,20,14,1,69
17169000701,1240,1098,836,19,164,75,10,2,262
17169000702,628,492,476,5,4,4,2,0,16
17169000201,142,128,125,0,0,1,0,0,3
17191001401,947,704,676,5,7,8,0,0,28
17191001001,367,278,275,1,0,2,0,0,3
17097Wau367,2560,1831,258,1281,259,106,52,2,1573
17157000604,1053,844,743,49,19,26,4,2,101
17157000605,3006,2875,1067,281,1502,16,11,1,1808
17157000603,833,623,561,33,8,12,4,0,62
17157001703,961,761,650,21,73,6,8,1,111
17157001701,833,647,470,14,138,15,5,0,177
17157000101,839,659,628,2,1,12,0,0,31
17157000401,244,211,201,4,2,4,2,0,10
17157001802,836,658,631,10,1,15,4,1,27
17157001803,794,633,607,4,1,10,3,0,26
17157001403,922,731,663,21,10,20,8,1,68
17157001404,1773,1366,1327,6,0,11,10,0,39
1718700RO02,493,396,369,6,5,8,0,5,27
1719500ST07,893,649,385,232,26,19,6,0,264
1719900ST02,389,289,274,4,3,5,4,0,15
1719900ST01,758,612,601,0,1,6,0,0,11
1719900WM04,1733,1353,1206,29,47,33,34,1,147
1719900LC04,1103,853,800,15,4,13,4,0,53
1709700Ant3,1748,1264,1071,109,39,13,30,3,193
1709700Ant2,2025,1548,1293,120,30,49,40,7,255
1709700Ant1,1861,1553,1394,86,19,32,16,1,159
170970Ant14,1184,1007,880,58,23,23,13,2,127
170970Ant15,1536,1296,1148,76,8,19,20,2,148
17097Lak143,1050,850,747,53,9,15,18,0,103
170970Ben63,1653,1195,477,594,93,62,13,4,718
170970Ben62,1879,1319,570,591,122,46,15,2,749
17097Lib170,1376,974,727,26,12,9,186,2,247
17097Shi233,10878,10679,4804,2579,2486,189,764,105,5875
17097Shi238,1148,868,803,25,7,0,22,0,65
17097Shi232,1753,1269,198,492,505,43,65,2,1071
17085000502,989,787,716,25,16,19,11,4,71
17085000503,1271,1003,951,23,6,9,9,0,52
17157000301,429,338,316,1,5,3,5,1,22
17113003012,1429,1137,1006,32,68,16,16,3,131
17113001503,1247,911,877,7,5,16,0,0,34
17031049028,2220,1850,694,605,382,68,146,3,1156
17031049018,1760,1535,845,285,277,43,111,0,690
17031049004,2375,1877,696,641,392,85,125,9,1181
17031041046,1087,813,642,107,8,24,44,1,171
17031041026,917,739,610,100,3,8,26,3,129
17031041017,973,802,686,63,11,3,36,0,116
17031920011,1600,1229,1031,145,15,21,23,1,198
17031920004,1807,1345,1041,218,28,16,38,0,304
17031920005,1081,887,639,172,38,18,23,0,248
17031850002,1673,1197,874,64,207,14,56,0,323
17031024036,1184,915,17,82,831,14,1,0,898
17031028046,1889,1646,618,323,324,26,352,2,1028
17031028035,1506,1033,17,49,954,9,10,5,1016
17031028029,664,486,55,47,378,9,14,2,431
17031026006,1063,843,117,628,91,40,31,1,726
17031037024,1441,1102,14,407,680,14,8,0,1088
17031001025,1316,1152,632,318,121,49,77,1,520
17031001024,1602,1319,507,550,240,26,60,0,812
17031001031,1460,1156,465,464,166,40,71,8,691
17031950046,1372,1083,29,26,1025,3,4,8,1054
17031004018,1208,1025,28,28,964,22,9,1,997
17031004032,1473,1108,60,56,992,21,19,3,1048
17031003009,1495,1120,42,29,1039,19,16,3,1078
17031003012,1257,1107,28,29,1058,14,6,1,1079
17031003004,1392,1066,27,36,1004,17,10,0,1039
1719500AL01,1041,792,766,7,1,8,5,1,26
1719500GP01,973,788,764,8,3,4,6,0,24
1719500PR03,827,652,614,16,13,6,3,0,38
1719500PO01,458,364,342,9,2,5,4,0,22
17161001801,758,612,593,11,0,7,0,0,19
17161001016,841,609,291,24,233,22,44,2,318
17161000712,995,742,403,68,173,7,86,0,339
1714500PI01,635,503,481,11,1,4,5,2,22
17085000901,1203,949,872,31,14,29,9,0,77
1714500CU01,578,432,391,16,5,7,4,1,41
1714500PI08,956,760,732,5,1,17,1,0,28
1714500PI05,664,536,516,3,4,7,3,0,20
1701500SA03,426,316,279,23,8,6,2,0,37
1701500SA06,977,808,700,67,19,23,4,2,108
1701500FH00,757,597,577,7,2,5,6,0,20
1701500RL02,1077,812,790,11,6,5,2,1,22
1714500PI07,2573,2437,892,288,1251,15,7,0,1545
1714500DQ08,743,568,525,7,11,18,1,0,43
17161000709,1277,1009,869,65,41,4,16,0,140
17161000713,1569,1242,1018,84,105,16,27,0,224
17161000707,1441,1156,906,145,64,38,14,6,250
1714300RO01,641,509,476,11,3,15,2,0,33
1714300RO02,582,471,454,5,2,12,0,0,17
1714300LI17,1028,804,722,31,16,31,4,0,82
1714300LI20,554,468,435,14,4,13,4,1,33
1714300LI16,698,565,528,7,13,9,6,0,37
1714300PE02,1088,748,234,92,416,12,2,4,514
1714300WP03,1114,892,706,47,132,2,5,0,186
1714300PE16,1241,902,414,62,384,21,16,0,488
1714300PE13,1538,1028,318,204,479,22,33,4,710
17023004001,347,284,272,1,1,6,3,1,12
17023015001,509,395,388,0,1,2,0,0,7
170970Avo48,1393,1030,670,181,88,10,81,0,360
1719900BL01,494,388,357,7,7,13,1,0,31
1719900BL05,1148,898,820,15,14,26,4,1,78
1719900HE14,546,430,395,14,6,4,10,0,35
1719900HE08,849,682,615,16,17,22,4,0,67
171630ESL10,454,360,0,4,354,8,1,0,360
1716300CS25,1658,1257,646,67,480,36,34,1,611
1716300CS26,2794,2296,1110,81,942,40,151,0,1186
17163000CS2,2570,2141,1437,113,465,48,94,10,704
1708900AU04,1676,1320,662,425,179,48,37,1,658
1708900AU11,1919,1501,807,514,150,36,13,1,694
1708900GE11,1466,1105,912,121,14,24,31,3,193
1708900GE10,572,421,319,84,13,11,5,0,102
1708900GE15,941,744,625,91,8,8,12,0,119
1708900RU08,541,450,407,21,5,1,10,0,43
1708900RU02,12065,8508,5912,1497,386,145,622,19,2596
1708900HA02,2916,2339,1971,226,40,49,52,1,368
1708900BU01,1810,1453,1249,157,8,40,8,0,204
1708900SC33,1217,932,818,49,4,10,49,0,114
1708900AU15,2305,1899,1341,283,146,33,113,0,558
170890AC508,1477,1082,432,442,161,44,40,0,650
170890AC513,1383,1087,727,164,132,16,57,2,360
17113003013,1346,1013,882,44,52,6,20,1,131
17113COB001,1100,961,776,59,95,20,16,2,185
17097Wau352,1521,1194,264,609,185,49,114,7,930
17097War307,1393,1105,615,121,215,8,160,2,490
17169000101,146,119,115,2,0,2,1,0,4
17169000401,126,101,97,0,0,2,1,2,4
1719900CA01,830,611,544,19,14,17,6,1,67
1719900WM01,781,637,511,21,75,17,12,0,126
1719900EM01,960,736,614,23,67,21,6,0,122
1719900EM06,1097,865,710,31,82,21,16,0,155
1719900WM06,1122,900,764,21,88,17,12,0,136
1719900WM11,1417,1128,915,94,54,25,32,0,213
1719900WM05,964,778,632,23,61,24,17,0,146
1719900SO02,1110,950,915,2,8,15,6,0,35
170890AC512,1097,888,658,113,60,36,38,0,230
1708900SG03,1182,971,851,63,11,12,25,0,120
170890AC511,1246,1007,703,121,96,26,73,0,304
170890AC108,1559,1211,348,607,201,26,55,1,863
1708900SG06,3225,2473,2147,159,56,25,66,4,326
171630ESL11,642,528,19,0,500,5,2,0,509
1719900HE05,765,596,570,8,3,7,1,0,26
1719900LC02,856,693,626,18,9,27,1,0,67
1719900HE02,1042,798,692,23,44,22,10,2,106
1719900HE09,959,717,642,7,29,21,10,0,75
1719900GR01,676,549,493,17,7,17,7,0,56
17179000301,1411,1113,1054,11,13,18,16,0,59
17179000101,212,160,156,4,0,2,0,1,4
17179001809,1226,930,879,12,12,15,13,0,51
17179001804,1382,1092,1036,10,11,16,11,0,56
17179001802,1180,879,829,9,5,18,14,0,50
17179001201,1290,935,911,8,4,7,0,0,24
17179001202,1432,1073,987,18,17,43,14,2,86
17179001908,1525,1100,980,17,19,62,15,0,120
17179001922,1148,884,821,11,22,21,5,2,63
17179001402,1229,863,822,14,7,12,7,0,41
17071000501,235,183,171,2,1,6,2,0,12
17169000901,343,280,269,9,2,2,2,0,11
17113002501,1528,1115,1043,26,9,18,10,0,72
17113001301,1346,942,879,15,11,28,15,0,63
17113002201,1047,836,791,15,16,11,2,1,45
17113003022,1078,868,704,45,73,19,25,2,164
17031800086,2460,2021,930,342,313,38,449,0,1091
17031800092,2326,1862,1250,183,108,12,325,3,612
17031780048,2534,1942,523,1323,50,69,41,2,1419
17031780031,2021,1573,539,933,46,26,57,0,1034
17031028031,1396,1177,17,190,1064,17,4,3,1160
17031028012,1337,974,3,40,941,4,1,0,971
1714500SW01,776,597,573,6,4,4,2,0,24
1701500SA02,375,323,279,19,7,8,3,0,44
17023002001,230,178,172,0,1,3,2,0,6
17023011001,283,194,188,0,0,5,1,0,6
17163000FY1,601,479,441,19,4,11,5,0,38
17163000FY2,934,761,721,19,5,13,5,0,40
1708900GE16,1054,783,685,37,2,8,25,0,98
1708900GE17,2256,1749,1586,67,31,6,49,0,163
170890AC102,1641,1340,518,482,280,37,52,1,822
1708900AU07,1848,1333,475,768,54,41,21,2,858
170890AC304,2265,1590,309,1122,132,131,22,4,1281
1708900AU05,1725,1254,398,764,71,66,10,1,856
170890AC404,2086,1404,337,879,187,58,4,0,1067
170890AC103,2420,1924,725,929,176,59,85,0,1199
170890AC106,1338,1011,225,736,42,54,6,1,786
170890AC703,2240,1517,113,1271,116,69,17,1,1404
17071000901,227,188,186,2,0,0,0,0,2
17157001402,1189,921,870,13,8,18,3,0,51
17157001706,970,736,566,17,121,10,6,4,170
17157000901,793,640,600,9,2,22,0,0,40
17157001601,827,626,584,6,1,20,5,0,42
17157001201,1113,852,720,99,5,23,5,0,132
17157002101,454,357,350,1,2,2,1,0,7
17023008002,1472,1172,1077,42,20,16,12,0,95
17023013001,648,495,478,1,1,8,6,1,17
17023013002,1433,1142,1101,10,0,18,7,0,41
17179000811,1071,876,784,33,10,31,5,0,92
17179000803,1231,973,905,22,12,15,15,0,68
17179001907,1008,736,695,12,10,17,1,0,41
17179001914,983,757,705,16,6,21,8,0,52
17031010019,1214,951,255,652,33,66,8,1,696
17031010032,1226,928,161,721,35,53,3,1,767
17031010010,1313,939,231,665,29,53,9,4,708
17031950110,939,789,21,51,717,3,1,6,768
17031950058,1797,1331,231,236,860,17,11,0,1100
17031950097,1612,1177,328,559,289,24,1,0,849
17031950032,1559,1073,43,17,1009,9,2,1,1030
17031950030,975,748,21,205,524,20,1,2,727
17031860029,2329,1768,1375,92,108,12,185,1,393
17031860022,1358,1145,918,101,61,13,48,0,227
17031860036,1994,1556,1251,179,28,23,77,2,305
17031860057,1209,989,870,39,26,4,54,0,119
17031900032,1798,1381,260,111,989,35,19,3,1121
17179001813,1502,1091,993,26,13,35,13,2,98
17179000806,1336,1030,935,26,10,38,11,4,95
17179001101,1473,1145,1095,15,3,22,3,0,50
1707700GT01,567,456,437,5,0,13,0,0,19
1707700MB08,802,605,530,12,50,5,10,0,75
1707700PM01,794,629,588,12,3,19,6,0,41
1714300TI03,689,561,528,6,10,18,1,0,33
1714300TI01,728,584,560,8,3,12,4,0,24
1714300PE44,1047,839,495,25,238,10,55,0,344
17031034008,817,605,4,9,594,6,0,0,601
17031034029,723,539,2,24,518,8,2,0,537
17031790007,1389,1056,493,177,355,34,26,0,563
17031023030,1987,1506,177,1288,38,102,10,0,1329
17031023005,1866,1366,85,1242,30,117,11,0,1281
17031023032,1772,1275,127,1084,70,104,4,5,1148
17031710054,1980,1475,382,592,497,29,5,2,1093
17031710056,1486,1156,517,313,312,18,14,2,639
17031720036,875,679,581,46,13,8,22,0,98
17031900006,1581,1245,147,39,1025,19,35,3,1098
17031900041,754,577,77,28,473,7,12,0,500
17031900039,1248,1090,293,18,750,6,29,0,797
17031900021,1819,1332,171,114,1048,26,20,0,1161
17031710007,1480,1178,555,162,435,11,19,0,623
17031710026,1719,1203,334,229,630,22,9,1,869
17071000801,1089,840,798,12,7,12,7,0,42
17179001414,1035,799,755,12,9,8,10,1,44
17179001406,1510,1153,1095,16,5,15,14,0,58
17179001602,878,690,668,3,0,14,3,2,22
17179001412,1319,978,934,12,7,8,13,0,44
17179001919,1213,939,875,22,9,15,4,1,64
17179001407,1109,912,830,26,11,17,25,0,82
17179001410,1035,899,829,19,1,30,14,0,70
17179000812,1597,1300,1204,25,42,13,5,0,96
17179000805,1098,898,839,12,16,16,15,0,59
17179001301,216,180,174,0,0,3,1,0,6
17031960061,1643,1342,1135,99,21,9,73,1,207
17031960003,1437,1111,1023,26,10,5,32,3,88
17031960024,758,748,706,19,4,1,13,1,42
17031890030,1755,1331,259,378,644,34,53,1,1072
17031890043,895,726,10,158,562,30,4,4,716
17031003029,2021,1463,55,46,1273,14,112,0,1408
17031003023,1196,946,29,39,872,14,11,1,917
17031003035,681,519,54,27,427,6,9,0,465
17031940013,1830,1443,916,440,49,21,43,1,527
17023008003,915,661,634,7,1,13,5,0,27
17023008004,1299,984,948,8,4,17,5,3,36
17023008001,895,735,669,24,3,19,13,1,66
17023003001,1132,896,860,5,9,12,2,1,36
17023003004,791,624,610,8,3,3,1,1,14
17023005001,353,286,280,0,1,2,2,2,6
17023010001,301,227,225,0,0,1,0,0,2
17023012001,167,136,134,1,0,1,1,0,2
17191002001,108,84,81,0,0,0,0,0,3
17031012018,2679,1972,157,1690,129,206,21,5,1815
17031920008,1567,1169,877,185,47,11,59,2,292
17031920009,1026,745,646,68,8,4,21,0,99
17031920001,1434,1076,851,145,41,22,27,1,225
17031790067,2106,1630,895,522,156,36,47,1,735
17031991001,1167,932,441,384,79,46,24,0,491
17031991004,1117,916,393,415,89,36,9,4,523
17031790032,585,431,281,131,10,10,3,0,150
17031790056,3963,2948,899,1773,104,108,162,3,2049
17031018043,1334,970,192,699,69,57,10,0,778
17031018046,1667,1188,199,851,126,31,16,0,989
17031950021,1436,1158,151,68,927,10,12,0,1007
17031950076,1239,946,108,86,744,16,6,2,838
17031860033,943,772,675,42,11,7,41,3,97
17031950006,1390,1161,51,48,1060,8,0,1,1110
17031950027,1198,1001,81,24,887,19,10,0,920
17031950107,1223,1073,78,21,958,26,12,1,995
17031950117,1388,1075,331,174,553,24,17,0,744
17031710023,2005,1428,200,162,1056,16,7,1,1228
17031950118,991,819,368,38,405,6,13,1,451
17031970086,1936,1489,1104,302,29,19,41,2,385
17031970076,1124,820,548,157,63,10,37,0,272
17031870010,1515,1144,1007,29,27,12,62,0,137
17067002301,292,224,214,1,2,6,0,0,10
17067002401,630,450,428,6,3,8,3,0,22
17067002201,291,242,240,1,1,0,0,0,2
1707700CB02,1175,910,357,58,431,14,48,1,553
1707700SS04,739,600,564,9,19,5,3,0,36
1707700SS01,945,750,688,11,21,22,5,1,62
17067001302,882,704,664,22,8,11,2,1,40
17067001304,457,327,316,8,0,2,0,0,11
17067001101,1050,800,751,20,9,10,14,0,49
17067001103,921,740,699,8,8,15,4,0,41
1708900RU03,678,678,661,4,0,1,12,1,17
17163000PD1,899,749,727,6,2,9,5,0,22
17163000PD2,1723,1261,1182,24,16,22,10,5,79
17163000SM1,1729,1312,1234,12,23,24,7,2,78
17163000ML1,1595,1239,1175,12,11,22,8,0,64
17163000ML5,1342,1037,978,21,3,19,4,0,59
17163000B35,1756,1317,1128,27,96,14,34,1,189
17163000SM3,1426,1107,1065,12,3,8,3,0,42
17163000SV4,1233,862,658,36,113,8,42,0,204
17163000B22,2143,1549,917,40,523,40,29,2,632
1716300SC14,1145,867,275,9,528,31,44,0,592
17113002001,1192,919,871,7,12,14,10,2,48
17113001102,1125,820,771,12,4,19,3,1,49
17113001101,728,567,543,7,3,12,2,1,24
17031950099,1244,955,112,264,572,12,3,2,843
17031008028,904,727,9,15,704,9,6,0,718
17031008009,678,515,15,11,492,4,3,0,500
17031970019,1643,1292,544,459,279,27,12,5,748
17031970024,1798,1299,172,990,137,44,7,1,1127
17031830001,3694,2917,1267,457,95,27,1095,2,1650
17031008036,953,806,7,4,794,11,2,0,799
17031008053,489,412,2,3,403,3,1,0,410
17031008035,842,686,9,13,659,1,6,0,677
17031008056,866,730,0,7,721,5,0,0,730
17031930074,1013,801,577,42,10,11,161,0,224
17031017038,1384,1043,7,46,986,27,5,1,1036
17031017004,1245,948,0,20,931,13,2,0,948
17031013036,939,695,93,586,11,18,13,1,602
17031040004,1161,917,285,213,81,23,342,3,632
17031040010,2582,1874,455,463,248,39,709,3,1419
17031050026,2710,2086,683,366,251,33,784,3,1403
17031023024,1394,1029,71,891,20,62,55,2,958
17031023026,1560,1216,237,913,26,61,54,1,979
17031041032,1006,803,628,122,10,21,29,1,175
17153000201,525,402,355,8,27,12,0,0,47
1708700CA01,611,479,456,2,7,13,3,1,23
1710900IN01,595,497,483,5,1,9,0,0,14
17153000503,533,392,184,1,200,4,1,1,208
17179000901,565,448,429,0,7,6,1,0,19
17179000705,1483,1182,1078,30,17,25,14,2,104
17179000702,1413,1166,1034,42,36,30,19,8,132
17179000707,1539,1251,1100,52,24,43,15,0,151
17179000602,1964,1559,1510,14,2,22,8,1,49
17031900017,1566,1168,350,93,703,31,23,1,818
17031710025,2115,1490,167,821,480,64,6,4,1323
17031930052,1763,1403,1012,89,18,15,263,0,391
17031014009,1343,1028,423,559,22,46,15,0,605
17031026012,1220,1036,309,531,162,39,50,2,727
17031960029,1034,842,514,158,14,30,152,0,328
17031045047,830,668,463,117,1,7,86,1,205
17031045048,879,713,544,117,13,12,35,0,169
17031890017,998,773,12,196,523,13,41,1,761
17031950081,1048,784,51,25,700,18,3,0,733
17031950015,1348,1009,45,39,928,12,3,2,964
17031950100,957,699,29,64,601,4,4,0,670
17031950077,2027,1584,57,49,1481,8,8,0,1527
17031030027,1360,1048,384,559,59,80,53,4,664
17031030031,958,712,194,380,24,34,108,3,518
17031970003,1348,1008,772,148,49,18,24,2,236
17031017026,1194,931,1,79,860,15,5,1,930
17031017040,836,682,3,37,645,10,4,0,679
17031860062,1392,1116,884,103,30,9,95,3,232
17031860028,975,738,606,62,20,19,41,0,132
1707700CB08,1020,867,625,30,130,21,63,1,242
1707700DS01,1392,1102,960,32,58,34,10,0,142
1714300RI01,1081,872,748,34,66,17,11,0,124
1714300RI02,1013,840,728,28,42,20,13,0,112
1714300CH05,922,697,661,17,6,11,0,2,36
1714300CH08,1213,905,848,29,4,15,3,1,57
1714300CH09,776,628,589,14,4,15,2,0,39
1714300PE90,980,750,622,26,33,6,61,0,128
1714300ME02,1057,834,750,7,24,13,36,1,84
1714300ME01,1006,743,655,24,13,10,34,0,88
1714300PE91,1694,1145,763,32,56,19,279,0,382
1714300PE93,2666,1615,998,40,43,5,518,1,617
1714300PE92,2008,1357,684,48,47,6,556,0,673
1714300ME04,1201,874,762,19,47,13,34,1,112
1714300PE11,2184,1392,334,35,985,21,16,1,1058
1714300PE10,924,679,67,23,590,4,1,1,612
1714300PE12,1587,1475,833,113,428,39,64,1,642
1714300PE23,1009,739,262,69,392,10,7,0,477
17031890037,855,678,14,146,506,21,9,0,664
17031890028,1466,1274,873,187,150,14,51,0,401
17031890024,1665,1182,1077,67,7,17,12,0,105
17031860052,1234,991,834,77,23,3,48,2,157
17031005012,1012,773,5,24,741,5,7,1,768
17031005002,1061,760,0,14,752,10,3,0,760
17031970031,1872,1393,823,214,331,27,15,1,570
17031017036,959,728,5,125,602,7,6,0,723
17031017003,1472,1058,40,219,801,24,3,1,1018
17031870062,3392,2670,909,242,268,10,1218,0,1761
17031870011,1702,1378,778,125,124,9,336,0,600
17031960082,1957,1463,1191,69,24,16,156,0,272
17031009051,707,561,0,9,546,6,2,0,561
17031009042,839,714,7,10,687,8,7,0,707
17031009024,991,854,19,36,791,5,6,0,835
17031016028,878,675,5,9,658,4,3,1,670
17031016025,1106,865,5,35,828,11,5,0,860
17031950042,796,619,5,68,543,9,0,0,614
17031950101,1102,840,4,93,742,8,2,0,836
1708900CA10,1813,1327,1121,63,25,19,89,0,206
1708900CA07,3695,2577,2255,102,33,43,148,0,322
1708900CA03,1368,1092,965,48,18,11,40,0,127
1708900DU29,1097,833,718,47,26,8,32,0,115
1708900DU03,1533,1128,624,410,56,48,35,1,504
1708900DU02,923,781,573,148,22,9,29,1,208
1708900DU07,3300,2435,927,1127,247,92,109,2,1508
1708900DU14,2263,1322,361,601,340,34,18,1,961
1708900SG02,5260,3724,2407,813,291,103,158,9,1317
170890AC514,1246,944,528,209,120,28,75,0,416
1708900EL58,5086,3458,2112,463,166,46,700,8,1346
1708900DU09,2026,1390,255,1051,54,50,25,2,1135
1708900EL09,2577,1771,322,1178,221,119,44,1,1449
1708900VI02,1092,890,812,47,6,14,5,1,78
1708900SC31,2854,1983,1573,106,26,9,232,1,410
17163000B31,1242,976,636,34,261,21,19,4,340
1716300SC12,1601,1227,750,36,368,23,53,7,477
1707700MB02,624,483,353,25,89,10,4,2,130
1707700SR01,722,591,540,17,8,15,0,0,51
17157001801,823,624,573,7,6,22,13,0,51
17157001401,835,691,660,8,3,5,4,0,31
17031039013,1350,1082,380,211,58,39,421,2,702
17031039018,1215,949,479,159,57,17,251,0,470
17031890018,1745,1359,62,202,1100,31,10,0,1297
17031950119,1511,1187,52,121,1000,14,10,1,1135
17031023028,1103,862,406,387,37,11,24,0,456
17031023018,971,773,377,353,29,28,11,0,396
17031027036,762,646,178,91,353,16,25,3,468
17031027039,683,542,63,45,431,6,6,0,479
17031700011,1172,876,527,24,11,5,313,0,349
17031700010,2121,1627,1113,90,15,8,383,1,514
17031040006,1346,1118,825,153,47,17,81,0,293
17031840006,2472,2039,1730,177,12,13,118,2,309
17031890063,1551,1155,890,208,31,15,15,1,265
17031021023,744,591,0,17,576,7,2,1,591
17031021027,885,684,1,10,676,15,0,0,683
17031006020,1045,781,8,31,749,9,3,1,773
17031006018,1346,1057,32,24,997,8,5,0,1025
17031006004,1005,735,1,11,720,4,4,1,734
17031006009,1482,1132,7,14,1101,9,10,11,1125
17031019055,792,609,521,63,19,5,3,0,88
17031740036,4718,3162,649,2418,41,209,49,1,2513
17031740017,2056,1688,993,416,83,51,160,0,695
17031740038,3624,2710,617,1162,249,93,658,9,2093
17031870052,1446,1113,852,34,25,12,202,1,261
17031870019,1286,1047,839,75,14,12,101,1,208
17031870024,2113,1736,1221,276,26,25,169,3,515
17031950028,1289,901,93,127,681,19,10,2,808
17031710001,1295,976,585,68,296,11,24,6,391
17031720026,912,684,189,32,449,7,11,1,495
17031024034,1025,688,10,38,643,5,0,0,678
17031028011,2598,2116,527,514,797,63,326,0,1589
17031019043,1135,947,56,19,874,5,1,0,891
17031018036,1279,953,138,458,351,52,11,0,815
17031018006,941,715,189,320,189,14,10,0,526
17031038036,1324,1041,608,297,33,21,86,0,433
17113COB031,1838,1365,885,191,218,54,40,5,480
17113COB016,1494,1175,810,49,218,23,81,1,365
17171000501,304,245,241,1,0,0,1,0,4
170890AC704,1185,855,213,456,129,15,54,1,642
170890AC705,1369,1177,607,239,158,15,183,0,570
1708900AU10,1634,1157,183,933,31,107,2,1,974
1708900BA05,1531,1145,872,177,45,19,21,0,273
1708900GE01,1243,1024,900,60,17,17,20,2,124
17163000ST1,651,441,15,2,420,6,2,0,426
17119002101,644,518,26,5,488,3,4,2,492
17163000OF8,1976,1430,1151,38,159,29,43,1,279
1716300OF15,1868,1322,996,74,161,29,60,4,326
1716300OF16,1846,1339,1067,55,142,23,57,2,272
17163000OF7,1482,1082,856,29,116,13,62,0,226
1716300OF11,1451,1166,1069,10,39,13,36,2,97
17163000OF1,1435,1079,758,25,238,35,33,0,321
17163000OF4,893,771,644,13,83,2,7,0,127
171630000B8,792,651,448,27,168,6,10,0,203
1708900BA14,1472,1128,980,44,24,10,58,0,148
1708900BA20,1466,1012,896,53,10,13,39,2,116
170890AC109,2555,1860,1328,188,135,35,174,4,532
1708900BA19,2357,1880,1454,192,86,20,129,0,426
1707700CB14,801,662,488,22,91,10,46,0,174
1707700CB16,1041,896,643,52,121,16,65,2,253
1707700CB15,767,643,488,21,64,6,63,0,155
1710900BT01,296,204,198,1,0,3,2,1,6
17115508006,1932,1489,1376,31,39,16,20,0,113
17115508003,1242,998,909,11,54,8,13,0,89
17115516002,1801,1448,1377,27,16,19,1,0,71
17115501060,935,847,571,17,170,13,76,0,276
17115506003,934,805,705,22,56,3,13,1,100
17115506004,1354,1143,919,21,170,16,11,2,224
17115506012,1149,922,716,35,136,25,13,1,206
17115501001,1887,1478,551,34,867,21,13,0,927
17115501003,2638,1961,666,56,1201,47,5,2,1295
17115501047,2316,1719,769,42,867,41,11,0,950
17115508002,2346,1796,1716,14,6,29,17,4,80
17115509001,1867,1409,1343,12,13,33,6,0,66
17115506008,1588,1271,1118,30,87,15,22,1,153
17017000308,584,447,259,141,29,12,11,6,188
17031022003,3561,2551,31,2496,22,178,7,1,2520
17031022004,2536,1809,30,1735,46,135,10,2,1779
17031015019,2094,1563,100,1172,271,64,20,0,1463
17031015015,2952,2063,51,1917,92,89,7,0,2012
17031023025,1998,1481,281,1115,36,89,49,0,1200
17031014018,656,505,136,339,12,15,19,1,369
17031014008,2291,1692,240,1375,17,151,53,8,1452
17031013012,1250,954,221,680,23,89,37,0,733
17031790029,1822,1465,1046,320,46,18,55,1,419
17031950022,1294,965,23,51,891,10,8,1,942
17031034006,949,745,3,11,731,8,0,1,742
17031034026,977,774,6,10,752,3,4,1,768
17031720051,1586,1152,54,59,1037,11,6,1,1098
17031720040,1823,1415,222,62,1128,22,19,0,1193
17031720003,1219,945,633,164,49,23,73,2,312
17031720056,1508,1095,111,49,932,12,3,0,984
17031720072,752,589,478,69,22,5,8,0,111
17031720079,1356,1079,853,111,45,13,67,1,226
1710900BL01,740,582,560,5,2,8,3,0,22
1710900MC09,1152,968,863,22,40,22,11,1,105
17157001101,546,444,430,4,4,4,4,0,14
17157001501,241,210,197,1,1,5,2,0,13
17157000701,583,469,459,0,6,0,4,0,10
17157001901,964,763,694,15,8,30,3,0,69
1707700EK03,626,511,475,7,5,22,3,0,36
17067001901,288,237,232,3,0,3,0,0,5
17067002001,568,440,427,3,5,3,1,0,13
17067002501,723,574,551,3,1,13,0,0,23
17067001502,571,442,411,5,3,16,3,1,31
17067000602,690,524,511,1,3,5,2,1,13
17067001001,218,178,174,1,1,4,0,0,4
1707700MK01,1161,916,763,18,40,36,51,0,153
1707700MK03,1017,825,692,37,36,22,39,0,133
1710900BU02,1492,1156,1060,23,15,28,7,2,96
1710900BU01,1427,1148,1098,6,9,22,6,1,50
1710900MC04,2071,1735,1177,141,303,45,82,2,558
1710900NS01,362,292,261,11,1,16,2,0,31
17031960076,3994,3213,1348,913,174,56,747,3,1865
17031970038,1258,955,393,167,372,14,11,2,562
17031026045,1049,816,83,630,104,18,14,1,733
17031037012,1806,1304,60,820,437,55,12,6,1244
17031027024,1659,1221,43,715,489,44,11,0,1178
1710900EL01,133,97,93,2,0,1,1,0,4
1710900TN01,339,268,240,3,1,14,1,1,28
1710900HI01,217,183,175,2,1,3,1,0,8
1710900LM01,478,325,313,0,1,6,0,0,12
1708900BA10,1872,1362,1177,79,17,22,56,0,185
1708900BB01,1743,1350,1196,79,22,28,9,0,154
17031009004,591,474,0,7,463,8,2,0,474
17031009039,862,652,5,7,642,2,2,1,647
17031009044,693,534,0,8,525,1,1,2,534
17031760034,3013,2285,871,872,289,91,261,0,1414
17115505001,1752,1418,1358,15,6,24,7,1,60
17115507001,1347,1006,951,12,15,12,6,0,55
17115506005,2606,2078,1358,114,468,28,105,1,720
17115501068,1394,1103,955,7,113,16,11,0,148
17171000702,505,382,358,3,3,11,1,2,24
1707500AR01,854,671,623,17,11,13,7,2,48
1707500DA01,883,696,662,15,1,15,3,0,34
1707500CO01,399,327,306,8,1,5,2,1,21
1707500MA01,813,655,596,17,15,14,7,2,59
17031790077,2191,1683,1244,302,72,36,44,1,439
17031790074,1182,957,670,165,87,12,27,4,287
17031019012,806,619,530,69,8,1,2,2,89
17031752005,1163,910,319,118,405,31,65,0,591
17031025014,2113,1804,155,111,136,12,1396,0,1649
17031016012,1483,1015,15,495,504,27,4,2,1000
17031016010,1219,851,15,164,677,12,5,1,836
17031016008,1941,1309,28,931,350,67,8,4,1281
17031020004,1130,774,34,344,319,6,77,2,740
17031020025,986,716,8,177,525,11,7,3,708
17031006008,889,764,7,10,747,10,1,2,757
17031006002,881,741,2,5,733,5,2,0,739
17031038023,1400,1106,585,416,38,20,59,4,521
17031038039,1374,1127,642,403,25,39,51,1,485
1707700CB06,1092,858,517,69,231,22,12,2,341
17067000601,687,557,547,4,6,0,0,0,10
17067001401,257,202,202,0,0,0,0,0,0
1707500BO01,458,331,310,10,4,6,1,1,21
1707500BL03,919,748,705,17,13,7,1,0,43
17191000901,1055,804,770,8,5,19,1,0,34
17031041045,1245,1004,678,189,29,15,104,0,326
17031041036,1093,827,581,135,17,15,75,1,246
17031041043,1007,817,675,59,6,10,64,0,142
17031034015,1083,801,11,19,772,2,0,0,790
17031034050,891,698,8,9,679,4,2,0,690
17031034003,1004,783,9,7,766,1,1,0,774
17031019019,961,744,494,51,186,4,15,2,250
17031019057,622,483,272,28,180,3,7,0,211
17031013021,895,700,454,230,9,15,10,0,246
17031013010,679,530,331,183,3,22,9,1,199
17031800024,1644,1310,1156,76,8,10,60,0,154
17031025024,1634,1341,251,933,116,115,53,1,1090
17031025007,1865,1562,367,995,149,100,66,1,1195
17031025002,1889,1603,453,937,150,99,82,7,1150
17031013046,1529,1098,114,951,16,57,15,0,984
17031950114,1083,836,274,101,445,20,8,0,562
17031044029,1576,1432,1111,105,69,11,136,2,321
17031023015,1689,1238,69,1095,68,61,7,2,1169
17031016035,2877,2032,44,1437,542,88,9,7,1988
17031016032,2341,1691,95,1374,224,88,8,2,1596
17031860002,1454,1184,1012,60,25,4,74,0,172
1708900BA09,1208,952,811,80,28,15,10,2,141
17031011012,1778,1398,954,285,49,25,121,3,444
17031011013,1659,1335,802,349,59,20,111,3,533
17031890021,963,733,604,75,10,18,28,1,129
17031890054,2357,1822,1287,248,198,34,68,1,535
17031890008,1072,958,279,82,538,12,52,1,679
17031890036,1622,1269,26,317,903,42,25,2,1243
17031008024,416,347,1,6,340,0,2,1,346
17071001001,748,614,570,22,1,9,8,0,44
1708900DU26,895,730,609,61,15,17,20,1,121
1708900DU31,1211,993,694,181,54,33,36,0,299
1708900DU04,1263,966,822,93,9,12,32,0,144
17031930003,1631,1298,843,197,33,27,223,0,455
17031930002,4922,3951,1679,689,399,68,1181,3,2272
17031029026,1005,850,91,37,723,10,4,1,759
17031890081,1389,1084,335,275,394,37,84,1,749
17031900022,1795,1431,437,128,857,24,17,0,994
1710500IG02,1003,806,752,19,9,20,4,1,54
1708900EL59,2929,2585,2081,238,83,39,149,2,504
1708900EL27,1158,890,401,390,36,39,56,2,489
1708900EL36,2059,1655,1052,332,120,45,119,1,603
1708900EL49,2226,1677,944,496,103,60,114,1,733
1708900DU35,3839,2988,1679,800,179,72,305,5,1309
170890AC604,1664,1147,332,619,153,44,30,0,815
170890AC401,1622,1248,381,712,144,64,17,2,867
1708900AU03,978,749,371,305,63,13,12,0,378
17163000SC2,928,765,671,17,66,10,1,0,94
1708900GE12,1011,834,724,70,14,14,14,2,110
1708900EL47,3545,2548,1694,283,88,41,435,2,854
1708900DU17,2202,1485,298,1128,48,71,16,4,1187
17031770013,2191,1552,1339,86,26,2,90,0,213
17031017023,718,543,3,64,475,2,2,0,540
17031017035,821,675,6,60,606,8,3,2,669
17031780050,2131,1658,1013,562,34,31,55,1,645
17031045039,1441,1182,724,285,35,35,124,3,458
17031039023,1048,827,664,90,23,14,59,1,163
17031039024,1206,967,711,128,22,21,109,0,256
17031043034,963,908,697,35,31,7,111,0,211
17031043025,998,933,774,53,15,5,85,0,159
1708900RU01,4056,2886,1970,398,108,54,367,9,916
17031001043,944,739,377,254,72,33,35,3,362
17031001007,1012,869,469,259,85,16,55,5,400
17031047035,1350,1015,784,111,31,24,77,2,231
17031047012,1253,995,792,102,26,16,56,4,203
17031890031,840,649,13,61,580,7,4,0,636
17031890022,988,781,15,120,642,6,6,0,766
17031036014,1342,1059,510,461,30,39,56,0,549
17031038034,1464,1151,547,471,54,32,75,4,604
17031036016,1401,1102,466,534,32,52,71,2,636
17031994001,1295,975,285,617,58,37,14,0,690
17031870007,1427,1163,929,134,20,25,46,0,234
17031740011,1369,1078,924,66,6,10,76,1,154
17031780016,2326,1790,823,821,37,51,96,3,967
17031740040,2756,2270,1258,469,109,60,421,8,1012
17031740042,2810,2347,1250,386,196,33,514,8,1097
17031840003,1425,1057,888,80,5,12,70,3,169
17031010012,846,632,116,499,22,49,4,2,516
17031800020,818,611,495,37,14,6,58,2,116
17031890019,1671,1300,28,294,978,20,1,1,1272
1719900CS01,925,711,657,9,2,32,1,0,54
1719900BL07,1036,811,618,16,151,19,4,2,193
1719900BL04,841,673,616,11,13,24,2,2,57
1719900SO01,2635,2391,1667,82,505,110,17,0,724
1713700FR01,1132,889,855,2,7,11,4,0,34
1713700AX01,394,324,317,2,3,1,0,0,7
1713700NT01,266,211,201,1,3,7,0,0,10
1713700AR01,858,709,686,9,10,8,2,1,23
1713700JK17,1330,1094,968,39,49,17,19,4,126
17031008027,744,646,3,16,631,6,2,0,643
17031008005,707,614,1,9,602,9,1,0,613
17031006014,982,761,8,13,747,2,1,2,753
17031006039,1068,815,4,17,794,17,1,1,811
17031006035,709,596,1,9,584,11,2,3,595
17031006046,895,703,1,18,684,6,1,1,702
17031006043,1034,805,3,7,788,7,2,0,802
17031720021,2081,1439,400,414,591,32,17,0,1039
17031720027,2203,1709,929,198,266,25,288,0,780
17031720046,1260,1009,759,105,49,12,72,0,250
17031790023,1552,1353,1123,153,19,16,42,1,230
17031880022,212,195,148,31,1,6,2,1,47
17031930070,1188,919,632,71,15,9,197,0,287
17031790021,1852,1261,1170,44,4,5,21,0,91
17031017016,1916,1423,48,801,560,66,18,1,1375
17031017012,2382,1788,76,1147,567,87,7,0,1712
17031047023,1332,1223,801,142,81,25,160,7,422
17031047019,1688,1577,977,196,117,28,249,4,600
17031026040,994,761,175,473,122,47,25,3,586
17031027044,1226,870,37,205,633,13,8,5,833
17031027008,1198,916,42,149,734,15,2,1,874
17031002004,1376,1240,904,191,37,4,77,2,336
17031002017,1434,1272,1025,113,20,13,85,1,247
17031002021,1355,1164,903,126,38,12,70,0,261
17031930045,2041,1663,830,250,113,16,486,1,833
17031800004,1375,1123,733,134,39,18,189,1,390
17031910006,917,663,567,35,14,5,44,0,96
17031020012,1632,1089,6,15,1065,10,6,1,1083
17031020023,1781,1211,8,18,1183,16,2,3,1203
17031980019,3350,2458,242,2087,125,188,16,2,2216
17031980018,1922,1434,131,1271,34,82,4,0,1303
17031980031,1964,1481,105,1314,40,101,15,1,1376
17031860075,1508,1184,988,33,43,16,99,5,196
17031860065,1133,959,798,61,28,6,60,0,161
17031900026,1647,1311,230,79,967,6,23,0,1081
17031900049,1811,1292,287,101,863,33,31,2,1005
17031003015,1436,1059,11,19,1032,7,4,1,1048
17031003024,1540,1154,37,40,1078,9,3,0,1117
17031730004,1421,1043,42,30,971,9,1,4,1001
17031950092,1493,1155,165,84,895,16,14,2,990
17031950115,1110,879,30,9,830,7,0,1,849
17031950120,1920,1532,122,173,1217,14,5,0,1410
17031950003,1742,1261,112,335,813,20,10,2,1149
17031019032,710,547,495,22,23,8,2,0,52
17031970009,1979,1610,1018,266,272,26,28,4,592
17031019017,696,589,541,32,9,4,2,0,48
17031830053,1332,1094,741,18,12,1,316,1,353
17031830051,4039,3202,2145,145,59,23,811,5,1057
17031830020,1366,1121,855,25,12,6,214,0,266
17031830010,1515,1165,822,86,22,10,209,1,343
17031830007,1904,1491,1118,73,18,12,270,3,373
17031830044,992,743,613,48,6,8,64,4,130
17031026048,927,790,440,243,76,33,39,0,350
17031026020,963,776,355,281,97,19,48,0,421
17031950004,1445,1145,54,60,1028,18,3,2,1091
17031950041,904,688,55,44,587,5,4,0,633
17031018022,855,713,20,46,635,11,4,0,693
17031018008,747,595,25,71,499,1,5,1,570
1719900WM08,1130,885,751,30,59,19,20,3,134
1719900WM10,832,676,584,15,33,16,21,1,92
1715900OL03,1005,774,714,20,7,22,7,0,60
1715900OL06,905,671,608,10,21,19,5,0,63
1715900OL04,1374,1093,1025,21,6,20,12,0,68
1703300HUT2,187,149,144,0,0,2,0,0,5
1719300CA14,703,554,528,5,3,16,4,1,26
1715900OL07,1560,1311,1235,16,9,10,32,0,76
1715900OL09,1075,842,796,13,8,14,10,0,46
17031930043,2068,1554,545,441,260,37,302,1,1009
17031017008,1648,1222,27,395,808,27,5,0,1195
17031880015,1079,827,760,41,5,12,10,1,67
17031880030,1521,1296,1142,50,54,6,35,0,154
17031720017,1308,975,64,55,856,18,6,1,911
17031020013,1704,1218,5,33,1173,6,0,1,1213
17023014001,658,499,490,1,0,8,1,0,9
17023003002,824,661,632,14,7,4,1,0,29
17027013001,1195,906,872,3,18,8,2,2,34
17027008001,1165,911,802,23,46,19,10,2,109
1717300SH01,509,411,384,5,6,7,5,0,27
1717300OK01,871,718,713,0,4,1,0,0,5
1717300CL01,385,283,275,6,0,0,2,0,8
1717300BS01,577,489,476,2,3,1,2,1,13
17001023024,1129,854,793,9,7,5,40,0,61
17001020005,772,594,565,15,10,1,1,1,29
1707700DS02,927,738,668,14,29,19,2,0,70
17027014002,188,148,142,1,1,3,0,0,6
17027004001,365,295,284,5,0,5,0,0,11
17027005001,1439,1019,979,16,5,12,6,1,40
17027006004,1486,1158,1103,16,5,13,17,2,55
1707500LO01,1429,1138,1068,21,14,13,11,1,70
1718700LE01,264,200,197,3,0,0,0,0,3
1718700MN09,790,599,481,67,29,4,13,0,118
17067000201,447,359,339,3,7,9,1,0,20
17067001301,869,676,621,24,8,15,8,0,55
17067001701,246,188,177,2,0,6,1,1,11
17067001303,739,597,539,28,4,12,8,1,58
1707700CB07,727,547,332,109,72,18,13,1,215
17027008003,754,603,548,12,19,14,10,0,55
17171000402,661,517,491,8,3,13,3,3,26
17171000403,676,488,472,5,3,4,1,4,16
1707500MI02,496,390,349,20,3,11,1,0,41
1707500FC01,315,244,232,4,2,2,3,1,12
17031021019,826,659,1,9,648,8,1,0,658
17031021010,704,569,2,9,559,2,0,2,567
17031790044,1761,1271,1174,38,18,9,31,0,97
17027010001,471,376,357,0,0,9,7,0,19
1718700MN05,770,603,457,104,16,12,16,2,146
17153000801,395,322,173,5,142,2,1,1,149
17067000301,365,281,277,1,1,1,0,0,4
1707700CB18,1998,1716,999,106,413,27,165,4,717
1707700MB06,701,524,433,13,61,12,3,1,91
1707700MB03,1087,895,746,13,78,8,39,1,149
1707700MK02,892,721,633,20,23,17,14,0,88
1707700SS03,1020,846,744,25,51,18,4,1,102
1707700SS02,1230,1012,796,34,140,24,9,1,216
17031018041,804,680,23,49,611,10,1,1,657
17031018004,856,685,22,39,613,8,6,0,663
17031048020,1286,1091,700,210,97,14,72,0,391
17031048038,1060,855,578,116,58,24,87,2,277
17031820021,1861,1366,763,139,259,33,190,0,603
17031780024,2888,2196,660,1286,157,95,99,1,1536
17031002030,1091,1007,780,75,27,11,118,1,227
17031002038,1107,1000,836,83,21,7,52,0,164
17031900025,1898,1470,179,94,1163,18,20,1,1291
17031950056,1688,1298,269,242,819,16,10,3,1029
17031950017,1974,1491,380,276,792,35,13,1,1111
17031710035,1761,1251,128,918,201,39,10,5,1123
17031004038,1266,1135,123,30,758,19,210,2,1012
17031004036,1586,1361,100,54,1049,21,162,6,1261
17031020002,653,477,11,136,326,9,2,0,466
17031020032,1095,849,12,134,709,23,4,2,837
17031003010,756,587,9,128,444,8,9,1,578
17031020038,460,347,11,116,204,7,21,0,336
17031020021,1571,1076,22,390,666,26,7,2,1054
1707500ST01,216,155,147,5,0,2,0,0,8
170970Ben55,1268,960,737,104,54,32,25,2,223
17097Wau379,1948,1411,93,659,651,55,15,1,1318
17097Gra141,2514,1969,1518,264,65,44,83,2,451
1703300HCR1,666,522,495,5,3,11,4,3,27
1719300IC08,861,658,633,2,4,9,0,3,25
1719300MS02,328,271,253,1,2,13,0,0,18
1719300CA16,1023,771,704,19,7,18,7,5,67
1708700BU01,427,349,335,2,2,4,0,0,14
1719900EM08,1355,1024,930,26,33,16,6,0,94
17027005002,1515,1204,1161,13,4,15,1,1,43
17027001001,1046,770,747,11,5,1,1,0,23
1703300ROB6,2142,1907,1235,173,491,11,12,2,672
1703300HCR2,769,616,603,0,1,7,1,0,13
1703300PRA1,300,243,234,2,0,3,5,0,9
1719300HP22,645,505,478,3,3,12,0,0,27
1719300CA18,889,657,601,13,20,13,3,4,56
17153000901,659,557,259,132,138,28,6,1,298
17153000401,544,392,160,5,218,6,1,0,232
17153000301,524,420,359,10,32,15,5,1,61
1707500MD03,774,637,575,23,16,10,10,1,62
17031001019,1730,1508,788,549,71,50,106,4,720
17031032020,1249,1036,572,350,71,21,49,1,464
17031011009,1775,1444,384,317,38,30,712,6,1060
17031018042,1139,897,40,340,528,29,1,2,857
17031018031,1099,854,32,321,502,20,0,0,822
17031018023,1060,810,42,255,502,33,11,0,768
17031010027,1897,1387,48,586,747,55,8,1,1339
17031007030,1097,835,20,182,637,17,1,0,815
17031021025,761,619,1,11,601,8,5,0,618
17031ZZZZZZ,0,0,0,0,0,0,0,0,0
17031042028,866,768,508,57,62,3,137,2,260
17031042013,1005,936,630,38,91,14,155,3,306
17031042029,2856,2544,1558,181,141,29,610,2,986
17031042007,1800,1646,1145,97,50,11,333,1,501
17031860056,957,841,702,27,40,5,63,0,139
1708900GE13,1078,933,867,23,13,9,14,0,66
1708900GE06,874,689,643,27,3,5,5,0,46
1708900BB03,4029,2915,2517,204,20,43,120,5,398
1708900HA01,2616,2012,1738,146,54,31,39,5,274
1708900PL03,2741,1852,1400,184,62,31,173,0,452
1708900PL02,3804,3061,2459,212,82,42,257,1,602
17093BR0211,2325,1499,756,461,184,46,83,1,743
170890AC201,1885,1424,248,994,152,88,24,3,1176
170890AC601,2765,2019,482,1113,295,90,134,2,1537
170890AC203,2217,1508,87,1346,79,82,15,0,1421
170890AC202,2323,1674,299,1220,133,118,17,4,1375
17157001301,851,655,611,4,3,29,2,0,44
17031009021,804,655,6,11,641,4,1,0,649
17031012022,2668,1930,95,1781,32,127,19,1,1835
17031012007,2452,1750,116,1539,88,165,22,1,1634
17031870066,4728,3378,925,1954,126,131,365,7,2453
1715900PRE1,786,659,628,5,1,15,3,0,31
1715900PRE2,390,324,317,2,1,3,0,0,7
1703300SWT1,96,83,73,0,0,8,2,0,10
1703300MON1,671,516,498,2,5,10,0,0,18
1719300GR24,1054,854,809,5,7,17,13,0,45
1715900CLAR,852,665,656,2,0,6,1,0,9
17031029032,1683,1395,852,465,22,33,66,6,543
17031029029,1635,1293,750,424,65,39,59,1,543
17031038030,1674,1339,836,410,31,32,65,0,503
17031820052,1391,1095,590,77,29,13,394,0,505
17031810018,994,680,605,28,3,6,32,2,75
17027011003,446,314,285,22,1,1,5,0,29
17027006003,1725,1298,1257,20,2,10,4,1,41
17157001704,782,641,586,4,28,14,6,1,55
17031800076,826,638,397,43,10,6,185,1,241
17031041037,1137,936,787,84,5,14,47,2,149
17031041015,1324,1059,878,115,11,12,40,2,181
17031041011,1156,923,742,145,17,19,17,0,181
17031740049,2963,2400,1408,447,69,35,455,1,992
17031740044,1450,1158,838,77,30,7,198,0,320
17031890009,1099,855,31,211,623,8,0,1,824
17031029012,1234,992,32,173,792,15,10,0,960
17031041041,1120,896,698,124,16,15,44,0,198
17031010021,1290,972,102,805,69,38,5,5,870
17031011018,1902,1478,424,168,12,16,864,2,1054
17031011016,1724,1373,324,168,17,9,862,1,1049
17031011030,1747,1482,109,62,36,4,1277,0,1373
17031011014,1335,1137,233,72,24,8,812,2,904
17031890084,880,758,553,91,84,4,32,0,205
17031890003,1789,1424,324,377,671,33,43,4,1100
17031998002,2010,1538,383,1005,115,55,36,0,1155
17031890047,1335,958,8,333,618,33,3,2,950
17027011001,1422,1049,956,33,20,14,16,1,93
17027005003,1225,951,853,34,14,23,23,1,98
1715900GERM,328,248,241,3,0,4,1,0,7
1703300LAM2,779,622,586,3,2,24,3,1,36
1703300LAM1,1108,876,853,5,2,2,11,0,23
1719300EN04,1124,935,833,32,40,25,8,1,102
1719300PH26,1129,866,832,1,8,17,3,2,34
1719300CA20,888,738,709,6,1,7,8,3,29
1715900DECK,418,323,318,0,1,1,3,0,5
1715900OL10,793,606,572,1,5,15,7,0,34
1715900OL11,799,608,600,2,0,3,3,0,8
1715900OL02,696,523,496,8,4,3,7,0,27
17027008002,1115,899,798,19,63,15,3,0,101
17027008004,808,658,594,6,21,17,11,0,64
17027005004,1121,891,825,12,10,10,22,0,66
17027006002,1117,923,873,26,5,9,4,0,50
1719300CA19,1063,906,855,8,1,22,17,1,51
17031820005,1266,917,585,65,28,10,218,2,332
17031960015,1068,816,687,22,29,6,53,2,129
17031960069,1469,1142,902,106,48,27,83,0,240
17031980014,2185,1599,172,1387,50,131,8,0,1427
17031014022,2143,1677,590,1011,54,92,26,0,1087
17031018007,1164,868,114,329,415,37,7,0,754
17031950065,2078,1534,659,339,505,33,17,2,875
17031900036,3024,2361,170,55,2099,12,39,0,2191
17031900030,1902,1473,87,44,1328,19,15,0,1386
17031900048,1345,1050,16,22,1000,6,10,0,1034
17031950024,1353,1035,689,93,217,11,33,0,346
17031758002,1821,1401,395,283,608,43,102,4,1006
17031042015,2007,1842,1446,73,92,15,212,3,396
17031042039,3033,2915,2230,172,108,28,365,3,685
17031042005,1023,943,768,37,32,8,98,0,175
17031032002,1560,1343,1049,114,47,17,129,0,294
17031001038,1321,1176,767,260,58,16,89,0,409
17031950116,2149,1559,102,739,709,27,1,2,1457
17031950112,1945,1348,88,974,281,48,6,1,1260
17031720022,1205,975,802,74,64,8,22,0,173
17031950102,1041,837,58,102,683,1,0,0,779
17031890052,1743,1247,19,499,728,39,13,2,1228
17031890098,1398,1105,479,478,115,42,32,0,626
17031820030,1582,1248,654,111,11,9,475,2,594
17031045027,1086,866,571,170,11,10,96,0,295
17031045023,1320,1044,700,242,19,14,72,2,344
17031950016,1487,1125,473,227,420,9,7,0,652
17031830048,1213,964,668,15,7,5,262,0,296
17031830041,1112,816,608,37,7,1,154,1,208
17031730010,1243,962,22,24,919,9,0,1,940
17031740031,1128,922,378,165,34,16,332,0,544
17031850028,2139,1815,979,180,489,22,165,3,836
17031016020,922,636,21,118,496,18,1,0,615
17031009027,712,549,4,13,530,9,0,0,545
17031034024,795,608,1,19,592,6,5,0,607
17031034004,769,590,7,13,569,5,1,0,583
17031009001,836,673,7,15,655,3,1,1,666
17031009022,762,620,0,4,613,7,1,0,620
17031009040,810,682,2,3,674,10,3,0,680
17031018014,828,681,9,41,632,8,1,0,672
17031018033,884,672,7,121,542,9,0,1,665
17031790026,1024,679,440,46,24,10,158,0,239
17031790040,1009,680,629,27,5,0,11,0,51
17031034034,776,653,7,11,634,2,3,0,646
17031034044,772,636,5,6,623,2,0,0,631
17031034025,1310,995,8,14,975,3,1,1,987
17031034045,883,691,2,8,682,3,2,0,689
17031020030,606,462,4,38,418,6,3,0,458
17031020039,133,88,5,8,72,2,0,0,83
17031020036,514,389,2,31,355,2,2,0,387
17031010002,1121,885,340,481,44,46,13,2,545
17031010003,1584,1195,459,494,215,46,12,0,736
17031740029,1265,1014,821,95,32,23,50,3,193
17031021046,890,723,4,14,713,3,0,2,719
17031025011,1969,1564,241,1192,92,176,46,2,1323
17031025019,1828,1541,327,1054,85,110,90,3,1214
17031025022,1971,1596,285,1180,76,118,42,3,1311
17031820039,1961,1600,1038,124,55,36,342,2,562
17031047045,1071,898,735,97,19,12,33,4,163
17031047022,1189,977,736,118,37,12,75,1,241
17031047020,1197,995,739,150,32,26,59,0,256
17031047042,1148,1000,703,149,26,22,106,3,297
17031790059,1789,1406,609,637,99,47,41,5,797
17031026038,902,691,13,570,107,19,8,0,678
17031026022,1363,987,41,877,57,57,23,4,946
17031800048,1455,1152,870,158,31,19,76,3,282
17031800061,938,745,524,171,9,16,34,0,221
17031800023,2226,1811,941,225,163,42,471,1,870
17031800064,1342,1086,619,135,19,23,296,1,467
17031003011,1521,1125,26,26,1078,23,5,0,1099
17031003031,1685,1269,20,23,1232,14,12,0,1249
17031008007,890,738,13,17,712,5,9,0,725
17031970054,1477,1106,688,164,205,12,24,2,418
17031730008,1426,1093,141,464,475,31,3,0,952
17031730007,2017,1553,272,698,579,34,9,0,1281
17031018027,1059,767,41,268,457,31,11,2,726
17031018049,1040,771,21,246,500,19,1,0,750
17031017001,1644,1164,53,876,233,86,5,1,1111
17031018050,1192,937,49,314,579,34,11,0,888
17031026015,1191,933,39,780,138,34,6,7,894
17031029001,1040,853,323,257,259,9,29,0,530
17031029009,977,738,302,221,206,26,15,1,436
17031029010,1028,828,315,167,310,19,40,0,513
1715900NOB2,700,502,475,6,4,5,2,0,27
1715900NOB1,736,574,540,11,7,5,2,0,34
1703300ROB9,713,557,519,17,10,11,1,0,38
1705700FA01,884,672,641,14,4,12,0,0,31
1705700CA13,839,698,680,6,6,1,1,0,18
1705700CA08,670,542,520,9,3,5,4,1,22
17169000801,497,378,346,6,13,10,3,0,32
1705700CA11,554,435,396,10,18,3,4,1,39
1705700CA02,813,598,567,9,5,13,4,0,31
1710300HR01,349,281,252,15,1,12,4,1,29
1705700BK03,287,238,227,0,5,9,0,0,11
1710300DX01,1063,873,831,16,6,10,10,2,42
17141000025,677,564,531,13,2,8,3,0,33
1710300DX02,898,678,570,57,38,9,8,0,108
1705700LV01,556,449,435,1,0,12,0,0,14
17091Bour21,1492,1049,840,71,61,25,41,1,209
17091Bour15,1387,1080,891,63,74,16,38,0,189
17091Bour18,1712,1339,779,78,396,16,73,0,560
17091Otto01,1181,986,776,120,57,16,6,1,210
1710300WY02,555,451,405,23,9,9,0,0,46
17091StAn01,2030,1613,1285,228,65,34,8,2,328
17091Lime03,1821,1439,1338,39,16,21,11,0,101
17091Bour19,2832,2061,1649,125,178,54,57,1,412
17091Bour11,2279,1771,1523,118,76,28,16,1,248
17091Sali01,1223,995,928,33,4,22,4,0,67
17093OS0330,2010,1343,857,215,152,25,114,2,486
17093OS0334,1300,997,590,229,88,19,75,1,407
17093LI0102,1270,929,425,417,67,51,9,1,504
17093LI0103,912,707,585,91,9,7,9,0,122
17093BR0217,1396,990,834,88,33,10,23,0,156
17093BR0204,1525,1126,728,210,98,27,55,1,398
17093BR0214,1820,1247,721,362,113,15,38,0,526
17093KE0504,1808,1245,979,154,61,15,27,2,266
17093KE0503,1845,1332,1128,93,56,35,12,3,204
17093KE0502,1228,909,744,95,22,22,24,4,165
17091Mome02,1266,1013,806,131,39,16,3,1,207
17093KE0506,1230,990,885,56,16,15,11,0,105
17093BR0202,758,591,477,73,25,16,2,0,114
1719700MA03,3600,2570,2264,165,60,39,18,3,306
1719700MA02,2891,2027,1779,128,32,27,40,2,248
1719700WT01,799,650,617,22,4,4,2,2,33
1719700HO03,1901,1480,1376,89,0,12,3,0,104
1719700WA03,1985,1532,1325,138,40,16,15,2,207
1719700PL19,2536,1728,1035,381,247,33,38,0,693
1719700DU03,1938,1468,1130,40,39,14,231,0,338
1719700DU07,1833,1331,983,45,23,8,260,0,348
1719700MO01,1755,1380,441,151,746,53,11,0,939
1719700MO03,2278,1817,1194,134,413,47,29,0,623
1719700WA01,1995,1584,1378,97,56,22,25,0,206
1719700MA01,2511,1828,1659,84,47,14,15,2,169
1719700GG01,1877,1545,1381,68,54,23,9,0,164
1719700JO22,2604,1946,751,616,541,39,19,1,1195
1719700JO23,3176,2229,587,637,1003,48,20,2,1642
1702500HRT5,1327,1059,1020,9,6,15,10,1,39
1702500XEN1,617,452,426,7,2,17,2,0,26
17093BR0203,1265,918,785,92,15,23,10,1,133
17093OS0311,1340,1034,758,158,51,25,24,10,276
17093OS0302,2661,1794,1353,228,133,27,66,1,441
17093BR0209,1507,1104,928,103,35,8,22,2,176
17091Kank01,1728,1228,422,346,446,24,2,0,806
1710300BK02,425,319,299,16,1,3,0,1,20
17093BR0206,1452,1075,803,128,131,6,11,2,272
17091Mant01,1651,1258,1106,65,20,37,20,3,152
17091Mant04,1410,1180,1088,43,16,15,7,0,92
17093BR0215,2480,1701,971,429,181,48,91,3,730
17093OS0335,1622,1104,885,103,48,25,34,0,219
17093OS0316,1307,865,618,81,87,12,66,3,247
17093OS0331,1956,1342,936,189,80,18,119,2,406
17093OS0327,711,582,483,69,9,9,9,0,99
17093OS0321,1442,1103,912,113,47,18,26,0,191
1720100Ha13,2331,1830,1416,158,123,50,67,1,414
17201000702,1674,1185,392,225,549,29,3,0,793
17201000701,1653,1177,541,148,451,37,19,0,636
17093BR0212,2120,1423,739,417,167,56,78,2,684
17093BR0216,2238,1464,783,379,211,43,74,0,681
17093BR0218,1277,833,579,164,61,5,6,1,254
17093BR0207,2081,1488,957,302,145,27,61,2,531
1719700PL08,2468,1761,1223,211,119,23,169,4,538
1720100Rt13,1030,825,756,21,10,20,12,2,69
1720100Rt02,1139,907,825,38,20,12,8,0,82
1719700JO06,2225,1601,83,1118,394,50,4,2,1518
1719700CR12,1372,1200,746,147,281,11,13,1,454
1702500BLA1,573,427,411,0,3,3,1,0,16
1702500OSK1,362,265,263,2,0,0,0,0,2
1702500LKB1,569,438,419,1,4,9,0,0,19
1702500STA1,625,488,456,10,2,19,3,1,32
1719700PL06,2503,1799,850,521,300,30,128,1,949
1719700NL18,2136,1581,1396,109,31,18,18,0,185
1719700DU19,2722,1960,632,680,484,73,149,0,1328
1719700DU18,2429,1831,738,541,416,62,133,3,1093
17091Kank15,1515,1159,450,150,546,24,3,2,709
17093KE0505,1292,964,887,40,26,9,8,1,77
17091Yell02,1367,1086,998,47,6,16,3,2,88
17091Gane03,1378,1056,833,124,65,27,5,2,223
17093OS0326,1636,1211,984,103,49,27,44,1,227
1702100RK01,1173,904,865,10,1,16,7,0,39
1705700KR01,79,73,72,0,0,0,0,0,1
1702100TL02,1164,938,882,12,14,14,12,0,56
1702100ST01,993,750,710,5,3,20,4,1,40
1705100AV01,1897,1480,1431,17,1,20,2,2,49
1705100WI01,522,383,371,1,0,5,1,1,12
17095001901,365,274,261,5,1,5,1,0,13
1705100VA03,606,490,436,6,28,18,5,0,54
17141000001,222,179,174,1,3,0,1,0,5
17141000049,3291,2336,1957,253,40,61,17,2,379
17141000034,1479,1149,1071,43,9,19,1,1,78
17141000014,1541,1162,990,129,13,30,6,0,172
1702500HRT7,846,654,615,10,2,11,8,0,39
1702500HRT6,846,656,602,8,6,26,9,1,54
17129000009,819,655,624,4,4,15,2,0,31
17093LI0111,1550,1076,564,329,148,26,31,2,512
17093LI0109,1742,1110,560,351,132,29,52,3,550
17093LI0110,2469,1640,804,553,209,40,64,6,836
17093OS0336,3009,1872,1172,193,273,32,210,3,700
17003000601,736,582,522,11,21,20,4,0,60
17083000401,1001,804,759,9,2,18,9,1,45
17003000105,296,220,90,0,129,2,1,0,130
17091Bour20,3287,2311,1750,249,196,59,45,0,561
17091Bour02,1681,1240,1060,51,70,29,23,1,180
17091Bour06,2594,2017,1640,84,220,21,51,1,377
17091Bour17,1968,1799,1331,184,198,32,56,3,468
17091Bour16,1623,1259,1009,109,79,31,20,0,250
17093OS0332,938,668,493,129,26,24,13,0,175
17093OS0328,1771,1256,834,222,113,17,67,2,422
17093OS0315,1426,1102,532,366,148,29,34,0,570
1703700DK15,879,686,460,168,37,15,18,2,226
1703700DK11,1151,1048,938,51,35,15,15,0,110
17141000041,748,592,560,11,5,5,2,1,32
17165000301,243,189,177,3,5,3,0,0,12
17165000901,405,326,298,4,9,10,0,0,28
17165000609,603,495,458,8,7,14,5,0,37
1705100OT01,1445,1064,1026,10,8,18,3,2,38
1705100VA02,743,595,558,9,6,13,10,1,37
17091Esse01,1512,1178,1082,42,7,26,6,2,96
17091Mome01,2320,1825,1458,227,62,63,6,0,367
17091Kank07,1512,1188,764,179,216,21,11,1,424
17091Bour01,2108,1646,1281,57,204,25,70,4,365
17091Bour05,2376,1893,1578,104,129,25,51,6,315
17093OS0319,1110,879,537,226,74,24,23,0,342
17093BI0702,520,371,347,11,2,13,2,0,24
1719700WH25,2664,1839,1352,164,104,15,201,4,487
1719700PL18,2808,2006,1093,521,180,64,164,1,913
1719700FR28,2594,1909,1473,78,275,15,69,0,436
1719700FR26,1978,1463,1103,72,216,14,65,1,360
1719700DU01,2407,1828,1362,100,57,15,281,3,466
17049001102,862,641,583,31,4,11,6,1,58
17049001104,1018,862,797,14,6,14,27,2,65
17049001103,832,654,610,9,1,7,18,0,44
17049001401,1702,1181,1147,8,1,13,5,0,34
17049000202,1203,897,868,3,5,11,2,0,29
1710300MY01,277,210,193,7,4,5,1,1,17
171670CP033,1842,1563,823,135,509,45,50,12,740
171670CP032,1434,1149,701,60,309,35,55,1,448
171670CP065,927,659,314,23,284,20,21,2,345
171670SP005,1219,981,803,14,113,41,3,0,178
1710300HM01,189,144,126,10,0,1,0,0,18
17093OS0318,937,666,372,224,21,32,17,0,294
17093OS0309,1506,1102,711,297,55,15,31,1,391
17093OS0306,857,614,375,185,38,21,4,3,239
1710300WY01,697,584,531,24,7,18,0,0,53
1710300AM03,1041,842,775,27,10,15,7,1,67
1711100Al23,1215,981,870,61,9,14,13,0,111
1711100Al55,1658,1269,1053,128,17,12,52,3,216
1711100Co02,1225,984,856,84,7,28,11,1,128
1711100Co03,1172,893,798,41,4,11,20,0,95
1711100Mc27,1431,1177,1068,59,9,19,19,1,109
1711100Gr31,1015,767,649,54,7,12,47,0,118
1711100Al13,1363,1040,728,230,21,41,22,0,312
1711100Mc13,1490,1122,816,242,15,41,15,1,306
17091Gane01,1280,1016,771,159,51,17,12,1,245
17091Pemb01,912,711,77,75,558,21,0,0,634
17091Bour03,936,755,572,46,102,12,22,0,183
1704500HU01,232,196,194,0,0,2,0,0,2
1704500ST01,461,355,348,1,0,2,1,0,7
17091Rock01,756,592,567,6,5,5,3,0,25
17049000401,731,579,537,14,0,24,2,1,42
171670DI002,606,455,420,7,4,11,9,0,35
1705100SH01,220,175,162,5,1,9,2,1,13
1705100VA04,687,527,511,0,7,8,4,1,16
17049001301,487,346,334,3,1,3,2,0,12
1719700HO16,2138,1567,1336,132,31,17,45,0,231
1719700HO14,3744,2667,2285,219,38,31,94,1,382
1719700HO12,2131,1589,1425,75,28,17,43,1,164
1719700FR02,2163,1836,1642,91,36,31,29,2,194
1719700TR06,1495,1206,732,238,166,36,50,2,474
1719700JO04,2679,1961,781,973,166,70,26,2,1180
171670CP101,1039,896,780,25,57,12,32,0,116
171670CP058,1061,808,526,24,215,21,27,0,282
171670PA003,952,724,687,3,11,8,0,0,37
1719700NL16,1723,1392,1243,82,31,20,16,0,149
1719700PL01,2572,1679,1199,197,113,19,172,3,480
171670CP053,777,644,514,8,71,4,45,0,130
171670WD012,655,488,362,16,82,4,23,0,126
171670WD008,1190,993,786,37,116,20,31,1,207
171670CP071,894,709,600,21,51,18,12,1,109
171670CP049,1438,1045,642,32,303,25,41,2,403
17043005041,984,728,558,57,53,12,58,0,170
17043005022,944,739,624,49,36,6,28,4,115
17043002038,1684,1383,928,102,72,13,271,0,455
1710300SB01,675,538,499,29,3,8,3,0,39
17043007061,1387,1073,375,167,99,15,428,2,698
17043007029,1105,852,449,160,22,15,218,1,403
17043005087,892,659,592,15,10,1,39,1,67
17043006003,830,609,373,91,50,21,86,0,236
17043003049,1144,805,685,55,5,15,41,0,120
17043009010,1049,795,708,46,7,9,28,0,87
17043002077,800,625,427,79,11,12,90,1,198
17131000201,1039,826,780,19,4,9,4,1,46
1711100Gr14,1424,982,740,49,32,10,143,0,242
1711100Co01,1241,985,842,96,7,24,15,1,143
1711100Al30,1235,987,897,55,14,7,10,1,90
1711100Ch05,1739,1313,992,269,11,31,12,0,321
1702100TL01,1394,1112,1049,10,26,16,9,0,63
1702100PN04,1012,774,723,11,5,16,7,1,51
1702100PN01,999,765,724,6,4,15,15,0,41
17043008011,2026,1470,327,1049,40,54,41,2,1143
17043008035,1727,1230,499,644,20,51,48,2,731
17043004019,719,531,448,38,7,11,27,0,83
17043004104,832,621,464,11,10,6,115,0,157
17043004012,2042,1653,1229,138,72,12,184,19,424
17043004014,492,385,325,4,0,1,52,0,60
17043004023,771,582,489,29,32,5,27,1,93
17043004045,592,451,380,35,9,5,15,1,71
17043003065,1030,718,646,22,14,3,28,2,72
17043001059,946,753,557,143,9,16,38,0,196
17043001047,1516,1184,657,319,65,16,145,4,527
17043009126,868,693,560,42,21,8,66,0,133
17043005121,503,385,223,46,16,7,84,1,162
17043005053,2087,1476,355,380,139,24,594,0,1121
17043005112,550,439,394,5,7,0,30,0,45
17043005027,817,579,539,13,4,8,4,0,40
17043009045,447,339,241,30,19,8,45,1,98
17043009118,1078,936,466,66,235,10,161,0,470
17043009129,876,763,483,40,133,15,93,0,280
17043007002,1139,862,612,89,14,4,135,0,250
17043009060,818,571,512,28,3,3,28,0,59
17043009038,848,596,534,43,6,1,16,0,62
17049000301,528,405,376,7,3,15,1,2,29
17049001106,943,735,702,6,3,6,14,0,33
17049000902,983,751,723,7,5,8,1,1,28
17049000903,1174,906,841,32,0,26,0,0,65
1718300BT01,895,667,616,27,10,11,0,0,51
1718300GR04,853,656,543,76,13,25,3,0,113
1718300GR06,954,731,671,26,8,10,9,0,60
1711100Al16,1105,869,755,38,7,8,59,0,114
1711100Al45,1130,894,825,20,9,10,27,0,69
17043002084,1370,1030,346,363,116,18,199,1,684
17043003118,1757,1349,702,323,116,25,187,4,647
17043005123,1097,743,358,99,194,7,83,1,385
17043005031,714,524,417,32,3,6,66,1,107
17043001043,1566,1291,827,315,67,23,71,0,464
17043001063,1492,1156,708,351,29,29,75,0,448
1710300DX04,448,348,298,20,14,8,5,1,50
1710300VI01,312,250,225,14,4,7,0,0,25
17043009109,767,539,487,11,2,1,30,0,52
1718300DC03,1099,869,621,39,177,12,20,1,248
1718300OK02,1052,811,750,23,7,23,5,0,61
1718300DN14,819,634,570,11,19,26,6,0,64
1718300JA01,203,160,152,0,1,7,0,0,8
1718300GR02,1035,794,697,76,6,18,2,0,97
1718300DC14,1394,1003,364,91,538,15,10,3,639
17019LUD200,1746,1291,851,179,243,22,13,0,440
17043004027,986,751,416,33,14,5,276,1,335
17043004110,1250,969,443,57,35,4,422,1,526
17043004073,1671,1240,552,209,381,8,97,1,688
17043005077,677,500,414,22,8,8,47,0,86
17043005094,867,758,582,26,76,4,61,0,176
17043003098,938,722,543,32,8,4,127,1,179
17043003004,863,580,504,24,4,4,38,0,76
17043004065,1202,808,222,382,138,2,61,0,586
17043004026,1261,993,582,125,150,5,133,1,411
17141000045,712,563,513,23,7,8,3,0,50
17141000015,1336,1034,858,115,25,17,17,0,176
17141000028,411,332,311,5,3,9,0,0,21
17043006008,987,771,641,44,27,11,38,2,130
17043008026,648,526,429,40,15,16,27,0,97
17043008027,1441,1117,581,404,57,20,55,1,536
17043004005,677,670,546,17,43,2,62,0,124
17043004029,1137,953,753,64,43,4,89,1,200
17119001302,1457,1137,906,71,110,44,13,2,231
17119001303,1831,1427,869,30,482,20,14,0,558
17119002316,1472,1129,805,40,204,55,29,1,324
17119000101,1626,1274,1203,15,6,21,24,1,71
17119002403,833,701,651,24,12,6,10,0,50
17119000201,2100,1728,1582,44,16,38,31,4,146
17119000205,688,507,484,6,2,7,5,1,23
17119000202,904,705,651,17,3,17,10,1,54
17119002317,759,614,521,18,55,16,6,0,93
17049000702,829,689,664,8,2,9,4,0,25
17049000703,1044,839,796,10,9,12,14,2,43
17049000701,917,726,695,11,1,5,9,0,31
17049001203,881,683,666,6,0,2,2,2,17
17119002301,1147,953,655,44,225,32,6,4,298
17119002305,1483,1177,960,18,143,31,12,3,217
17119000103,1253,966,893,11,6,23,17,0,73
1703700DK09,2264,1860,1253,248,171,30,164,2,607
1703700CO03,1095,839,721,51,40,9,16,2,118
1703700CO02,1784,1388,1208,63,50,14,37,0,180
171670CP050,1362,1075,668,35,312,36,25,3,407
171670CP042,1348,1169,760,32,288,21,66,0,409
1718300CR01,514,401,382,1,1,13,1,0,19
1718300GT02,876,670,622,11,21,12,2,0,48
1718300BL02,1016,808,748,18,6,16,6,0,60
1718300DN08,856,686,646,13,8,11,4,0,40
17043003112,1517,1194,895,108,69,12,106,2,299
17043007043,665,547,372,54,14,15,96,0,175
17043007036,786,574,375,40,12,6,139,0,199
17043007067,1012,752,482,30,20,1,209,0,270
17043003134,1001,837,672,37,25,14,85,0,165
17043003093,886,729,542,20,16,0,148,6,187
17043003133,1567,1097,582,103,138,11,258,1,515
17043003114,920,739,586,17,12,0,118,1,153
17043003057,863,649,540,34,9,18,51,0,109
17095000011,994,821,676,34,91,11,4,2,145
17095001601,926,749,716,7,3,19,3,1,33
1705700CA14,1016,839,787,8,14,16,7,0,52
1711100Al15,1246,916,664,183,28,40,25,1,252
1711100Ha01,1148,963,843,70,4,31,9,0,120
17073001401,222,178,170,3,0,4,1,0,8
17081001110,1288,917,534,59,263,38,9,2,383
17081001302,623,486,466,0,5,5,10,0,20
17081001102,1859,1430,1325,23,22,38,6,1,105
17095000009,1630,1235,959,109,126,27,11,4,276
17095000010,1543,1178,939,81,117,23,14,2,239
17095000012,2216,2058,1161,263,330,30,217,155,897
17095000013,3195,2815,1176,408,1196,29,19,2,1639
17095000018,1216,844,638,60,124,21,1,1,206
17095000501,498,379,342,17,5,12,1,0,37
17049001111,905,695,621,42,2,18,6,2,74
17049001113,1026,798,759,13,10,2,5,0,39
17049001112,870,652,628,9,5,8,0,0,24
17011011001,574,452,422,12,6,9,1,0,30
17119001407,1785,1330,1125,41,97,21,54,0,205
17119002215,1200,921,667,70,156,27,4,1,254
17119002219,1089,797,615,47,112,24,6,0,182
17081001001,372,280,273,2,1,4,0,0,7
171670CL001,1168,903,828,12,19,26,11,1,75
17149001302,594,467,438,9,8,4,2,1,29
1709900OP01,436,356,325,18,5,6,1,0,31
1706300FE04,979,770,690,47,7,17,9,2,80
1706300FE02,1103,823,767,27,2,10,8,0,56
1706300NE01,501,383,340,23,4,6,9,1,43
1706300AS02,1507,1173,945,164,16,42,16,1,228
17081000101,800,611,595,2,5,5,3,1,16
1706300MR05,1447,1098,844,202,20,22,9,0,254
1706300NR01,321,264,249,8,0,4,3,0,15
17011025001,191,148,145,0,0,3,0,0,3
17139000706,687,518,476,14,9,9,6,0,42
17011020001,763,635,599,10,4,13,6,2,36
17011013001,705,522,387,103,15,10,5,0,135
17011014001,341,258,233,9,6,3,4,1,25
17139000501,1765,1216,1161,24,2,12,5,0,55
17011003002,219,153,149,3,0,1,1,0,4
1709900AL01,531,400,374,9,3,12,2,0,26
1709900LS07,827,627,500,111,7,7,4,0,127
1709900LS02,1151,891,658,173,33,24,5,2,233
1709900OR01,375,308,298,8,0,1,0,0,10
1709900BC02,896,690,608,52,20,8,3,0,82
1709900BC01,896,693,548,103,10,22,8,0,145
1709900OT02,1083,899,701,104,56,21,14,1,198
1709900DT02,1928,1469,1237,98,54,34,35,1,232
1709900LS01,1492,1180,838,207,72,52,22,1,342
1709900LS04,775,583,453,103,20,11,5,1,130
1709900BC08,661,524,440,55,13,15,2,1,84
1709900BC09,1001,793,685,68,14,13,8,0,108
1709900PR04,693,540,452,51,4,20,14,0,88
1709900PR03,676,539,475,48,4,9,3,0,64
1709900MA01,1134,883,796,37,12,20,8,0,87
1709900MA04,1354,1008,936,26,10,27,8,2,72
1709900BC07,786,595,472,64,33,18,8,1,123
17119000105,1194,908,852,13,1,28,11,0,56
17119002402,829,665,569,11,50,18,8,0,96
17119002314,941,754,493,16,224,19,2,0,261
17119001505,1704,1340,1238,28,15,30,11,0,102
17149000201,89,71,64,4,1,4,1,0,7
1718300GR05,1233,946,844,72,6,27,2,0,102
1718300GR01,741,600,487,85,8,20,3,0,113
1718300DC25,1325,656,77,21,547,13,0,0,579
1718300DC28,1036,812,449,81,252,15,9,1,363
1718300DC29,1099,902,817,37,24,20,5,1,85
1718300SI01,900,679,645,4,6,22,0,0,34
17149002001,698,530,501,6,4,8,1,0,29
17149002201,265,212,201,1,2,5,1,0,11
17149002101,484,392,377,2,1,6,5,0,15
17119001410,951,761,642,17,64,18,16,0,119
17119001001,1407,1075,987,34,19,28,10,0,88
17119000903,1034,808,756,21,6,12,6,3,52
17119001920,499,433,400,3,5,15,5,4,33
17119001418,1784,1340,1148,50,72,24,35,2,192
17119001412,1791,1616,1272,127,146,22,31,2,344
17119001421,2306,2264,1333,127,667,17,127,0,931
17081000901,1269,988,902,20,34,21,7,0,86
17081000601,599,436,418,3,0,7,1,0,18
17081001403,1271,1005,848,28,86,11,22,0,157
17081000402,1361,1039,896,9,62,38,25,3,143
17119000301,601,456,428,4,0,19,3,0,28
1709900PR10,893,794,751,18,7,1,13,0,43
1709900PR11,950,810,706,39,9,8,50,2,104
1709900PR09,1511,1224,1077,101,24,14,11,0,147
1709900RT02,692,575,509,29,6,17,5,0,66
1709900RT01,1464,1165,1053,39,13,31,11,0,112
1709900AD02,668,518,471,28,4,7,4,1,47
1709900MA05,1325,1025,901,61,11,28,7,1,124
17119002308,1041,718,259,22,424,11,10,0,459
17119002312,844,624,489,16,103,16,8,2,135
171670CP052,1084,883,777,9,38,7,44,0,106
1718300GR03,788,616,534,55,14,14,5,0,82
1718300EL01,867,686,650,11,5,15,1,3,36
1718300PI01,544,440,411,2,3,13,6,0,29
1718300GT06,973,708,673,10,0,17,1,0,35
17119002409,1646,1288,1116,20,66,47,27,0,172
17119002410,1534,1200,1031,22,109,19,13,2,169
17119002412,1113,963,817,18,103,12,13,1,146
17119000906,1247,953,849,27,17,31,14,0,104
17119000902,1818,1384,1193,51,61,41,24,1,191
17119001201,1682,1290,1230,19,5,21,5,0,60
17119001202,765,587,555,5,4,14,1,0,32
1711700DH01,730,552,535,5,2,13,1,0,17
17119001320,1054,772,579,23,124,30,12,0,193
17119002105,128,92,4,3,82,2,1,0,88
17119002216,1317,1045,850,69,74,57,6,1,195
1718300DN05,593,474,440,9,10,8,2,0,34
1718300RS01,971,737,700,17,3,12,3,0,37
1718300GT01,1135,875,821,11,27,9,2,0,54
1718300MD01,1021,794,727,19,18,15,6,0,67
17049000801,464,365,344,8,0,11,3,0,21
17149000901,212,151,147,3,0,1,0,0,4
17059000901,446,354,343,1,0,3,6,0,11
17119001922,1067,864,803,13,17,18,8,0,61
17149001701,214,150,140,1,1,4,0,0,10
1720300MN03,593,442,421,5,6,8,2,0,21
1718300GT07,1008,770,733,5,15,10,1,0,37
1718300NW02,1321,967,897,20,18,21,11,0,70
1718300DC20,781,595,399,42,130,10,13,0,196
17011019001,333,254,223,21,0,8,1,0,31
17081000301,1209,934,885,10,10,14,8,1,49
17049001108,884,681,619,30,9,10,17,0,62
17065000201,293,242,238,1,0,3,0,0,4
17065000101,274,189,183,0,0,4,1,0,6
1710300DX06,650,475,406,30,16,11,7,0,69
17163000MS4,2129,1544,1255,54,135,41,58,9,289
17163000SC7,943,787,562,29,170,17,11,0,225
17163000B20,1507,1163,572,36,522,16,20,2,591
1716300CS23,1280,999,482,38,421,35,35,3,517
1716300CS24,1034,798,370,35,331,20,34,0,428
17073002504,1073,878,771,57,35,9,5,2,107
17073001801,1261,994,943,13,5,17,2,2,51
17081001402,1181,931,875,13,20,7,11,6,56
1710300WC01,646,495,464,14,6,5,3,1,31
1710300DX03,496,375,319,33,15,1,2,0,56
1710300DX17,635,517,482,14,10,3,5,1,35
1710300DX12,809,633,560,48,8,14,7,0,73
1710300DX15,647,481,419,28,17,12,7,0,62
1710300DX13,1327,1037,920,40,33,23,6,1,117
1710300FG01,714,571,527,16,2,12,6,0,44
17019RA4000,1573,1274,1132,50,60,17,7,0,142
1717500ETOU,1066,840,793,12,3,8,15,1,47
17119001301,1276,1015,799,62,91,36,21,1,216
17119001321,1029,875,778,21,40,24,5,1,97
17119001323,1442,1211,1082,15,48,20,20,0,129
17119001310,1233,1017,850,51,56,22,29,2,167
17119001306,1697,1278,764,88,367,35,14,5,514
1718300DN09,907,754,711,16,7,14,4,0,43
17019PHI000,1897,1456,1396,11,7,16,16,3,60
17019CH6000,2297,1979,1564,33,149,10,201,1,415
17019CN1900,3249,2326,1082,150,916,32,151,0,1244
17019UR4000,2419,1790,1049,183,441,78,71,2,741
17081001404,1964,1545,1247,16,189,26,63,0,298
17081001105,1433,1117,987,14,38,33,25,1,130
1711100Do03,1129,824,513,259,35,19,8,0,311
1711100Mc16,1889,1512,1361,91,0,48,6,1,151
1711100Mc18,974,780,698,28,15,20,5,1,82
17009000401,246,171,162,1,0,6,0,0,9
17165000605,1083,809,706,17,39,32,9,1,103
1709900ER02,1193,965,895,41,7,19,4,0,70
17127000003,616,473,410,10,33,16,3,2,63
1719700DU30,2189,1679,494,396,545,33,243,0,1185
1719700DU25,2220,1680,583,516,396,50,165,2,1097
1719700DU20,2820,2036,652,834,399,70,127,1,1384
1719700JO09,2477,1903,596,406,865,13,32,2,1307
1719700JO08,2021,1520,759,474,205,60,49,2,761
1719700FR01,2810,2191,1956,130,36,37,50,0,235
1719700FR05,2979,2377,2124,142,41,26,49,0,253
1719700CR02,2841,2212,923,298,942,54,21,1,1289
1719700NL19,2587,1754,1575,127,10,13,20,0,179
17061000101,292,221,216,1,0,2,0,0,5
17061001101,967,773,753,0,2,15,1,2,20
17061001102,739,562,538,4,4,11,4,0,24
17061000601,404,309,296,2,1,8,1,0,13
17061000401,547,457,436,2,0,10,1,0,21
17061001103,846,637,617,0,1,14,2,0,20
17043002051,919,738,505,131,27,14,68,1,233
17043002004,751,586,427,69,7,9,82,1,159
17043003137,905,729,522,66,37,4,94,2,207
17043003040,589,506,311,17,16,2,163,2,195
17043008007,840,688,614,16,14,6,27,1,74
17043008040,793,680,508,63,31,7,73,0,172
17043006061,779,678,635,12,10,8,5,1,43
17043008002,1068,807,677,56,8,12,51,0,130
17043006035,994,717,296,281,119,27,27,1,421
1711100Al10,1288,1008,859,77,17,29,23,1,149
1709900PR01,350,268,217,33,7,8,2,0,51
1709900PR02,1289,1000,854,90,21,11,20,2,146
1709900OT13,1144,913,845,31,11,7,14,1,68
1709900ED02,505,397,368,7,3,5,5,0,29
1709900SO02,950,759,626,80,18,19,9,0,133
1709900MN05,1147,906,695,181,7,13,9,1,211
1709900MN04,919,706,501,179,14,16,3,0,205
1709900LS03,1130,855,622,173,40,28,5,0,233
1709900SR01,1191,951,861,41,6,26,14,0,90
1709900OT03,752,576,461,68,19,15,8,2,115
1709900LS09,1119,892,768,76,15,9,16,0,124
1709900FR01,802,649,599,13,4,10,4,0,50
17081001107,898,707,630,21,20,30,1,0,77
1709900PR06,977,796,689,64,20,11,6,1,107
1709900PR05,1389,1091,939,101,18,17,8,2,152
1719700JO21,2404,1839,1047,547,194,38,19,5,792
1719700JO32,2128,1467,86,765,619,53,6,0,1381
1719700JO28,2224,1603,158,741,702,38,15,3,1445
1719700HO18,3219,2146,1876,173,38,23,47,0,270
17019CPE000,305,250,236,6,8,2,1,1,14
1703700DK13,1660,1270,940,226,82,32,13,2,330
1703700DK06,938,805,613,84,66,23,26,0,192
1703700SA04,1458,1119,933,131,16,23,25,1,186
17019CC2400,1949,1630,1312,49,63,7,182,0,318
1711100Mc15,1077,917,821,62,6,8,12,1,96
1711100Mc04,1496,1197,1093,59,5,21,13,0,104
1711100Mc22,586,487,395,55,3,8,14,0,92
17019SOH000,1492,1196,1122,19,7,34,11,1,74
1719700JO03,1506,1202,669,422,82,33,18,0,533
1709900BC10,1836,1461,1285,89,44,30,17,0,176
1709900BC11,397,323,305,10,5,1,0,0,18
1709900OR03,1079,813,714,53,29,14,3,2,99
1709900MN03,1207,891,506,352,5,41,5,0,385
1709900DI01,755,600,530,36,11,5,17,0,70
1719700PL30,1988,1481,1065,228,104,22,63,0,416
1719700WH27,3375,2320,945,261,446,21,643,2,1375
17043003078,781,637,479,47,11,6,89,1,158
17043004046,870,613,529,34,11,7,28,1,84
17043004105,1047,831,581,55,42,6,150,0,250
17043004047,898,631,509,39,20,7,46,1,122
17043009075,998,786,648,70,9,10,52,1,138
17043009021,926,677,554,54,16,15,45,0,123
17043007010,847,665,464,25,5,3,165,0,201
17043007005,1042,825,594,57,24,2,150,0,231
17043008001,1968,1426,409,926,59,59,32,1,1017
17043005083,848,735,620,33,19,1,60,0,115
17043003020,761,581,513,30,15,10,9,0,68
17043003026,1130,784,704,37,13,22,15,0,80
17043009044,845,675,548,59,8,7,46,0,127
17147000502,1765,1328,1265,17,7,10,25,1,63
17147000304,801,623,585,7,4,13,0,0,38
17147000401,788,602,563,7,3,17,0,0,39
17147000102,922,743,704,10,6,25,5,1,39
17147000702,656,513,482,10,2,19,0,0,31
17147000201,1382,1103,1066,8,2,19,7,1,37
17147000701,736,562,535,5,3,12,8,0,27
1709900RL01,362,297,280,9,0,2,2,0,17
1709900RT03,1506,1184,1039,82,20,33,8,1,145
1719700DU31,1283,954,497,144,162,18,136,5,457
1719700DU02,1916,1438,1080,49,28,11,267,0,358
1719700TR08,3072,2424,1783,357,174,40,71,3,641
17019STA000,514,390,372,5,6,9,1,1,18
17019CN1200,1745,1499,1058,110,174,35,110,10,441
17019OG1000,1001,757,728,6,6,4,6,1,29
17019CN1500,823,667,499,34,62,19,64,0,168
17019CN1800,1518,1323,882,83,230,23,102,3,441
17019UR2000,2251,1743,1184,296,145,79,67,5,559
17019SCB000,519,439,390,8,22,12,8,0,49
17019CGI000,1018,799,756,11,10,12,6,1,43
17019CC0300,4412,4209,1535,309,166,33,2196,0,2674
17019PES000,882,675,647,9,3,7,2,0,28
17019TO1000,2057,1546,1434,32,15,25,11,1,112
1709900AD01,951,718,644,38,1,10,7,0,74
1709900LS13,633,501,447,38,7,5,7,1,54
1709900BF01,1069,820,764,31,8,14,8,1,56
1709900DT01,527,408,375,11,5,3,6,0,33
1709900OT01,686,544,499,23,6,7,4,0,45
17019OG2000,530,412,396,2,5,4,3,0,16
1703900CL03,694,531,503,11,8,4,6,2,28
17147000801,966,709,684,6,5,8,2,0,25
17147000503,1148,916,883,7,5,10,2,0,33
1720100Pe02,1473,1132,1070,30,5,9,13,0,62
1720100Rt06,1893,1463,1161,154,77,46,18,1,302
1720100Rs11,1679,1296,1077,77,41,15,61,0,219
17201001206,1282,1073,897,62,60,17,41,0,176
1720100Ro14,1653,1304,1029,142,84,27,34,0,275
1720100Ha01,1818,1457,1111,109,90,14,129,1,346
17201001305,2264,1768,478,280,965,67,27,9,1290
1720100HS01,618,499,470,10,0,6,3,0,29
17121001001,416,317,309,4,1,2,0,0,8
17121001002,341,270,251,2,4,8,3,0,19
17121003015,694,487,421,7,34,24,2,0,66
17121003017,1740,1427,1287,9,69,29,19,0,140
17121003014,1325,1084,974,22,27,15,38,1,110
17121003012,660,536,512,3,4,10,0,0,24
17121003004,651,479,371,22,53,13,13,0,108
17121003010,618,474,411,17,30,17,2,1,63
17121003013,654,504,425,7,49,10,5,1,79
1709900LS12,1029,768,683,43,8,20,7,1,85
1709900LS11,1053,798,749,30,4,8,10,0,49
1718300SR01,1003,763,724,9,1,21,4,0,39
1718300NW04,353,300,231,9,58,4,2,0,69
17149001001,489,366,352,0,1,11,2,0,14
1711100Mc35,1266,987,922,35,7,10,11,0,65
1711100Al14,1187,974,817,77,34,8,41,0,157
1711100Gr16,3789,2492,1802,252,62,58,322,7,690
1711100Gr23,1968,1369,992,184,26,34,136,1,377
1711100Du01,2823,2063,1281,705,23,56,15,1,782
1711100Mc24,1719,1311,974,264,20,45,23,1,337
1711100Mc11,2710,1982,1703,141,21,31,71,0,279
1711100Mc01,1383,1055,956,45,5,21,23,1,99
1711100Al39,1537,1176,880,169,59,19,58,2,296
17019CC2700,822,643,492,26,92,4,28,0,151
17163000OF9,1388,1040,851,32,79,19,56,2,189
1716300OF13,1659,1209,863,49,242,18,46,2,346
1716300OF12,1850,1330,1051,34,162,24,66,3,279
17201000802,1784,1264,677,339,204,54,27,1,587
17201000803,1613,1179,660,268,158,25,74,3,519
17201000804,1614,1212,784,237,132,41,24,1,428
17073000603,1003,787,680,62,15,25,2,0,107
17019LUD100,626,480,401,37,8,19,8,1,79
1711100Se01,1272,1074,923,109,8,19,12,0,151
17121004001,380,290,277,9,1,4,0,0,13
17121011002,270,209,207,0,1,0,0,0,2
17121013001,497,367,356,1,1,4,2,0,11
17121011001,688,531,500,3,5,7,2,1,31
1716300SK10,871,699,540,12,136,8,1,0,159
1716300SC17,787,580,118,3,445,3,11,1,462
1712500SC01,225,180,176,3,0,1,0,0,4
1712500CC01,158,128,124,2,1,1,0,0,4
1712500MC01,837,641,608,7,5,15,4,1,33
1716300CT13,1079,822,277,16,514,16,3,0,545
17163000CT9,1153,797,212,11,553,21,5,0,585
17163000CT8,824,608,311,12,275,8,2,2,297
17163000CT2,981,738,167,14,544,20,2,0,571
17163000LB1,2997,2638,2065,83,405,36,56,5,573
17163000SV5,2853,2154,1516,84,383,38,114,2,638
17163000SV3,886,667,515,28,59,20,39,0,152
17163000SC5,737,599,435,34,100,11,19,3,164
1716300SC13,972,823,684,16,98,9,14,1,139
1716300OF14,1122,861,613,45,132,16,49,3,248
17163000OF6,994,753,613,27,66,20,21,3,140
171630000B5,1235,955,610,22,262,25,29,1,345
1716300CS18,2982,1981,1330,94,409,20,112,6,651
1716300CS12,4108,2786,2032,151,391,69,143,9,754
17121014002,593,463,407,15,13,17,5,1,56
1712500MC03,795,652,625,10,4,12,3,2,27
1716300SC29,1357,1033,456,20,491,17,47,1,577
1716300SC18,847,629,305,26,259,14,28,0,324
17163000B33,1278,890,485,33,317,24,21,9,405
17163000B23,1151,945,685,27,196,29,11,2,260
17163000CS1,1524,1251,1051,79,45,44,16,1,200
1716300CS21,1119,869,697,23,84,21,29,1,172
1716300CS11,861,726,471,20,139,15,83,1,255
17163000SC8,1396,1091,849,20,171,21,21,1,242
1704100TU04,1012,761,705,21,7,12,9,2,56
1704100SG01,240,198,189,3,0,4,0,0,9
17163000B29,955,740,412,28,273,18,8,0,328
17163000SK4,735,593,502,15,61,7,14,0,91
17163000B28,873,698,509,16,157,19,11,1,189
1716300CT14,1016,704,14,2,680,4,1,4,690
17163000SK2,1150,970,643,32,262,24,7,1,327
1716300CT21,950,699,153,10,523,16,1,0,546
1709900GV01,569,452,412,10,11,8,2,0,40
1709900UT01,1454,1126,1031,55,9,13,11,0,95
1709900ED01,893,694,616,43,1,17,4,0,78
1709900SO08,656,520,480,10,7,8,6,0,40
1709900SO06,1344,1050,920,51,18,16,35,0,130
1709900FM01,844,664,609,31,5,8,5,0,55
1709900LS08,1228,917,796,70,18,18,16,0,121
1709900MN02,1277,959,680,236,10,20,18,2,279
17073002501,970,818,728,59,17,11,10,1,90
17121008001,321,264,254,6,0,3,1,0,10
1702900MT17,1100,825,770,14,16,10,14,0,55
1702900MT16,1022,815,760,21,11,11,8,1,55
1702900EO01,1229,992,942,19,6,22,3,2,50
1702900PD01,959,800,744,23,4,14,8,0,56
1703900CL01,852,616,561,19,14,11,7,0,55
1703900CL09,743,524,493,14,2,15,1,1,31
1703900CL06,721,547,505,21,9,6,3,0,42
17201000901,1866,1329,697,224,382,31,12,1,632
1720100LA01,1242,1051,990,23,9,10,5,2,61
1720100Ha25,2792,2059,1477,189,189,23,168,3,582
1720100Ha14,1466,1157,1008,66,37,19,20,1,149
1720100Ha24,1286,1023,930,31,18,5,25,1,93
17201001304,1504,1017,209,242,548,34,4,5,808
17201000108,1266,1099,827,73,93,14,83,2,272
1720100Wi04,1076,834,764,28,9,18,4,0,70
1720100Ro26,1197,961,728,104,64,30,43,0,233
17201000307,1299,960,719,78,123,10,17,1,241
17201000304,1264,1081,892,82,54,16,35,2,189
1720100Rs03,1035,787,722,22,17,6,14,0,65
1720100Rs09,1424,1105,1016,35,9,6,27,0,89
17121017001,1022,763,717,1,4,19,5,2,46
17121007001,755,610,564,14,7,21,3,1,46
17121003002,666,482,255,18,192,13,3,5,227
1720100Ch06,1350,1150,919,140,34,37,21,0,231
17201000603,2544,1867,826,479,258,47,261,0,1041
171630ESL19,759,594,13,5,579,5,2,2,581
171630ESL18,334,273,1,1,272,4,0,0,272
1716300CT20,1201,864,310,12,523,25,4,3,554
1716300SC16,2107,1486,436,61,905,52,53,4,1050
1716300SC23,1846,1382,836,50,415,20,61,4,546
1716300SC26,1241,970,496,34,424,11,14,1,474
1716300SC27,1207,946,598,38,230,23,60,0,348
1720100Ha06,1809,1382,1123,124,50,45,24,1,259
17201001001,1853,1354,713,390,194,56,33,2,641
1720100Rt09,1049,817,717,50,14,17,16,0,100
1720100Rt08,1505,1056,928,60,44,10,12,1,128
1720100Ch05,642,568,498,34,10,6,21,0,70
1720100Ch12,898,751,667,45,10,10,13,0,84
1720100Ro15,1197,923,703,116,65,10,17,0,220
1720100Rt01,1983,1544,1401,58,22,40,14,3,143
17201001205,1677,1271,627,174,421,35,17,1,644
1720100Ha10,1885,1458,1207,97,55,51,42,2,251
1720100Ha11,1069,870,772,39,16,24,8,0,98
1720100Wi01,1459,1149,1031,43,11,37,10,0,118
17201000504,1568,1120,248,418,453,22,3,0,872
17201000201,2371,1666,820,384,402,44,36,1,846
1716300SC31,1123,886,591,44,195,21,48,2,295
1716300SC22,824,633,209,22,387,15,5,0,424
1716300SC21,765,645,547,22,27,20,31,2,98
1716300SC15,1773,1356,928,35,306,21,63,4,428
1716300SC28,998,828,663,23,113,10,15,3,165
1716300SC19,809,662,436,15,179,14,18,2,226
17163000SK1,2056,1686,1462,41,119,42,13,0,224
17061000901,272,223,219,0,0,1,0,0,4
1709900SO07,1452,1208,1083,70,29,6,11,0,125
1709900SO05,1475,1182,1044,59,46,11,14,1,138
1711100GW07,1595,1241,1010,172,8,29,23,0,231
1711100Al35,2093,1634,1017,489,34,64,75,4,617
1711100Mc07,1932,1527,1052,420,18,29,12,3,475
17101000010,847,666,620,10,1,25,0,2,46
17119002211,1331,979,675,70,179,26,2,1,304
17119002201,675,518,353,43,104,15,5,3,165
17119002207,1374,982,577,37,325,26,6,0,405
17119001925,1075,846,762,35,16,15,9,0,84
17119001918,611,480,458,6,5,5,3,0,22
17009000601,891,663,647,3,5,5,2,1,16
17061000301,904,706,655,13,9,19,6,1,51
17061000703,516,375,367,1,0,6,0,0,8
17061001202,212,165,156,3,1,2,0,0,9
17061000802,583,452,437,0,1,7,1,0,15
17061001302,224,183,181,0,0,2,0,0,2
17009000605,471,354,334,4,5,12,0,2,20
1720100Rs07,1247,982,876,37,21,26,21,0,106
1720100Ha17,1466,1165,1049,41,24,19,20,1,116
1702900MT12,1083,827,744,27,26,22,10,2,83
1702900MT10,1078,834,771,14,24,13,8,2,63
1702900LY02,1329,1055,990,12,15,24,8,0,65
1704100TU01,1903,1432,1330,41,6,31,24,2,102
1704100TU02,1289,982,904,16,9,36,10,2,78
1704100BO02,2963,1989,1908,44,3,25,8,4,81
1704100BO01,1136,837,797,22,6,6,4,1,40
1704500PA12,607,470,437,10,7,8,3,1,33
1704500PA07,630,524,507,6,0,4,1,0,17
17155000101,398,323,297,18,1,0,0,0,26
1707900FX01,442,355,350,0,0,2,1,1,5
17101000001,278,223,205,2,1,11,1,0,18
17101000014,603,444,417,7,13,6,0,0,27
1707900GV01,356,269,253,0,2,8,0,0,16
1707900CR01,698,523,499,3,2,18,4,0,24
1707900NM01,746,563,554,2,2,5,1,0,9
17091Otto02,956,760,677,37,19,14,5,1,83
1709900OS01,235,176,157,10,5,0,1,0,19
1702900MT21,1047,796,686,22,47,18,18,0,110
1702900CH05,912,749,658,17,33,7,19,1,91
1702900CH13,1091,859,785,15,27,15,13,0,74
1702900HT01,763,629,608,2,8,9,1,0,21
17019RA1000,1386,1119,824,103,140,25,31,5,295
17019MA5000,2224,1604,1462,35,36,46,24,2,142
17019MA2000,1697,1269,1181,28,13,18,25,0,88
17019MA3000,2406,1749,1566,60,27,43,29,0,183
17019CC0700,4464,4237,1695,512,353,37,1625,8,2542
17119002224,984,829,764,20,13,28,0,0,65
17119002106,1257,981,360,37,555,14,8,0,621
1712500BT01,737,622,601,7,5,9,2,0,21
1712500KB01,492,386,361,5,2,13,3,0,25
17017000518,458,376,368,2,3,0,2,0,8
17133000033,835,665,619,14,4,19,3,2,46
17133000032,821,627,563,16,6,25,7,1,64
17133000011,763,607,583,11,0,8,4,1,24
17133000018,764,601,567,9,0,14,1,0,34
17061000402,211,167,164,0,0,3,0,0,3
17009000501,156,140,139,0,0,1,0,0,1
17061000701,311,244,239,1,1,1,0,0,5
17061000302,888,677,654,5,2,8,4,1,23
17009000602,578,435,406,6,6,17,4,3,29
17101000019,433,328,299,7,5,7,2,1,29
17119001601,947,756,703,7,8,24,9,0,53
1704500BK01,214,172,172,0,0,0,0,0,0
17119002004,708,605,550,16,14,13,7,0,55
17119002411,826,681,630,4,26,9,8,0,51
1704100AR02,982,735,442,275,3,11,2,0,293
1707900ST01,404,322,315,2,0,4,2,0,7
17107000805,1764,1438,1282,39,59,23,35,2,156
17107001201,1394,1056,972,15,33,23,9,0,84
17107001202,629,503,470,5,6,15,2,1,33
17107001203,1164,909,859,8,22,9,6,0,50
17107001205,1268,954,843,29,38,15,20,2,111
17107000602,795,639,624,5,4,4,1,0,15
17107000501,1906,1430,1350,26,12,20,17,1,80
1707900GR01,595,462,457,2,0,2,0,0,5
17101000022,327,265,234,6,10,8,6,0,31
17009000201,264,221,214,3,0,5,0,1,7
17009000603,1826,1775,528,235,1026,2,3,0,1247
1714300MI01,419,344,324,6,0,5,2,0,20
1714300PE15,1143,879,393,84,355,30,29,1,486
1714300HA01,803,624,592,10,8,9,2,0,32
1714300HA02,785,643,614,9,1,8,5,2,29
1710500NE01,1298,993,941,14,16,11,10,0,52
1705700WT01,173,156,151,1,0,2,0,0,5
1707900WA03,924,712,690,6,2,11,0,0,22
1710500CW01,1344,985,902,47,14,13,7,1,83
1705500EA01,589,465,446,6,2,7,0,0,19
1705300PT06,907,704,642,25,1,32,4,1,62
1705300PT02,622,475,434,21,0,10,6,1,41
1705300PT01,723,539,472,22,19,11,12,1,67
1705500BR02,1293,985,898,18,10,36,15,0,87
17001023001,1002,789,708,6,66,4,0,1,81
17001017001,929,697,681,2,3,4,2,3,16
1705500BR03,463,373,356,5,0,2,3,0,17
17177000602,1229,969,909,19,10,13,2,1,60
1705500DE04,1529,1178,1120,13,5,18,11,1,58
1705500DE03,462,380,367,3,0,8,0,0,13
1705500BE05,2240,1727,1646,27,8,38,5,1,81
1705500BE06,856,622,562,28,4,15,9,0,60
1710500PT03,988,773,723,26,6,4,10,0,50
1710500PR01,256,172,169,1,1,1,0,0,3
1705500BE03,550,432,413,8,0,5,0,3,19
1705500BE04,1254,981,909,28,9,22,9,3,72
1705500CA01,1683,1315,1266,9,10,20,3,0,49
17107000701,654,518,502,6,5,5,1,0,16
1714300PE83,895,692,480,28,135,11,38,2,212
1714300PE80,903,762,550,31,129,21,28,1,212
1714300PE85,750,621,577,13,14,0,10,1,44
1714300PE86,668,623,592,11,2,13,4,0,31
1714300PE88,968,803,715,38,15,9,21,0,88
1714300JU01,847,618,594,7,4,10,3,0,24
1714300JU02,894,679,665,3,1,3,5,0,14
1714300PE04,1140,816,180,100,516,21,8,6,636
1714300PE09,834,621,79,75,460,16,2,1,542
1705300DM02,625,492,453,10,9,6,8,1,39
1705300WL01,190,139,139,0,0,0,0,0,0
1707900WA05,895,703,671,8,7,15,1,1,32
17031019046,871,648,583,42,9,3,9,1,65
17031840001,2291,1799,1238,362,32,25,169,2,561
17031007028,985,773,16,138,614,14,4,1,757
17031950005,2056,1453,146,502,793,52,3,3,1307
17031010017,1710,1312,528,668,95,55,21,0,784
17031010016,1404,1067,349,589,123,26,10,0,718
17031007032,843,707,3,10,690,10,2,1,704
17031007031,1083,800,19,198,589,22,4,1,781
17031007033,819,686,2,22,667,9,1,0,684
17031008017,562,475,0,0,475,1,0,0,475
17031008046,630,511,3,9,505,3,1,1,508
17031008034,639,541,0,9,537,8,2,2,541
17031016023,2567,1868,50,1606,203,108,7,1,1818
17115501063,1728,1433,1211,30,124,31,33,1,222
17115506014,1215,975,852,15,41,13,49,0,123
17115506007,1222,964,771,22,115,18,34,0,193
17135000501,832,630,590,4,6,14,2,0,40
17177000601,983,757,713,13,4,10,7,5,44
17181000106,861,675,604,26,7,24,0,4,71
17181000101,903,760,704,15,10,21,3,0,56
17181000122,647,489,468,10,1,8,4,1,21
17007003003,1654,1260,979,187,57,21,15,1,281
17135001401,247,183,171,6,1,5,5,1,12
1705500GD01,1389,1111,1054,17,6,25,3,0,57
1711700HP00,227,177,153,4,4,12,1,3,24
1700500CN01,937,757,697,17,21,12,1,0,60
1711700MO05,655,508,489,1,2,14,1,0,19
17001009001,1102,880,826,5,6,15,3,2,54
17001023008,920,704,609,9,44,21,13,2,95
17001023009,1006,759,719,5,15,3,13,0,40
17001022002,668,529,484,7,12,10,5,1,45
17001020001,971,740,686,15,18,7,6,1,54
17001020002,1109,861,845,1,5,5,4,0,16
17001021001,536,415,388,6,7,6,7,1,27
17001023015,1046,824,785,6,16,8,10,0,39
17001019003,744,581,553,7,14,2,5,0,28
17001023018,948,807,767,13,24,1,3,0,40
17043006062,2646,1891,779,123,136,19,844,0,1112
17043006083,2131,1612,573,229,352,9,449,0,1039
17043006025,921,729,388,107,129,11,104,0,341
17001023012,948,772,680,24,38,20,4,3,92
17001023011,888,696,613,11,43,12,15,1,83
17031028022,897,683,86,77,507,8,15,1,597
17031028025,1535,1114,42,89,978,16,15,0,1072
17031001010,1745,1558,1129,175,54,24,167,4,429
17031032026,1189,1002,678,216,41,26,69,2,324
17031032014,1120,1015,710,157,51,13,78,4,305
17031032011,1071,968,623,197,64,29,74,2,345
17031810010,1279,919,802,24,9,3,63,1,117
17031026024,1128,903,212,589,91,32,17,9,691
17031035007,1308,1058,484,440,73,22,59,1,574
17031760032,2378,1834,624,1012,98,84,100,5,1210
17031045040,1219,1006,689,231,21,26,56,0,317
17031045037,1407,1120,613,246,68,32,187,2,507
17115501049,1901,1499,1315,12,124,29,16,1,184
17115501071,886,733,648,8,62,5,2,1,85
17115501033,1026,753,493,13,225,19,5,2,260
17115501023,2038,1567,956,25,555,26,1,0,611
17115501062,1035,792,569,10,181,29,5,3,223
17031980005,2309,1738,243,1449,22,107,19,1,1495
17031025032,1859,1433,164,781,22,86,470,1,1269
17031012008,1746,1382,211,715,26,54,444,0,1171
17031015010,3327,2373,145,1833,58,121,329,4,2228
17031012020,3272,2356,152,1927,44,164,237,4,2204
17031820059,2265,1790,1029,135,45,19,570,1,761
17031036009,2218,1633,119,1421,80,60,29,3,1514
17031036008,1833,1329,77,1199,40,70,17,2,1252
17115506002,1576,1283,1114,20,103,11,30,2,169
17115506010,1012,831,638,36,112,17,28,0,193
17115501067,1038,864,669,15,144,13,12,0,195
17069000701,525,424,404,1,0,15,3,3,20
17069000201,580,483,457,2,0,21,1,3,26
17001023003,1150,865,720,5,111,20,3,0,145
17001023005,971,714,538,12,146,10,1,3,176
17031960086,1420,1162,1027,33,13,7,79,0,135
17031960046,2195,1732,1529,86,8,22,78,1,203
17031820007,2857,2381,1244,199,161,31,773,0,1137
17031740010,1692,1331,1184,57,14,10,59,0,147
17031037016,1363,1051,13,447,602,22,4,1,1038
17135000201,924,735,698,13,4,16,4,0,37
17031800053,1648,1303,617,477,37,49,158,1,686
17031740023,2248,1742,1211,164,54,15,296,0,531
17031780049,2438,1936,1299,523,41,50,64,0,637
1710500RG01,341,283,263,6,2,8,0,1,20
1710500IG01,1103,833,787,29,6,5,4,0,46
17031043038,811,741,661,27,19,6,28,0,80
17031043028,1742,1674,1353,95,71,10,143,0,321
17031043043,1144,1063,933,45,24,5,47,1,130
17031754003,1659,1545,847,109,51,3,521,0,698
17031040032,1201,985,629,205,63,18,79,0,356
17031040023,1361,1224,785,200,118,21,113,0,439
17085002203,1057,868,774,74,3,6,7,0,94
17085002202,809,694,590,71,7,17,7,0,104
17085002201,1364,1086,985,76,11,9,6,0,101
17085001101,344,267,251,7,0,4,0,0,16
17085000201,137,103,97,2,0,1,2,0,6
17097Shi242,951,798,711,31,17,3,35,2,87
17097Shi244,1256,1003,886,43,13,8,41,0,117
17097Shi237,1708,1297,1071,133,18,16,59,2,226
17097Wau351,2600,1932,397,1290,160,106,73,6,1535
17097Lak148,1528,1102,927,67,36,14,54,3,175
170970Avo40,1420,1136,520,327,102,24,185,2,616
170970Avo41,2126,1602,1099,266,58,21,164,3,503
170970Avo39,2722,1929,548,1273,66,85,22,4,1381
17097Fre109,1228,1206,1129,39,8,8,9,4,77
17097War315,1778,1361,1045,112,38,19,139,2,316
17097War317,1494,1170,994,105,21,13,38,1,176
17097War318,2474,1995,1406,358,119,35,96,0,589
17097War301,1514,1150,475,431,92,34,116,2,675
17177001601,1287,997,948,19,7,8,5,0,49
17135000402,146,127,119,0,0,8,0,0,8
1710500ES01,338,270,233,17,11,9,3,0,37
1715900BONP,428,315,313,0,0,0,0,0,2
17097Wes398,1956,1495,1262,59,20,6,138,0,233
17097Wes390,1057,761,639,21,7,5,88,1,122
170970Ben61,1345,1040,598,309,110,16,18,2,442
17097Zio409,2988,2078,364,801,864,64,37,4,1714
170970Cub76,1678,1286,1097,68,24,24,72,1,189
170970Cub77,1693,1299,1145,39,17,8,85,4,154
170970Cub75,995,794,681,37,4,2,53,1,113
17097Wau339,1707,1444,1141,230,22,12,37,0,303
17097Wau353,2871,1988,213,1273,408,100,84,4,1775
17031870040,2195,1658,1135,56,49,24,391,1,523
17031870060,2545,1950,817,790,160,85,183,4,1133
17031830031,1747,1303,1094,72,9,10,117,2,209
17031760018,2369,1761,548,829,69,98,301,1,1213
17031045024,1002,810,504,169,17,13,116,1,306
17031700008,2349,1739,861,48,21,4,805,1,878
17031700007,499,367,272,24,5,4,62,0,95
1711700CK02,1121,871,814,13,2,29,5,0,57
1711700MO03,500,380,364,4,2,6,3,0,16
1700500BG01,876,692,657,4,6,18,5,4,35
1700500OR00,819,648,622,3,5,10,2,0,26
1700500LG02,705,568,549,5,4,7,0,0,19
1700500CN02,1370,1236,715,238,165,8,52,10,521
1711700CK05,645,507,480,6,2,10,4,0,27
1711700GP03,355,296,284,2,0,7,3,1,12
1711700ST01,798,599,563,5,2,19,4,1,36
17007001018,918,746,682,26,3,0,27,2,64
17007001003,1365,982,565,340,43,30,14,2,417
17097Wes385,1024,775,661,18,7,7,77,0,114
17097Wes380,1135,889,755,38,7,7,81,1,134
170970Ela99,1892,1455,1170,51,9,12,209,1,285
17097Ela100,1853,1356,1038,39,18,2,254,0,318
17097Ela101,2068,1615,1300,93,30,10,185,1,315
17097Gra128,1721,1393,1055,201,52,41,45,1,338
17097Ver262,1448,1078,601,21,15,1,429,1,477
17097Ver261,1581,1144,711,22,19,8,389,3,433
17097War288,1558,1215,797,99,62,27,244,4,418
17097War291,1112,848,543,169,48,15,58,1,305
17097War308,1648,1341,940,188,103,31,99,2,401
17097War297,1490,1209,692,210,186,21,102,0,517
17097Fre113,1931,1495,1211,77,20,12,151,1,284
170970Ela79,2098,1516,1070,69,36,12,318,4,446
17043002017,914,719,568,49,6,9,93,0,151
17043009102,913,678,521,71,6,10,73,1,157
17043009136,817,696,458,106,47,9,68,1,238
17043003028,856,556,427,23,5,4,95,0,129
17043009128,1057,1026,876,19,62,6,66,1,150
17043005043,890,740,681,10,4,3,33,1,59
17043005051,1301,1230,896,83,28,17,192,5,334
17043005114,874,711,529,45,44,7,75,4,182
17043004007,919,733,564,48,24,8,77,0,169
17043002012,1112,861,730,66,10,10,31,1,131
17043002030,1080,825,650,99,11,29,39,0,175
1705300BT01,232,169,164,4,1,0,1,0,5
1715900MAD2,405,318,313,0,2,2,1,0,5
1719300IC06,1284,997,961,8,1,17,1,5,36
17031038007,1369,1103,752,257,16,28,72,1,351
17031038017,1552,1223,840,303,38,19,56,4,383
17031038020,1343,1098,789,243,29,29,30,0,309
17031038024,1210,1013,737,199,16,21,56,0,276
17031031026,949,736,117,581,31,23,22,3,619
17031031036,1148,880,241,579,25,37,38,11,639
17031031040,1272,1025,266,658,75,53,36,5,759
17031031041,1296,999,99,821,60,45,35,3,900
17031031013,1381,1052,148,834,55,74,24,1,904
17031890050,2224,1718,527,499,626,54,68,5,1191
17031037035,1072,823,4,168,658,13,2,1,819
17031037025,842,657,3,128,538,8,0,0,654
17031006022,763,592,4,52,530,5,3,1,588
17031017005,738,576,5,48,522,18,0,0,571
17031014005,3363,2372,98,2146,111,139,4,2,2274
17031015008,2779,1950,97,1796,33,166,33,14,1853
17031015004,2692,1874,109,1662,37,121,70,4,1765
1705300RG01,381,303,291,6,2,4,1,0,12
1705300DX01,598,464,450,2,0,7,4,0,14
1705300DM03,918,680,608,24,18,16,6,0,72
1711700HY00,628,499,397,3,74,13,2,0,102
1711700BH01,1041,791,731,17,6,27,7,0,60
1711700CF01,744,585,540,7,7,15,3,0,45
1711700SH01,759,585,548,5,4,18,0,0,37
1700500SH01,288,246,234,4,1,6,0,1,12
17001023040,1160,1030,793,61,131,33,13,1,237
17001023007,557,422,263,9,133,12,2,0,159
17001023006,673,530,416,9,85,14,2,3,114
1711700DH02,782,645,589,5,7,31,4,1,56
1700500CN03,567,423,367,10,26,14,3,0,56
17031890032,1605,1201,886,245,27,40,26,0,315
17031996002,1644,1204,277,695,196,61,38,1,927
17031995003,1749,1341,194,1019,89,57,35,2,1147
17031993001,1568,1216,373,763,35,41,43,1,843
17031001012,1748,1550,1258,144,42,24,83,0,292
17031026017,756,617,465,85,25,5,45,4,152
17031001032,1321,1118,707,246,54,33,96,1,411
17031037009,1466,1048,38,125,895,11,4,1,1010
17031037037,1168,862,33,67,775,9,3,0,829
17031028038,703,506,12,211,284,18,3,0,494
17031028021,956,739,0,54,691,4,0,0,739
17031790028,1594,1233,1064,71,15,17,59,0,169
17031790012,838,701,569,22,13,4,98,0,132
17031720024,1041,798,648,81,36,9,23,1,150
17031720057,1323,1077,885,89,30,21,44,4,192
17031720069,1366,1184,709,67,360,6,49,0,475
17031049030,1636,1456,708,175,474,20,95,3,748
17031049014,1065,992,465,236,283,10,55,3,527
17031751004,1948,1799,1327,85,87,8,274,0,472
17031039004,1049,774,495,126,14,12,129,4,279
17031039037,924,723,522,51,25,13,107,3,201
17031720012,1250,919,87,194,626,9,17,0,832
17031006027,788,595,3,40,546,3,5,0,592
17031006021,780,553,2,54,490,5,6,3,551
17031019015,1215,931,789,97,10,20,13,2,142
17001007002,872,633,613,2,1,8,0,1,20
17001023017,1010,802,721,16,30,7,25,1,81
17001019002,1055,798,767,5,3,12,7,0,31
17001023025,1372,1064,951,17,53,10,35,1,113
17001023026,1163,870,739,18,63,15,33,0,131
17001016001,1168,889,832,12,18,24,5,0,57
17001023039,1340,1007,774,25,168,27,1,0,233
17001019001,1021,803,752,16,11,12,11,0,51
17001012001,354,274,262,5,2,1,0,0,12
17085002301,543,460,444,8,1,1,2,0,16
17031820053,2241,1871,980,115,66,16,703,1,891
17031820002,2515,2132,1298,189,67,21,563,0,834
17031720002,1559,1208,872,176,110,14,44,4,336
17031010024,1101,831,335,419,69,22,7,0,496
17181000109,1105,919,784,85,9,29,6,2,135
17191000101,330,265,254,0,1,6,2,0,11
17191001201,1039,772,734,14,4,12,6,1,38
17191000601,250,203,203,0,0,0,0,0,0
17191001901,1325,1042,992,10,8,20,3,1,50
17191001601,147,111,107,1,1,1,1,0,4
17191000502,698,564,545,7,3,5,2,0,19
1719500ER02,803,624,583,17,6,9,3,0,41
1719500MT01,967,788,713,33,2,10,1,0,75
1719500HA01,348,262,238,11,4,10,0,0,24
1719500MT02,1492,1157,1046,80,4,9,5,0,111
17043009042,771,590,465,77,6,3,38,0,125
17043009123,914,704,535,72,30,12,55,0,169
17043003042,1072,856,612,120,20,25,79,0,244
17043002069,1823,1224,249,492,317,37,168,0,975
17043005047,965,727,586,57,31,5,46,0,141
17043005060,602,461,372,33,18,4,26,0,89
17043005050,863,688,597,34,24,10,26,0,91
17043005021,701,490,378,33,25,11,42,2,112
17043005064,927,671,508,58,41,13,41,1,163
17043005007,705,521,472,20,14,5,2,0,49
17043005044,763,565,476,22,31,6,30,3,89
17113COB012,1981,1485,914,176,342,48,4,6,571
17031997004,2158,1641,368,968,240,138,67,2,1273
17031830028,2332,1906,1496,70,26,9,302,0,410
17113001601,283,227,212,7,1,6,1,0,15
1703300ROB7,743,581,528,14,17,13,1,1,53
17031754001,785,633,447,29,99,14,57,1,186
17031030022,2331,1865,644,1055,90,81,73,3,1221
17031030024,2317,1888,842,884,92,60,88,4,1046
17001018002,536,407,391,2,1,8,0,2,16
17007001011,1546,1112,711,292,55,32,26,3,401
17031048041,2016,1835,831,289,399,28,308,3,1004
17031759004,1495,1157,688,148,259,22,68,2,469
17031751001,2729,2701,1308,285,228,13,869,8,1393
17031960092,1952,1599,1308,77,24,27,162,3,291
17031960060,937,750,628,38,7,8,73,0,122
17031960052,1098,933,810,16,5,5,94,0,123
17031035009,1722,1327,359,663,102,53,188,2,968
17031830046,1829,1320,1108,48,3,6,154,0,212
17031960033,2453,1817,677,909,80,67,146,2,1140
17031760037,2514,2046,1187,452,168,46,238,5,859
17031930030,1205,945,619,55,30,13,238,2,326
17031930039,1956,1457,1018,126,41,37,249,0,439
17031038028,1511,1220,872,262,36,22,48,2,348
17043009002,1220,986,836,68,7,6,72,1,150
17043009050,937,684,584,40,9,5,42,0,100
17043001016,1084,815,487,113,22,11,174,0,328
17043001006,1373,1052,802,125,53,14,56,2,250
17043001055,1005,798,509,108,17,18,154,0,289
17043002011,845,638,539,54,18,8,22,4,99
17161000728,1288,952,613,68,142,25,111,2,339
17161000729,2304,1691,1094,151,342,30,84,1,597
1719500ST15,1338,1048,797,172,24,10,51,0,251
17031810037,1275,940,804,35,6,5,85,0,136
17031047002,1211,875,697,59,21,10,83,1,178
17031047004,1424,1025,842,84,24,5,60,2,183
17031002012,1139,920,475,38,332,15,69,1,445
17031043003,1289,1005,823,62,27,4,83,2,182
17031002009,1312,1133,819,77,110,19,116,1,314
17031752004,2020,1538,483,357,606,63,71,1,1055
17031027026,872,687,89,75,525,5,12,1,598
17031032041,1469,1083,825,135,30,23,78,0,258
17097War314,1429,1129,752,157,113,23,76,2,377
17097Fre116,1071,861,657,114,6,19,69,1,204
17097Wau358,2305,1656,148,1105,347,137,30,1,1508
170970Avo34,1652,1227,917,170,61,11,77,1,310
170970Avo21,2104,1554,774,628,55,59,66,5,780
170970Avo33,1319,983,736,114,42,16,80,0,247
17069000101,411,343,320,7,0,5,4,4,23
17161001103,2267,1844,1601,77,89,28,33,1,243
17161001106,1517,1175,1003,50,53,30,31,0,172
17161001601,2240,1793,1695,39,17,25,5,2,98
1719500ST11,782,652,542,74,19,11,9,0,110
1719500ST18,517,409,285,106,6,12,6,0,124
1719500JO01,825,648,600,26,4,11,2,1,48
17161001701,732,599,554,17,5,15,6,1,45
17097Zio411,1475,1025,303,321,378,48,14,3,722
17097Zio410,1648,1216,462,421,300,68,35,6,754
17097Ver271,1253,956,744,53,15,4,134,0,212
1708900SG05,3468,2589,2201,221,57,40,62,1,388
17163000SL2,969,751,649,13,48,27,5,2,102
17163000CT4,1041,802,558,33,164,20,15,0,244
17163000CT6,882,706,25,7,670,2,0,1,681
17163000B30,762,575,268,8,277,20,0,0,307
17031041016,1161,896,717,107,18,16,45,2,179
17031041003,1135,893,575,200,16,14,86,0,318
17031032007,1528,1298,1037,90,56,13,86,0,261
17031044009,1415,1176,884,124,36,23,104,2,292
17031044002,1446,1192,979,91,38,10,75,0,213
17031048031,2365,2137,917,335,521,29,343,3,1220
17031048032,1711,1569,711,261,369,46,218,4,858
17031048045,890,791,507,92,80,20,95,2,284
17031048034,971,866,645,105,58,17,60,0,221
1710500OD01,1225,957,893,26,8,22,2,1,64
17031043030,1484,1252,1030,69,28,20,95,1,222
17031027027,1585,1235,294,97,745,15,93,1,941
17085001301,522,423,410,6,0,1,4,0,13
1711700GP04,302,254,241,0,0,7,0,1,13
1711700GP05,1067,859,820,7,6,16,9,0,39
1711700GP02,533,406,386,1,0,15,1,0,20
1711700GP01,712,541,512,1,3,11,3,1,29
1711700CN01,1332,1023,958,8,25,15,6,0,65
1711700BD00,291,241,237,0,1,3,0,0,4
170890AC406,1944,1433,451,772,170,53,26,13,982
170890AC407,1025,806,486,238,50,17,17,1,320
1708900HA03,3578,2640,2187,313,38,25,57,1,453
170890AC504,1680,1289,480,590,164,44,43,3,809
170890AC506,1489,1165,552,379,114,29,102,3,613
1708900EL11,2092,1479,239,1075,133,77,33,1,1240
1708900BA11,1479,1115,800,152,62,10,80,3,315
1708900BA16,1625,1149,1045,44,14,6,35,0,104
1708900SC18,1525,1215,976,158,48,10,30,2,239
17035000602,954,692,665,8,2,9,7,0,27
17035000301,1567,1225,1182,10,6,18,4,1,43
17031045003,1112,938,542,210,65,19,114,0,396
17031045002,1199,1034,466,374,89,29,99,1,568
17031035031,1623,1276,492,604,89,45,91,0,784
17031039028,1430,1163,595,369,99,53,99,4,568
17031035023,1534,1229,428,611,55,44,137,1,801
17031830037,1493,1109,954,34,6,1,108,0,155
17031890076,1697,1418,611,221,450,23,129,5,807
17031049032,1669,1397,465,187,645,54,72,4,932
17031890073,1138,935,492,105,270,16,60,2,443
17031890074,1312,1100,523,122,375,18,85,1,577
17031890079,901,751,46,75,614,11,17,1,705
17031020015,3535,2443,105,2111,200,91,41,5,2338
17031036020,1671,1290,588,583,45,51,80,1,702
17031030004,1696,1338,595,661,31,60,60,0,743
17031047046,1500,1063,770,129,47,12,112,3,293
17031047003,1078,854,569,166,19,10,92,0,285
17031047017,1350,990,678,153,36,15,125,2,312
17031045041,1195,1000,638,252,34,23,62,0,362
17031045042,1025,861,586,186,13,21,57,0,275
17031030017,1846,1454,582,683,66,47,135,2,872
17031036018,1493,1177,507,548,35,45,88,2,670
17031036017,1621,1323,582,626,22,33,93,1,741
17031997002,1417,1112,249,580,238,45,45,3,863
17031997003,1983,1591,441,898,183,85,70,1,1150
17031790039,1201,778,732,18,9,2,12,0,46
17031016009,1038,791,0,47,758,16,4,3,791
17031840016,1698,1469,1186,188,14,11,68,0,283
17031048007,1000,859,624,97,37,6,78,2,235
17031048010,1207,1111,864,100,33,24,94,0,247
17031006040,1039,786,3,8,772,5,0,0,783
17031006030,1173,845,1,27,819,11,0,0,844
17031010015,1604,1280,13,46,1227,21,1,0,1267
17031940014,2408,1850,1303,454,27,59,52,0,547
17031840008,1173,937,810,77,5,6,45,0,127
17031960035,1330,1063,922,57,25,19,56,1,141
17031960007,1506,1183,1068,38,3,6,53,1,115
17031008013,1596,1261,8,13,1245,28,2,3,1253
17031008020,1001,823,10,14,788,17,3,2,813
17031008021,1337,1103,22,19,1065,27,3,3,1081
17031004003,1160,932,32,27,860,8,9,3,900
17031004033,1393,1134,180,40,883,17,32,0,954
17031005004,1622,1387,386,81,770,15,160,2,1001
17031012002,1658,1209,76,890,34,58,219,6,1133
17031012015,2569,1971,98,1655,216,97,12,2,1873
17031860021,1512,1200,1046,47,28,9,56,2,154
17031720037,885,723,50,26,649,4,0,4,673
17085001201,215,177,173,3,0,1,0,0,4
17085000601,1287,1080,993,30,6,16,12,0,87
1719900LC03,998,795,740,12,5,20,2,0,55
1719900HE06,906,693,642,7,6,27,0,0,51
1719900CA02,1269,935,841,15,22,12,37,0,94
1719900CA07,1644,1236,1092,45,42,35,10,0,144
1719900CA03,2040,1454,1184,45,85,42,94,1,270
1719900CA06,1606,1227,1112,18,37,22,24,2,115
1719900LC01,1178,893,843,8,7,25,2,0,50
17031002028,1599,1520,1290,77,24,8,95,1,230
17031002035,1783,1684,1348,59,109,5,146,0,336
17031012010,2732,2014,187,1712,116,151,22,6,1827
17031024039,1348,1071,98,492,481,32,2,2,973
17031027007,1380,1217,785,262,97,31,76,4,432
17031001037,1255,1121,842,157,18,13,84,2,279
17031028017,1038,750,9,28,710,5,2,1,741
17031024019,1294,976,8,67,901,12,4,3,968
17031029044,1433,1165,32,107,1032,13,4,0,1133
1708700BL01,917,736,694,11,6,15,2,1,42
1719900BL03,1213,977,875,28,23,31,13,0,102
17035000201,485,374,368,1,1,2,1,0,6
17035000101,667,528,510,4,2,9,1,0,18
17031011031,1356,1070,487,249,28,30,295,0,583
17031024033,836,615,9,52,569,5,4,0,606
17031850025,1288,911,583,78,184,18,62,0,328
17031850033,1477,1103,448,116,488,24,51,3,655
17031027049,1087,749,40,54,652,9,7,1,709
1710500BR01,303,222,211,4,0,4,0,2,11
1710500SL01,657,518,498,9,2,9,0,0,20
17097Gra139,2266,1711,1193,284,74,38,120,2,518
17097Fre112,2054,1892,1651,107,23,13,99,1,241
17097Wau337,1420,1144,868,169,10,18,78,0,276
17097Wau336,1497,1132,912,164,18,19,24,1,220
17097Ver279,1834,1401,961,31,17,4,380,1,440
17097Lib175,2082,1707,1033,112,98,21,437,1,674
1714500PI06,550,416,406,0,3,2,1,0,10
1714500TA02,717,590,566,6,2,8,4,2,24
17031023033,1840,1333,75,1218,9,64,28,0,1258
17031023009,1668,1182,89,1011,39,110,47,6,1093
17031022012,1477,1180,157,753,204,66,70,0,1023
17031993003,1100,869,337,462,32,35,36,4,532
17031993002,860,709,315,329,31,24,20,0,394
17031008038,627,506,0,8,503,2,0,0,506
17031970045,1065,751,648,34,45,6,8,0,103
17031970037,1008,757,263,152,325,9,14,0,494
17031018044,1117,816,205,497,102,38,17,1,611
17031018003,998,734,164,381,172,61,12,0,570
17031019013,1000,792,66,23,695,10,7,1,726
17031970039,1189,896,790,60,29,10,10,1,106
17031970013,1437,1124,723,130,243,6,24,0,401
17031860001,2734,2185,1580,202,257,29,102,1,605
17031770004,1365,1103,1019,47,7,6,10,0,84
17031770002,1286,1099,1005,43,20,9,28,2,94
17031770014,1463,1143,1019,73,8,13,29,0,124
17031770003,1667,1386,1261,74,9,6,38,1,125
17031880008,886,678,543,90,16,8,23,0,135
17031013013,1018,751,166,563,22,32,4,0,585
17031800074,1136,916,614,75,11,15,216,0,302
17097Lak157,1393,1095,881,127,29,38,19,1,214
170970Ela86,1277,993,889,48,6,18,34,0,104
17097Wau361,2616,1916,312,1143,416,96,37,2,1604
17097Wau360,2832,2042,305,1302,347,182,42,4,1737
17097Wau374,3563,2483,243,1397,825,95,19,4,2240
17097Wau375,3925,2644,102,1934,587,97,20,3,2542
17097Lib177,2212,1710,919,567,62,59,140,0,791
170970Avo25,2409,1830,766,907,104,79,44,3,1064
17097Wau350,2173,1640,402,832,328,67,58,8,1238
17097Shi241,1481,1101,1023,21,4,6,35,0,78
17097Mor223,1529,1138,983,54,13,12,63,0,155
17097Mor220,1336,1045,943,36,5,1,54,0,102
1709700Ant8,1701,1274,1053,101,33,30,36,3,221
170970Ant12,1266,997,863,73,24,12,26,3,134
17043001049,2671,1915,551,1213,94,53,58,0,1364
17043003056,745,608,396,64,57,12,76,1,212
17043003067,602,494,358,44,16,5,74,1,136
17043005025,881,647,599,21,9,3,18,0,48
17043005095,1076,806,726,13,11,3,48,1,80
1708700LA01,858,703,666,5,4,14,2,1,37
17085001601,649,493,475,7,4,10,0,0,18
17097Fre122,1178,910,695,79,29,21,93,0,215
17097Lib189,2422,1790,811,854,48,48,86,6,979
17031800056,2755,2101,890,856,35,74,309,0,1211
17031810005,1148,827,705,55,30,6,24,2,122
17031810001,1986,1395,1246,35,18,9,79,2,149
17031840002,1663,1356,1002,259,22,16,81,6,354
17031001028,546,432,95,162,147,6,28,2,337
17031004023,1565,1306,565,47,548,15,133,3,741
17031004022,1187,894,284,41,547,16,26,6,610
17031038005,1377,1099,664,312,32,26,92,2,435
17031029031,1773,1399,745,533,59,41,64,4,654
17031038029,1476,1200,729,362,28,26,73,0,471
17031034016,1005,751,9,16,721,11,2,0,742
17031012003,1655,1347,314,694,43,76,305,2,1033
170970Ela94,1503,1114,817,59,13,3,218,0,297
17161001104,1622,1168,987,72,66,27,10,2,181
17161000602,1146,942,855,44,15,20,4,1,87
17161001102,799,684,588,35,26,27,6,0,96
17161001105,805,677,583,26,27,20,14,1,94
17161000704,1983,1573,1276,128,76,26,50,0,297
17161000617,1453,1171,1027,84,16,13,10,0,144
17161000603,2198,1881,562,414,883,46,16,0,1319
1719500ST04,804,586,371,161,41,21,1,1,215
1719500ST06,471,335,230,85,7,8,5,0,105
1719500CO01,731,597,510,70,8,8,2,0,87
17161001202,1040,828,742,48,15,17,3,0,86
1719500LY01,930,754,699,24,3,12,4,2,55
17161000606,1155,859,565,178,71,23,25,0,294
17161000608,604,449,367,49,10,13,6,2,82
17161000901,1032,665,107,58,465,21,41,1,558
1719500ST09,1391,1102,713,325,41,36,2,0,389
1719500TA01,1004,755,707,15,4,19,3,0,48
17161000804,1012,848,702,101,27,6,12,0,146
17161000805,1110,872,706,94,50,9,15,0,166
17017000220,470,358,345,0,3,7,2,0,13
17017001115,724,565,535,12,4,11,0,0,30
17115501057,1114,868,637,34,170,28,1,0,231
17115501061,990,727,554,13,138,12,3,2,173
17115506006,1573,1222,727,47,405,27,19,0,495
17017001114,445,341,306,14,0,16,3,1,35
1714500DQ07,637,502,467,12,3,11,8,0,35
1714500DQ01,541,430,406,6,11,7,2,0,24
1714500DQ11,764,557,501,5,31,13,4,0,56
1714500DQ10,915,739,645,32,39,6,11,0,94
1714500SU01,1103,876,843,3,16,11,3,2,33
17179000708,1294,1015,946,19,12,17,13,1,69
17179001001,747,606,575,3,8,16,3,0,31
17179001807,1133,812,783,13,1,2,7,0,29
1719500FU04,1105,902,874,8,4,6,4,0,28
1719500MP02,1364,1021,985,15,1,6,6,1,36
1714300PE36,890,612,214,65,320,16,11,0,398
1714300PE54,1497,1104,798,34,169,14,88,0,306
1714300PE33,1342,895,353,117,405,19,7,2,542
1714300RA02,1054,804,732,29,23,11,8,0,72
1714300RA01,990,732,641,16,14,4,50,0,91
1714300RA03,1006,754,707,12,7,7,19,1,47
1714300LI05,1019,818,734,21,41,10,7,0,84
1714300LI09,775,619,572,13,13,8,8,0,47
17115501044,1162,817,396,26,376,21,3,0,421
17085001501,359,284,278,5,1,1,0,0,6
1714500WI01,921,694,642,32,2,12,2,1,52
1714500PI03,675,547,513,11,7,7,6,2,34
17179001906,1106,836,780,18,10,20,7,2,56
17179001816,1055,764,695,16,5,18,19,0,69
17179001805,1349,1003,902,34,22,28,15,0,101
17179000710,935,761,696,10,25,8,18,3,65
17179001806,1070,863,790,19,7,30,11,0,73
17179001814,1097,843,787,11,11,10,10,2,56
17179000704,1267,970,894,28,24,16,5,1,76
17179000701,685,533,494,7,5,11,9,0,39
17179000703,1249,982,913,16,30,7,15,1,69
17179001601,799,656,618,12,0,15,5,1,38
17043005056,1154,865,669,67,62,6,52,2,196
17043008029,992,757,482,166,32,23,62,2,275
17043008028,1213,961,681,190,16,31,56,1,280
17113002901,270,200,188,0,1,3,4,0,12
17113000801,1018,776,696,42,11,14,12,2,80
17113COB008,738,626,499,13,26,8,77,1,127
17071000301,514,412,398,6,1,8,2,0,14
17097Ver254,1128,839,533,60,24,17,208,3,306
17097Ver253,1402,1054,692,62,22,8,269,1,362
170970Avo46,1275,1022,770,130,32,31,63,2,252
1708700TH01,691,563,547,1,1,13,0,0,16
1707700FB01,204,151,145,3,0,3,0,0,6
1707700MB09,998,710,555,25,92,22,4,3,155
1714300TI02,866,677,632,12,6,12,4,0,45
17031800042,1674,1227,1108,66,7,7,30,0,119
17031840004,2128,1679,1271,227,11,21,161,2,408
17161001201,1144,924,823,41,23,22,9,0,101
17161001001,1239,864,344,93,353,27,66,3,520
1719500ST17,1193,976,760,141,37,36,18,0,216
1719500ST16,1089,859,659,138,30,19,18,0,200
17161001502,657,472,444,8,5,6,3,0,28
17161001501,806,636,605,20,4,10,0,0,31
17161000616,1788,1258,910,121,167,22,17,0,348
17161000605,992,785,648,71,34,18,18,1,137
17191000903,487,366,351,4,1,7,2,0,15
17191001801,631,410,390,2,0,16,0,0,20
17161001203,2290,1769,1604,74,19,29,31,3,165
17191000301,1045,814,768,10,1,20,4,1,46
17179000706,1403,1065,965,15,19,44,12,2,100
17179001808,1250,981,931,17,5,16,7,0,50
17179001501,1306,1033,978,16,8,32,2,0,55
17179001921,1402,1107,1042,15,11,27,5,1,65
17179001810,1096,818,779,12,4,7,12,0,39
17179001920,1205,954,891,13,4,28,8,3,63
17179000809,1066,813,752,17,5,27,9,0,61
1716300ESL5,644,505,3,8,489,15,2,1,502
1716300ESL7,423,335,0,2,328,8,2,1,335
17031860070,1868,1393,1028,112,74,20,146,0,365
17031710032,1196,868,162,103,582,23,16,1,706
17031720050,1200,988,792,86,46,10,48,0,196
17031710024,2716,2038,487,279,1278,35,14,2,1551
17031710018,1173,921,379,162,358,18,7,2,542
17031021044,921,697,7,15,684,9,1,1,690
17031021031,572,470,3,11,460,2,2,0,467
17031021002,919,610,0,8,596,8,4,1,610
17031900001,3732,2952,92,73,2758,31,28,3,2860
17031900037,909,689,8,13,660,17,7,0,681
17031048033,531,517,350,47,45,6,70,1,167
17031042021,1774,1697,1157,80,64,7,374,2,540
17031042036,1930,1822,1297,119,105,19,269,2,525
17031027045,4194,3949,2630,308,321,24,635,8,1319
17031027016,1397,1259,876,100,113,25,142,0,383
17031049013,1868,1417,530,453,345,75,78,0,887
17031880018,2434,1832,1406,247,72,28,79,1,426
17179000802,1096,884,769,22,30,28,16,1,115
17179001002,1097,822,788,9,6,16,0,2,34
17179001803,1896,1329,1211,30,18,12,36,5,118
17179001817,1638,1055,984,18,6,24,24,0,71
17179001820,1037,722,687,6,8,2,9,0,35
17179001902,1294,992,927,20,7,13,14,5,65
1708900EL19,2171,1507,241,1123,115,92,38,2,1266
1708900DU01,1447,1181,985,121,30,16,34,0,196
1708900DU27,1910,1367,633,599,54,75,53,1,734
1708900AU06,1760,1223,154,988,70,78,12,1,1069
170890AC701,2245,1605,160,1104,316,115,25,5,1445
1708900EL25,2105,1572,538,849,154,88,32,8,1034
1708900RU09,1067,1064,1011,25,8,5,16,1,53
1708900EL06,1957,1461,269,1087,72,84,36,0,1192
17067000801,322,253,237,9,1,7,0,0,16
170890AC608,1320,1005,315,520,100,25,60,3,690
170890AC607,2059,1417,315,725,312,58,64,1,1102
1708900AU14,1832,1542,1079,340,73,18,31,3,463
1708900AU13,2990,2498,1469,633,212,53,153,5,1029
1708900EL01,830,644,354,249,29,17,13,0,290
1708900EL12,581,573,483,56,20,10,3,0,90
1708900EL30,820,794,550,109,64,9,66,3,244
1708900EL02,1086,814,375,376,21,29,23,3,439
170890AC408,1656,1420,879,317,169,18,58,1,541
170890AC402,1295,926,218,587,104,43,12,2,708
1714300LI19,741,616,576,13,7,18,3,1,40
1714300LI14,914,715,689,6,5,7,4,2,26
1714300LI18,1243,924,876,17,1,21,5,0,48
17035000702,840,673,653,9,1,8,0,0,20
1708900BR02,893,709,670,24,0,11,2,0,39
17031024038,774,567,66,46,454,2,5,0,501
17031970033,1884,1450,878,408,57,47,82,0,572
17031970090,2533,2054,1284,347,314,28,81,0,770
17031010020,1250,955,226,676,50,42,4,3,729
17031950053,1003,761,40,56,678,0,1,0,721
17035000601,1097,806,774,6,2,18,3,2,32
1708900BA21,3306,2585,1960,280,163,46,141,1,625
1708900EL38,1335,1034,705,225,38,37,53,1,329
1708900EL55,2056,1593,1047,334,62,43,125,0,546
170890AC105,1646,1188,375,636,136,83,38,1,813
170890AC606,1694,1221,331,674,205,36,21,1,890
1708900AU08,622,497,315,138,16,11,8,0,182
1708900SC07,1300,1095,928,87,18,16,43,1,167
1708900SC32,1037,818,688,33,5,8,85,0,130
1708900SC22,1282,972,913,21,2,4,22,0,59
1708900SC04,789,616,521,56,14,21,12,0,95
1708900SC01,1222,1023,851,79,22,19,36,0,172
1708900CA02,1567,1221,1073,84,11,12,27,0,148
1708900CA06,1213,915,838,47,19,6,8,0,77
1708900SC08,1471,1158,1044,59,11,10,29,3,114
1708900SC19,1230,1041,735,222,36,20,34,1,306
17031950113,735,547,9,67,471,8,1,2,538
17031950035,1608,1313,104,248,960,19,5,1,1209
17031950094,1290,1019,69,214,732,10,11,2,950
17031950104,748,559,11,81,470,4,8,0,548
17031038027,1576,1260,803,376,29,44,41,3,457
17031038006,1633,1291,740,430,27,23,97,0,551
17031047009,1260,1051,865,88,25,14,62,0,186
17031032021,1373,1045,825,97,16,17,90,3,220
17031032015,1303,1053,822,114,38,22,64,0,231
17031047001,835,696,574,52,14,9,40,3,122
17031930019,1372,1050,492,331,52,26,178,0,558
17031930062,2520,2033,1253,161,115,19,499,1,780
17031930010,1410,1034,430,408,65,28,124,1,604
1718900CV01,388,317,300,2,0,9,3,1,17
17067001801,340,260,257,2,1,0,1,0,3
1707700CB05,647,454,28,32,389,5,3,1,426
1707700CB12,969,778,554,40,133,22,45,1,224
17067001102,782,612,571,7,13,12,4,0,41
17191001501,448,337,326,3,0,4,3,0,11
17191000501,1071,860,805,10,22,8,3,0,55
17031033012,1701,1395,584,584,60,66,169,3,811
17031033022,1425,1120,433,513,36,38,130,6,687
17031960062,2605,1860,976,90,33,10,758,4,884
17031960071,2104,1650,1372,82,32,6,160,0,278
17031024030,652,460,1,26,432,7,3,1,459
17031790038,1340,1100,739,163,177,11,21,3,361
17031019002,898,714,218,21,472,8,0,0,496
17031019005,790,620,364,29,215,8,7,0,256
17031860066,1091,872,719,58,36,7,51,2,153
17031003020,1588,1182,41,21,1106,6,12,3,1141
17031049012,2248,2038,1189,239,325,62,235,3,849
17031049025,1774,1627,868,191,406,38,135,2,759
17031029043,1082,860,194,269,383,33,36,1,666
17031760026,2918,2245,1172,393,60,35,606,4,1073
17031760009,1541,1193,917,66,18,12,190,0,276
1708900BR01,875,657,589,39,7,12,9,4,68
1708900BA12,1879,1431,856,410,95,39,51,0,575
170890AC107,1355,956,124,786,38,68,4,0,832
17163000B17,1046,772,561,26,137,15,15,1,211
1708900DU11,1215,1000,798,126,30,29,22,0,202
1708900DU15,1368,1134,848,167,80,7,33,0,286
1708900SC12,1580,1228,906,132,28,21,131,0,322
1708900SC11,1702,1289,1009,219,23,38,25,0,280
17031760010,1703,1232,318,789,55,75,63,2,914
1708900EL03,1333,1007,293,623,53,59,26,1,714
17153000502,267,241,134,5,98,6,0,0,107
17031800046,1969,1646,1123,202,24,20,291,3,523
17031800008,1846,1528,1016,240,35,23,226,3,512
17031800066,1495,1173,400,632,58,52,91,1,773
17031041027,2237,1776,1447,168,49,19,108,0,329
17031970029,1116,898,250,177,457,29,12,1,648
17031880004,1277,983,795,126,24,12,19,1,188
17031880019,1753,1368,1080,208,19,16,56,1,288
17031710057,1349,1047,358,222,449,19,12,0,689
17031756007,1440,1071,984,23,20,8,26,1,87
17031756006,969,862,826,6,16,0,15,2,36
17031016017,2168,1582,31,1120,432,58,5,3,1551
17031016011,1900,1323,42,808,468,57,8,1,1281
17031890064,1498,1154,46,388,714,22,21,3,1108
17031850024,995,752,557,56,80,11,60,1,195
17031024029,635,510,0,30,474,5,5,0,510
17031024009,1249,891,23,145,733,18,5,1,868
17031021012,866,695,1,17,678,11,1,0,694
17031980027,2901,2209,193,1873,134,121,12,0,2016
17031820016,2389,2008,940,130,129,6,803,7,1068
17031820015,2667,2097,1006,288,198,34,607,1,1091
17031700006,1657,1210,1042,102,20,10,50,2,168
17031700001,1299,1000,866,32,5,8,87,1,134
1714300PE22,968,695,199,38,429,40,1,0,496
1714300PE79,1742,1361,865,25,200,19,246,0,496
17031890040,1176,885,12,205,664,21,9,10,873
17031992001,1099,827,255,473,70,27,27,4,572
17031992004,2783,2108,660,1261,121,76,71,2,1448
1707700CH01,1010,723,699,6,0,14,0,1,24
1707700CB13,873,713,568,25,67,20,29,1,145
17067001501,337,256,243,6,0,6,2,1,13
1707700CB20,745,571,428,50,50,17,24,1,143
1707700CB19,1202,969,654,70,167,41,53,1,315
1708900EL24,2760,2117,1642,199,36,43,193,1,475
1708900BB02,3499,2559,1956,273,115,39,188,0,603
170890AC104,1884,1319,164,1077,67,96,4,4,1155
1714300PE62,1371,1005,518,72,391,9,16,1,487
1714300PE63,1380,859,223,13,612,8,4,1,636
17043008037,1224,954,423,464,33,22,32,1,531
17043008019,906,723,549,64,23,16,74,0,174
17043008005,1059,818,457,296,36,59,22,2,361
17043009095,639,478,391,44,15,13,21,0,87
17031017028,770,590,3,41,543,7,3,1,587
17031019049,873,691,155,27,499,11,8,0,536
17031019020,749,635,157,20,460,10,2,0,478
17031970066,1371,1071,823,184,11,9,42,1,248
1714300ME06,1018,822,740,22,14,28,10,0,82
1714300ME05,868,667,641,13,9,2,1,0,26
1714300LO02,1225,955,906,23,6,10,4,0,49
17043003050,1263,924,794,58,29,9,34,3,130
17031043016,2358,2154,1751,155,62,24,161,1,403
17031043006,1122,960,807,56,25,3,69,1,153
17031810030,1572,1107,1005,22,11,8,48,0,102
17031009034,980,757,9,10,735,7,1,0,748
17031009043,1268,985,2,24,964,17,0,1,983
17031021004,996,786,1,9,776,6,2,0,785
17031021053,664,547,4,2,536,4,1,0,543
17031019050,793,605,438,38,110,4,5,0,167
17031019007,871,651,464,51,121,7,5,0,187
17031039030,1521,1202,469,318,86,43,318,5,733
17031039033,2015,1655,733,397,160,32,347,3,922
17031045046,1008,814,535,162,11,9,104,1,279
17031045045,748,599,412,144,7,27,33,1,187
17031039040,1174,867,566,87,20,14,183,5,301
17031031019,1041,797,176,566,35,32,33,2,621
17031031025,1350,1055,268,734,34,57,20,1,787
17031007020,1039,762,14,42,718,9,1,0,748
17031007017,1202,902,16,22,866,10,9,0,886
17031007019,1101,873,11,25,836,3,3,0,862
17031039022,1864,1482,515,379,132,20,442,5,967
17031041020,925,777,615,108,16,8,30,2,162
17031760002,1807,1438,650,150,79,16,557,3,788
17031740034,2132,1548,1350,84,12,5,87,3,198
17031019030,923,667,587,65,4,11,3,1,80
17031021026,1164,923,7,24,903,10,1,1,916
17031710046,2540,1805,125,1048,607,59,4,7,1680
17031800054,1087,800,725,30,0,7,37,0,75
17031820033,1980,1540,736,145,156,21,489,3,804
17031001039,1324,1060,570,361,36,17,77,1,490
17163000CN9,1582,1046,449,555,27,61,4,0,597
17031021033,757,616,5,17,589,10,5,0,611
17031021006,944,720,6,23,697,14,1,2,714
17031021017,862,657,4,14,635,3,0,0,653
17031009035,605,495,0,2,491,4,4,0,495
17031009014,866,685,1,3,678,2,3,0,684
17031034049,831,627,28,20,581,20,2,0,599
17031034035,1237,885,1,36,853,7,11,2,884
1708900EL14,2520,1866,779,726,181,82,132,5,1087
1708900EL50,908,747,403,248,41,31,28,1,344
1708900BA18,1078,778,703,29,4,5,25,0,75
1710900CH01,718,584,553,10,7,10,4,2,31
1710900MC11,892,777,645,28,67,8,34,1,132
1710900ST01,386,307,290,2,3,13,2,0,17
1710900MC10,1277,1114,1029,12,22,18,34,0,85
1714300CH10,958,736,689,18,13,7,2,0,47
1714300PE18,941,858,632,82,89,12,42,0,226
17031830019,1440,1203,1008,37,17,3,135,0,195
17031022011,2483,1773,31,1726,19,103,6,0,1742
17031780042,1993,1670,1453,106,12,12,99,1,217
17017000302,956,708,456,188,27,9,21,12,252
17017000301,691,494,258,188,36,24,10,1,236
17031870041,2142,1567,933,74,21,10,524,0,634
17031870036,1600,1237,678,103,66,8,398,1,559
17031001021,1927,1705,1352,103,64,8,168,0,353
17031001005,1523,1317,965,123,104,22,102,1,352
17031002001,1629,1489,1045,258,38,27,143,0,444
17031800063,1225,978,574,78,20,16,299,1,404
17031039011,1199,969,355,321,21,26,264,2,614
17031009050,904,761,1,8,756,9,1,0,760
17031009031,1082,830,14,210,591,29,11,1,816
17031009007,1132,876,19,166,684,12,2,4,857
17031009028,1110,821,37,372,412,8,0,1,784
17031033011,1769,1420,612,559,76,61,164,1,808
17031033017,1876,1464,601,623,81,51,135,1,863
17031033015,2068,1642,488,862,104,52,191,5,1154
17031790057,3457,2457,437,1842,134,104,22,1,2020
17031970044,1214,927,674,194,28,17,22,0,253
17031970002,2034,1547,946,484,59,38,41,3,601
17031860051,1651,1212,1064,63,26,11,49,0,148
17031720032,1183,881,61,48,776,20,3,0,820
17031014030,1961,1373,55,1295,12,73,11,1,1318
17031014019,2104,1502,60,1401,18,123,14,1,1442
17031015009,3236,2344,116,2022,49,233,163,1,2228
17031015006,2811,1944,162,1708,17,119,62,7,1782
17031012017,2186,1676,171,1119,54,114,347,1,1505
17031012013,2419,1822,190,1317,20,101,295,0,1632
17031870016,4422,3206,1094,1534,209,93,355,4,2112
17031870059,2511,2050,1305,455,81,59,170,2,745
17017000111,742,581,544,13,9,5,0,1,37
17115501030,1455,1117,955,13,91,35,17,0,162
17115501046,1043,818,573,36,179,26,3,0,245
17115501041,2369,1551,447,28,1048,27,8,4,1104
17115503001,822,649,632,7,3,2,0,0,17
17031720009,1214,945,777,92,64,2,18,0,168
17031720052,1568,1186,606,475,65,51,17,2,580
17031016018,1751,1235,29,641,561,31,4,0,1206
17031016019,1686,1187,14,442,747,27,3,1,1173
1719900CO01,938,730,698,2,4,17,3,0,32
1708700OZ01,542,427,402,9,2,10,1,0,25
17157001702,764,593,521,7,54,7,2,1,72
1708700VI02,928,720,682,8,8,14,3,0,38
1708700BE01,222,186,181,1,0,3,0,0,5
1719900HE11,834,644,588,5,16,8,15,0,56
1719900HE10,1038,786,685,16,22,28,28,2,101
17115517002,2380,1781,1195,62,453,35,24,3,586
17115508001,1009,862,780,9,38,21,9,3,82
17115501017,1208,868,484,25,341,23,6,2,384
17115501005,1272,891,544,12,303,31,4,0,347
1708900GE19,1227,906,823,44,7,10,24,1,83
1708900GE04,966,809,770,10,1,6,9,1,39
17163000SL1,1577,1282,1205,27,9,23,6,0,77
1708900EL51,1428,1089,777,135,58,9,113,3,312
1708900EL16,1302,1022,715,196,34,21,59,3,307
1708900CA01,2194,1676,1518,97,18,23,20,1,158
1708900CA08,1253,981,894,36,10,16,20,1,87
1719900HE13,762,583,530,5,17,15,8,1,53
1719900CA05,1281,934,838,19,21,30,20,0,96
17031950073,1967,1408,145,107,1155,10,8,0,1263
17031820020,1472,1186,693,97,52,12,349,1,493
17031030032,996,827,354,336,43,28,91,1,473
17031030003,992,814,359,357,52,21,45,2,455
17031850018,1295,936,684,66,87,21,74,1,252
17031007002,1723,1270,7,36,1235,27,7,1,1263
17031008042,1480,1134,7,10,1110,4,3,0,1127
17031007001,1375,1049,10,28,1025,7,4,0,1039
17031940008,2115,1636,938,599,42,30,46,0,698
17031044041,1990,1900,1396,140,140,12,183,1,504
17031044018,1706,1552,1144,112,147,17,137,8,408
17031027002,1215,942,460,50,323,10,96,1,482
17031995001,3136,2340,368,1694,193,134,86,4,1972
17031810003,1333,960,722,39,12,7,164,1,238
17031810007,1297,894,789,38,21,3,39,1,105
17031033010,1435,1170,619,352,54,25,137,4,551
17031930049,1415,1094,528,191,46,53,320,0,566
17031930042,4255,3406,1253,302,209,42,1588,2,2153
17031005025,1302,1035,58,53,935,20,21,0,977
17031005017,1657,1194,19,33,1156,8,4,3,1175
17031900009,1657,1298,97,37,1146,8,23,1,1201
17031900023,1886,1440,83,51,1300,19,3,0,1357
17031930022,2365,1781,720,489,122,35,440,3,1061
17031740037,1846,1512,1060,131,22,19,292,0,452
17031740026,1459,1191,874,81,29,11,203,1,317
17031740032,2705,2120,950,471,115,37,571,0,1170
17031021028,1277,988,0,17,975,2,1,0,988
1705500FR02,1435,1062,961,24,16,37,8,5,101
1705500FR03,1386,1148,1051,20,13,41,16,1,97
17157000801,893,699,682,6,0,8,2,0,17
17157002001,419,335,325,1,0,4,0,0,10
17071000101,242,191,189,0,0,1,1,0,2
17031038002,988,816,714,59,15,9,17,0,102
1719900HE04,1243,956,857,12,32,22,26,0,99
1719900WM03,838,634,540,19,50,14,5,0,94
17085001702,1282,1011,964,20,8,10,10,1,47
17085001701,1000,784,750,11,2,5,9,0,34
1705500SX01,1451,1162,1095,18,10,21,2,0,67
17017000307,1550,1114,659,324,94,27,18,1,455
17017001012,330,287,272,10,0,5,0,0,15
17179001701,1649,1213,1116,29,18,25,19,1,97
17179001702,1042,738,701,14,5,14,5,0,37
17179000601,985,766,732,11,6,6,1,3,34
1714300LI03,829,658,614,8,13,14,3,0,44
1714500DQ09,698,534,470,13,35,10,8,0,64
1714500DQ05,663,522,425,11,73,10,3,0,97
17179001905,1138,890,839,11,7,23,7,0,51
17031970020,1500,1122,348,613,141,54,19,1,774
17031970059,1797,1492,416,235,795,21,37,1,1076
17031950049,823,621,11,104,487,24,14,0,610
17031720038,1162,865,16,62,791,16,1,0,849
17179001819,1224,915,831,18,22,20,11,0,84
17031041034,960,785,634,88,12,8,48,3,151
17031800060,2448,1878,1480,137,34,24,202,1,398
17031890049,1083,912,124,355,403,22,27,0,788
17031003005,1049,775,27,132,614,17,12,2,748
17031020022,1283,1032,156,35,819,11,23,0,876
17031006048,1073,847,0,6,833,11,4,1,847
17031006032,1030,848,2,11,834,11,7,2,846
17031006011,1187,890,6,18,862,12,6,4,884
17031820014,1888,1466,748,152,205,22,352,3,718
17031820036,1125,872,330,100,200,10,244,0,542
1707500AU02,380,300,291,2,1,7,0,0,9
17027015001,1789,1666,770,193,681,14,6,0,896
17027015005,676,577,529,14,15,7,8,0,48
17115514001,1411,1033,961,22,9,28,1,1,72
17115515001,1468,1121,1079,10,5,14,0,1,42
17115501020,1007,721,377,17,313,13,6,0,344
17115501018,2021,1510,1047,32,379,31,22,0,463
17017000221,812,635,600,1,2,28,1,0,35
1713700PS01,388,306,298,2,3,3,0,0,8
17031756003,979,717,637,20,20,1,36,0,80
17031035011,1852,1554,547,842,84,37,85,4,1007
17031035024,1586,1292,418,705,54,51,112,2,874
17031035006,1653,1336,474,757,32,61,70,0,862
17031810004,1573,1157,1011,38,14,8,69,1,146
17027011004,1378,1006,943,39,7,6,5,0,63
17027012002,850,633,595,25,3,5,5,2,38
17027005005,1343,1028,958,29,7,18,10,1,70
17027006001,1266,985,906,52,7,13,6,1,79
1707500AS01,657,516,495,7,1,7,2,0,21
17171000101,532,434,423,3,2,2,2,1,11
1707500PR01,162,122,109,12,0,0,1,0,13
1713700JK13,985,849,791,13,27,18,5,0,58
1713700LY01,544,429,406,4,7,9,3,0,23
1713700MY01,938,717,680,6,13,12,7,0,37
17031790027,1343,956,747,39,47,7,113,2,209
17031008001,1284,985,21,16,950,17,2,0,964
17031950038,2340,1756,209,242,1302,21,10,1,1547
17031003017,2022,1799,660,154,762,32,221,1,1139
17031003003,1507,1216,141,58,641,30,372,3,1075
17031003014,1607,1439,581,111,544,19,191,3,858
17017000303,704,482,206,196,74,18,7,1,276
17017000304,768,530,259,201,55,21,11,2,271
1703300ROB5,652,522,469,17,12,10,10,0,53
17031950043,1071,894,417,102,356,18,9,2,477
17031042040,4027,3792,2316,272,182,20,948,2,1476
17031008043,706,527,0,8,521,0,1,0,527
17031756001,1826,1331,1103,52,43,8,95,2,228
17031700009,921,675,592,29,7,3,46,0,83
17031700002,1423,1095,862,74,15,4,133,0,233
17031850023,1373,1092,789,74,156,7,64,2,303
17031008041,1296,1073,13,12,1052,8,1,0,1060
17031008040,806,680,7,11,658,2,4,1,673
17031850016,2023,1481,1064,114,185,25,87,1,417
17031850017,2193,1582,1022,140,290,27,110,1,560
17031008054,1468,1113,13,9,1093,6,1,1,1100
17031027010,1730,1565,208,142,879,21,350,1,1357
17031890060,1017,799,174,272,329,20,20,0,625
17031980016,2133,1492,127,1309,46,75,19,2,1365
17031006044,1389,1094,5,19,1081,16,2,0,1089
17031006042,1289,1008,5,12,990,11,1,1,1003
17031007036,964,726,22,3,689,5,8,0,704
17031020009,1416,1099,49,26,1005,17,13,1,1050
17031005016,1527,1151,20,20,1118,16,5,0,1131
1713700MK01,476,369,348,14,5,4,1,0,21
1713700JK02,1668,1292,1077,31,143,19,13,0,215
1713700WD01,1071,849,821,6,2,7,13,3,28
17007005001,864,664,568,69,1,14,4,1,96
1713700LT01,783,644,630,2,0,7,0,0,14
1713700PG01,1089,867,822,10,6,20,5,2,45
1713700JK04,1937,1724,975,124,582,22,17,0,749
17115501006,1217,983,792,29,122,23,12,6,191
17191000701,574,417,400,5,3,4,2,1,17
17191000401,375,299,290,0,0,4,1,0,9
1700500PM01,409,327,304,3,11,7,2,1,23
1700500MG01,737,583,542,3,18,14,0,0,41
1700500ML00,473,378,371,7,0,1,0,0,7
17031960017,2384,1902,897,327,48,30,616,1,1005
17031043040,1020,948,742,78,35,12,79,0,206
17031043022,1105,954,714,106,63,8,64,0,240
17031035028,1321,1070,462,514,44,50,41,1,608
17031035015,1574,1287,513,686,53,46,41,5,774
17031035002,1072,909,452,363,47,25,51,1,457
17031031007,1400,1160,475,526,76,45,80,3,685
1703300ROB4,597,459,433,7,6,3,10,0,26
1703300MAR1,504,373,361,2,2,4,1,0,12
1703300LIC1,407,283,278,1,1,0,0,1,5
1703300ROB3,1316,1061,968,33,20,23,12,2,93
1719300EM30,295,237,230,1,0,5,1,0,7
17031720077,2208,1902,1455,129,230,25,64,2,447
17031720067,1661,1351,1164,94,43,11,21,2,187
17031045038,1383,1151,673,317,22,17,136,1,478
17031720006,1550,1166,442,457,249,61,17,2,724
17031790050,1752,1295,979,185,69,10,58,1,316
17031790010,1282,953,760,131,38,12,23,0,193
17031790016,2251,1681,1539,69,22,9,40,0,142
17031920002,256,193,108,77,7,2,5,0,85
17031790045,1926,1499,1004,374,59,42,45,0,495
1708900EL33,890,605,151,134,287,2,28,1,454
1708900BB05,2477,1658,1429,94,24,20,87,0,229
1708900BB06,2099,1423,1255,79,18,12,57,1,168
1708900CA04,1355,1047,940,52,20,14,20,0,107
17163000B10,994,769,405,26,309,17,11,3,364
171630000B9,801,601,393,18,178,12,4,1,208
17031800065,947,739,645,40,13,2,36,0,94
17031800067,1684,1330,1211,54,8,2,52,0,119
17031760014,2200,1742,867,343,127,41,383,0,875
17031755002,3057,2668,1487,212,256,15,691,4,1181
17031820034,1695,1322,684,110,74,13,454,0,638
17031790076,1500,1187,688,435,18,59,11,2,499
17031950084,1593,1276,32,39,1213,14,7,0,1244
17031008025,1065,871,4,8,850,6,10,1,867
17031015003,1033,759,4,287,477,17,4,1,755
17031013043,1138,855,304,516,22,46,15,2,551
17031900013,1069,745,129,48,566,18,6,0,616
17031950029,670,514,7,40,466,12,6,1,507
1717300TP01,463,371,362,0,2,6,1,0,9
17031009003,1512,866,0,9,856,5,2,0,866
17031009046,965,774,42,44,681,15,9,0,732
17031009015,2890,1579,15,17,1549,23,8,4,1564
17031950039,912,755,9,62,675,16,5,2,746
17031900003,1437,1164,306,44,792,14,14,2,858
17031900031,989,742,394,44,276,8,25,0,348
17031720075,1214,980,366,44,562,11,16,0,614
17031970060,870,714,545,116,24,10,24,0,169
17031970004,4301,3151,2343,308,372,26,89,4,808
17031960087,1526,1119,779,143,27,13,160,1,340
17031960053,1334,1046,909,33,3,4,95,2,137
17031001027,1489,1204,749,299,65,29,105,1,455
17031028005,582,544,139,85,298,8,24,0,405
17031850026,1322,969,682,79,162,10,50,0,287
17031720054,1148,896,680,121,41,18,36,1,216
17031720010,1589,1257,1008,137,57,13,45,0,249
17031820048,2431,1882,771,239,197,22,651,3,1111
17031700005,1358,1070,911,41,6,2,97,0,159
1717300DP01,951,760,713,8,2,22,2,1,47
17031035013,1774,1276,104,1054,140,65,7,1,1172
17031035012,2014,1474,127,1271,86,105,20,6,1347
17031041018,895,679,573,81,4,4,17,0,106
17031041008,1071,800,675,73,7,17,34,1,125
17031014004,1050,794,398,378,4,15,10,3,396
17031023014,966,749,414,317,8,20,9,3,335
17031023003,969,757,423,311,4,24,24,5,334
17031880003,1037,779,737,27,7,3,4,0,42
1719900EM07,1131,832,713,8,53,27,12,0,119
1719900WM02,502,380,277,10,75,15,1,0,103
1719900EM02,559,444,376,15,47,2,4,0,68
1707500DO02,805,610,518,74,7,9,2,1,92
1707500CH01,1786,1381,1290,31,10,32,7,0,91
17031023006,1860,1356,223,1052,26,72,45,2,1133
17031860015,2002,1490,1215,71,65,7,123,0,275
17031860020,874,702,585,46,9,13,37,1,117
17031013006,769,600,356,226,8,18,10,1,244
17031013020,692,528,279,228,13,20,5,1,249
17031950059,1133,807,117,53,624,15,5,1,690
17031008044,674,570,3,12,560,11,3,0,567
17031008048,1007,809,2,10,788,10,9,0,807
17031950111,1169,846,18,177,648,13,16,0,828
17031007015,909,768,5,19,745,4,4,0,763
17031007016,2063,1429,16,27,1393,10,6,1,1413
17031027018,995,664,76,33,532,12,27,1,588
17043005124,483,366,323,10,5,1,28,1,43
17043006037,1509,1274,731,92,126,9,310,0,543
17043006082,1260,970,517,79,92,11,252,1,453
17031890080,2999,2185,204,1876,82,43,35,0,1981
17031890078,1780,1272,217,1013,27,55,20,2,1055
17031790018,1005,742,673,35,9,1,14,0,69
17031019053,802,576,456,44,68,2,11,0,120
17031011010,2356,1917,384,202,46,23,1291,2,1533
17031011001,1795,1465,405,283,91,44,702,3,1060
17031040038,1222,1055,828,111,36,16,78,2,227
17031047038,1222,966,727,118,28,32,80,0,239
17031040012,1034,818,548,147,36,18,72,2,270
17031710020,1101,844,579,72,164,11,27,1,265
17031023007,1564,1174,107,1046,16,51,4,0,1067
17031009002,804,623,12,15,597,7,2,0,611
17031009005,772,654,3,7,649,3,2,1,651
17031024010,682,487,16,109,357,7,7,3,471
17031790078,1053,828,706,81,17,8,15,4,122
17031009037,1418,1165,348,263,550,22,6,0,817
1707500PI01,1103,856,822,20,2,6,3,0,34
17031890102,1818,1437,783,452,162,25,32,0,654
17031970082,1580,1313,1035,226,13,23,16,1,278
17031013025,1312,1006,230,709,46,59,18,2,776
17031720013,1795,1483,772,292,374,37,28,1,711
17031970064,1737,1398,1200,114,37,28,25,1,198
17031950121,904,679,23,23,639,8,3,0,656
17031950072,1094,828,12,25,785,6,4,4,816
17031900015,1722,1407,74,10,1317,10,2,1,1333
17031900034,1016,825,107,9,698,5,16,1,718
17031759005,1027,800,522,91,98,29,63,1,278
17031970058,1793,1392,859,387,94,44,44,0,533
17031045043,1158,949,636,186,24,19,107,0,313
17031770001,1647,1343,1167,68,12,13,71,0,176
1714500TA01,685,536,518,6,4,9,1,1,18
1708700VI03,586,428,377,22,6,19,3,1,51
17031880001,770,621,563,32,9,0,11,0,58
1708900GE08,604,464,431,16,0,2,10,0,33
1708900SC16,1704,1329,1099,77,10,3,136,0,230
1708900BB04,3462,2542,2321,95,32,11,75,1,221
1713700SJ04,822,681,637,11,14,11,5,0,44
170890AC503,1439,1130,748,292,48,33,20,3,382
1708900SC21,2811,2150,1738,169,42,35,173,1,412
170890AC307,2574,1861,624,689,418,78,133,0,1237
1708900RU04,2068,2065,1992,32,16,8,17,1,73
1708900SC25,1383,1070,869,97,17,25,65,0,201
1708900BA02,1094,888,793,48,12,12,15,0,95
17031027033,1349,1196,713,68,278,8,130,7,483
17031044040,1506,1280,1055,94,41,25,62,0,225
17031991002,1520,1166,405,699,37,38,24,1,761
17031040011,1070,869,580,168,35,25,74,4,289
17031040013,1505,1333,972,183,60,11,101,1,361
17031040018,2140,1604,433,306,401,33,462,0,1171
17031950071,875,685,5,90,587,8,1,0,680
17031036028,1552,1275,620,540,52,33,75,1,655
17031026049,1144,890,68,767,52,56,22,1,822
17031026023,1024,772,149,580,35,36,15,0,623
17031017009,972,689,1,22,666,6,7,0,688
17031017022,1087,810,7,32,785,4,1,4,803
17031006025,845,659,0,50,606,10,5,2,659
17031034033,820,638,8,14,619,4,0,0,630
17031034011,1029,696,5,31,655,7,1,1,691
1713700JK18,643,464,388,15,47,10,8,0,76
1713700JK08,770,613,499,17,80,11,5,1,114
1713700WV03,621,458,428,6,2,10,4,1,30
1713700WV01,699,551,520,2,7,7,6,1,31
1713700WV02,441,335,323,1,0,7,1,0,12
1713700JK10,865,687,584,38,50,10,6,0,103
1713700JK06,911,744,662,17,40,14,12,0,82
1713700SJ02,646,527,476,9,9,17,6,1,51
1713700JK01,978,682,519,15,132,11,1,1,163
17031860039,973,792,663,50,28,1,54,1,129
17031880016,1464,1209,1028,43,32,9,95,1,181
17031880011,1254,1096,979,55,12,5,43,0,117
17031023039,1593,1195,81,1020,8,78,90,4,1114
17031720035,758,575,8,12,532,3,23,0,567
17031050007,1193,979,477,210,193,26,99,0,502
17031009032,893,720,2,16,708,2,3,2,718
17031010011,1996,1547,182,1317,40,74,11,0,1365
17031010030,1535,1135,119,947,68,71,5,6,1016
17031034030,651,547,2,2,540,9,0,0,545
17031034002,815,678,27,24,627,8,3,1,651
17031008002,1418,1149,20,39,1097,16,3,1,1129
17031013035,1280,940,131,792,15,44,7,0,809
17031023010,2026,1509,217,1279,11,70,6,3,1292
17001023004,1071,862,775,13,49,15,2,0,87
17001001001,958,773,724,9,10,17,5,0,49
17031043027,1151,1048,840,58,39,10,97,0,208
17031044021,1622,1472,1159,93,47,16,150,2,313
17031860072,1090,884,747,64,15,12,43,1,137
17031710043,960,778,71,36,663,14,4,0,707
17031022022,2622,1799,40,1682,63,99,19,4,1759
17031012016,2742,1944,39,1869,36,101,1,2,1905
17031790071,1904,1303,612,521,153,45,10,4,691
17031880026,1353,1093,881,101,60,16,34,1,212
17031860007,970,746,586,93,21,13,27,0,160
17031710031,1455,1171,443,351,352,18,9,0,728
17031021001,776,638,3,9,628,3,0,0,635
17031029039,1849,1493,575,769,79,55,85,2,918
17031023029,867,646,303,327,9,22,7,3,343
1705700FE01,370,286,279,1,2,4,0,1,7
1705700LS04,448,352,350,2,0,1,0,0,2
1705700LS01,386,320,301,2,5,9,0,0,19
17169000601,189,156,154,1,1,1,0,0,2
1705700PL01,706,558,541,4,2,4,3,0,17
1705700LE01,230,182,175,3,0,4,0,0,7
1705700VT03,154,114,107,3,1,2,0,0,7
1702100BH01,1749,1365,1304,12,5,26,1,0,61
1717500WJER,240,184,174,1,1,2,3,0,10
1717500OSCE,899,691,664,7,3,11,0,0,27
1717500VALL,275,220,208,2,3,4,3,0,12
17065000402,623,496,477,1,1,11,6,1,19
1710300NE01,775,646,568,46,3,12,2,1,78
17091Lime02,1210,910,857,19,7,18,4,0,53
17091Mant05,1482,1054,915,56,37,12,19,2,139
17091Mant02,1504,1142,1028,70,4,14,13,1,114
17095000204,846,655,597,6,16,22,7,0,58
17095000020,1399,1170,943,59,119,17,28,1,227
1702500HRT1,946,735,693,8,5,17,8,1,42
17141000035,751,589,544,24,4,14,6,3,45
17141000040,736,595,527,34,10,7,9,0,68
17141000042,863,722,680,21,2,16,3,0,42
1719700JO18,1731,1414,1107,224,65,16,18,2,307
171670CO001,898,704,663,6,2,14,7,0,41
171670CP024,1126,896,717,17,131,12,8,2,179
171670CP027,1160,900,623,24,209,22,20,2,277
171670CP015,1345,1096,950,20,57,12,51,0,146
1719700HO08,2109,1677,1536,77,6,15,38,0,141
1719700HO09,1811,1360,1239,89,10,7,12,1,121
1719700DU17,2505,1934,697,413,392,25,429,0,1237
1719700NL06,1923,1436,1261,109,16,17,35,0,175
1719700NL05,1827,1391,1222,94,27,19,17,0,169
1719700WH18,2138,1593,1137,61,63,12,330,0,456
17141000019,909,690,522,141,15,21,1,0,168
171670CP019,758,617,484,24,73,14,12,0,133
171670CP070,1029,769,530,29,174,12,21,0,239
171670CP086,945,807,667,23,73,13,21,0,140
1710300DX14,818,657,576,34,22,13,8,0,81
17133000034,961,677,642,8,0,15,7,0,35
17043009029,969,702,586,46,11,4,51,0,116
17043009098,685,479,419,17,4,10,30,0,60
17043004117,560,410,337,22,4,4,42,1,73
17043004100,771,570,477,23,2,5,55,1,93
17043004043,764,557,482,16,1,0,49,1,75
17043004055,622,481,418,20,11,0,29,0,63
17043004003,688,564,507,17,9,5,29,0,57
17043004031,873,657,552,33,10,5,59,0,105
17043004080,854,704,438,63,76,4,120,1,266
17043004038,1052,796,558,87,31,25,110,1,238
17043004092,751,670,477,44,31,7,115,0,193
17043004056,745,561,458,36,16,2,51,1,103
17043004111,1611,1323,786,84,129,16,310,0,537
17043006041,620,475,345,29,9,2,80,1,130
17043006067,1074,885,626,66,67,0,119,6,259
17133000029,1242,973,927,12,1,16,0,0,46
17133000007,1109,849,819,6,4,11,3,0,30
1703700SY04,1080,842,696,73,37,39,5,1,146
1704500PA05,613,458,432,12,5,9,1,0,26
17091Bour04,2508,1885,1493,171,145,37,20,1,392
17093NA0601,1513,1102,922,84,44,28,36,3,180
17043003089,912,773,611,33,16,10,94,1,162
17043004094,634,510,344,17,8,2,134,0,166
17043004042,1382,1260,891,53,109,6,197,0,369
17043005116,757,632,537,14,8,5,62,0,95
17043005102,649,514,409,29,8,4,53,1,105
17043005061,745,560,470,10,2,1,77,1,90
17083001101,395,297,284,1,1,7,0,0,13
17083000405,1668,1250,1193,6,10,24,4,0,57
17095001801,836,645,614,13,9,4,4,1,31
1702500HRT3,1265,961,869,27,7,26,15,0,92
1719700FR17,2861,2105,1895,98,42,20,55,1,210
1719700FR27,1644,1199,1033,53,65,14,26,0,166
1704500BC01,191,155,149,0,3,0,0,0,6
17083000201,461,366,348,4,2,6,2,1,18
17141000032,1068,826,750,30,9,25,4,1,76
17141000031,1815,1441,1327,59,8,31,12,0,114
17141000023,368,282,273,3,4,0,2,1,9
171670CP092,1110,885,813,13,42,6,8,0,72
171670CP094,1085,852,670,23,130,10,17,0,182
171670BA004,1911,1365,1168,49,65,23,66,0,197
171670WD009,800,671,597,6,47,11,8,0,74
17083000601,899,726,686,8,1,24,1,0,40
17083000703,534,443,395,3,12,23,3,0,48
1703700CL01,1828,1386,1225,84,21,28,14,0,161
1703700DK25,1537,1107,743,183,96,20,57,1,364
1703700DK24,1180,886,616,109,113,18,37,0,270
1703700DK10,1701,1342,818,330,105,49,51,1,524
17201001401,2478,1803,768,380,519,65,101,3,1035
17201000604,2035,1526,851,371,208,41,87,1,675
17201000705,1566,1117,202,203,686,15,5,0,915
1720100Ha22,1718,1428,1249,66,47,21,28,0,179
17141000012,976,688,512,126,16,41,9,2,176
1703700PI01,440,364,329,22,0,5,4,1,35
1711100Mc25,1758,1406,1132,183,31,33,34,1,274
1711100RI03,870,722,585,54,25,15,27,2,137
1711100RI01,2114,1640,1496,82,12,18,19,2,144
1711100RI02,2118,1748,1599,88,12,27,17,1,149
1711100RI04,1711,1366,1243,57,16,29,8,0,123
1711100Do14,577,517,475,17,5,0,11,1,42
1711100GW06,2045,1538,1052,402,21,43,41,0,486
1711100GW04,1734,1335,734,511,29,57,46,0,601
1711100Nu25,1085,869,763,49,11,8,20,1,106
1711100Nu09,1051,827,686,81,10,30,17,5,141
171670CP072,1225,872,665,14,157,29,2,1,207
17149002002,907,707,665,9,5,15,7,0,42
1705700FV01,596,478,460,2,2,8,3,0,18
17119001307,1180,918,688,57,127,31,17,0,230
1703700MF01,872,681,607,36,9,16,11,0,74
1720100Ha07,1006,786,682,53,16,11,6,0,104
1720100Ha09,870,648,546,49,10,15,14,0,102
17201000103,1293,1066,789,84,103,12,73,1,277
17141000011,1191,931,641,207,34,33,13,0,290
1720100Rt11,981,789,722,25,5,8,24,1,67
1720100Rt12,1029,744,691,19,10,10,12,0,53
1720100Rt05,1305,873,704,59,38,41,32,3,169
17201000501,1527,1142,95,426,619,37,6,2,1047
17119002307,719,532,300,22,186,19,6,4,232
17011016002,541,412,385,12,1,12,0,1,27
17095000901,1046,851,795,27,9,13,6,1,56
17095000203,720,616,592,8,2,3,0,1,24
17095000202,811,614,582,9,8,14,2,1,32
17095000201,670,496,475,2,5,9,3,0,21
17149001801,468,366,356,3,2,3,1,0,10
17065000601,545,426,404,8,1,8,0,0,22
17065000501,291,224,217,0,0,5,1,1,7
1706300WA02,1124,891,815,44,4,12,13,1,76
1720300CR01,1100,800,776,4,2,13,5,0,24
1720300ME01,869,666,609,26,3,17,8,2,57
17131000901,449,349,320,10,3,8,1,1,29
17131000602,929,692,632,25,3,17,0,0,60
1720300MT02,1384,1010,981,10,5,14,4,1,29
1720300SB01,1355,1048,964,15,4,41,17,3,84
1720300WO09,812,620,588,12,3,11,8,0,32
17011007002,601,482,449,21,3,0,8,0,33
1703700SA05,1386,1099,1018,58,7,9,12,1,81
1703700CO08,1455,993,841,63,5,33,55,0,152
1703700SY01,1113,855,745,64,13,22,7,0,110
1703700SY08,1174,1017,884,56,27,11,31,2,133
17011021001,593,451,428,6,2,12,1,0,23
17011007001,273,219,208,1,4,4,1,0,11
17011003001,595,471,449,5,4,6,2,0,22
17011013006,1101,845,689,126,6,12,11,1,156
17139000801,602,496,480,0,0,4,3,0,16
17139000702,857,634,598,7,5,18,5,0,36
17091Mant07,1688,1315,1172,74,25,25,4,2,143
17095000008,821,625,419,58,124,22,9,1,206
1719700PL20,3135,2341,1527,531,169,102,61,5,814
1719700MO08,1806,1374,879,163,289,26,24,1,495
17131001101,639,505,470,10,3,14,0,1,35
17119002415,1179,943,823,36,48,18,14,0,120
17133000017,1113,816,769,6,1,19,10,1,47
17011014002,917,693,329,316,12,16,29,0,364
17011002001,797,643,608,27,0,3,2,0,35
1719700RE02,2242,1823,1630,84,27,43,12,0,193
17043001010,2963,2181,758,1146,67,76,182,0,1423
17043001031,1440,1092,566,432,25,32,56,1,526
17043008016,1473,1103,647,361,29,21,44,0,456
17043004010,1239,986,827,62,43,11,46,1,159
17043009107,1748,1328,327,119,78,6,797,1,1001
17043009065,1066,818,477,107,78,19,138,0,341
1717500PENN,302,202,187,10,1,7,0,0,15
1719700WA02,2515,1893,1568,194,87,44,12,1,325
17049000704,970,733,701,20,0,7,5,0,32
17049000901,1031,795,762,6,4,14,1,2,33
17119001708,1543,1181,983,64,82,29,11,2,198
17119001906,1440,1068,977,18,27,37,7,0,91
17011015005,877,672,605,28,10,8,15,1,67
17073000602,1407,1145,1021,53,10,33,9,0,124
17073001001,173,129,127,1,1,0,0,0,2
17073000804,1734,1311,1225,20,12,24,20,0,86
17043009072,780,648,544,46,7,8,37,0,104
17043009059,975,693,617,34,9,1,28,0,76
17043009058,608,493,315,128,36,10,36,0,178
17043003085,920,630,519,23,4,14,66,2,111
17043003007,1283,929,720,68,30,14,87,4,209
17043003084,1119,730,604,19,5,11,93,0,126
17043003043,698,508,435,16,5,5,43,0,73
17043003001,816,605,518,39,10,4,33,0,87
17043003011,1185,814,708,26,12,7,51,0,106
17043003088,645,522,419,30,8,5,60,0,103
17043003013,682,557,420,24,8,3,104,0,137
17043009032,1193,1100,853,65,71,5,102,0,247
1719700CH04,1688,1309,1207,75,4,11,6,0,102
1719700JO17,1979,1621,1022,333,205,19,32,1,599
17165001301,282,205,186,6,3,11,2,2,19
17165000403,576,466,429,10,12,7,0,0,37
17165000402,914,699,657,6,6,15,5,0,42
17165000607,1184,996,867,35,56,24,13,0,129
17019CN1700,2094,1774,1041,109,494,33,108,2,733
17019UR3000,2461,1871,1058,479,219,88,81,0,813
17019RA3000,1045,769,554,83,101,35,10,1,215
1719700HO07,1993,1621,1445,98,7,19,48,0,176
17049001110,830,646,529,73,15,18,9,0,117
17043006072,1052,793,327,49,51,7,362,1,466
17043001045,2747,2044,794,1083,81,63,76,2,1250
17043001001,1623,1168,456,622,39,49,51,2,712
17043005038,1247,1007,676,127,103,18,95,0,331
17043005111,783,567,507,18,10,4,24,0,60
17043005089,1129,855,536,117,77,16,115,0,319
17165000603,1008,774,676,16,53,21,10,1,98
17165000608,1180,922,811,10,42,43,15,1,111
17131000502,683,560,516,16,1,23,5,1,44
17073000301,1713,1262,1172,47,6,14,11,0,90
17073001201,434,354,334,9,4,2,1,0,20
1711100Al27,1490,1064,746,249,22,32,24,0,318
1711100Mc33,719,591,505,61,4,8,3,0,86
17043005129,502,375,322,21,1,5,21,0,53
17043005090,811,635,558,39,0,3,32,0,77
17043009037,734,490,441,16,8,10,13,0,49
17073002006,974,672,485,72,85,18,4,0,187
1719700FR08,2745,2030,1641,138,93,50,112,0,389
17043003021,1101,799,686,33,5,6,68,2,113
17043002026,1189,973,500,148,16,9,298,0,473
17043002081,935,737,507,71,18,15,122,1,230
1719700NL04,1356,1057,950,52,17,13,6,0,107
1719700NL08,2238,1661,1509,94,13,17,25,2,152
17119001314,1220,1015,772,32,162,23,13,0,243
17043008008,745,592,407,124,1,12,42,0,185
1719700LO14,2126,1630,949,440,138,50,71,0,681
1719700LO20,1811,1407,977,283,88,33,27,1,430
1718300MD02,348,294,281,6,0,6,1,0,13
1718300DC19,553,386,199,39,135,13,4,0,187
17149001101,149,108,102,0,0,5,1,0,6
17043004025,727,560,361,34,15,9,144,0,199
17043004083,927,784,453,83,46,6,198,1,331
17043002001,695,630,527,34,13,1,54,3,103
17043002058,1058,848,618,128,6,7,87,1,230
17043002103,527,436,208,36,18,12,159,0,228
17043007065,1071,815,510,75,10,2,214,0,305
17043007014,879,668,484,63,24,14,75,0,184
17081001101,1867,1463,1370,20,28,16,20,3,93
17163000B34,420,358,141,9,203,0,2,1,217
1716300CS16,597,490,412,19,42,7,8,1,78
1716300ESL9,648,510,5,3,502,1,0,0,505
171630ESL15,552,434,4,3,427,2,0,0,430
17155000202,551,440,404,24,0,4,4,1,36
17155000201,470,369,344,10,4,6,3,0,25
1718300OK03,384,329,310,9,3,8,0,0,19
17019CN2300,2247,1892,1425,73,184,21,184,3,467
17019CN2200,1676,1329,808,95,296,45,93,0,521
17019UR1000,425,369,310,18,16,7,22,1,59
1715100GOL1,573,466,454,5,2,5,2,0,12
1715100GOL3,630,493,454,8,18,14,7,0,39
1717500NESS,583,476,453,15,2,4,2,0,23
171630000B1,944,748,523,18,174,16,15,2,225
17163000SC3,986,798,500,41,222,13,29,3,298
17163000B11,808,625,382,28,189,12,17,2,243
17163000SK7,727,596,466,10,99,9,7,1,130
171630000B7,1105,861,599,26,217,16,10,1,262
17201000405,1478,1200,897,71,88,13,134,1,303
17163000CN6,358,284,14,8,264,1,6,0,270
17163000CN4,426,347,9,12,324,2,1,0,338
171630ESL13,1014,695,2,2,683,6,2,0,693
17065000901,202,165,157,1,0,5,0,0,8
17147000602,1498,1167,1106,17,11,27,4,0,61
17119001911,1523,1188,1019,18,101,33,14,0,169
171670CP017,1308,1022,717,16,228,17,38,2,305
171670CP010,921,689,586,4,73,17,0,1,103
171670CP060,933,733,582,7,117,19,4,0,151
1711100Ch03,1644,1147,566,523,16,34,18,2,581
1711100Nu13,710,533,410,71,17,7,17,1,123
1711100Mc08,917,766,663,71,8,21,2,0,103
1711100Gr17,2004,1410,1133,79,45,11,126,1,277
1711100Gr12,2482,1755,1352,227,46,25,112,4,403
1711100Gr19,2252,1599,1205,202,44,31,126,1,394
1711100Al28,1409,1096,838,193,8,36,31,1,258
1711100Al61,1110,853,625,154,24,19,36,0,228
1711100Nu10,1218,955,865,38,16,12,15,1,90
1711100Gr26,1234,1207,1134,33,3,6,21,0,73
17073000701,685,525,484,19,6,8,5,1,41
17121003005,893,648,492,21,79,34,10,0,156
171670ME002,507,384,361,5,6,11,1,0,23
1719700JO01,2309,1800,748,364,623,22,65,0,1052
1719700CU01,1367,1127,1030,44,2,31,5,0,97
1704100CA03,1214,891,831,17,10,22,4,2,60
171670CH003,1784,1273,1156,13,47,21,26,0,117
171670CH005,1766,1332,1191,31,54,26,35,1,141
17019CC2600,1411,1189,934,42,126,28,56,0,255
17019HAR000,610,503,432,57,6,8,2,1,71
17019CC1400,803,679,484,50,67,8,65,0,195
17133000019,806,611,554,17,3,25,9,0,57
1711100Ch04,1228,874,356,494,6,29,10,1,518
1711100Ch02,3021,2147,963,1110,16,51,19,2,1184
1711100Ma02,1584,1229,925,246,28,32,8,3,304
1711100Mc30,1456,1139,928,135,11,15,33,2,211
1711100Mc21,1727,1363,1168,95,25,14,40,3,195
1711100Mc03,1347,1126,967,89,16,19,21,5,159
1711100Nu15,2200,1627,1386,116,15,28,69,3,241
1711100Al59,2094,1684,1234,303,54,27,73,2,450
1711100Gr08,2622,1969,1747,86,14,13,90,0,222
1711100Al42,1605,1182,1013,94,17,17,48,0,169
1711100Ma04,2327,1736,1402,269,14,30,28,0,334
1711100Mc31,1224,952,877,31,1,10,20,0,75
1711100Al53,1158,933,726,114,35,13,45,0,207
1711100Al50,1196,863,749,58,9,20,34,1,114
1711100Al64,909,741,581,67,26,6,64,0,160
1711100Nu26,1503,1180,879,214,12,24,44,0,301
17121010001,495,385,370,5,2,7,0,0,15
17181000117,391,317,293,6,4,9,0,0,24
1704500SH01,157,135,127,2,0,5,0,0,8
1702900MT18,1005,782,674,22,45,29,8,0,108
1702900MT22,903,720,682,9,12,12,2,0,38
1702900MT08,960,772,704,13,18,20,9,0,68
1711100GR02,895,677,616,33,2,12,9,2,61
1711100Nu04,1316,1089,859,141,13,21,34,0,230
1711100Nu02,1205,925,753,117,16,13,23,0,172
1711100Do10,3484,2558,1806,507,96,55,86,4,752
1711100Do09,2138,1627,1188,331,21,40,45,2,439
1711100Nu27,2043,1680,1341,160,49,40,87,0,339
1711100Nu21,1659,1250,1127,38,7,18,57,0,123
1711100Nu19,2634,2112,1811,176,28,38,63,4,301
17031027011,1362,1247,900,83,108,12,142,4,347
17031027001,2537,2367,1677,208,135,22,290,3,690
17031043032,1475,1314,973,98,66,13,171,5,341
17031760015,3267,2297,493,1521,108,127,163,3,1804
17101000027,397,314,296,4,8,6,3,0,18
17101000013,515,395,355,9,7,14,6,0,40
17101000015,931,754,715,11,7,11,2,2,39
17031050015,1124,919,567,130,64,24,136,1,352
17031030021,1252,958,409,466,41,39,52,0,549
17031890101,1252,1030,556,188,199,11,70,3,474
17031810022,1362,934,828,50,3,3,42,0,106
17031810014,1555,1077,957,42,18,11,47,1,120
1720100Ro12,1144,891,575,159,91,26,38,0,316
17201001201,1393,1076,838,103,110,18,12,0,238
17201000902,1759,1312,698,237,324,43,12,2,614
17201000502,2338,1635,199,1006,427,60,3,0,1436
17043002037,1061,907,467,233,79,15,142,6,440
17043002098,1122,890,565,128,69,7,127,13,325
17043002083,1002,788,473,146,45,16,103,0,315
17031810041,1159,766,674,22,2,9,49,2,92
17031800029,2097,1573,1303,180,16,9,69,0,270
17031960042,2164,1793,1259,103,12,6,408,1,534
17031740002,2101,1694,870,309,146,20,347,0,824
17001023019,425,353,331,0,17,1,3,0,22
17001023013,873,666,574,16,50,13,11,1,92
17001010001,279,191,189,0,0,0,0,0,2
1704500YA01,417,340,326,4,0,10,0,1,14
1702900MG01,304,255,237,4,0,14,0,0,18
1704100AR03,1288,993,680,274,10,16,15,4,313
1702900CH10,816,665,585,19,22,5,28,0,80
1702900CH16,1203,1144,563,212,240,4,58,10,581
1702900MT03,1032,841,762,29,24,22,9,1,79
1702900NO01,1004,719,699,4,9,7,2,1,20
17059000801,132,117,108,1,2,2,1,1,9
17043004008,1159,970,739,65,70,14,74,0,231
17043004101,1084,949,736,57,57,10,81,2,213
17043004016,804,636,464,32,39,4,93,0,172
17043004062,700,581,480,49,15,17,29,0,101
17043003075,669,554,494,20,15,8,18,0,60
17043003148,832,586,484,34,20,10,42,0,102
17043003010,1266,976,805,76,27,23,44,3,171
17043003014,1248,969,775,101,27,14,51,0,194
1712500AG01,470,366,352,5,4,3,5,0,14
17031041001,1088,824,657,114,13,11,30,0,167
17031041040,1087,845,724,74,7,13,23,0,121
17031038009,1556,1189,790,338,16,17,42,1,399
17031758001,1867,1492,579,269,510,58,129,4,913
17031001026,1187,955,266,584,107,28,17,3,689
17031026011,1047,792,157,559,73,50,24,4,635
17031045008,1419,1142,494,496,76,59,84,3,648
17031045010,1383,1083,511,471,39,49,53,1,572
17031045009,1569,1211,526,560,44,38,82,0,685
17031022019,912,610,36,237,337,29,1,0,574
17031026036,945,819,547,181,41,17,42,1,272
17031026033,1053,916,506,251,131,8,43,1,410
17031026027,1103,958,367,406,150,17,53,7,591
17031026021,1406,1095,396,424,269,27,27,1,699
17031036006,2004,1434,104,1209,118,57,28,5,1330
17031036013,1487,1093,53,982,63,73,14,4,1040
17031037010,1503,1149,32,604,509,30,21,0,1117
17031820029,1225,1059,706,45,32,3,273,3,353
17031810021,1586,1212,846,49,22,8,269,0,366
17031960057,1516,1062,950,33,12,7,56,1,112
17121014004,937,734,674,13,10,26,3,0,60
17133000027,819,610,579,14,0,7,10,0,31
17119000909,2111,1469,1320,47,18,36,26,2,149
17119001322,871,682,523,56,71,25,9,0,159
17119001329,827,671,522,43,90,8,11,0,149
17119001304,1120,858,652,36,116,39,10,0,206
17119001309,1483,1186,993,84,49,25,30,0,193
17119001327,818,665,547,21,71,6,18,0,118
17059000701,742,603,570,8,9,11,3,2,33
17047000102,780,559,541,5,1,5,5,5,18
17047000103,723,564,519,11,4,14,11,2,45
17091Kank14,1214,865,54,112,700,10,1,1,811
17091Kank10,3732,2573,386,884,1249,83,6,1,2187
17019CC1100,2104,1893,1357,109,266,26,121,6,536
17043003087,1043,979,871,18,9,4,78,0,108
17043003131,1135,986,812,41,21,7,109,1,174
17007001020,921,756,666,39,25,6,21,0,90
17101000008,589,468,451,3,4,8,2,0,17
17107000803,985,840,799,2,23,3,8,1,41
17107001301,577,451,434,6,5,4,2,0,17
17001023022,927,711,646,15,26,10,8,2,65
17001023023,873,718,623,25,32,15,21,3,95
17065001201,488,355,350,0,0,4,0,0,5
17119001807,955,750,641,17,51,30,4,0,109
17119001915,893,688,634,12,12,21,6,0,54
17119001926,1456,1145,1067,20,12,23,13,0,78
17113002101,1206,895,844,7,10,26,1,0,51
17113COB051,2813,2107,1076,81,100,26,835,3,1031
17113COB042,1069,804,638,12,57,3,82,2,166
17113COB045,961,813,702,26,66,0,10,0,111
17113COB047,873,665,511,62,51,35,4,0,154
17113003003,1562,1369,967,93,203,19,94,1,402
1711700MO04,426,352,340,3,1,3,5,0,12
1700500MG02,396,317,300,2,8,5,1,0,17
1700500SH02,249,203,192,1,2,5,0,0,11
1705700IS01,175,145,143,1,0,0,0,0,2
17097War320,1545,1244,903,111,53,20,161,1,341
17097War323,497,445,335,42,25,8,40,1,110
170970Ela80,1423,1066,882,67,31,10,77,1,184
17185000001,503,398,352,16,4,8,7,0,46
17185000002,669,528,498,7,6,11,6,1,30
17097Wes388,1731,1356,931,76,92,14,190,4,425
17097Wes387,1713,1355,1125,68,32,12,113,0,230
17097Wes392,1767,1265,1140,45,19,7,45,1,125
17097Wes393,1303,902,800,39,6,2,45,1,102
17097Wes395,1880,1369,1174,74,20,11,77,0,195
17097Lib184,1281,907,775,30,19,13,67,1,132
17031013011,963,701,331,327,19,16,22,0,370
17031013004,1090,865,436,367,29,32,25,0,429
17047000301,303,224,222,0,0,1,1,0,2
17031013040,1012,769,157,595,12,43,6,0,612
17031013016,1196,866,95,760,4,67,11,0,771
17031006034,1040,868,3,2,862,11,2,0,865
17031008045,1550,1252,12,14,1221,12,4,0,1240
17031050038,854,743,557,27,19,0,123,0,186
17031050012,0,0,0,0,0,0,0,0,0
17031007007,1599,1155,11,18,1118,12,5,3,1144
17031820054,1045,849,509,83,25,10,218,7,340
17031820035,1805,1369,697,108,26,17,533,4,672
17031760020,3016,2222,1108,182,91,48,818,3,1114
17031037018,939,738,8,137,610,22,5,0,730
17031960040,1619,1195,985,59,29,11,100,2,210
17031960032,914,673,588,35,5,7,41,0,85
17031920007,1008,792,507,222,21,14,36,0,285
17031790068,1680,1350,738,525,62,21,18,0,612
17031970010,1556,1155,711,166,245,17,21,0,444
17031950007,1100,980,14,24,943,8,0,0,966
17031950055,941,786,104,71,603,9,10,0,682
17031950083,1776,1345,32,30,1274,3,6,0,1313
1709700Ant5,1827,1425,1140,154,72,29,29,2,285
1709700Ant4,1475,1156,973,103,27,20,22,6,183
17031870018,924,757,597,107,6,19,42,0,160
17031870047,1597,1482,1162,88,42,3,184,0,320
17031930057,1750,1396,1063,68,16,7,241,0,333
17031800031,1631,1420,874,95,51,5,400,2,546
17031800069,1819,1540,895,76,44,10,528,2,645
1705500DE01,726,593,553,3,11,19,1,0,40
17031810002,1950,1427,1247,53,12,11,91,2,180
17031950074,1788,1381,17,11,1352,3,0,0,1364
17031006017,1300,920,5,15,897,9,5,3,915
17031006010,1226,880,3,25,849,6,2,0,877
17031007043,814,648,2,26,614,12,5,0,646
17001023029,1016,786,724,15,23,18,7,0,62
1719500UG01,1172,930,901,15,0,9,3,0,29
17161000817,982,732,572,100,45,21,9,3,160
17161001003,1499,1270,953,78,181,10,43,0,317
1717300SH06,769,568,533,12,3,10,4,0,35
170970Ela89,1389,1065,929,67,3,15,45,1,136
17031991005,1080,873,441,318,80,39,31,0,432
17031036030,1540,1205,483,563,60,49,96,0,722
17031036015,1354,1084,502,467,18,50,90,4,582
17031900010,1080,891,188,75,601,9,24,0,703
17031900008,2511,1987,290,43,1624,20,8,2,1697
17031035026,1488,1193,435,610,49,41,90,3,758
17031050008,1723,1357,395,320,471,44,160,1,962
17031049008,1465,1148,366,283,369,25,126,4,782
1717300MO02,1051,826,796,6,6,9,4,0,30
17097Wau328,998,739,556,112,20,19,26,0,183
17097Wau332,1181,891,756,103,5,19,10,1,135
170970Avo30,2873,2205,1086,865,117,75,105,1,1119
170970Avo37,2473,1697,881,360,84,58,353,9,816
17097Mor222,1189,884,822,17,11,4,29,0,62
17097Mor217,1351,1067,981,38,10,4,25,0,86
17097Wes399,1864,1332,1177,48,20,4,76,6,155
17097Wes400,1783,1363,1176,39,17,4,116,2,187
17013000001,227,177,174,0,0,1,0,0,3
17013000006,778,605,589,7,1,8,3,0,16
1719500ST08,1129,845,481,297,40,35,2,0,364
1719500PR02,571,422,374,15,1,14,4,0,48
17031900050,1652,1269,753,362,79,34,47,5,516
17031900002,923,770,49,21,696,9,16,0,721
17031830008,1314,1051,893,26,14,9,102,2,158
17031830009,1007,708,609,21,9,2,58,1,99
1711700BR01,314,253,242,5,1,0,0,0,11
1711700ST04,1269,1000,955,13,3,21,4,1,45
1700500SH03,356,279,254,6,6,11,2,1,25
17031028006,430,367,181,43,102,1,40,0,186
17031028027,1171,1068,506,94,51,15,406,2,562
17031890069,1286,968,18,290,660,32,6,4,950
17031026013,1067,843,40,710,111,30,4,6,803
17031034022,700,561,0,3,553,8,5,1,561
17031034020,772,650,1,10,638,2,2,2,649
17031022015,2228,1631,46,1570,12,86,1,1,1585
17031758003,1702,1321,366,193,605,39,163,3,955
17031019047,1090,888,219,41,613,9,15,1,669
17031050019,2225,1602,220,379,155,13,828,2,1382
17031050036,1668,1212,500,265,84,15,364,0,712
17031015013,3399,2367,80,2191,97,156,31,2,2287
17031015014,2871,2043,62,1885,102,111,10,8,1981
17031012021,2190,1674,204,1114,128,157,238,5,1470
17031017039,875,709,7,15,692,5,3,1,702
17031017015,1328,965,5,10,948,1,4,2,960
17031012006,2421,1843,128,985,48,58,701,1,1715
1718900OV02,281,213,201,3,0,7,0,0,12
17031820006,1288,1047,731,73,12,3,225,1,316
17031960078,1870,1437,1277,53,15,8,81,1,160
17031800005,3718,3162,1219,302,195,26,1420,3,1943
17031041029,2215,1850,1321,196,57,10,274,2,529
17031780013,2421,1885,891,800,115,42,82,4,994
17031003008,1563,1086,12,25,1055,12,4,3,1074
17031003037,1421,1101,32,27,1036,12,11,1,1069
17031003016,1614,1212,22,59,1126,23,7,1,1190
17031029011,737,584,9,22,558,3,1,0,575
17031029018,1261,985,42,52,892,9,5,1,943
17031047007,1300,978,707,121,22,13,111,2,271
17031036024,2068,1583,656,813,34,41,79,3,927
17031049033,1485,1200,392,284,455,33,71,11,808
17031049015,1492,1167,304,287,457,31,97,2,863
17031004004,1758,1303,44,36,1212,16,22,1,1259
17031028002,950,698,85,82,529,4,3,0,613
17031041014,1040,766,634,71,7,13,47,0,132
17031041006,1030,764,670,37,10,7,28,0,94
17031041019,1157,825,650,76,13,11,79,2,175
17031930072,1804,1417,711,133,63,15,500,3,706
17031800018,1385,1106,660,331,13,56,88,0,446
17031037034,1128,840,4,119,717,5,3,1,836
17031800034,2104,1805,1216,304,32,17,238,2,589
17135001002,938,726,695,9,7,13,2,1,31
17177001101,1425,1144,1096,19,6,12,0,0,48
1718900RC01,318,255,247,1,5,2,1,1,8
1703900CL04,927,733,672,26,5,14,15,4,61
17135000802,595,490,454,9,9,9,4,2,36
17135000805,994,797,754,11,6,16,4,1,43
17135000804,630,509,499,3,0,4,1,1,10
17135000602,242,195,182,2,2,4,2,0,13
17031007035,1062,815,25,103,686,15,5,0,790
17031007034,911,751,13,23,717,7,3,0,738
1718900OK01,561,430,405,8,3,8,1,0,25
17135001102,828,621,572,7,6,19,13,0,49
1705100SR01,2968,2799,1649,394,704,56,6,2,1150
1717300LA01,381,320,301,3,6,6,2,0,19
17135000806,2531,2356,1480,146,697,28,12,0,876
17031039026,1184,894,514,58,20,6,295,3,380
1705100VA08,927,741,685,27,4,9,17,0,56
1707500ON01,715,520,227,277,6,9,2,0,293
17031048044,1328,1157,760,176,83,29,118,0,397
17031001033,1563,1288,811,290,62,21,114,2,477
17031810038,1419,1020,896,32,22,18,46,2,124
17031810036,1839,1294,1086,53,25,11,112,1,208
17031930033,1052,812,630,58,14,9,112,0,182
17031960022,1464,1337,1082,70,12,3,151,0,255
17031870067,1013,825,724,17,6,4,72,1,101
17031870056,1931,1480,905,152,66,37,345,2,575
17031870064,2121,1731,1000,319,148,21,240,0,731
17031930034,2988,2239,801,583,261,46,573,4,1438
17031930027,2313,1911,935,310,246,27,417,13,976
17001023016,1074,799,702,27,41,14,14,0,97
17001023020,1026,773,713,9,29,7,10,1,60
1707500BE01,515,408,368,9,23,8,1,1,40
1707500CH02,1076,816,761,20,8,15,6,0,55
17031810019,946,679,625,22,6,0,21,0,54
17031930011,1564,1212,856,133,34,16,184,0,356
17031850006,1949,1657,892,157,488,24,106,3,765
17031011037,805,682,27,15,46,3,594,0,655
17031710008,1946,1496,819,369,261,41,33,1,677
17031014017,1947,1414,75,1272,29,92,46,7,1339
17031970063,1673,1321,639,320,278,27,79,1,682
17113COB005,1265,987,716,67,153,28,26,0,271
17113COB041,1345,1084,883,32,139,18,12,2,201
17113000301,498,373,319,25,3,13,8,1,54
17031960047,2411,1896,1248,424,33,19,189,0,648
17031004006,1536,1433,159,49,879,17,343,0,1274
17031003018,2461,1818,186,98,1327,18,217,4,1632
17031003027,1692,1443,768,141,220,12,315,1,675
17113COB038,1654,1288,922,38,88,22,232,1,366
1719500ST05,702,537,372,127,23,14,0,0,165
17161000802,1379,1102,702,301,85,42,8,2,400
1719500HO02,960,753,679,55,2,10,5,1,74
1719500CO09,1271,1041,850,133,10,16,8,1,191
1718700GR01,517,422,410,2,6,2,0,1,12
1718700EL01,340,243,220,7,6,3,2,0,23
17031780006,2523,1933,810,955,46,85,99,0,1123
17031039012,2424,1872,494,732,153,79,485,0,1378
17031033007,2739,2120,494,1064,136,106,434,7,1626
17031035029,2841,2146,262,1291,132,137,444,5,1884
17031035030,2429,1851,283,959,124,65,476,4,1568
17181000113,822,639,613,3,5,14,3,0,26
1718700FL01,406,327,314,2,0,9,0,0,13
17161000719,1412,1075,869,91,82,23,10,0,206
1703900WA01,905,722,699,8,2,4,3,0,23
17043009120,608,569,502,10,16,1,39,0,67
17043009031,1306,1011,772,93,32,16,88,3,239
1718700PP01,172,138,126,2,0,6,1,0,12
17031720074,2072,1604,795,473,229,36,102,0,809
17031950062,797,605,199,312,96,9,2,0,406
17031017013,1138,885,5,70,807,14,6,3,880
17031018011,1075,837,95,455,278,36,7,0,742
1719900WM07,1267,988,812,28,88,47,7,0,176
1719900BL06,808,624,588,3,9,14,1,2,36
17043005029,800,575,456,51,8,16,44,0,119
17043007027,1445,1101,378,435,108,23,168,3,723
17043007051,1062,841,460,57,27,19,274,4,381
17043004089,1347,1215,870,100,95,12,135,0,345
1714300PE34,1437,919,222,147,545,23,5,2,697
17043006023,1114,847,486,206,91,16,63,1,361
17043007055,761,611,497,32,7,6,72,0,114
17031034012,775,638,4,10,622,6,5,2,634
17043001017,746,554,476,32,6,5,20,0,78
17043001050,562,493,393,63,5,1,27,1,100
17043001020,1570,1237,560,528,42,36,84,0,677
17179001903,1003,773,725,11,6,16,13,0,48
17043002064,1619,1369,719,300,143,23,184,6,650
17043002025,1281,971,349,375,34,44,216,7,622
1717300PR01,1212,883,839,9,4,9,10,3,44
17031890087,2232,1722,511,1104,92,32,28,0,1211
17031820022,2378,1898,948,231,252,22,458,5,950
17001020003,1156,880,814,8,19,17,8,2,66
17001023031,882,729,709,10,5,3,0,0,20
17113COB004,2506,2213,1610,181,231,26,159,3,603
17031830045,1623,1235,1025,32,11,14,143,0,210
17031960070,1706,1474,1165,147,29,11,123,0,309
17031960051,2040,1691,1206,204,31,15,226,3,485
17031800017,1573,1273,803,267,41,24,147,1,470
17031011028,942,681,279,260,67,21,93,0,402
17031890062,1291,1200,627,84,373,23,107,0,573
17031890046,337,241,218,14,6,3,0,0,23
17031014024,1191,910,473,402,14,50,19,2,437
17031900028,898,728,22,25,678,11,14,0,706
17031002003,1461,1305,1002,145,49,19,94,1,303
17031037031,1212,950,9,238,697,26,7,1,941
17031037038,1058,824,1,135,697,7,3,2,823
17031037041,1284,953,17,286,659,31,9,3,936
17031720020,1143,838,673,93,31,20,21,1,165
17181000116,247,192,179,3,1,5,0,0,13
1711700NO00,781,672,657,2,6,7,0,0,15
1705500TY01,723,584,559,2,1,16,2,1,25
17031860003,1008,858,589,71,129,7,59,3,269
17031860025,2102,1757,1461,133,71,6,87,0,296
17031860069,1218,888,518,83,253,10,30,2,370
17031016034,913,659,0,48,604,5,4,0,659
17031019025,779,557,396,30,120,11,8,0,161
17031880034,1071,910,783,81,18,12,22,0,127
17031016029,952,704,1,75,631,13,2,1,703
17031006024,765,592,9,21,556,1,2,0,583
17031016030,737,556,4,39,508,5,4,1,552
17031040028,1544,1256,547,363,206,44,124,6,709
17031039021,1161,949,654,189,21,18,73,4,295
17031045044,1121,891,672,132,14,10,68,0,219
17181000103,1047,827,765,18,21,14,7,3,62
17097Mor204,2733,2176,1263,697,67,63,121,6,913
17097Mor203,1461,1089,980,40,13,2,57,6,109
17097Mor207,2987,2240,986,1098,62,99,75,4,1254
1705300PT03,193,159,143,7,3,4,0,1,16
17031026030,803,654,265,251,116,13,37,0,389
17031026042,701,575,229,273,59,32,22,0,346
17031037007,1274,937,32,544,374,13,6,1,905
17031037004,1393,1005,43,497,459,27,5,2,962
17031037008,1092,810,41,418,363,36,3,0,769
17031760024,3456,2570,545,1547,113,115,364,2,2025
17031016013,2265,1561,38,1194,333,31,9,2,1523
17031039041,1089,845,590,140,19,24,91,1,255
17031045032,1228,977,478,276,15,15,205,1,499
17031021050,728,573,1,24,554,3,3,0,572
17031890056,1173,912,25,312,585,23,7,1,887
17043004052,1051,762,547,47,29,9,119,0,215
17043004106,527,407,233,10,2,2,150,0,174
17043009016,870,628,547,31,13,3,35,0,81
17043009066,835,619,520,39,13,10,36,1,99
17043009013,725,588,465,76,21,6,22,0,123
17043009132,473,356,216,82,17,9,35,0,140
17097Wau366,3131,2270,393,1293,513,112,52,5,1877
170970Avo23,1249,1009,832,81,34,13,52,1,177
170970Avo22,1072,927,792,63,18,17,43,1,135
17097War311,1380,1050,755,113,56,10,117,1,295
170970Cub65,1349,997,860,38,19,9,69,0,137
17031023036,979,753,419,314,5,21,2,1,334
17031023027,730,603,373,223,4,14,6,0,230
17031009033,784,572,1,16,558,0,6,0,571
17031009026,2076,1344,17,72,1257,15,3,1,1327
17031950031,1112,777,119,353,296,25,6,0,658
17031970095,1307,1107,942,62,71,3,31,0,165
17031970089,1430,1229,1123,56,16,0,32,0,106
17031710009,1988,1487,618,545,274,30,46,2,869
17031710015,1999,1502,493,681,306,50,23,3,1009
17031720034,1710,1341,1206,80,22,20,18,1,135
17031760001,2614,2084,920,169,215,26,759,1,1164
17031820013,2003,1561,1091,152,22,19,294,0,470
17085001401,348,297,273,14,3,1,0,0,24
17085000801,1504,1329,1271,20,5,16,3,0,58
17085000701,1008,811,779,13,4,10,2,0,32
17161001002,975,765,282,95,294,27,84,0,483
17161000610,1398,1078,825,103,116,10,24,1,253
1719500ST01,656,505,363,111,17,24,1,1,142
17031002046,782,670,505,36,56,11,62,0,165
17031027042,683,635,361,55,181,4,35,0,274
17031043001,603,501,345,29,89,4,32,0,156
17031026018,1183,909,113,717,77,33,19,2,796
17031026031,596,461,39,367,47,42,9,5,422
17031026043,1072,797,78,662,63,25,10,0,719
17031850031,2287,1674,1004,168,319,24,152,2,670
17031015002,726,526,0,133,394,6,3,1,526
17031015018,787,599,2,114,478,17,9,1,597
17031015020,872,654,0,120,532,9,3,3,654
17031015024,774,600,0,89,513,10,1,1,600
17031013027,1023,789,361,407,21,44,4,0,428
17031016021,966,676,2,124,556,8,0,1,674
17031016003,737,525,5,76,452,17,2,1,520
17031019006,1009,744,634,74,9,15,19,1,110
17031019001,780,584,498,30,34,3,20,1,86
17031790035,1804,1439,1079,274,28,18,41,1,360
17031790051,1820,1415,1017,228,122,33,37,2,398
17031730002,1935,1481,225,922,325,64,5,1,1256
17097Lib192,2069,1429,740,57,42,4,577,5,689
17097Lib200,1797,1461,851,99,73,22,419,2,610
17031720039,1045,772,56,109,597,11,14,0,716
17047000101,1060,806,782,7,6,6,7,2,24
17161000803,1594,1211,793,277,72,66,22,6,418
17097Fre114,1370,1119,966,113,8,12,32,1,153
17097Fre124,1603,1226,795,193,42,17,188,0,431
17097Wau335,1754,1348,751,530,24,48,28,0,597
17007003002,2213,1592,1214,237,63,63,18,0,378
1719500CO02,1319,987,758,177,28,22,4,1,229
17035000703,676,533,503,3,6,13,1,0,30
1710900MC05,957,811,692,34,47,27,15,0,119
17043005118,1184,793,260,94,35,15,395,0,533
17043005072,2068,1570,396,464,186,48,509,0,1174
17043002055,1226,969,800,91,7,13,62,1,169
17135001604,641,521,512,2,0,0,1,2,9
17135001602,1223,980,921,16,8,22,4,0,59
1701500WY02,603,466,434,6,9,13,4,0,32
17097War306,1723,1271,620,144,71,19,420,4,651
170970Cub73,1554,1196,1007,45,14,3,121,2,189
17097Wes381,972,754,605,30,17,5,96,0,149
17043004079,1832,1628,1289,127,105,19,82,0,339
17043007016,1042,821,243,178,40,24,353,0,578
17097Wau334,1357,1099,867,133,30,27,40,1,232
17097Wau333,1116,902,743,120,4,23,12,0,159
17097Wau331,798,628,544,47,4,16,17,1,84
17113003009,2135,1966,1489,153,174,28,120,3,477
17113COB010,1647,1324,1080,70,84,12,77,1,244
17113COB032,1411,1159,730,62,186,21,157,0,429
170970Cub69,1171,1106,1033,16,6,7,32,0,73
17191001301,371,272,259,2,0,6,0,0,13
17031035027,1577,1236,382,669,86,43,105,3,854
17031740027,1630,1348,1129,60,14,7,138,2,219
17031740050,1885,1512,615,221,107,24,555,5,897
17097Ver257,1212,870,617,67,14,8,156,0,253
1701500SA05,568,445,406,31,3,7,1,0,39
17157000602,587,446,406,15,14,2,3,0,40
17157000601,585,470,424,12,22,9,2,1,46
1714300PE82,938,784,592,17,82,9,80,0,192
1714300PE81,1316,1036,672,40,218,23,84,5,364
17191001101,671,489,471,3,2,10,0,0,18
1708700GO01,1583,1207,1149,17,5,29,4,0,58
1719900HE03,883,659,602,9,26,11,7,0,57
17097Zio404,1556,1159,361,455,274,58,53,4,798
17097Zio405,1812,1315,305,337,610,27,54,2,1010
17097Lak144,1785,1419,1195,151,31,28,22,3,224
17097Mor224,1019,747,676,27,8,3,24,2,71
17097Lak147,1738,1237,973,87,50,20,90,0,264
17097Wes396,1644,1137,1051,39,8,1,35,0,86
17085000501,1283,1033,995,8,6,12,7,1,38
17157000702,678,539,512,3,6,12,2,5,27
17113002503,1072,817,770,21,6,9,5,1,47
17031890068,828,712,503,63,88,12,49,2,209
17031025005,1837,1450,346,961,85,88,59,2,1104
17031024022,1568,1104,9,43,1059,5,4,0,1095
17031037030,1182,908,3,171,733,21,6,0,905
17031028042,1353,998,8,53,946,7,3,0,990
17031022024,3087,2168,57,2094,23,183,8,1,2111
17031950052,1135,919,20,37,857,10,3,0,899
17113002502,1653,1184,1134,21,6,13,3,0,50
17113001702,997,731,689,8,7,10,10,1,42
17161001010,1150,926,719,73,81,17,44,1,207
17161000815,1264,883,556,229,77,18,12,0,327
1714500PI04,670,551,515,8,2,14,9,0,36
1719500MP01,928,777,665,66,32,10,12,1,112
17163000OF5,1680,1249,832,57,282,34,54,4,417
170890AC510,945,801,379,273,122,15,20,2,422
170890AC305,2291,1613,168,1362,72,121,8,1,1445
170890AC204,2782,1961,79,1712,158,125,23,1,1882
170890AC605,1483,1107,281,674,132,38,27,2,826
17097Fre120,1402,1099,606,304,37,10,139,0,493
17097War305,1489,1101,645,116,78,10,257,3,456
17097War290,1202,893,521,165,73,19,121,3,372
17097War319,1456,1193,917,78,41,15,137,1,276
1719900CR01,966,756,711,5,9,22,1,0,45
1719900CS02,1550,1248,1186,12,10,24,3,0,62
17179000501,943,735,706,0,0,14,2,0,29
17179001915,1322,1035,960,11,6,39,12,2,75
17071000401,263,213,206,0,0,2,0,1,7
17071000602,1136,950,906,9,4,12,2,4,44
17071000601,500,410,381,8,3,9,3,0,29
17113003029,2989,2395,1340,151,782,25,99,2,1055
17113COB018,1631,1281,1021,108,102,21,21,3,260
170890AC507,1491,1139,473,430,158,20,66,3,666
1708900BA13,1026,755,656,39,15,4,33,1,99
17179001401,1294,968,913,11,7,10,23,0,55
17179001415,1289,910,866,9,6,10,18,0,44
17031940018,1558,1182,686,396,38,22,64,0,496
17031860068,983,791,690,49,18,0,31,0,101
17113001201,523,442,432,5,3,0,0,0,10
17113001001,1191,955,881,22,14,20,8,2,74
1707700DG01,154,118,113,2,0,2,0,1,5
1707700KK01,449,352,336,3,0,13,0,0,16
17179000205,885,707,665,12,11,10,8,0,42
17179001403,1112,841,780,13,8,12,20,0,61
17031980017,3486,2512,193,2145,148,137,23,1,2319
17031012014,2633,1825,42,1735,53,114,2,2,1783
17031031016,1100,927,334,521,37,52,43,8,593
17031031004,1072,875,355,428,74,22,26,8,520
17031960039,1620,1220,1032,84,14,2,72,3,188
17031018025,1476,1068,197,762,101,50,14,0,871
17031018030,1698,1258,273,885,69,87,38,0,985
17031710039,1757,1228,119,567,535,38,5,2,1109
17023009002,553,422,395,7,3,10,1,3,27
17023003003,712,549,539,7,1,2,0,1,10
17031980007,2463,1771,106,1460,187,122,33,8,1665
17031021009,674,573,2,6,563,4,0,0,571
17031019035,718,568,400,29,131,5,4,0,168
17031950009,541,532,32,13,483,10,1,0,500
17031710037,569,474,58,30,383,3,0,1,416
17031950069,937,655,5,33,618,7,2,0,650
17031710027,2015,1452,303,194,945,33,19,7,1149
17031970021,3335,2509,1811,416,157,51,85,8,698
17067000501,248,213,210,0,0,3,0,0,3
1707700AV01,898,688,648,15,0,14,1,1,40
1707700CB09,690,532,328,35,130,18,27,0,204
1707700CB04,1458,1115,391,86,555,47,61,3,724
1707700CB01,1188,947,701,51,142,35,22,5,246
1707700CB26,956,812,376,66,206,39,124,6,436
1707700LE01,814,668,631,8,2,10,5,0,37
17163000B25,980,780,619,17,93,24,22,0,161
17163000B21,1040,807,532,30,207,27,5,1,275
17031900004,1084,845,69,39,734,13,1,0,776
17031720061,1528,1183,841,247,63,36,17,1,342
17031005027,2695,2528,1319,252,203,10,730,11,1209
17031005039,1198,1017,455,31,186,3,337,1,562
17031004029,1379,1016,37,51,946,24,9,5,979
17031045036,1172,931,616,212,27,14,76,1,315
17031045035,1183,920,575,154,18,26,152,2,345
17031950018,2413,1801,749,451,580,53,19,2,1052
17031014003,2204,1594,64,1481,38,108,11,1,1530
17031023013,2046,1438,56,1348,26,111,10,2,1382
17153000501,261,215,30,2,176,5,5,0,185
17031860050,1410,1068,875,100,41,7,43,0,193
17031860014,1657,1273,1051,124,39,17,33,0,222
17031013017,1148,827,268,544,11,30,11,0,559
17031013008,863,634,219,394,12,26,16,1,415
17031880033,1008,965,926,12,12,0,13,0,39
17031890095,1261,1072,359,384,279,12,52,1,713
17031890100,2173,1626,714,802,70,29,54,2,912
17031015005,2974,2070,96,1855,96,139,40,1,1974
17031015001,2757,1943,80,1781,45,105,51,2,1863
17031012019,1714,1255,151,839,24,70,241,2,1104
17031790020,1986,1422,1324,49,9,6,19,0,98
17031019052,1267,977,748,135,60,13,12,4,229
17031019021,1167,856,749,56,23,15,16,2,107
17031940003,2936,2230,1068,992,85,54,91,2,1162
17031940009,1920,1478,726,626,71,60,71,0,752
17031023002,1155,961,522,376,29,22,27,0,439
17031013031,1076,813,437,348,15,18,10,0,376
1707700EK01,1120,851,768,13,38,25,2,2,83
17031860042,1377,1154,1009,47,33,3,53,0,145
17031860058,1295,1013,823,53,57,4,73,1,190
17031755003,1840,1358,279,205,789,40,81,7,1079
17031024014,1155,759,14,34,699,5,2,0,745
17031980002,2413,1655,52,1512,88,159,4,2,1603
1708900GE21,2757,2090,1798,106,32,29,120,2,292
1708900SG04,1566,1296,1142,80,27,12,24,0,154
1708900EL08,1696,1291,509,561,158,53,48,1,782
1708900EL10,1540,1250,695,392,50,42,89,0,555
1708900EL37,1711,1345,628,511,156,68,27,1,717
1708900EL18,2907,2113,364,1559,145,122,48,3,1749
1708900VI01,829,625,554,46,2,8,12,1,71
1708900SC10,1067,865,763,52,11,7,17,0,102
17031036004,2430,1715,103,1350,191,127,84,3,1612
17031036026,1644,1301,628,511,46,62,118,4,673
17031038010,1403,1108,614,382,31,21,86,1,494
17031820055,1023,794,448,70,77,15,196,2,346
17031023012,879,700,456,226,8,15,9,1,244
17031013042,840,679,426,229,6,35,11,2,253
17031023037,931,738,425,273,15,27,12,4,313
17031018035,826,665,27,59,583,9,2,0,638
17031980004,3011,2209,103,1984,108,143,22,4,2106
17031730009,887,741,20,28,686,6,1,2,721
17031970062,746,565,460,61,29,1,11,0,105
17031970049,915,741,529,122,61,17,22,0,212
17031038001,1181,954,534,328,20,42,70,0,420
17031038041,1021,798,505,228,21,25,36,0,293
17031710030,1331,1011,392,87,498,9,15,1,619
17031710060,995,802,81,27,689,8,3,0,721
17031024015,734,554,13,57,496,5,2,1,541
17031040021,1343,1040,626,215,80,33,115,0,414
17113003002,2686,2294,1780,129,249,17,116,4,514
17035000701,741,604,556,11,13,20,6,2,48
1708900DU32,3111,2319,1288,384,118,33,497,2,1031
1708900DU33,3072,2189,1333,333,100,42,397,2,856
1708900DU24,1326,1051,795,198,19,21,15,0,256
1708900GE02,980,816,743,45,5,5,7,1,73
1708900DU18,2348,1786,1356,214,51,24,141,0,430
17067000101,963,784,722,18,8,33,5,2,62
17113COB022,1502,1188,1022,60,57,17,24,3,166
17031021043,1012,789,5,10,772,8,4,2,784
17031021054,923,757,6,20,729,1,3,0,751
17031021015,1089,863,5,16,850,14,2,0,858
17031021022,785,636,5,26,609,9,4,1,631
17031790062,512,400,329,22,7,8,36,0,71
17031790036,1242,1083,897,58,7,12,105,0,186
17031950037,1506,1164,309,97,758,8,3,0,855
17031720018,2358,1894,1241,295,172,50,139,1,653
1710900SC01,469,383,362,9,1,8,3,0,21
1710900MC08,1122,871,767,19,34,20,31,4,104
1707700VG01,717,558,532,7,4,13,1,1,26
17153000701,327,256,205,5,30,10,5,0,51
17031021034,1052,819,0,20,800,6,0,0,819
1710900CO01,1559,1275,1236,4,1,21,9,0,39
170890AC306,1378,982,352,327,226,19,87,0,630
1708900CA05,1402,1042,944,35,16,11,27,3,98
17031040008,1476,1235,819,222,71,26,121,1,416
17031021049,750,628,0,13,613,3,3,1,628
17031850030,1744,1415,613,95,633,8,66,0,802
17031004016,2655,2489,1248,206,286,39,736,1,1241
17031004037,2462,2257,1306,179,341,15,417,2,951
17031008014,1440,1167,3,7,1156,8,1,1,1164
17115506001,2971,2187,1787,45,58,29,259,0,400
17171000401,668,546,532,5,0,6,1,2,14
17031035022,2484,1923,564,1037,164,88,141,6,1359
17031980023,3556,2593,207,2301,71,166,20,2,2386
17031960073,1511,1125,834,38,8,10,238,0,291
17031033024,1547,1200,837,195,71,32,83,0,363
1707700OR01,492,373,353,7,1,5,1,1,20
17191000904,724,604,592,5,1,4,2,0,12
17031790006,1193,930,499,319,56,30,49,0,431
17031720064,1595,1403,1156,89,123,7,23,1,247
17031720068,918,743,550,133,16,14,22,0,193
17031950075,1152,877,29,40,805,6,5,3,848
17031930008,1405,1088,634,228,31,30,173,3,454
17031930068,1667,1260,641,41,45,20,521,0,619
17031017025,1224,939,30,268,627,38,10,3,909
17031037017,1047,747,6,138,604,13,3,0,741
17031037011,1004,685,0,111,581,6,2,1,685
17031046006,1544,1245,494,145,341,35,258,5,751
17031046001,1058,938,510,102,272,18,40,1,428
17031013030,1243,909,59,828,10,51,5,0,850
17031023011,1953,1400,112,1256,12,102,9,1,1288
17031013044,1468,1042,69,947,21,64,15,0,973
17031024024,1657,1129,4,66,1066,5,2,0,1125
17031890004,1759,1350,55,237,1058,29,2,1,1295
17031890071,2466,2012,575,587,742,47,95,5,1437
17031900027,1448,1106,130,71,905,17,12,4,976
1710500PT04,982,781,722,29,16,7,5,1,59
1710500PK01,208,167,156,6,1,6,1,0,11
1708900SC26,1604,1226,1048,66,17,17,62,1,178
170890AC603,2188,1510,137,1108,223,65,43,3,1373
1708900EL21,1474,1109,654,319,46,29,70,0,455
1708900EL48,1487,1295,863,206,100,46,95,0,432
1708900SC17,1455,1096,788,210,30,12,63,0,308
17031050023,985,779,328,136,35,5,268,1,451
17031003030,1334,1055,23,11,1024,11,1,0,1032
1716300CS13,1090,887,518,39,280,20,36,1,369
17163000CS9,1274,1081,606,41,383,21,24,0,475
17031038004,1388,1090,625,358,38,25,70,5,465
17031038016,1194,993,566,364,27,52,41,1,427
17031050039,1471,1116,500,130,64,25,410,0,616
17031040026,1072,943,673,144,39,25,71,2,270
17031045025,746,619,394,122,7,10,91,0,225
17031045026,652,517,338,98,16,10,64,5,179
17031890094,942,764,33,127,600,17,5,1,731
17031870017,1297,1032,862,82,14,0,63,4,170
17031045018,1601,1277,736,392,46,19,107,2,541
17031038022,1277,1007,594,288,24,30,90,4,413
17031041044,1053,768,627,81,10,6,38,0,141
17031780009,1508,1221,940,210,5,16,67,0,281
17031890011,2529,1837,273,1491,74,75,7,2,1564
17031890010,3376,2416,199,2048,178,100,11,0,2217
17031020011,1788,1319,10,48,1278,18,0,0,1309
1708700GR01,3073,2913,1151,376,1381,12,3,3,1762
1719900HE07,1288,1034,955,24,10,31,3,0,79
1713700MD02,528,410,397,5,3,6,0,0,13
17031950036,862,603,7,94,506,7,5,0,596
17031006033,927,795,5,13,776,9,1,0,790
17031020010,1205,867,17,30,824,15,4,0,850
17031020008,1091,867,6,9,846,5,3,2,861
17031020028,816,613,0,30,588,13,6,4,613
17031013015,1862,1432,227,1158,2,87,45,1,1205
17031013003,1308,973,105,835,7,85,22,0,868
17031790058,2815,2139,1678,292,95,24,58,2,461
17031026009,1013,820,116,634,81,35,17,1,704
17031003002,1453,1331,30,15,1284,11,9,2,1301
17031860045,1105,865,761,48,14,6,33,0,104
17031970025,1946,1441,909,375,74,56,49,0,532
17031006007,1454,1054,8,20,1015,5,6,0,1046
17031023023,1022,799,437,327,18,20,12,0,362
17031970050,1421,1270,1046,92,92,7,26,0,224
17031012005,1550,1237,226,407,14,42,584,2,1011
17031012023,1960,1524,224,848,50,58,403,2,1300
17031034031,1189,882,8,26,851,4,4,0,874
17031047011,1282,1114,830,107,84,16,77,4,284
17031049001,1429,1124,232,152,699,29,43,0,892
17031023001,779,616,406,179,23,6,4,1,210
17031970043,812,625,7,67,543,3,2,2,618
17031013033,753,569,318,243,4,14,3,0,251
17031950061,1174,872,102,90,642,16,29,1,770
17031890015,2428,1831,220,1480,120,62,20,1,1611
17031890088,1577,1174,38,1088,49,54,16,0,1136
1707700MB07,1034,716,548,28,120,9,9,0,168
1707700MB01,1222,956,663,50,212,23,2,1,293
17067001201,382,300,289,3,3,4,0,0,11
1707700CB21,2743,2530,1214,178,480,48,627,1,1316
17031021020,860,703,0,11,694,4,4,3,703
17031790017,762,640,533,20,9,0,74,0,107
1718700MN06,831,664,528,94,14,4,23,2,136
1718700MN01,609,487,286,84,70,7,41,2,201
1718700BE01,291,251,245,0,2,3,0,0,6
17031022023,1120,840,20,263,550,34,3,2,820
17031022001,590,453,10,138,305,6,0,0,443
17031008010,834,716,6,18,698,15,8,0,710
17031008037,552,462,9,6,449,6,2,1,453
17031008052,872,735,4,10,717,7,11,2,731
17031013034,1492,1086,88,956,30,77,8,3,998
17097Lib173,1443,1104,967,39,10,0,77,0,137
17097Mor218,1174,853,798,15,12,0,24,0,55
17097Wes402,1258,936,839,45,1,2,50,0,97
1703300OBL2,1269,971,902,16,19,24,6,0,69
1715900DENV,409,300,285,3,2,0,3,0,15
1708700EL01,818,619,595,8,6,6,2,0,24
17027002001,438,341,331,2,1,1,1,0,10
17027015004,598,494,436,5,20,24,2,2,58
17027011006,1436,1099,1000,24,26,23,14,3,99
1703300ROB8,952,728,679,13,14,19,7,0,49
1708900EL23,1691,1171,370,603,153,58,26,0,801
170890AC101,2038,1602,632,537,357,68,67,4,970
1708900DU10,2523,1792,441,1178,64,63,93,0,1351
171630ESL22,392,284,8,5,271,5,3,2,276
1707500RI01,328,248,219,23,0,4,1,0,29
1719300CA13,1281,996,956,13,6,15,3,0,40
1715900OL05,1093,784,728,17,4,19,16,0,56
17031004013,2047,1954,1225,166,297,16,244,2,729
17031004021,2912,2801,1474,306,764,34,260,8,1327
17027011002,931,707,569,59,27,39,13,2,138
17157000607,722,565,536,20,7,2,0,0,29
17031800021,1469,1058,955,54,7,11,30,1,103
17031800011,1007,937,699,65,19,1,148,0,238
17031740043,1312,1143,862,64,15,11,196,0,281
17031830033,1950,1564,753,115,46,4,643,0,811
17031830039,961,738,515,17,5,4,194,0,223
17031006031,813,655,5,7,643,12,0,2,650
17031009012,853,697,1,15,682,7,6,0,696
17031006001,919,775,5,5,760,4,1,0,770
17031006037,775,646,5,5,630,12,4,1,641
17031020024,1402,1141,230,60,731,11,115,0,911
17031020016,1316,1076,147,47,767,19,114,1,929
1719300MS01,301,251,239,3,0,4,1,0,12
17027011005,834,664,534,109,6,5,6,0,130
1719300BP10,297,235,225,1,1,1,2,0,10
1715900MAD1,381,290,280,0,2,4,3,0,10
17031970005,1573,1192,856,208,69,12,50,2,336
17031710002,1388,1062,619,136,292,9,26,1,443
17031900042,1148,920,37,21,860,10,11,1,883
17031780015,2319,1884,907,824,76,71,76,2,977
17031041005,1418,1177,977,126,12,17,48,0,200
17031009017,784,582,3,33,552,10,1,1,579
17031720011,1503,1318,1005,134,146,23,18,1,313
17031017017,1457,1056,48,347,653,18,12,0,1008
17031014013,1785,1284,152,936,76,81,111,0,1132
17031018019,696,578,2,34,540,9,2,2,576
17031011005,2186,1814,610,495,188,41,495,3,1204
17031011019,2070,1719,652,596,76,23,384,2,1067
17031023020,1754,1239,80,1129,23,81,6,1,1159
17031023017,1782,1311,80,1102,117,94,11,3,1231
17031021005,802,657,0,20,635,9,3,0,657
17031021024,818,663,0,2,657,0,3,1,663
17031890082,1764,1403,42,317,1045,26,14,2,1361
17031010034,1514,1079,42,528,515,26,6,1,1037
17031010036,419,328,9,166,160,14,1,1,319
17031890093,1090,924,374,151,349,11,55,1,550
17031850036,1802,1345,944,117,173,17,118,1,401
17027003001,736,611,566,10,5,13,1,0,45
17027003002,300,253,239,1,8,1,0,0,14
17031032036,1327,1088,866,103,20,18,95,0,222
17031033020,2521,1974,689,944,101,87,222,1,1285
17031038003,1699,1363,823,397,32,19,106,3,540
17031800014,1720,1411,1060,170,53,25,94,2,351
1705700CA12,628,538,506,6,12,11,2,0,32
1705700CA04,1037,770,723,8,14,6,6,2,47
17003000103,196,157,30,0,123,6,0,0,127
17169001101,340,281,270,9,0,1,0,1,11
1705700LS03,430,350,334,3,0,11,2,1,16
17091Bour13,1782,1392,1079,114,140,33,18,0,313
17091Mant03,948,763,690,41,9,9,7,2,73
17093KE0501,1129,895,717,107,35,19,21,2,178
1719700LO08,3187,2352,683,643,760,37,249,2,1669
1719700LO07,2983,2169,653,560,523,37,411,2,1516
1719700TR04,1805,1436,1022,272,63,31,36,3,414
1719700JO20,2384,1946,1019,496,337,50,68,5,927
1705700YH01,548,442,423,5,4,11,0,0,19
1705700UN01,900,675,656,8,5,2,0,0,19
17091Kank12,1928,1378,135,126,1119,15,4,3,1243
1719700PL26,2728,1863,840,594,301,40,101,2,1023
1719700PL27,2807,1953,1019,555,243,23,103,2,934
1719700PL25,2740,1982,1195,481,181,39,86,0,787
1719700DU11,2288,1767,716,456,410,48,163,5,1051
1719700FR19,2217,1684,1395,140,56,23,74,2,289
1719700FR24,1915,1474,1019,75,303,16,68,1,455
1719700WH16,2365,1756,1173,135,92,27,323,2,583
1719700WH23,3138,2186,1229,218,143,26,579,0,957
1705700FA06,728,556,517,10,2,21,0,0,39
1705700BA01,325,284,274,0,1,5,0,0,10
1720100Ha26,1132,968,795,74,39,15,30,1,173
1720100Ha27,1059,820,626,54,57,11,60,2,194
1720100Ha18,1017,834,680,52,46,12,48,0,154
17201000407,1148,921,720,76,82,14,31,3,201
1720100Bu01,1111,848,761,41,15,14,5,1,87
1719700MO07,1690,1197,81,41,1071,14,4,0,1116
17093OS0308,1760,1313,829,396,48,28,22,0,484
17091Bour07,1748,1359,1207,40,33,17,53,2,152
17093BR0213,3093,2078,1455,332,176,41,83,0,623
17003000401,899,764,608,13,115,17,5,0,156
17083001001,415,320,315,2,0,3,0,0,5
17083000301,651,505,481,4,0,11,1,0,24
17091Bour08,2181,1693,1334,151,149,48,10,0,359
17093BR0205,2438,1764,1192,248,231,39,74,0,572
17141000051,711,526,458,41,5,10,9,1,68
17165000606,956,710,676,3,15,15,0,0,34
17093BI0701,1102,821,757,35,1,11,1,1,64
1719700LO06,3285,2427,1096,750,331,44,231,3,1331
1719700CR05,1776,1468,499,90,855,22,24,1,969
1719700NL17,2221,1778,1646,73,21,22,19,0,132
1719700NL11,1982,1552,1386,96,13,29,17,2,166
17095000801,634,528,495,7,15,6,1,1,33
17095000806,617,493,474,5,4,9,3,0,19
17049000101,444,356,347,2,0,3,1,0,9
17049001001,755,527,517,3,1,4,0,2,10
17049001202,1059,736,707,15,2,9,3,0,29
17049001201,842,643,627,4,0,4,6,0,16
17003000801,580,481,433,9,20,18,0,0,48
171670CL006,1012,781,723,14,19,9,8,1,58
17093NA0602,3895,2648,1503,586,390,50,134,3,1145
17093NA0605,1679,1110,554,268,187,32,70,9,556
1710300BR01,287,237,211,11,1,5,3,0,26
1710300AS01,639,512,469,11,6,8,5,0,43
1711100Mc17,1348,1060,923,88,12,21,5,0,137
1704500KS01,862,660,615,6,0,20,2,1,45
1704500PA08,419,313,306,3,0,1,2,0,7
171670CP002,932,763,608,17,112,17,5,1,155
171670CP102,881,681,520,33,101,24,7,0,161
1705100CA01,108,86,80,2,0,4,0,0,6
17049001114,891,737,692,15,5,17,2,0,45
1702100TL07,1339,1021,958,12,22,19,7,0,63
17141000018,1549,1159,789,304,19,50,12,0,370
1710300DX09,530,391,353,25,4,5,0,0,38
1710300PM01,805,649,552,40,26,16,17,0,97
17131000303,684,516,499,5,2,7,3,0,17
171670LA001,212,156,140,0,1,9,1,0,16
1710300PM03,1053,835,737,53,12,21,8,0,98
1710300FG02,489,378,342,16,3,12,3,2,36
1711100Do07,1550,1240,1000,184,7,26,24,0,240
171670WD013,633,494,319,55,82,17,18,0,175
17043003139,1149,882,441,76,235,8,124,0,441
17043003072,1501,942,242,72,561,8,67,0,700
17043003132,690,531,357,29,18,10,110,1,174
17043009033,931,778,544,156,35,10,27,0,234
17043009055,1007,803,515,155,74,17,46,0,288
1711100Al62,1477,1191,979,98,27,24,68,1,212
1711100Al48,1605,1229,1086,77,3,10,41,4,143
1711100Nu07,1235,976,831,67,13,15,50,1,145
1711100Nu22,1756,1412,1247,85,27,13,29,2,165
1711100Al52,1552,1270,1031,131,17,11,66,0,239
1711100Nu29,414,313,306,4,1,1,0,0,7
17165000610,1114,858,780,10,29,11,25,0,78
17165000602,1060,809,714,35,35,16,7,2,95
17165000801,275,217,204,1,0,11,1,0,13
1710300RE01,248,206,176,11,2,9,2,2,30
1710300DX11,517,393,365,16,3,1,5,0,28
17043009106,595,535,379,5,17,13,120,0,156
17043009134,516,420,289,20,11,1,96,3,131
17043009048,564,457,259,47,18,4,129,0,198
17043009125,663,559,391,44,27,1,84,0,168
17043008020,973,726,607,82,2,5,25,0,119
17043005005,650,464,361,30,18,5,42,1,103
17043008030,841,743,602,85,3,9,36,0,141
17043005126,704,503,422,46,12,21,15,0,81
17043004057,910,722,544,62,36,16,71,0,178
17043004113,1018,777,606,79,15,7,67,2,171
17043002021,1310,1015,699,190,51,20,62,9,316
17043005034,997,817,679,65,29,16,26,0,138
17043005010,846,621,562,36,5,4,11,0,59
17043004115,888,690,513,33,22,6,108,2,177
17127000014,1714,1342,1231,18,51,23,6,0,111
1718300DN13,456,354,326,8,9,6,1,0,28
17043007022,1011,785,595,39,9,16,124,0,190
17043003074,1066,868,637,65,50,8,107,1,231
17043003107,1054,818,632,42,12,3,126,0,186
1703700SA02,1554,1225,1068,97,13,32,13,0,157
1718300DC22,1158,819,357,47,393,17,7,0,462
1718300DN02,718,564,536,10,3,11,2,0,28
1718300GT04,639,480,439,8,25,6,1,0,41
17043001003,1459,1148,859,83,15,19,166,0,289
17043001044,1106,862,511,192,30,15,121,0,351
17043005100,1073,858,665,30,43,3,104,0,193
17043005092,941,638,580,16,7,8,22,1,58
17043004050,641,518,433,19,18,5,40,0,85
17043004024,997,757,561,62,21,11,91,2,196
17095000019,1756,1418,1100,46,229,11,27,0,318
17083000403,1124,824,791,10,2,10,4,0,33
17119002318,865,657,254,16,374,11,1,0,403
17119000401,516,399,347,35,2,15,1,0,52
17119001101,1232,931,868,8,16,22,8,0,63
17119001504,2039,1548,1413,26,33,43,16,0,135
17119001102,1519,1153,1077,24,12,10,11,1,76
17119001910,919,729,693,9,14,12,1,0,36
17141000038,1369,1068,983,50,11,19,2,0,85
17141000036,615,509,455,27,5,16,1,0,54
1703700MI01,305,229,206,13,1,5,3,0,23
1703700DK05,4612,3636,1475,439,1224,80,440,2,2161
171670CP034,1280,979,709,44,195,17,9,2,270
17043006022,901,694,279,29,13,4,371,2,415
17043006084,727,521,429,6,8,2,74,0,92
17043006031,1125,1006,774,71,68,5,86,0,232
17043006096,428,304,272,14,4,1,14,0,32
17043003035,939,791,671,30,15,3,79,1,120
17043005006,812,583,520,28,0,6,22,2,63
17095001401,402,339,315,16,0,6,2,1,24
17095000005,957,766,608,43,73,22,28,2,158
17095000007,1461,1009,686,43,252,17,11,0,323
1705700BE01,249,206,193,8,0,1,1,0,13
17073000803,810,658,618,13,2,18,6,1,40
17119002315,856,689,561,9,94,18,11,0,128
17119002413,1464,1166,1054,9,68,14,19,0,112
17011010001,278,229,218,6,0,3,0,0,11
17081001501,1918,1737,1166,135,400,22,11,0,571
1706300GL01,798,667,657,2,0,1,6,0,10
1706300WA01,1165,928,837,56,4,12,8,0,91
17011013010,642,531,413,61,18,15,25,3,118
17011013007,726,573,526,19,4,12,11,0,47
1709900BC04,655,519,393,59,26,13,13,0,126
1709900BC05,1191,909,738,100,38,22,1,0,171
1709900NV01,925,725,676,16,7,7,8,0,49
1709900PR08,467,367,325,28,1,4,4,0,42
1709900PR07,996,798,711,53,11,5,14,0,87
1709900MS02,1110,894,845,10,6,22,5,0,49
1709900BC06,1564,1132,922,129,49,24,12,1,210
1709900ER01,1239,946,828,74,6,24,4,0,118
17011005001,353,253,247,3,0,3,0,1,6
17119000901,1924,1422,1241,35,53,32,47,1,181
17119000910,1687,1242,1161,27,31,14,9,1,81
17119001317,1325,1089,944,43,48,27,18,0,145
17149000301,263,210,208,1,0,1,1,0,2
17149000501,197,162,153,1,0,8,1,0,9
17081000501,701,589,556,6,6,17,3,0,33
17119002320,1024,805,547,9,217,18,6,2,258
17119000203,1964,1466,1418,19,3,11,8,0,48
17119000204,1135,853,833,6,3,9,0,0,20
17119001428,954,716,616,22,41,14,15,1,100
17119001401,1147,963,804,18,101,16,18,4,159
17119001409,1995,1792,1341,84,279,20,60,23,451
1709900EG01,908,714,603,58,18,15,11,2,111
1709900LS10,588,477,439,22,3,4,1,0,38
17081001602,976,773,738,10,4,10,5,0,35
17119001705,735,585,511,34,16,17,4,0,74
1718300EL02,592,470,443,16,4,3,0,1,27
1706300BR04,1502,1145,1043,50,10,27,3,0,102
17119002217,1144,902,753,44,71,18,12,1,149
17119002206,1228,956,807,45,55,30,10,2,149
17073001701,881,711,681,8,1,14,1,0,30
1718300OK01,913,711,664,15,11,12,4,0,47
17139000201,976,774,742,8,11,4,2,0,32
17127000001,569,422,295,21,85,13,2,0,127
1716300OF10,1522,1143,633,18,402,29,67,1,510
1716300OF17,1387,1116,686,50,320,15,46,5,430
1716300CS10,746,580,397,33,105,27,22,0,183
17163000CN5,656,484,8,6,469,2,3,0,476
17081000701,1482,1171,1127,11,8,14,7,0,44
1710300LC01,568,438,407,13,5,8,0,2,31
1710300MR01,206,171,164,1,0,3,0,0,7
1718300DC33,729,557,443,22,55,10,29,0,114
1718300RS02,480,373,336,22,2,7,4,0,37
1711100GR07,1422,1077,903,84,24,15,39,0,174
1711100Gr11,1411,1083,898,117,15,20,24,0,185
1711100Bu02,1543,1230,1147,38,8,4,23,0,83
17061000702,735,569,544,4,0,14,2,1,25
1709900OT04,1140,923,789,78,19,13,11,0,134
1709900OT12,996,816,697,65,22,14,12,0,119
1709900NV07,943,742,667,46,5,18,7,0,75
1709900NV06,967,743,684,36,4,20,2,0,59
1709900EG03,302,246,218,15,2,8,0,0,28
17127000002,495,398,343,12,31,6,4,0,55
17127000005,744,577,487,10,57,20,2,4,90
1719700FR23,1751,1286,1154,52,52,13,16,0,132
17061000501,295,221,214,3,3,3,0,2,7
17061000303,1111,853,831,12,1,8,0,0,22
1709900WT01,510,388,352,23,4,4,2,0,36
1709900NV03,1348,1044,927,68,15,19,5,0,117
1709900NV04,1303,1007,909,51,12,21,0,0,98
1709900TG02,791,571,426,115,12,15,8,0,145
1719700PL07,3295,2328,912,798,328,55,288,0,1416
1703700DK23,878,719,563,71,55,13,11,0,156
17019CN1400,1114,974,792,29,47,22,83,1,182
1709900OR02,1189,963,875,34,23,14,3,1,88
17043006033,878,631,547,22,4,11,43,0,84
17043002039,782,599,455,86,14,7,34,0,144
17043001057,1719,1318,534,659,44,55,59,1,784
17043001035,713,569,291,171,26,21,72,0,278
17043004017,993,797,601,71,44,14,69,3,196
17043007062,927,685,269,198,40,17,168,2,416
17043007031,1087,831,331,235,45,22,211,0,500
17043003069,938,806,504,87,59,16,148,0,302
17043005109,841,599,535,20,21,4,20,0,64
17043004037,903,677,515,34,25,13,92,0,162
17147000302,360,279,258,2,6,7,0,0,21
17147000301,738,547,520,2,3,18,2,0,27
1709900MA03,1102,870,790,40,6,25,9,1,80
1709900LS14,775,623,568,35,6,11,3,1,55
1719700LO13,2245,2063,1685,171,136,38,46,1,378
1719700FR15,1980,1557,1293,129,67,25,36,0,264
17061000801,608,453,434,3,0,12,3,0,19
1709900LS05,738,597,504,76,5,11,2,0,93
1709900FE01,619,488,454,17,1,8,7,0,34
1709900OT10,474,399,350,20,9,13,2,0,49
17019CC1000,1707,1293,509,187,532,41,44,5,784
17019CC1900,1120,941,806,32,57,24,22,0,135
17019CN1000,788,633,523,33,11,11,44,0,110
1703900RU01,136,106,104,0,0,0,1,0,2
17073002004,692,501,384,74,35,6,0,1,117
17123010001,246,178,163,2,1,6,0,0,15
1720100Rs10,966,775,702,29,16,8,15,0,73
1720100Ro30,1604,1301,1018,127,57,22,74,1,283
17201000904,2075,1534,842,242,416,41,10,0,692
17201000605,2000,1497,913,384,135,54,32,3,584
1709900BC12,800,646,560,56,14,11,4,0,86
1711100Al58,1677,1281,920,143,49,10,160,2,361
1711100Al57,1988,1534,1167,178,53,23,116,8,367
1711100Al44,1071,872,703,96,29,10,40,0,169
1711100Al32,1028,828,619,144,13,28,24,0,209
17019CC2800,649,508,398,18,69,2,19,0,110
1716300ESL6,427,353,3,2,348,7,2,2,350
17155000401,616,535,516,3,1,12,1,0,19
17201000801,2042,1510,739,263,355,28,111,3,771
17147000601,959,754,719,9,2,11,12,0,35
17019CC3100,1613,1137,537,66,484,19,48,0,600
17163000SC1,1339,1047,618,86,280,34,22,2,429
17123012001,275,230,215,9,3,6,0,0,15
17059000201,433,362,337,8,13,1,4,0,25
1716300CT19,1138,757,218,24,492,10,2,2,539
1716300CT18,1061,657,178,7,467,3,3,0,479
1716300SC11,1091,906,579,29,259,14,14,5,327
1716300SC10,1027,842,577,10,240,15,2,0,265
1702900CH01,1609,1321,923,50,213,18,109,1,398
1720100Ch02,2430,2077,1236,329,363,27,93,2,841
1709900NV05,1620,1398,1269,81,5,26,9,0,129
1709900HP01,570,448,418,14,1,10,3,1,30
17121014006,1059,789,737,9,9,23,10,1,52
1720100Ro09,1327,1074,868,107,40,15,38,0,206
1720100Wi03,1150,891,831,14,22,12,9,0,60
1720100Ro51,1122,863,734,44,28,30,8,2,129
1720100Ro55,941,753,620,45,38,21,16,4,133
1720100Ro05,868,732,578,61,40,7,38,1,154
1720100Ow01,1433,1249,1136,43,25,24,8,0,113
1709900GR01,299,236,220,13,0,1,0,0,16
1709900OT08,917,716,615,62,15,17,7,0,101
1711100Gr24,1748,1262,911,157,37,8,135,3,351
17101000024,423,318,304,1,2,9,0,0,14
1720100Ro31,1130,884,700,69,75,30,6,0,184
1702900CH04,1057,797,721,16,32,21,8,1,76
1707900WH01,558,443,428,1,0,6,2,0,15
1709900MN07,961,764,616,114,1,18,13,0,148
1702900CH18,1638,1276,947,75,179,19,50,9,329
1702900CH14,576,492,338,55,68,11,20,1,154
1702900CH02,1597,1362,1203,34,65,19,30,1,159
1704500PA02,1053,820,778,9,1,22,10,0,42
1702900CH03,1253,1046,882,32,86,12,35,1,164
17019CC3500,2373,1694,936,146,428,48,149,1,758
17019CN1100,1390,1144,437,78,88,11,526,1,707
17019SCS000,480,361,333,4,7,11,1,0,28
17019CN0800,1589,1468,779,148,75,10,436,0,689
17019RAY000,354,289,281,1,3,5,0,0,8
17119001701,1309,1039,881,65,41,36,13,1,158
17101000021,452,335,314,9,3,4,3,0,21
17101000025,656,525,492,6,4,17,2,0,33
17119001908,1559,1216,1036,20,60,69,14,2,180
17107001601,466,358,333,5,3,15,2,2,25
17061000803,678,526,484,7,1,26,6,3,42
1714300TR01,1003,766,736,5,1,19,1,0,30
1710500LP01,464,358,346,3,1,2,3,0,12
1710500PT07,980,730,668,30,12,13,5,0,62
1705500DE02,1028,770,728,5,1,21,4,1,42
1707900WA01,756,584,569,7,3,3,3,0,15
1705700CA06,722,551,529,6,7,3,2,1,22
17185000005,923,740,693,13,9,14,5,1,47
1705500EW02,727,575,559,2,9,2,3,0,16
1705500BR01,680,533,495,7,3,17,2,1,38
1714300CH01,780,592,536,21,3,24,4,0,56
1714300CH02,938,754,690,27,1,29,2,0,64
1707900WA02,1098,891,860,8,8,14,1,0,31
17031027031,1007,746,70,178,513,13,3,0,676
17031014029,1699,1268,48,1191,29,76,10,3,1220
17031018010,924,729,17,33,674,9,7,0,712
17031018037,922,728,45,96,571,16,11,1,683
17007001002,1116,800,475,276,18,30,7,0,325
17007001007,1108,835,591,207,23,16,4,2,244
1700500CN07,761,565,497,17,27,14,3,1,68
1700500CN05,2260,2075,1270,111,644,39,8,0,805
1700500CN04,685,554,520,6,13,10,1,0,34
1711700MO02,527,407,401,3,0,0,0,2,6
17031014031,1229,847,23,741,8,42,80,0,824
17031757002,2101,1672,1345,64,87,19,160,3,327
17031033005,1619,1340,617,510,92,52,113,2,723
17031032001,1604,1394,765,445,70,12,116,2,629
17031002014,1297,1119,874,122,40,16,59,1,245
17031960066,1708,1404,1097,107,22,17,157,3,307
17031960091,1540,1152,908,65,28,8,147,4,244
17031960064,2178,1854,1386,96,35,11,321,1,468
17031041009,1127,854,615,86,9,6,142,0,239
17031037032,981,783,1,146,639,7,5,0,782
17031850010,1380,989,686,67,163,6,68,1,303
17115508004,997,864,711,11,70,21,43,0,153
17031050025,1412,999,565,91,31,2,296,1,434
17031980013,1607,1204,207,964,33,51,9,1,997
17031021036,906,679,2,9,671,5,0,1,677
17031032010,1543,1258,981,129,42,18,89,2,277
17031032018,1410,1126,852,113,44,12,97,2,274
17031032023,1542,1258,1029,99,42,10,68,2,229
17031870004,3386,2388,769,1140,244,63,227,8,1619
17031870058,1622,1386,866,272,53,36,180,0,520
17177001001,622,503,468,20,4,6,2,1,35
17135001103,694,539,497,9,2,8,20,0,42
17177001102,1257,918,868,17,4,9,4,0,50
17069000301,1082,854,810,12,13,16,6,2,44
17031960034,1596,1197,1095,41,3,4,48,0,102
17031960045,1051,738,652,36,6,10,30,0,86
17031960023,1199,866,743,54,22,5,40,1,123
17031041004,896,660,592,39,8,9,16,0,68
17031041010,909,704,643,38,9,9,11,0,61
17031041042,1069,857,723,77,16,14,31,1,134
17031830052,1156,922,808,31,8,6,66,6,114
17031830056,1684,1390,1123,54,9,2,182,3,267
17031960026,1933,1413,1201,93,21,14,82,1,212
17031870063,1611,1257,885,97,24,12,243,1,372
17179000817,1095,875,785,27,20,18,16,0,90
17181000107,1062,821,773,16,7,24,2,0,48
1700500BG03,646,506,487,3,3,7,3,2,19
17097Lib201,805,635,530,44,10,3,48,0,105
17097War289,1376,960,622,64,76,10,190,0,338
17031800007,1238,1012,755,119,19,17,100,3,257
17031740024,1744,1379,810,232,25,23,307,0,569
17031047029,1345,1087,854,96,39,14,90,0,233
17031753001,1439,1095,840,86,62,17,97,2,255
17031050034,1774,1307,743,326,86,38,128,6,564
17031800071,798,650,401,35,8,11,196,2,249
17085001001,1035,795,762,21,5,5,1,0,33
17097War321,1316,1114,809,114,80,17,95,0,305
1703300ROB2,757,585,553,6,5,13,5,0,32
17097War324,1799,1368,819,191,108,37,225,3,549
17097Ver266,1441,1116,737,31,9,8,328,2,379
170970Avo27,1963,1433,371,969,58,91,16,4,1062
17097Wau342,1204,1029,913,67,12,33,13,1,116
1711700GP06,715,568,537,4,1,13,2,0,31
1700500SH04,717,585,568,1,3,5,5,0,17
1711700SP00,469,378,364,5,3,2,3,1,14
1700500PM02,498,391,334,8,38,9,3,3,57
17097Ela103,1641,1187,991,50,14,3,124,2,196
17097Lak162,1372,1092,889,134,27,33,16,0,203
17043003055,973,601,498,26,11,8,59,0,103
17043008013,1435,1053,266,739,22,70,19,2,787
17043008009,1978,1435,204,1176,12,86,34,2,1231
1703300PRA2,320,260,256,1,0,0,0,0,4
17031029024,1113,874,20,311,554,29,5,0,854
17031830004,1602,1206,761,81,38,25,314,7,445
17031048028,1591,1524,751,126,343,6,280,1,773
17031048005,577,535,442,20,23,4,46,0,93
17031048014,782,681,346,45,100,11,174,0,335
17031048036,611,575,357,57,44,14,104,2,218
17031036029,1593,1262,503,619,64,42,81,2,759
17031820010,1852,1493,688,143,25,14,629,0,805
17031820041,1944,1556,748,144,134,19,528,1,808
17031810031,1353,1025,871,39,20,5,79,0,154
17031039044,778,575,463,62,9,6,34,0,112
17031850013,1419,1154,565,119,396,22,55,1,589
17031029041,911,703,6,101,592,4,0,1,697
17031029040,1018,823,11,122,692,7,1,3,812
17031753007,1174,927,673,65,89,16,86,0,254
17031048024,1433,1307,760,125,228,11,189,0,547
17031046040,1195,1070,614,132,222,19,98,6,456
17031046037,1471,1342,460,187,321,24,366,3,882
17031033009,1579,1314,705,438,51,36,108,0,609
17031033004,2097,1685,716,735,76,78,143,1,969
17031790022,1218,993,476,379,120,32,21,2,517
17031003001,2131,1665,49,60,1546,22,21,1,1616
17031970046,1678,1324,976,214,62,39,40,1,348
17031970040,1995,1627,810,406,355,39,53,1,817
17113000601,390,307,300,2,0,0,1,0,7
1700500TM01,232,183,177,3,0,1,1,1,6
17031960006,1028,822,654,61,7,4,93,1,168
17069000601,527,438,413,5,0,15,2,0,25
17069000501,524,443,415,5,5,15,3,0,28
17031030015,927,746,465,153,27,40,85,1,281
17031002008,1769,1598,1074,264,79,16,166,8,524
17031002007,1119,955,654,149,36,5,112,1,301
17031048001,1110,982,584,157,141,39,85,1,398
17031033026,1078,941,493,334,46,24,60,2,448
17031033028,1265,1080,532,459,38,26,58,0,548
17031031035,1388,1030,161,806,37,63,26,2,869
17031031017,1117,880,169,643,27,53,38,1,711
17031031027,1477,1139,135,930,44,48,32,2,1004
17031870027,1198,998,573,125,45,23,249,0,425
17031840005,1439,1177,934,118,15,17,113,4,243
17043001066,1087,929,698,124,29,11,77,4,231
17043005075,936,648,524,34,8,6,58,1,124
17043002032,987,754,653,38,2,9,57,1,101
17043002020,1014,794,709,49,4,10,18,0,85
17031027009,682,566,313,28,154,3,62,0,253
17031040005,1354,1106,628,238,65,31,164,1,478
17031040003,1368,1194,830,203,43,20,109,2,364
17043009034,846,635,558,44,6,1,20,1,77
17097Wau372,2685,1956,366,1123,398,49,53,6,1590
17097Lib174,1215,889,709,50,5,8,105,2,180
17161000907,815,671,388,60,205,6,14,0,283
17161001009,892,705,529,87,52,20,26,0,176
1719500MP05,444,356,334,16,1,5,4,0,22
17161000701,1207,893,543,220,97,31,19,0,350
17161000819,727,598,418,116,42,20,9,0,180
17161000820,1030,799,646,95,27,23,9,0,153
17113000901,199,154,143,6,0,2,1,0,11
17113003004,904,716,635,29,34,8,9,0,81
17097Mor208,2354,1624,1071,345,103,37,76,6,553
17097Mor210,1703,1403,1155,148,36,26,48,1,248
17097Mor209,1724,1379,1050,190,45,20,74,0,329
171630ESL23,851,677,9,1,665,1,0,1,668
17031030012,1844,1411,300,997,54,79,78,1,1111
17031005008,1168,959,579,42,86,1,238,5,380
17031041012,1364,1112,826,150,8,12,115,0,286
17031047016,1197,894,661,144,18,14,59,7,233
1710500UN01,195,145,135,5,1,3,0,0,10
1705700CA05,1026,822,776,8,9,21,5,0,46
17031040031,1143,958,629,170,32,11,106,4,329
17031047030,1405,1264,814,198,103,24,119,2,450
17031047036,1289,1155,825,182,46,20,86,1,330
17031047031,1258,1063,685,205,63,54,100,1,378
17031047034,1361,1139,773,158,87,21,109,4,366
17031870031,809,633,559,33,8,4,32,0,74
17031760008,1617,1313,732,274,62,63,222,1,581
17085000301,161,134,129,1,1,4,0,0,5
17043006056,1780,1346,429,85,315,19,504,1,917
17043006064,766,544,319,27,43,2,145,1,225
17043008024,881,760,639,54,14,18,36,0,121
1711700BH03,1411,1124,1041,12,17,31,17,0,83
1708900AU01,1175,940,693,178,27,7,36,0,247
1708900SC23,722,604,494,75,13,11,8,0,110
170890AC505,2115,1597,444,644,440,28,64,3,1153
170890AC206,2279,1610,86,1443,67,97,12,1,1524
1708900SC30,1299,977,859,28,15,15,51,1,118
1718700SW01,248,192,186,3,0,1,2,1,6
1700500CN06,631,477,424,11,25,7,4,3,53
17031033014,879,684,288,340,22,18,32,0,396
17031033019,1735,1438,706,549,85,41,78,1,732
17031890092,1748,1419,788,249,293,22,85,4,631
17031760028,2477,2160,1388,121,107,13,515,3,772
17031049005,1609,1420,604,377,397,33,70,11,816
17031039017,1132,901,555,214,36,18,99,4,346
17031039014,1312,1074,606,269,43,19,149,6,468
17031039019,1294,1033,581,273,50,30,126,1,452
17031050013,2586,1938,457,382,508,44,580,7,1481
17031050031,3102,2323,415,626,521,68,758,3,1908
17031050032,2697,1939,367,300,494,27,766,7,1572
17031030009,1574,1257,466,674,55,47,77,0,791
17031043005,1172,973,828,45,26,6,67,0,145
17031890089,989,754,559,149,21,18,24,1,195
17031850001,1122,788,345,50,339,14,38,2,443
17031044030,1546,1340,1165,70,24,1,70,2,175
17031930009,1813,1479,725,303,102,30,338,0,754
17031038037,1263,1009,511,401,29,46,58,3,498
17031008051,812,688,3,13,672,6,4,1,685
17031008030,935,741,3,18,723,2,5,4,738
17031008049,726,589,5,4,578,6,0,0,584
17031028044,1009,682,10,28,645,5,0,0,672
17031028024,1054,775,16,57,701,7,8,2,759
17135001003,695,514,491,6,3,10,2,0,23
17135000803,995,763,703,14,16,15,8,0,60
17177001401,811,618,578,13,5,15,0,0,40
17031001006,1415,1231,688,366,96,37,79,0,543
17031002015,1231,1068,766,135,73,14,94,2,302
17031002016,1322,1155,807,125,112,25,100,3,348
17031032006,1417,1258,975,86,51,8,126,0,283
17031039007,1180,905,410,270,21,26,187,1,495
17031970026,1725,1354,887,244,144,25,65,0,467
17031014002,2121,1574,241,1200,13,97,127,2,1333
17031022016,1516,1144,28,1085,20,76,7,0,1116
17031993004,1732,1270,445,759,32,64,35,1,825
17031970017,2388,1797,432,881,477,53,18,4,1365
17031860034,1457,1218,1037,73,41,11,54,1,181
17031860027,1139,934,756,67,66,13,33,1,178
17031720070,698,515,21,22,469,4,3,0,494
17031720047,1003,707,37,21,643,11,5,0,670
17031770008,1743,1393,1238,124,3,12,15,0,155
17031770005,1670,1373,1241,76,18,14,23,0,132
17085000401,274,240,233,0,1,3,0,0,7
170970Avo31,2853,2066,782,975,223,78,61,2,1284
170970Avo32,2732,1988,745,1106,75,100,39,3,1243
170970Avo29,2260,1587,421,1058,66,76,32,1,1166
17097Wau373,2522,1915,86,1420,390,108,26,1,1829
170970Ela93,1305,1003,833,95,15,15,36,5,170
17097War316,1789,1413,1129,168,30,33,41,2,284
170970Ben53,1176,977,778,110,54,18,14,0,199
17043004088,633,476,377,44,14,2,39,0,99
17043004001,1307,1119,855,93,83,17,62,10,264
17043004006,620,547,391,8,6,3,137,0,156
1718900VD01,406,329,328,0,0,0,1,0,1
17043001056,2074,1607,613,850,83,42,50,1,994
17043006018,925,692,446,45,60,17,128,2,246
17043006079,1283,981,324,187,266,10,198,1,657
17043006093,738,628,370,88,86,11,72,0,258
17097Lak153,1970,1326,993,96,50,17,167,1,333
1719900HE15,1071,868,822,10,7,20,5,0,46
17043005046,552,463,431,7,11,3,14,0,32
17043005125,549,405,326,19,14,3,42,0,79
17043005054,893,669,608,18,9,6,27,0,61
17043005076,955,743,547,61,30,9,96,0,196
17043005084,1017,737,616,32,23,20,38,1,121
17043005093,1046,791,507,52,159,7,58,0,284
17031751003,1562,1275,867,58,112,15,217,2,408
17031010025,348,290,7,158,124,2,0,0,283
17031005030,1398,957,11,22,914,10,8,2,946
17031720016,1212,995,818,96,44,16,28,2,177
17031007027,769,596,8,18,566,5,5,0,588
17161000912,2150,1976,1352,208,232,35,154,1,624
17161000904,571,480,204,60,209,7,2,1,276
17161000814,721,525,323,114,67,20,8,0,202
1719500ST10,991,839,662,135,15,13,13,0,177
17115513001,982,811,787,6,8,3,0,0,24
17043005128,840,622,523,40,10,17,29,0,99
17043005115,804,655,525,28,31,8,56,0,130
17043005015,862,605,517,38,9,7,35,3,88
1719500US01,553,446,427,6,3,2,8,0,19
1719500CO05,878,701,606,69,11,6,3,0,95
1719500CO08,1449,1037,725,209,32,56,6,0,312
1714300PE42,1033,740,412,73,229,23,4,1,328
17115501034,1581,1060,290,25,717,32,4,4,770
17071000701,481,398,381,6,2,6,0,0,17
17179001912,1303,1018,971,17,5,13,6,2,47
17179001904,1548,1189,1095,25,9,24,23,5,94
17179001409,1101,852,806,11,1,14,11,1,46
17097Lib171,1559,1143,943,29,19,8,130,0,200
17097Lib167,1234,982,822,51,11,17,77,3,160
17031038012,1311,1138,981,101,15,3,37,0,157
17031960011,2120,1739,1126,88,33,13,466,7,613
17031910007,1245,969,732,49,91,7,94,0,237
17191000902,808,621,593,2,5,11,8,0,28
171630ESL20,639,530,4,6,525,1,2,0,526
17163000B27,893,706,398,20,274,13,6,0,308
17163000CS7,1185,955,674,115,110,48,4,1,281
17163000CS6,815,666,552,38,61,14,0,0,114
17031710047,1438,1080,707,77,283,6,8,0,373
17031710045,1632,1307,264,87,961,12,1,0,1043
17031018021,1012,776,38,129,617,9,2,0,738
17031020007,2002,1354,16,32,1308,16,3,0,1338
17031017014,1968,1452,79,877,494,70,7,3,1373
17031017007,1988,1398,42,883,474,57,11,0,1356
17031017030,1576,1133,58,857,219,56,10,0,1075
17031023016,763,600,390,195,2,11,7,0,210
17031014001,988,766,459,279,13,16,7,3,307
17031004034,1226,967,71,28,862,16,14,0,896
17067000401,864,682,673,4,0,0,2,1,9
1714300PE30,1036,761,534,49,159,13,6,1,227
17031880023,1517,1114,792,123,94,20,78,1,322
17031880038,1846,1390,1156,155,30,17,36,0,234
17031880035,2050,1579,1332,136,51,23,41,4,247
17031880031,1788,1442,1228,141,22,10,37,2,214
1708900GE03,1007,799,728,30,12,13,19,0,71
1708900CA09,1215,944,868,34,4,15,18,0,76
1718900HY02,275,215,207,5,2,3,0,0,8
17031047047,1512,1148,937,99,26,12,75,0,211
17031040007,1055,835,604,127,23,14,68,0,231
17031037028,1229,943,22,423,511,28,3,0,921
17031028043,1608,1180,3,73,1103,1,0,0,1177
17031032028,1123,966,564,271,61,21,73,3,402
17031007037,791,661,2,37,622,11,4,0,659
17031730012,889,667,11,18,632,7,1,1,656
17031026016,1012,803,67,653,81,26,8,8,736
17031045019,841,758,445,143,43,18,117,0,313
17031045020,997,870,489,227,25,17,123,0,381
17031045016,1145,928,574,237,34,48,73,1,354
1708900DU20,1305,1086,950,89,10,6,26,0,136
1708900BA06,2075,1505,1097,165,145,27,66,2,408
1708900PL01,2751,2017,1512,212,44,24,234,2,505
17031013037,995,761,132,520,99,42,15,1,629
17031013009,1316,974,98,845,32,67,19,1,876
17031790049,1069,906,688,141,29,15,25,0,218
17031790053,1405,1151,971,102,19,7,48,1,180
17031860010,1501,1211,1059,68,28,6,46,0,152
17031860047,1771,1507,1217,87,65,2,132,0,290
17031860024,1286,1051,908,68,32,1,35,0,143
17031960012,2198,1805,1302,129,30,4,318,9,503
17031007039,760,629,2,11,617,1,0,0,627
17031790055,1350,970,885,43,3,8,24,0,85
17031050003,1110,732,413,106,42,16,160,4,319
17031040019,2116,1703,724,449,151,49,376,0,979
17031009048,783,638,0,24,613,6,7,0,638
17031009025,762,580,4,2,571,7,1,1,576
17031760036,1520,1226,697,206,86,19,226,4,529
17191000801,157,113,111,1,0,0,1,0,2
1714300PE46,1011,853,669,28,108,17,25,1,184
17067001503,602,461,434,4,1,14,1,1,27
1714300LI13,974,760,670,19,30,19,9,1,90
1714300PR01,567,415,406,4,2,0,2,0,9
1714300PR02,953,699,603,58,7,15,5,0,96
1714300PE21,735,494,169,22,279,14,11,1,325
170890AC403,2002,1386,154,1103,128,71,18,0,1232
1708900SC03,2025,1595,1236,187,43,28,100,4,359
17031970068,1294,966,179,443,342,21,13,1,787
1714500BE01,770,599,573,1,6,13,5,1,26
17031034048,703,594,2,5,587,10,2,1,592
17031034043,599,506,0,10,493,5,3,0,506
17031034053,710,535,5,15,515,5,3,1,530
17031034038,575,440,4,13,422,9,2,0,436
17031001014,1143,999,718,109,66,16,101,0,281
17031032043,1177,1023,666,215,58,19,79,3,357
17031830061,923,734,550,41,5,1,137,0,184
17031780001,1748,1362,730,477,34,22,127,0,632
17031021011,852,679,2,25,656,5,1,0,677
17031870025,974,803,674,33,16,8,59,2,129
17031039009,1380,1110,530,321,16,38,237,0,580
17031800036,1111,862,772,37,2,4,48,1,90
17031780012,1195,977,776,131,14,31,44,1,201
17031930017,1559,1243,624,52,28,12,540,0,619
17031790042,1146,830,764,33,4,3,22,0,66
1708900BA15,1316,1080,957,77,28,7,14,0,123
1708900SC06,1367,1001,834,122,7,12,19,2,167
17031028026,1113,814,22,57,732,14,2,2,792
17031028007,1253,916,0,65,854,7,2,3,916
17031028009,1202,852,11,76,767,13,1,2,841
17031980025,2218,1629,105,1478,17,231,24,1,1524
1708900SC29,2162,1595,1129,177,42,26,207,0,466
1714300PE94,1277,856,581,23,46,12,194,3,275
1714300PE43,1119,876,507,60,259,23,19,5,369
17031031005,1054,843,202,543,49,22,56,5,641
17031031024,1215,955,157,736,56,29,20,4,798
17031030020,1611,1259,444,680,37,73,96,5,815
17031032037,1568,1346,988,183,49,13,110,0,358
17031045007,1467,1150,722,242,65,9,105,0,428
17031045030,1267,1000,394,285,36,17,275,2,606
17031009036,893,672,2,8,655,4,6,2,670
17115506011,1029,805,399,31,327,16,31,0,406
1718900AS01,761,584,558,8,3,11,0,0,26
17031870005,1957,1610,1236,252,17,23,80,1,374
17031950019,1945,1533,384,222,893,26,13,0,1149
1719900BL02,259,206,187,3,0,7,3,0,19
1719900EM05,1296,1005,904,15,31,34,21,1,101
1708700GO02,511,408,384,9,3,2,2,0,24
1708900EL04,1576,1149,399,647,70,73,14,1,750
1708900AU02,698,564,346,143,66,31,1,2,218
17031770007,1336,1063,923,76,18,18,29,0,140
17031960030,1814,1412,1156,55,22,14,157,1,256
17031012011,2426,1832,78,1426,53,88,286,1,1754
17031012012,2553,1860,136,1453,51,85,226,4,1724
17031710058,850,636,112,98,417,17,5,4,524
17031010009,1073,804,290,452,60,14,5,0,514
17031710011,1135,893,511,183,149,23,28,3,382
17031757004,822,564,471,9,30,3,44,1,93
17031930063,1217,955,747,70,10,20,114,0,208
17031740012,840,665,544,65,10,10,37,0,121
17031800025,1272,917,858,17,2,4,35,0,59
17031930078,1497,1187,561,173,65,22,385,1,626
17031960028,1861,1515,1306,71,16,17,104,0,209
17031033021,1871,1489,578,698,88,56,119,2,911
17031010028,1571,1206,150,1008,45,59,2,1,1056
17031025015,1623,1288,188,994,76,112,25,2,1100
17031720071,908,672,44,32,589,9,4,0,628
17031008016,420,281,4,4,270,4,1,0,277
17031820056,1855,1499,958,109,32,6,390,2,541
17031780026,2256,1914,1321,357,110,26,115,1,593
1705500TY03,440,374,350,2,0,10,3,0,24
1705500EW01,634,463,442,3,3,14,0,0,21
17115501016,1100,838,444,32,328,14,17,1,394
1714300PE48,950,804,687,29,57,8,19,0,117
1714300PE24,987,732,257,57,393,16,16,1,475
1714300PE03,1022,759,226,114,396,23,2,1,533
1714500DQ06,518,400,374,9,5,3,1,0,26
17031720019,641,555,73,37,443,6,1,2,482
17031004025,1738,1625,901,119,239,17,368,0,724
17031020026,1270,1005,78,73,825,18,43,4,927
17031001001,1415,1192,654,392,97,33,56,13,538
17171000201,533,404,397,1,0,3,1,0,7
17017000305,569,420,198,158,55,12,6,3,222
1707500MD01,1019,800,690,66,20,15,10,1,110
17031039039,660,524,272,150,16,21,79,3,252
17031040027,1814,1502,677,424,220,48,171,0,825
17031980012,1878,1514,177,1250,123,77,15,4,1337
17031039031,1699,1360,419,674,47,73,212,4,941
17031039010,673,525,190,201,55,28,86,1,335
17027007002,942,727,665,29,5,13,10,0,62
17027009001,481,404,377,6,2,8,4,0,27
1707500PA01,445,371,352,1,3,4,2,0,19
1707500LV01,382,296,279,11,1,5,0,0,17
17115501032,1023,856,728,9,91,25,0,0,128
17171000701,618,490,476,3,4,7,3,0,14
17031870001,1128,1038,884,74,21,11,49,0,154
17031044024,890,817,608,63,22,4,114,0,209
17031044004,1206,1128,865,61,47,21,124,2,263
17031890072,1171,948,520,106,233,21,78,1,428
17031890001,1663,1230,175,600,443,47,30,6,1055
17031890002,1989,1466,145,1067,246,54,17,5,1321
17031001011,1321,1192,926,107,63,11,95,1,266
17031994003,2324,1709,325,1260,79,80,44,0,1384
17031980029,2998,2157,126,1936,69,139,30,2,2031
17031980008,1424,1024,55,949,17,72,7,1,969
17031980009,3543,2507,89,2293,120,162,23,4,2418
17031850015,1934,1441,696,115,567,34,59,6,745
17031004012,1729,1274,56,70,1157,36,11,1,1218
17031004026,1238,1015,66,23,918,20,4,1,949
17031004015,1691,1359,108,36,1193,8,27,5,1251
17031890020,898,743,11,115,616,5,3,0,732
17031850029,1286,889,675,83,69,7,51,1,214
17031850003,1876,1355,905,130,221,28,92,0,450
17031997001,1816,1377,332,712,276,69,63,2,1045
1713700JK11,1121,930,784,33,81,14,23,0,146
1713700MD01,652,520,495,3,8,6,0,4,25
1713700CH01,657,513,500,1,3,8,0,0,13
1713700CN01,464,351,340,1,0,9,0,0,11
1701500WY01,721,583,544,14,8,7,4,0,39
1711700GD01,741,560,510,14,5,21,2,1,50
17031740018,2036,1644,1201,203,23,21,185,0,443
17071000201,361,280,277,0,0,2,0,0,3
17031900020,1656,1565,1257,64,183,8,43,0,308
17031017021,932,775,2,17,750,5,9,1,773
17031970099,1265,985,639,283,25,26,18,0,346
17031860048,1428,1119,875,154,24,13,56,0,244
17031860040,1585,1296,1043,104,63,12,71,0,253
17031970091,762,612,457,74,43,17,29,1,155
17031970056,1255,986,801,131,20,9,24,0,185
170890AC301,2438,1667,231,1334,98,101,9,1,1436
170890AC302,2028,1375,155,1154,58,90,9,1,1220
17181000119,1185,952,889,19,5,24,5,2,63
17031740003,1592,1286,1011,187,18,19,69,2,275
17031008003,718,637,3,6,629,8,3,0,634
17031008008,653,558,3,3,548,2,5,0,555
17031015023,1021,729,10,164,559,7,7,0,719
1717300SH07,625,498,482,1,1,5,4,1,16
17031045013,949,749,429,244,32,25,38,2,320
17031045012,1333,1108,542,432,57,46,67,1,566
17031045014,2012,1618,838,574,66,52,110,7,780
17031030011,2380,1737,108,1550,56,117,30,7,1629
17031028003,1065,651,14,43,592,8,3,1,637
17031710040,718,528,177,39,288,4,13,0,351
17031006038,806,650,2,9,641,7,2,0,648
17007001013,813,615,409,174,14,21,4,1,206
17031040015,1731,1391,596,307,107,28,381,0,795
17031047041,1236,1061,819,120,42,24,77,2,242
17031039003,1235,977,573,226,63,53,106,7,404
17031045005,1116,872,605,156,53,19,60,2,267
17031010018,1398,1011,32,607,381,29,0,1,979
1719900EM10,993,789,723,7,21,8,19,0,66
17031790041,864,665,556,51,12,5,39,0,109
17031016022,1503,1029,19,421,593,34,9,1,1010
17031740039,3324,2581,1356,520,193,71,491,2,1225
17031024041,775,610,11,41,557,3,11,1,599
17031029006,941,729,13,41,685,4,3,1,716
17031890044,991,768,28,141,605,2,3,0,740
17043004118,572,414,366,11,3,2,30,1,48
17043004070,613,439,377,19,5,3,33,0,62
17043004033,985,717,615,26,7,2,56,2,102
17043004013,741,615,392,37,22,11,154,0,223
17043004096,647,513,277,7,23,2,201,2,236
17031026029,635,514,167,268,51,11,31,0,347
17031890026,1587,1142,993,94,27,9,24,0,149
17031790011,952,694,626,39,6,2,18,0,68
17031790014,1536,1026,959,25,3,10,25,1,67
17031022018,2474,1740,39,1646,52,136,10,1,1701
17031011025,1659,1310,538,318,73,29,374,7,772
17031790048,1676,1352,919,333,23,33,52,0,433
17031019031,716,574,421,20,111,19,8,1,153
17031019044,1124,840,735,77,10,15,8,0,105
17031970100,1497,1146,857,161,92,13,24,0,289
17031018001,1106,790,22,367,393,19,0,0,768
17031710028,1432,1088,371,261,434,35,8,1,717
17031950054,1543,1202,146,56,982,13,19,0,1056
17031043011,1385,1194,1040,66,16,5,49,5,154
17031043023,1069,898,747,41,23,7,68,3,151
17031760033,2405,1828,779,872,48,57,127,2,1049
17031940001,759,594,318,243,18,32,10,0,276
17031006012,1201,870,1,46,828,10,4,0,869
17031860063,1408,1056,832,77,46,4,88,0,224
17031720076,1099,802,654,105,14,8,21,1,148
1719900WM09,1014,799,629,27,109,26,0,0,170
1719900EM03,1236,1040,917,26,60,19,9,0,123
1713700JK09,742,661,571,22,54,4,6,1,90
17031045015,1302,1037,639,284,42,38,68,1,398
17031041028,3444,2851,1375,282,170,22,1008,9,1476
17031780020,992,776,450,275,27,20,22,0,326
17031046014,1898,1530,292,107,956,7,167,1,1238
17031046026,1890,1761,1024,265,286,34,183,4,737
17031046029,1260,1161,650,113,222,31,165,2,511
17031001004,1633,1389,927,305,35,30,104,2,462
17031009013,811,670,5,9,659,9,6,2,665
1713700JK05,1113,898,693,46,125,10,16,1,205
17031042003,2391,2271,1059,90,95,24,965,3,1212
17031042041,2569,2356,1040,126,131,24,1013,0,1316
17031042016,1592,1471,858,79,68,19,444,1,613
17031009011,721,550,3,19,527,4,2,1,547
17031009045,1035,716,1,10,706,6,1,1,715
17031009016,765,589,3,7,581,7,1,0,586
17031025026,1618,1353,214,1050,55,105,35,1,1139
17031025001,1209,967,152,762,25,71,18,0,815
17031012004,1678,1294,249,773,44,119,229,2,1045
17031020006,766,550,10,40,498,4,7,0,540
17031018045,1497,1131,72,830,208,73,16,0,1059
17031018018,819,731,72,72,596,4,6,3,659
17031860023,1036,817,697,57,19,10,35,0,120
17031710061,1799,1421,550,448,417,37,12,4,871
17031009023,877,718,4,11,702,7,2,0,714
17031020019,1709,1176,31,30,1121,17,0,2,1145
17031020003,1044,776,20,13,746,15,4,2,756
17031011024,1150,931,561,172,28,20,165,0,370
17003000101,429,326,69,3,242,11,4,0,257
1705700JH01,465,369,350,0,1,12,3,0,19
1703700GE01,2608,1987,1717,191,14,53,17,0,270
1719700LO21,2559,2161,1136,395,542,36,58,1,1025
1719700LO22,1980,1481,926,435,79,33,25,1,555
171670CP054,892,690,619,27,22,3,13,1,71
171670CP045,950,727,605,24,62,11,20,1,122
1719700WH09,2275,1725,1241,95,51,21,315,1,484
17093NA0604,1852,1280,830,246,155,39,39,1,450
1710300EG01,245,189,177,7,0,0,1,0,12
17043004018,715,556,379,102,29,19,32,2,177
17043004102,943,740,531,96,19,15,77,4,209
17043003080,1228,993,767,72,52,11,98,0,226
17043001011,1190,925,495,353,3,31,62,0,430
17043005040,1405,1136,877,60,71,14,111,0,259
17043002104,752,576,363,130,15,14,61,3,213
17043002015,1406,993,208,464,108,9,208,0,785
17043005001,869,726,613,45,27,5,29,0,113
17043007025,697,536,460,30,10,0,35,0,76
17043007068,702,530,445,11,9,0,58,0,85
17043007011,529,421,354,34,2,3,20,0,67
17091Bour14,2077,1555,1178,76,232,20,29,0,377
17093OS0310,851,638,527,69,20,17,3,0,111
17093OS0320,861,672,526,91,24,18,21,0,146
17095001701,248,196,192,1,0,2,0,0,4
1720100Ha23,1327,1088,875,88,82,17,35,0,213
171670CP028,1027,871,747,15,69,3,35,0,124
171670MA001,219,169,164,1,0,0,2,0,5
171670CP088,1174,893,518,34,289,27,22,6,375
17083000501,1098,919,885,8,8,13,1,1,34
1703700DK01,1068,899,604,114,117,26,51,0,295
1703700DK17,827,702,430,172,62,33,11,1,272
1711100Gr30,1172,904,734,42,11,16,90,0,170
1711100Ma03,1496,1186,999,127,11,21,10,1,187
171670CP039,1201,843,431,17,370,22,5,1,412
17149002401,54,35,34,0,0,0,0,0,1
17149001901,64,54,54,0,0,0,0,0,0
17119001429,1179,948,794,26,72,32,20,0,154
17119001406,1617,1148,969,17,104,2,50,2,179
17119001416,1217,966,823,35,69,8,19,0,143
17119001413,1447,1127,1030,25,24,10,29,0,97
17119002202,1027,811,692,41,50,20,10,0,119
17119000905,1931,1502,1362,21,50,32,25,0,140
17141000016,1015,824,625,153,24,27,6,0,199
17119000106,1692,1314,1253,16,5,15,16,0,61
17119002325,633,487,346,22,90,19,3,1,141
17011009001,490,397,373,13,3,9,1,0,24
17095000021,1139,863,757,33,46,6,8,2,106
17095000807,641,482,457,5,12,6,2,1,25
17095000803,773,617,573,11,12,15,3,0,44
17095000101,761,594,572,3,6,10,5,1,22
1720300WO10,889,661,639,4,1,11,5,1,22
17165000701,1182,897,854,10,14,13,2,0,43
1706300SA03,1101,845,713,56,38,23,13,1,132
1704500GR01,523,394,366,3,2,11,1,0,28
1720300MN01,590,491,470,4,7,4,1,0,21
1720300PA01,565,450,432,6,2,2,4,0,18
1720300SB02,1181,938,881,17,6,19,10,1,57
17131000804,631,510,462,15,18,11,3,0,48
17131000803,598,488,454,17,8,5,3,1,34
1705700CA07,2366,2174,883,343,945,19,4,1,1291
17011013008,1159,821,626,155,24,15,2,5,195
1706300AS01,1864,1331,1056,163,58,31,29,2,275
17095000017,1674,1422,1165,81,133,20,19,2,257
17073002503,754,565,484,39,30,5,5,0,81
17119001603,1676,1360,1250,37,19,38,10,1,110
1719700NL10,1609,1320,1235,48,17,7,10,0,85
1719700PL29,2019,1501,1042,265,109,25,60,7,459
17043009103,876,694,560,48,18,17,54,0,134
17043009063,1104,874,650,103,38,17,68,2,224
17043009104,845,641,498,42,20,4,77,0,143
17043009088,2504,1872,466,567,213,41,612,1,1406
17043009081,1413,1185,569,165,174,17,264,4,616
1704500PA11,659,523,505,8,5,10,2,0,18
1718300DN07,809,648,624,5,3,7,8,0,24
1705700HA01,312,251,247,1,0,3,0,0,4
1706300MR04,1280,970,847,65,22,13,11,0,123
17049000601,1227,971,945,3,8,12,1,0,26
17119002222,965,741,602,53,56,9,3,0,139
17119002212,928,716,626,39,27,12,7,0,90
1719700WH20,1944,1441,827,81,143,9,372,0,614
1719700RE03,2243,1780,1595,103,25,55,11,0,185
17127000016,1706,1302,1142,33,79,20,19,2,160
17127000017,1199,921,808,12,77,13,8,2,113
1719700DU34,1076,1065,972,36,32,6,18,1,93
17043002061,774,602,511,38,10,13,27,0,91
17043002041,823,692,555,75,14,7,42,0,137
1710300DX18,834,650,556,32,34,5,9,3,94
17131000501,748,610,576,17,0,14,3,1,34
1711100Al24,1393,1031,687,269,35,29,23,1,344
17043009115,882,723,533,65,42,13,73,3,190
17043009090,990,747,487,82,37,18,120,2,260
17043003008,1397,1197,1050,43,24,9,66,1,147
17043003155,1576,1248,329,233,457,34,219,2,919
17043003111,516,418,343,21,4,0,44,1,75
17043002048,1145,864,370,352,21,38,112,2,494
17043006004,596,437,365,32,8,8,24,2,72
17119001411,938,676,568,17,28,30,30,0,108
17043002024,1397,1220,925,152,44,17,86,2,295
1719700DU10,2471,1912,657,292,442,32,492,1,1255
17043003022,1081,718,610,19,2,4,59,5,108
17043004004,1128,854,722,46,20,5,58,1,132
17043004116,833,606,454,36,40,5,74,0,152
171630ESL21,854,628,2,3,623,2,4,0,626
1718300BL01,981,799,746,21,7,17,4,0,53
1718300DC17,888,764,656,17,45,10,33,0,108
17019NEW000,1377,1026,967,13,7,13,13,0,59
171630000B3,1202,961,691,25,195,29,16,2,270
17163000SK9,1064,853,618,33,159,16,23,2,235
17163000SK5,439,368,235,5,112,6,8,1,133
17081000801,900,705,658,9,14,12,9,0,47
17073002008,1062,771,600,111,46,12,1,2,171
171670WD003,857,699,591,19,46,22,14,0,108
171670CP013,853,666,495,21,115,20,6,0,171
171670CP007,961,715,378,12,313,14,4,1,337
171670RO001,1332,946,865,20,19,26,8,0,81
1711100Do12,1735,1328,1113,121,23,20,49,2,215
1711100AD01,1275,1099,1000,67,5,16,5,0,99
1711100Al07,562,441,406,17,3,3,2,0,35
17019CN0600,1643,1261,542,103,493,35,109,1,719
17019CN0100,3041,2619,498,147,1010,42,953,1,2121
17185000015,310,259,247,1,0,11,0,0,12
1719700PL11,1429,1037,409,324,179,47,110,0,628
17083000410,1590,1236,1191,6,1,15,9,0,45
1719700WH21,1866,1351,838,88,68,8,351,1,513
1719700WH24,2108,1467,941,64,87,7,360,1,526
17019BF1000,1812,1316,1246,13,10,34,11,2,70
17019CN2000,1249,973,593,62,228,42,54,0,380
17163000SL5,1064,829,736,19,18,39,11,1,93
1711100Al09,1079,814,681,85,7,9,23,1,133
17121006001,1071,773,741,2,3,20,2,0,32
1711100Al17,1468,1166,1061,60,5,15,29,0,105
17031035025,1229,1090,626,292,98,22,72,1,464
17031760038,1892,1549,893,210,86,16,335,0,656
17031800016,1043,792,589,112,8,17,69,0,203
17031030002,1659,1321,393,821,55,59,67,2,928
17031021030,1039,804,1,19,787,14,1,1,803
17031021047,1000,762,3,14,740,8,8,2,759
1720100Ha12,1461,1119,876,88,76,39,35,2,243
17043006002,890,762,669,20,19,0,45,1,93
17043006005,1171,891,679,81,26,11,85,3,212
17043006011,869,601,516,23,12,7,41,0,85
17031800032,1121,963,728,50,11,7,174,0,235
17031800083,1073,848,725,34,11,4,70,0,123
17181000121,713,553,514,19,3,11,0,0,39
17181000108,1154,887,842,14,15,12,3,0,45
1704100CA01,871,699,670,7,2,9,2,1,29
17043005071,643,556,505,11,4,2,29,0,51
17043006010,1078,780,592,57,21,11,105,1,188
17043006020,1382,1057,541,227,138,12,153,1,516
17031800022,1575,1119,1006,56,9,10,32,0,113
17031035014,1534,1186,152,958,71,60,17,5,1034
17031035021,1549,1197,353,776,53,83,22,2,844
17031050022,2146,1510,691,215,159,15,424,4,819
17031004020,1073,1001,426,56,160,8,364,0,575
17031033018,3185,2492,815,1146,167,88,372,3,1677
17031044022,1141,1084,820,93,56,6,102,1,264
17031036011,1381,982,106,847,29,44,12,8,876
17119002310,971,812,676,12,82,36,11,2,136
17119002319,1435,1114,510,22,533,34,18,2,604
17019CC2900,975,785,544,28,147,12,51,0,241
17019CC3600,1463,1154,877,74,116,14,73,0,277
17019CON000,486,380,361,5,3,8,4,0,19
17043003099,1379,1106,793,102,103,17,97,1,313
17007007002,1395,1007,602,363,18,27,5,0,405
17007007001,598,465,406,41,1,14,3,0,59
1719700HO15,2644,1969,1752,134,20,12,39,0,217
17007001006,923,679,482,157,20,20,5,1,197
17119001419,2585,1775,1397,68,120,37,122,5,378
17119001423,2164,1740,1300,65,318,25,38,3,440
17119001602,883,700,660,1,10,15,4,1,40
17113001901,168,140,129,7,0,3,2,1,11
1700500BG02,668,558,523,10,9,9,2,1,35
1710500IG03,1036,799,757,23,6,7,5,0,42
1710500PT01,816,679,617,25,18,11,7,0,62
17107000901,381,283,267,3,2,6,5,0,16
17097Shi240,1236,913,830,18,5,3,44,1,83
17097Mor221,1124,831,720,32,19,13,39,0,111
170970Ant17,1791,1539,1387,81,20,14,25,2,152
170970Ant16,1667,1447,1356,48,12,11,10,0,91
17097Fre107,2105,1437,737,286,79,48,304,5,700
1705700FA03,227,176,171,0,1,3,0,0,5
1705700CA09,296,223,213,0,1,6,0,0,10
1717300PE01,83,67,66,0,0,1,0,0,1
17047000701,221,181,176,0,1,3,0,0,5
17031033002,3606,2967,883,1233,254,79,583,15,2084
17031007010,814,667,2,31,645,9,3,0,665
17031740033,907,718,581,83,12,16,34,0,137
17031992002,1617,1223,272,885,41,71,29,0,951
17031820003,2244,1709,1276,95,41,4,291,0,433
17031820038,3033,2493,1383,149,57,6,895,2,1110
17031930044,3344,2589,882,640,318,42,726,4,1707
17031960010,1755,1246,1091,40,9,8,88,3,155
17031039020,1472,1148,862,174,16,20,77,3,286
17031048042,1378,1231,732,233,127,26,124,1,499
17031007045,1531,1091,28,121,936,26,2,1,1063
17177001501,1473,1156,1101,15,6,17,7,1,55
17031049021,1345,1016,237,267,373,29,138,2,779
17031780007,1091,849,402,357,70,24,26,1,447
17031030006,1668,1282,198,937,112,59,48,5,1084
17031048021,2075,1843,687,301,509,54,353,1,1156
17031870032,1281,930,711,40,13,6,154,2,219
17031041024,1071,830,621,131,5,12,59,1,209
17031038018,1395,1113,738,235,29,15,121,1,375
17031038014,1440,1126,633,346,32,25,123,1,493
1717300RU01,306,233,228,0,0,5,0,0,5
170970Ela83,1744,1306,1114,73,13,23,80,0,192
170970Ela82,1679,1218,960,57,17,14,162,3,258
170970Ela84,1588,1107,743,57,4,12,293,4,364
170970Ela98,1212,853,731,22,4,1,92,0,122
17031780045,2331,1840,1180,482,34,56,142,0,660
17031753004,1005,922,592,45,94,6,183,0,330
17031740045,1004,835,679,79,25,13,43,0,156
17031022017,2447,1762,36,1679,46,131,4,1,1726
17031022006,2087,1521,33,1464,17,121,7,4,1488
17031890029,1648,1209,950,196,37,33,20,1,259
17031890027,1534,1224,931,213,35,15,22,2,293
17031034042,685,602,10,9,589,1,0,0,592
17031049019,2270,1677,362,670,550,57,90,8,1315
17031049011,2033,1678,677,382,478,43,124,1,1001
17031009008,1273,905,5,15,881,2,4,0,900
17031780019,2208,1772,1111,529,65,33,49,1,661
17031810027,1395,1010,828,30,28,0,115,4,182
17031020027,700,553,3,26,525,7,0,0,550
17031036023,2525,1838,98,1658,76,90,15,8,1740
17031960084,3094,2368,1074,848,56,35,385,0,1294
17031840013,1480,1204,1032,73,7,5,85,5,172
17031006041,1043,839,1,15,828,7,7,0,838
17031850027,448,320,240,14,45,4,14,0,80
17031002005,1698,1548,1017,292,51,33,146,1,531
17031027013,1344,1155,305,76,701,18,65,1,850
17031759002,1117,865,444,166,227,47,21,0,421
17031049026,1729,1562,891,197,339,28,115,9,671
17031040002,1529,1219,548,288,77,18,298,0,671
17031042026,3589,3350,2196,197,159,16,772,5,1154
17031042002,2670,2562,1442,277,129,24,646,9,1120
17031042035,2198,2059,1238,138,118,24,549,4,821
17031830049,1043,785,641,33,2,4,108,0,144
17031780022,858,666,541,91,15,13,19,2,125
17031780035,834,659,223,409,2,34,12,2,436
1718900HY01,760,549,517,11,13,4,3,1,32
17031998001,3412,2624,689,1538,257,128,140,1,1935
1700500LG01,398,306,284,4,4,10,3,0,22
1705100HU01,222,176,171,0,0,1,0,0,5
17135000701,198,160,148,5,1,6,0,0,12
17031044032,1864,1558,1282,140,49,8,76,2,276
17031044011,1418,1236,1048,82,25,9,74,1,188
17031044025,1531,1212,955,104,52,7,86,3,257
17031046038,1593,1406,771,137,381,18,101,4,635
17031046024,1438,1392,1003,148,85,28,148,2,389
17031001029,1696,1398,887,306,65,36,129,1,511
17031960037,2670,2095,788,1114,24,63,147,0,1307
17031830057,982,762,552,21,10,9,168,0,210
17031830059,1547,1244,657,60,44,5,484,0,587
17031830024,1291,941,747,29,15,8,139,1,194
17031850021,1175,971,468,98,338,20,65,3,503
17113003016,1682,1185,870,97,138,33,54,1,315
17031780023,2089,1601,1344,120,19,25,104,1,257
17161000816,1284,941,645,146,111,31,16,1,296
17161000911,803,689,440,100,93,13,45,5,249
17161001013,1365,1057,862,67,64,20,46,0,195
17031780034,1998,1591,945,553,35,29,59,0,646
17161000808,985,721,495,170,40,39,5,2,226
1710500CH01,164,110,104,2,1,4,2,0,6
17043003025,1089,730,584,27,13,3,102,2,146
17043003046,696,536,454,17,3,0,58,0,82
17043003005,1009,851,711,55,24,10,51,0,140
17043003063,1043,895,585,111,47,12,140,2,310
17043003130,1467,1171,633,196,191,21,143,0,538
17043008023,915,684,289,350,13,5,27,0,395
17043008039,856,715,614,67,13,13,17,2,101
1718700MN02,673,496,332,90,44,13,17,0,164
1718700RO01,642,518,487,17,3,9,0,0,31
17031880012,2031,1633,1184,217,122,43,60,1,449
17031013018,848,653,322,302,17,23,9,1,331
17031780047,1841,1419,499,836,19,60,61,2,920
17043008038,790,630,545,16,4,18,49,0,85
17043008004,764,586,507,32,12,7,29,0,79
17043005018,983,701,613,37,17,10,28,0,88
17043004035,726,574,464,38,21,9,36,0,110
17043004123,550,413,317,44,12,0,41,2,96
17043007054,1121,915,589,88,26,16,196,1,326
1714300CH04,696,518,467,28,6,12,1,0,51
1714300CH03,606,473,423,19,8,17,6,2,50
17043002080,724,580,375,32,15,4,159,1,205
17043002068,1163,927,467,118,49,19,271,1,460
17043009099,883,640,531,39,17,5,41,0,109
17043009001,1096,708,598,35,10,10,48,1,110
17043009053,824,599,480,38,3,6,69,0,119
17043003083,1122,848,643,38,14,7,142,1,205
17179001918,1383,1124,1064,24,5,14,5,2,60
17031031001,1366,986,83,856,57,46,10,0,903
17031031018,1237,922,98,782,60,46,13,3,824
1710500FY01,246,182,168,6,4,1,3,0,14
17031028013,1202,1034,20,41,976,7,0,1,1014
17031780005,1829,1413,678,651,25,41,58,0,735
17031980030,3066,2170,141,1918,89,155,18,3,2029
17031753006,1305,1077,851,75,76,12,58,1,226
17031780041,1185,868,257,547,29,32,35,1,611
17031920003,833,639,503,89,12,18,21,0,136
17001023021,1024,771,707,10,24,16,8,2,64
17001018001,1207,858,814,10,5,16,1,0,44
17043009046,1062,903,595,34,46,10,220,2,308
17043009097,865,706,522,49,39,7,88,2,184
17179001411,1244,940,877,22,5,11,22,1,63
17043003125,829,694,525,30,6,7,125,0,169
17043009127,761,564,442,41,36,7,27,0,122
17043009083,955,718,542,53,45,7,76,0,176
17043009030,789,623,392,33,5,4,178,1,231
17043009130,691,540,406,22,15,11,85,0,134
17007001005,730,578,447,104,2,22,10,0,131
17031025018,1964,1721,93,53,93,2,1483,0,1628
17031025006,2092,1713,37,33,14,7,1627,1,1676
17031860061,991,804,662,43,24,3,74,0,142
17031049023,1882,1696,859,270,394,21,172,1,837
17113COB037,835,625,510,17,17,3,77,1,115
17031870044,1567,1192,1049,30,8,11,88,2,143
17031034040,1049,779,12,10,757,9,0,0,767
17031025020,997,676,42,40,593,9,11,1,634
17031025004,1421,1122,292,84,555,15,186,1,830
17031025029,1116,944,193,108,608,7,44,2,751
17031830018,1818,1317,1041,32,4,4,218,0,276
17043004103,622,499,366,24,21,13,75,1,133
17097Wau340,1423,1122,874,152,23,15,52,1,248
1711100Nu28,973,774,643,96,17,15,12,0,131
17097Wes384,1143,834,750,30,7,8,37,0,84
1714300PE58,809,641,371,30,190,19,29,1,270
1714300PE51,1092,866,561,32,192,7,74,4,305
17031770006,1570,1236,1131,65,12,5,23,0,105
17031756004,1274,948,777,23,78,6,55,0,171
17031800038,1083,894,586,110,19,6,176,0,308
17031042030,51,42,19,4,8,8,10,0,23
17031003021,1300,1110,455,45,371,8,230,2,655
17031003019,1444,1205,660,51,177,4,306,0,545
1719500MP03,927,714,655,32,9,10,6,0,59
17031028023,1549,1159,14,97,1056,21,4,0,1145
17031037003,1116,768,16,182,579,8,2,1,752
17031026025,863,719,268,337,98,25,27,2,451
17031030028,1326,1142,489,513,73,32,83,0,653
17031011006,1660,1443,727,240,220,21,249,3,716
17031029008,1853,1335,17,50,1264,21,1,0,1318
17031019039,565,489,74,16,386,0,9,0,415
17031970075,1729,1409,954,228,186,11,50,0,455
17031050004,1327,996,371,151,172,25,294,1,625
17031753003,1411,1144,839,68,85,14,122,3,305
17031780036,2087,1689,933,672,49,41,27,1,756
17097Ver260,1106,839,554,35,6,2,241,0,285
17043003023,557,394,350,13,2,0,21,1,44
17097Fre126,1970,1522,797,609,35,40,70,2,725
170970Ela81,1683,1310,941,49,35,7,267,2,369
17097Shi235,1114,844,559,71,22,12,178,0,285
17113003019,2034,1444,1192,68,96,19,62,0,252
17031840017,1958,1669,1348,154,6,17,155,2,321
1718900DU02,305,247,236,6,1,1,1,0,11
1718700SA01,546,425,400,10,2,5,2,0,25
17157000606,740,606,578,15,4,8,2,0,28
17157001001,31,23,20,1,0,2,0,0,3
1719900EM04,1204,919,883,9,5,11,8,0,36
17097Lib190,1700,1306,925,122,38,3,215,0,381
17097Wau359,2275,1699,532,810,313,88,26,4,1167
17097Lib194,921,848,758,13,23,1,52,2,90
170970Ben52,1142,958,761,119,20,46,29,0,197
17113003011,1415,1171,879,48,218,10,17,0,292
17031050040,1462,888,569,94,39,15,166,2,319
17031024012,759,554,11,29,516,4,1,0,543
1714500DQ03,699,593,517,13,34,17,17,1,76
1714500DQ04,888,703,619,11,55,16,5,1,84
1701500SA01,413,332,302,16,10,5,2,0,30
1719500ST14,1110,880,699,151,21,13,3,0,181
1714300ME03,1030,782,755,9,6,5,4,0,27
17097Zio413,1644,1164,250,498,382,69,11,4,914
1719900HE01,930,626,553,9,32,17,9,0,73
1708900EL32,1223,835,263,491,58,42,26,1,572
170890AC303,1886,1374,311,1016,47,93,5,0,1063
170890AC405,2364,1613,270,1217,98,83,18,5,1343
17097Lak158,1692,1311,1005,191,36,36,40,6,306
17169001001,112,101,98,1,0,1,1,1,3
17115501052,1526,1118,557,27,514,25,3,0,561
17113003005,748,611,554,13,25,10,5,0,57
17023009001,989,728,697,13,2,10,5,0,31
17179000813,1040,823,744,31,16,20,8,1,79
17031790070,1617,1127,150,85,871,7,21,4,977
17023006001,129,112,106,2,0,4,0,0,6
17191001701,345,268,256,4,2,3,3,0,12
17031022014,1940,1395,49,1166,235,83,18,5,1346
17031950105,1034,785,32,16,735,12,0,0,753
17031760040,1877,1523,828,198,77,16,418,2,695
1708900SC24,3196,2131,1563,149,45,26,340,2,568
17031710055,1624,1132,152,112,853,21,3,0,980
1710900PC01,535,411,392,3,5,6,4,0,19
17031890097,1824,1413,1114,160,55,32,62,2,299
17031014012,1640,1259,249,917,21,65,75,1,1010
17031020031,1759,1269,17,27,1236,12,3,2,1252
17031011036,1181,1007,178,56,21,0,746,1,829
17031994002,2110,1624,358,1144,102,77,27,6,1266
1714300PE87,1145,884,702,48,61,18,53,3,182
1714300PE84,658,523,446,7,43,2,23,0,77
1714300ch07,780,591,538,30,2,11,3,0,53
1714300CH06,619,502,474,13,0,2,3,0,28
1714300PE17,2630,2367,1405,303,496,32,124,0,962
17031880037,1623,1427,1317,45,8,16,23,2,110
17031860012,748,587,509,47,11,5,9,3,78
17031860008,1346,1035,771,160,8,7,85,1,264
1708900DU28,2928,2337,1668,263,73,29,308,4,669
1708900SC34,2822,2158,1558,248,211,12,110,0,600
17157001705,819,616,448,7,139,11,6,3,168
17031960068,727,560,488,22,8,3,36,0,72
17031014014,2361,1665,75,1548,29,135,12,1,1590
17031710034,910,705,146,35,503,6,19,2,559
1708900DU25,805,638,560,47,8,10,11,0,78
1707700MB10,541,431,400,4,6,8,11,1,31
17115501035,990,783,665,9,71,11,17,2,118
17115517001,1931,1488,1385,19,11,27,18,1,103
17067000701,437,369,353,7,2,3,3,1,16
17031049020,2105,1797,767,504,404,66,112,0,1030
17031049010,1900,1504,523,455,415,84,104,4,981
17031049003,2018,1491,513,467,380,37,119,3,978
1710900MO01,274,216,211,2,1,4,2,0,5
17031870033,2015,1528,661,619,89,54,145,0,867
1707500ON02,898,661,452,175,12,11,6,1,209
17031008050,779,653,0,4,651,9,0,0,653
17031039001,911,693,502,86,10,6,92,0,191
17031930056,1532,1203,861,68,38,4,217,0,342
17031014023,1197,896,307,560,10,57,10,1,589
17031023008,1672,1278,419,780,34,60,33,2,859
17031980024,3923,2815,149,2551,76,156,33,5,2666
17031018034,726,647,31,33,579,5,5,1,616
17031018026,817,670,8,36,624,6,8,1,662
17031044016,1612,1251,1017,91,34,17,85,1,234
1708900BA07,1429,1095,955,71,17,17,21,0,140
17031004008,1140,932,18,21,895,6,5,1,914
17031920013,1929,1472,788,486,95,60,71,1,684
1708900SG01,1011,804,686,87,19,20,6,0,118
1708900EL17,2909,2260,736,1195,233,82,80,6,1524
1708900EL39,1901,1415,900,286,93,41,109,3,515
1708900EL22,1899,1357,188,1017,104,91,36,6,1169
1708900DU13,1453,1067,226,804,25,50,10,2,841
1708900EL42,1533,1107,372,647,50,69,40,4,735
17031032024,1288,1022,749,87,26,11,143,1,273
17031001009,953,887,390,374,50,25,69,1,497
17031041039,1026,780,604,71,19,7,82,0,176
17031041047,1154,832,667,79,14,11,68,0,165
17031740046,849,686,584,34,3,7,58,2,102
17031004007,1540,1202,78,46,1064,9,19,1,1124
17031004005,1198,965,63,43,854,16,17,5,902
17031720033,1257,1004,841,70,48,19,20,0,163
17031860011,1089,816,642,79,46,13,35,1,174
17031040035,1717,1541,694,224,167,28,446,1,847
17031028014,1104,815,8,57,741,2,8,1,807
17031950001,729,565,17,61,483,1,7,3,548
17031970028,1380,1122,687,120,271,15,34,0,435
17031016001,2383,1756,80,1588,52,138,19,2,1676
17031019011,903,693,627,34,12,16,6,0,66
17031790005,1796,1404,998,247,98,32,49,0,406
17031790052,1573,1349,1085,175,35,14,41,0,264
17027007001,683,532,504,18,3,5,5,1,28
1718700MN07,750,590,442,73,50,9,19,2,148
1707700CB10,571,449,271,21,114,23,23,1,178
1707700MB05,961,754,536,37,143,12,10,4,218
17031830003,1309,1093,837,62,25,10,165,1,256
17031048009,988,934,502,95,85,9,242,1,432
17031044006,1831,1701,1308,143,60,20,170,6,393
17031011027,1196,964,154,74,25,5,711,0,810
17031011020,1074,891,263,140,27,9,456,1,628
17031011022,1925,1604,589,289,38,36,676,3,1015
17097Wau363,2198,1673,234,995,262,76,166,2,1439
1703300OBL3,481,384,377,0,1,0,4,0,7
1710900MC02,1889,1816,1272,192,269,12,71,2,544
17031960002,1070,826,667,71,10,4,71,0,159
17031006029,771,639,4,9,628,2,3,0,635
17031830047,1588,1270,1019,36,8,3,209,2,251
1708900BA17,1141,888,802,39,15,4,14,0,86
170890AC610,2852,1952,319,1098,376,72,165,3,1633
170890AC609,1926,1452,514,606,208,66,120,3,938
17031740008,1187,902,776,55,9,1,60,1,126
17031740048,746,698,656,16,6,7,19,0,42
17031780003,2544,2117,1297,623,142,32,60,2,820
17031036001,1849,1381,319,971,41,103,67,0,1062
17031008019,713,606,3,2,601,5,1,1,603
17031020033,844,654,12,24,620,8,3,1,642
1703300HUT1,807,652,628,7,11,5,3,2,24
17031850004,1565,1167,764,95,231,9,73,1,403
17031005034,1661,1432,810,149,186,7,272,7,622
17031018024,1533,1079,224,780,60,72,14,0,855
17031970055,1023,772,329,339,64,16,35,1,443
17031026035,829,681,233,365,82,17,14,1,448
17031001018,1326,1113,569,363,137,41,56,0,544
17031780008,2195,1729,887,705,72,49,62,1,842
17031890006,878,737,494,131,74,18,35,0,243
17031840007,1484,1170,985,99,8,8,80,0,185
17031014016,1300,1003,70,615,18,20,296,1,933
17031970078,2444,1912,1358,282,214,13,52,0,554
17031028001,1300,855,3,30,825,7,0,1,852
17031028039,1103,777,4,21,754,1,1,0,773
17031034018,822,601,8,19,567,7,2,0,593
17031810024,1931,1497,815,154,24,11,501,4,682
17031950057,1041,796,414,156,213,11,9,0,382
17031021018,1120,929,0,20,907,11,2,1,929
17027014001,624,507,473,9,1,11,6,0,34
17031994004,1313,1019,231,679,51,55,55,2,788
17027015002,584,398,310,24,44,11,7,0,88
17031032034,1388,1205,930,148,30,10,87,2,275
17031032005,1336,1143,870,126,47,13,79,1,273
17031010001,1182,925,29,266,633,30,10,2,896
17031010008,1533,827,16,236,578,15,3,0,811
17031018005,716,539,10,87,437,9,2,0,529
17031040016,1294,1106,791,164,39,32,80,4,315
17169000804,590,438,388,4,29,9,8,0,50
17091Mant06,2572,2106,1825,112,94,40,24,2,281
17091Bour12,1091,866,727,37,40,16,53,0,139
17091Bour10,1548,1168,867,181,75,32,22,0,301
1719700CR10,1742,1445,1160,149,88,42,8,2,285
17093OS0303,635,498,412,51,16,12,4,0,86
17093NA0603,1832,1324,824,253,195,9,63,0,500
1720100Ro08,1373,1153,951,116,21,36,11,1,202
1720100Rs15,1383,997,902,18,12,25,29,0,95
1719700WH28,2930,1990,1364,217,165,22,210,5,626
17093OS0333,2459,1560,1136,174,135,22,110,2,424
17093LI0108,808,660,512,118,7,20,1,1,148
1702100GR01,200,163,154,0,2,5,0,0,9
17003000901,647,500,456,4,3,26,2,0,44
17083000404,1047,828,781,9,15,14,6,0,47
1719700WH17,2332,1665,966,67,56,8,565,2,699
171670CP056,987,786,692,22,43,12,11,0,94
1719700CR07,1581,1353,535,112,689,16,14,2,818
1719700PL05,2556,1863,997,538,227,41,86,1,866
1710300DX10,714,545,484,29,19,7,5,1,61
1719700DU21,3035,2207,798,811,415,63,182,1,1409
1719700NL14,3180,2209,1959,145,38,19,30,2,250
17101000017,430,336,317,8,4,6,1,0,19
171670CH001,2174,1546,1269,38,86,19,130,0,277
171670CH004,1355,1013,880,28,59,13,25,0,133
1711100Do06,960,766,617,113,19,17,6,0,149
1711100Do05,836,709,590,82,13,21,7,0,119
17043004125,892,725,642,36,19,16,10,1,83
17043004082,825,637,537,52,17,2,30,0,100
17043004041,851,653,493,86,21,14,42,0,160
1711100Al18,1005,793,657,82,17,10,14,0,136
17165001101,71,40,36,2,1,2,0,0,4
1710300DX08,705,552,453,31,30,23,6,1,99
17043002033,1189,990,782,76,25,14,94,1,208
17043002014,915,730,314,303,45,40,62,0,416
17043005035,1078,744,534,37,46,10,116,0,210
17043005002,1024,703,632,32,5,10,19,2,71
17019TO3000,1720,1240,1141,32,27,26,13,0,99
17043009135,1019,810,509,49,50,4,193,0,301
17043003061,1259,924,700,53,31,5,133,0,224
17043003039,1184,955,698,61,34,5,160,1,257
1717500WTOU,1167,897,850,24,5,15,1,0,47
17043003073,842,655,539,53,13,10,40,0,116
17043003031,1268,1081,908,94,20,8,60,0,173
17141000004,910,696,645,29,4,12,7,0,51
17043004040,907,698,590,39,9,9,54,0,108
17043005055,1453,1016,674,57,27,11,250,0,342
17043001037,1216,938,396,455,21,17,59,2,542
1703700DK22,1480,1143,727,188,148,25,52,1,416
17043003151,658,513,442,26,8,5,29,1,71
17043003102,818,647,515,35,13,13,83,2,132
17095001501,685,540,510,10,2,11,4,0,30
17119002220,1115,912,754,29,83,22,18,0,158
17139000707,1178,899,877,5,4,6,3,0,22
1709900OT07,616,501,461,15,11,7,4,0,40
17073001802,1144,875,824,14,13,15,2,1,51
17131000101,400,315,287,5,1,15,0,1,28
1718300OK05,837,643,601,7,9,18,4,0,42
17119002306,910,729,601,16,60,36,8,0,128
17131000701,249,167,157,3,1,3,2,0,10
17119001305,1018,789,609,42,86,25,9,4,180
17119001503,1678,1312,1237,15,8,31,9,0,75
1705700BK01,416,349,332,3,1,8,4,2,17
17059000101,406,328,315,0,0,9,2,0,13
17119000701,1033,834,784,8,8,18,10,1,50
17081001108,1058,797,674,18,62,29,15,2,123
1716300SC24,888,743,560,17,108,15,40,1,183
1711100GR01,1625,1302,1040,163,24,35,44,0,262
1711100GR05,1254,953,707,172,6,14,37,1,246
1709900MN01,679,516,358,129,6,9,19,0,158
1709900ML01,574,448,402,27,0,10,2,0,46
17127000012,405,311,293,6,3,4,2,0,18
17127000015,919,722,616,22,60,20,2,0,106
1719700DU27,3685,2710,688,883,814,81,308,5,2022
17009000801,70,56,55,1,0,0,0,0,1
17043009040,1074,739,630,61,1,3,46,0,109
1719700PL12,2595,1899,729,596,276,54,286,5,1170
1703700DK14,930,687,351,264,38,24,15,4,336
1711100GR06,1404,1019,892,56,17,6,46,0,127
1709900EG02,389,323,283,26,8,7,0,0,40
1709900LS06,831,671,558,79,16,6,4,0,113
17043006032,1265,885,500,195,104,21,84,1,385
17043003154,773,622,410,74,32,7,99,1,212
17019CC0200,3110,3043,683,234,141,14,1971,7,2360
17019SAI000,334,271,258,4,3,5,2,0,13
1709900BC03,1117,835,587,169,51,21,9,0,248
1709900DP01,459,372,349,14,5,3,1,0,23
17073002007,864,656,513,90,34,12,8,0,143
17121003018,469,340,290,4,30,13,4,0,50
17121003003,590,453,404,4,29,10,1,0,49
1709900TG01,468,366,341,18,0,5,0,0,25
1718300DC04,1221,843,355,47,425,10,7,0,488
1711100Al05,1547,1146,993,73,16,15,49,0,153
1711100Al31,1613,1234,1046,91,12,11,61,3,188
1716300CS20,696,560,357,27,134,32,10,0,203
17121003008,791,603,532,14,42,10,0,0,71
1716300CS19,667,541,405,18,90,9,10,0,136
17121003007,614,482,403,22,40,13,8,0,79
1709900OT09,940,737,622,73,13,20,8,0,115
17163000SL6,1317,1005,877,10,83,20,7,0,128
17119002104,854,570,8,2,557,5,2,1,562
1707900ST02,106,84,83,0,0,0,0,0,1
17101000009,2531,2389,793,305,1279,6,11,0,1596
17091Gane02,490,355,62,22,262,5,4,0,293
17019CN1600,1265,1048,668,58,217,18,101,0,380
17119001502,1614,1299,1159,31,66,26,10,0,140
1712500QU01,732,603,570,4,4,24,3,0,33
1712500HV02,632,494,456,8,8,21,2,2,38
17009000604,531,397,374,5,11,5,1,1,23
17119001403,628,495,412,14,36,15,12,0,83
1710500IG04,1006,715,668,20,5,9,13,0,47
1702900CH19,1078,844,773,26,9,19,16,0,71
17101000012,497,389,378,3,0,5,1,0,11
17061000201,454,380,368,2,0,4,1,0,12
17009000301,290,221,217,1,0,2,0,0,4
1710500NV01,167,139,133,2,0,2,0,0,6
1714300PE56,985,774,579,26,114,5,44,0,195
1705300DM05,841,682,662,10,5,2,3,0,20
1707900HC01,248,184,174,3,0,4,1,0,10
17101000003,560,449,420,2,9,9,5,1,29
17031032035,1343,1120,859,92,45,6,103,0,261
17007002002,862,694,620,52,12,16,5,0,74
17031029007,904,755,138,163,441,20,16,0,617
17031820024,3096,2378,1095,316,275,41,661,9,1283
17031002025,1319,1155,869,139,29,13,106,1,286
17031032004,1172,949,750,96,31,17,66,4,199
17031043045,729,547,410,21,43,0,70,0,137
17031042014,2340,2234,1706,119,67,21,288,0,528
17031042017,2408,2304,1889,122,58,8,207,3,415
17031048006,1892,1660,772,223,390,27,260,4,888
17031038035,1404,1087,524,459,43,26,65,3,563
17031980020,1592,1165,123,1020,21,108,16,1,1042
17031820049,1397,1097,733,77,161,11,115,4,364
17017000306,897,645,348,200,90,22,8,3,297
17031028033,1398,1040,3,48,991,12,5,2,1037
17179000810,925,724,647,18,11,22,10,2,77
17031890083,2112,1612,89,471,1059,27,13,1,1523
17031830027,3177,2483,1081,223,165,35,985,3,1402
17031043004,1708,1559,1347,99,21,10,71,3,212
17031043015,1451,1322,1118,65,32,12,90,1,204
17031800062,934,738,443,42,2,7,244,0,295
17097Ver270,1163,917,802,18,8,5,84,0,115
17135001901,443,342,321,1,2,9,3,0,21
1719300CA12,439,351,331,6,2,7,1,0,20
17097ZZZZZZ,0,0,0,0,0,0,0,0,0
17097Ver258,1673,1239,813,174,8,23,228,2,426
17031960081,1012,751,630,19,14,4,76,1,121
17031930038,1600,1216,694,304,48,50,163,4,522
17031036027,1505,1228,377,724,108,75,33,2,851
17097Shi243,2053,1674,1519,57,22,4,53,2,155
17043008021,869,783,672,38,13,8,52,1,111
17043003147,599,458,381,34,8,8,18,0,77
17043003054,659,520,474,9,6,8,23,2,46
17043003121,723,536,482,29,4,0,15,0,54
17043002028,1016,748,266,287,36,46,138,3,482
17043009025,857,626,542,46,4,8,26,0,84
17043009047,1078,853,716,66,14,7,28,1,137
1703300OBL1,1012,782,757,7,4,11,4,1,25
17031040024,1814,1486,600,334,105,45,440,3,886
17031042008,1410,1353,909,115,101,14,211,2,444
17031046013,1398,1318,913,121,118,15,148,1,405
17031046017,1276,1187,682,130,110,10,270,0,505
17031800057,1776,1481,667,122,46,15,644,0,814
17031800078,2041,1759,945,110,74,17,617,0,814
17031050024,1233,802,563,43,11,4,165,1,239
17031039032,1188,886,481,65,21,4,306,0,405
17031039025,1402,1199,568,314,185,35,138,0,631
17031037002,1707,1257,44,747,496,49,6,3,1213
17031026004,1235,978,26,740,232,28,6,0,952
17031048030,956,800,583,66,64,7,81,0,217
17031034036,676,535,5,7,521,5,1,0,530
17181000112,485,379,341,11,1,21,4,0,38
17181000102,803,650,595,9,26,7,6,1,55
17043002091,827,614,230,164,40,13,173,0,384
17085000101,459,354,339,4,3,3,1,1,15
17031960008,939,687,598,28,11,9,43,1,89
17031810020,1876,1537,1210,91,12,17,210,2,327
17071000702,364,308,300,3,3,5,1,0,8
17031031037,1284,992,158,771,51,98,34,4,834
17031028045,1027,947,671,53,92,11,124,1,276
17031002032,1186,1112,825,82,73,9,126,4,287
17031002045,1995,1929,1200,142,300,22,263,5,729
17031002041,2852,2784,1985,196,163,21,418,1,799
17031820046,1936,1597,930,71,19,4,578,2,667
17031890041,1172,921,10,142,768,15,14,0,911
17043005117,2164,1590,494,462,351,13,268,3,1096
17043005103,1559,1325,701,270,199,19,136,2,624
17031042022,978,916,686,64,19,10,130,1,230
17031042020,2087,1983,1374,115,55,17,400,2,609
17031042023,1814,1700,1259,71,68,11,277,3,441
17031042025,2356,2238,1493,138,89,21,488,4,745
17031032025,1327,1030,785,146,34,16,57,0,245
17031026046,687,589,454,100,16,5,22,0,135
17161000613,873,560,146,205,195,6,13,0,414
17161000722,1577,1156,679,90,328,21,30,1,477
1708900SC02,1128,900,826,38,15,9,16,1,74
1708900SC20,1876,1476,998,371,54,28,41,0,478
17031004001,2264,2055,818,202,608,22,411,4,1237
17031780038,1026,828,500,233,25,34,65,1,328
17031800009,2804,2365,1457,358,104,36,446,2,908
17031035010,1248,1138,763,236,59,19,66,2,375
17031032012,1027,944,452,361,92,20,44,0,492
17031032029,1401,1129,785,190,45,15,94,2,344
17031870061,2130,1629,641,618,107,54,253,0,988
17043005014,809,568,530,14,8,4,10,0,38
17043005052,865,625,571,10,22,5,13,0,54
1708900RU05,3628,2563,1598,453,100,51,381,3,965
170890AC702,1722,1198,67,960,166,50,3,3,1131
1708900RU06,1334,994,674,139,29,26,138,1,320
1700500CN1A,757,605,524,20,28,11,24,1,81
17031960072,1523,1215,858,176,34,27,131,2,357
17031850035,1778,1464,937,125,234,26,149,1,527
17031760016,2186,1712,970,169,71,22,468,1,742
17031030025,2196,1837,837,800,109,76,83,4,1000
17031760041,2218,1818,1006,434,148,60,199,3,812
17031032003,1285,1082,701,226,54,23,90,1,381
17031001041,740,643,395,177,24,23,35,0,248
17031001042,539,431,213,147,41,15,39,0,218
17031031008,1183,864,167,624,47,53,29,6,697
17031031034,1253,950,315,560,50,46,30,7,635
17031031009,1478,1070,136,867,39,78,33,2,934
17031790019,1903,1495,737,629,80,47,31,1,758
17031850034,1219,980,593,108,183,28,80,2,387
17031790054,734,559,456,53,15,9,24,0,103
17085001901,398,295,286,8,0,1,0,0,9
17031037039,1128,847,1,96,747,8,2,1,846
17031830040,1044,832,671,38,9,6,108,0,161
17031030026,1088,840,223,521,38,32,64,3,617
17097Gra142,2629,1907,1153,370,146,34,215,0,754
17097Fre117,1482,1156,867,144,19,4,124,0,289
17097Wes394,1437,1045,894,55,11,8,59,1,151
17031010005,1243,918,330,521,60,35,11,0,588
17031860053,955,735,636,53,13,8,23,1,99
17097Mor206,1361,1036,899,91,8,1,30,0,137
17097Mor205,1341,1032,871,63,19,11,58,1,161
17043005004,681,491,433,20,6,4,20,0,58
17097Mor213,1371,1122,940,98,24,26,39,0,182
17043003077,871,718,556,45,21,5,91,1,162
17097Lib197,1467,1173,784,97,52,17,225,7,389
17031870043,1238,909,659,42,14,5,187,0,250
17031960063,2059,1712,1160,284,52,17,204,0,552
17031800040,1721,1354,711,51,20,4,561,0,643
17161000910,1562,1206,813,148,184,50,27,2,393
17161000915,1336,1014,699,135,127,30,32,0,315
17031800088,754,564,518,24,0,4,16,0,46
1719500ST02,961,714,526,155,16,15,0,1,188
17043009086,1429,1209,724,115,177,21,163,1,485
17161001107,1740,1358,1127,47,141,26,13,2,231
17031950044,1206,908,27,26,857,7,1,4,881
1714300PE40,1257,959,636,78,221,12,14,0,323
17031018047,1001,762,24,277,461,17,2,1,738
17031018039,1097,804,26,351,434,36,1,0,778
17179001404,1203,858,795,13,13,14,17,3,63
1707700CB25,1471,1427,1013,145,219,14,44,5,414
17161001004,1204,979,750,50,142,18,22,0,229
17161000703,857,639,440,52,111,23,9,0,199
17161000727,1204,986,721,132,55,23,51,1,265
17179001413,1336,1089,1005,27,11,9,35,0,84
170890AC706,1763,1257,515,279,376,31,84,1,742
17031710052,983,749,16,86,647,8,0,2,733
17031800090,1150,920,594,83,19,12,229,5,326
17179001917,1293,1061,1004,20,4,18,10,0,57
17179001911,1137,871,839,6,6,9,6,3,32
1708900EL43,2563,1830,500,1078,184,83,54,2,1330
1708900EL46,969,755,330,311,68,18,36,4,425
17067000901,282,225,217,3,1,4,1,0,8
170890AC502,871,717,529,112,58,14,9,0,188
1708900AU09,908,764,515,203,32,15,9,0,249
170890AC501,1148,988,700,167,85,3,35,0,288
17031970057,1458,1138,827,108,180,12,16,2,311
17031034001,864,668,2,4,662,3,0,0,666
17031034007,792,660,2,8,639,12,8,3,658
1708900DU19,1600,1111,144,921,41,71,5,5,967
17031970087,1392,1056,674,305,59,33,10,3,382
17031048018,1343,1241,594,122,328,13,191,4,647
1707700CB24,1532,1242,714,130,216,33,144,0,528
17031045031,1046,831,454,242,20,23,107,4,377
17031020034,2389,2147,769,200,729,21,454,1,1378
17031800002,2006,1678,792,195,71,24,603,3,886
17031037040,1100,873,8,158,719,18,4,0,865
17031037023,1081,842,5,163,684,14,4,0,837
17031830054,1155,918,705,25,14,5,172,0,213
17031830016,1515,1143,875,36,7,4,214,0,268
17031890045,1569,1177,20,207,962,18,4,3,1157
17031790004,2151,1616,1021,442,77,56,53,0,595
1708900EL29,927,718,306,341,49,41,16,3,412
17031043031,1392,1236,888,132,129,20,69,1,348
17031043039,2942,2737,1963,297,213,19,249,3,774
17031043002,1387,1136,975,51,21,7,83,0,161
17031048017,1144,1070,534,109,222,36,185,4,536
17031960056,1316,996,677,65,14,9,242,0,319
1714300PE28,1214,867,458,63,312,17,18,1,409
17031980006,2107,1530,178,1269,55,173,34,1,1352
17067001104,588,475,463,3,8,2,1,0,12
17067002101,282,236,225,2,0,5,1,1,11
1708900EL13,2243,1575,441,989,94,80,49,5,1134
1708900EL07,1104,929,637,189,23,34,73,3,292
1714300PE27,893,763,645,20,73,11,14,3,118
1714300PE49,1103,898,705,29,134,18,9,0,193
1714300PE50,1252,1008,677,58,224,22,32,2,331
1714300PE78,900,740,617,33,34,9,46,1,123
17043006027,2043,1677,856,252,212,13,350,1,821
17043006029,1018,812,573,98,41,16,84,0,239
17043006053,1485,1137,448,274,285,20,128,1,689
17043006007,1179,874,673,71,33,23,65,2,201
17031017006,1683,1221,35,455,718,45,8,1,1186
17031008004,769,656,2,5,648,3,1,1,654
17031800010,914,751,553,133,16,13,43,1,198
17031870013,1632,1383,885,352,20,33,116,4,498
1708900DU08,2247,1553,307,1147,40,89,51,1,1246
1708900SC28,1258,1004,913,33,12,8,37,3,91
1708900DU06,1871,1288,230,994,33,81,22,6,1058
17031046022,1123,1055,537,121,278,17,107,4,518
17031006045,973,781,5,5,766,12,5,0,776
17031820040,870,664,419,59,11,0,175,1,245
17031014026,1875,1327,59,1249,10,104,7,2,1268
17031014021,2025,1462,87,1343,17,62,13,2,1375
17017000609,352,274,238,23,3,9,2,1,36
17115504001,1363,1026,977,10,5,23,3,0,49
17031043041,2184,1905,1488,146,133,3,123,2,417
170890AC409,1154,882,599,160,72,23,24,0,283
17031930064,1449,1137,823,67,27,9,215,2,314
17031930066,1303,1017,692,68,38,11,208,1,325
17031007009,665,525,5,8,508,10,4,0,520
17031980022,2254,1614,103,1422,62,149,26,8,1511
17031930028,1632,1294,900,191,40,11,157,1,394
17031028036,563,413,10,20,376,6,4,1,403
17031024027,1214,957,98,69,794,11,1,1,859
17031720007,1075,752,93,168,483,8,11,1,659
17031790066,1115,863,422,392,26,30,26,2,441
17031790003,1653,1284,628,569,56,34,20,1,656
17031870049,949,714,613,29,11,4,49,1,101
17031720059,1378,1123,868,109,94,18,43,0,255
17031009047,761,637,0,7,628,3,2,0,637
17031047039,1243,1022,761,115,53,19,88,0,261
17031047037,1118,935,739,120,25,5,55,0,196
17031047025,1656,1318,939,199,53,34,115,2,379
17115501070,959,790,628,15,121,12,7,0,162
1714300LI15,860,710,663,15,14,8,7,0,47
1714300LI12,816,652,596,17,7,19,12,1,56
17031950079,2103,1590,295,386,901,39,9,4,1295
17031720015,1323,963,303,228,403,33,20,1,660
17031800082,1271,998,789,108,24,10,73,3,209
17031029035,1096,826,6,93,731,12,6,0,820
17031007044,815,637,8,58,571,10,0,1,629
17031820028,1245,897,759,36,45,12,47,0,138
17031036007,1237,1021,627,304,41,26,53,1,394
17115502001,240,176,169,2,1,0,0,0,7
17115501056,1800,1434,855,53,451,31,58,0,579
17031050030,1632,1168,221,260,113,25,554,3,947
17031050029,2682,1883,346,346,259,25,928,5,1537
17031002037,932,889,728,62,29,6,66,0,161
17031002031,1280,1193,1025,54,28,5,62,1,168
1707500ML01,204,156,140,2,0,8,0,0,16
1707500BL01,400,308,290,7,0,8,0,0,18
17031022008,1789,1339,260,902,137,102,40,3,1079
17031022002,1464,1143,354,753,27,56,23,2,789
17031800026,1364,1221,915,99,57,15,141,3,306
17031029037,1115,881,11,110,766,15,0,2,870
17031029005,1244,892,15,165,699,9,9,0,877
17031930029,1629,1265,895,103,38,29,212,0,370
17031005024,1609,1431,599,131,460,9,247,1,832
17031005019,1079,926,361,49,230,16,275,1,565
17031004031,1215,1146,147,24,901,17,73,0,999
17031004009,952,833,48,13,750,19,23,4,785
17031029022,1121,919,127,174,597,14,15,1,792
17031029019,1139,958,32,18,909,3,4,0,926
17031029034,840,655,84,181,380,13,8,0,571
1713700JK03,913,750,571,29,107,20,18,2,179
17031033013,1671,1431,532,766,37,65,91,5,899
17031014020,1778,1281,77,1055,29,41,128,3,1204
17031790009,1322,1016,863,73,42,14,17,1,153
17031790073,1194,1115,938,71,65,7,31,0,177
17031790031,1116,829,723,52,21,11,24,1,106
17031970097,1271,1050,316,175,539,18,23,1,734
17031900038,1674,1261,107,51,1102,12,3,0,1154
17031900040,1255,1033,53,97,940,8,6,0,980
1708900EL41,1185,938,503,340,56,50,40,1,435
1708900EL35,1006,775,376,348,29,33,12,0,399
1708900RU07,1164,1164,1110,30,7,4,9,2,54
17031020005,1615,1149,29,41,1081,24,10,0,1120
17031900018,1443,1105,116,47,926,6,10,0,989
17031900035,851,739,135,31,557,7,13,1,604
17031820019,1468,1071,803,66,79,9,100,0,268
17031007023,758,658,0,14,641,6,4,3,658
17031900029,1291,983,520,41,390,21,28,0,463
17031035018,1576,1178,93,1026,50,84,23,3,1085
17031031022,1366,1068,109,905,69,79,14,2,959
17031044010,1406,1227,1030,69,36,3,104,1,197
17031044027,1492,1364,1135,122,32,10,60,0,229
17031009029,1088,850,0,8,845,2,0,0,850
17031970079,848,708,590,68,14,9,23,0,118
17031970023,2063,1784,1410,158,174,8,29,0,374
17031950103,1018,784,10,65,686,3,17,0,774
17031710053,987,707,198,133,362,28,11,1,509
1708900EL52,2194,1713,744,633,142,49,187,2,969
1708900EL53,4181,3166,1791,723,137,67,498,1,1375
17031024008,605,445,3,42,403,4,2,0,442
17031860071,981,922,841,28,9,7,37,1,81
17031036012,1681,1231,71,1084,74,72,7,2,1160
17031950066,1474,1193,150,36,1000,21,2,1,1043
17031012001,1642,1299,205,846,42,82,215,2,1094
17031970042,1688,1311,809,184,287,15,22,0,502
17031970034,1642,1316,643,285,360,17,27,0,673
17031009018,674,519,4,7,510,1,1,0,515
17031011021,1366,1137,646,246,28,33,207,3,491
17031880007,1864,1414,1171,170,18,13,41,0,243
17031043029,2277,1970,1603,120,60,10,169,1,367
17169001301,152,132,128,1,2,2,0,1,4
1719700WH13,1928,1447,941,74,99,10,316,2,506
1719700FR18,1716,1303,1154,52,25,12,52,0,149
17141000020,538,437,306,97,18,6,8,0,131
17043004081,785,586,475,16,16,4,81,1,111
17043004126,603,435,332,11,3,1,83,0,103
17043006024,1090,827,452,135,93,12,138,1,375
17043003108,1162,934,732,70,34,7,88,0,202
17043003051,970,685,612,41,4,11,18,0,73
1703700DK19,1060,859,642,174,21,28,14,0,217
1720100Ha08,1753,1329,1119,93,20,54,40,2,210
171670CP006,1469,960,301,24,633,21,1,1,659
1703700DK02,4906,4545,2080,693,1410,49,356,4,2465
17119001905,1030,787,712,12,23,27,11,1,75
17095000601,216,170,161,2,0,4,0,1,9
1720300OL01,1213,974,905,18,17,25,5,0,69
17095000102,712,546,491,27,11,14,0,0,55
1720300WO03,1188,800,769,10,4,5,11,0,31
17095000802,725,553,530,3,3,5,7,1,23
17095000015,1813,1444,1057,128,214,44,12,0,387
17119002001,1221,991,943,9,14,10,6,0,48
1710300DX16,628,525,453,41,11,13,6,0,72
17043005098,1125,812,594,82,20,14,103,2,218
17043003012,853,629,535,37,9,15,31,0,94
17043003096,1020,810,645,48,47,11,50,0,165
1705700FA04,206,164,151,5,1,7,0,0,13
17043007066,599,488,148,53,23,3,258,1,340
17043007063,928,717,312,243,19,20,136,7,405
17043001015,1282,957,711,172,4,16,63,0,246
17043003105,1221,1006,451,41,14,10,492,3,555
1719700DU35,2244,1634,656,496,318,22,152,5,978
1719700DU36,2852,2206,1314,588,176,62,94,7,892
17019SAS000,614,460,418,8,6,20,4,0,42
17043007028,815,637,316,64,17,15,226,0,321
17043003129,1112,867,675,111,21,29,37,0,192
17043003018,1204,937,790,69,11,13,55,2,147
17185000012,486,382,370,2,0,9,0,0,12
17073000805,1108,882,860,5,1,7,8,0,22
17073001301,385,337,335,1,0,0,0,0,2
1711100Mc06,1647,1282,1126,109,6,19,14,0,156
1711100Al43,1725,1344,1064,150,36,20,80,1,280
17043006097,994,835,336,172,212,8,117,0,499
17043006060,850,574,328,57,44,11,129,1,246
17185000013,247,166,165,0,1,0,0,0,1
17043005058,1094,740,648,30,14,6,36,0,92
17043005073,754,594,457,24,14,6,92,1,137
17043001026,1422,1131,639,356,30,22,104,0,492
17043003146,1189,964,708,58,54,15,134,1,256
17043003120,577,429,397,10,5,11,2,0,32
17043002075,524,424,341,35,2,11,42,0,83
17043002078,1134,928,709,96,42,13,66,6,219
17043002003,890,704,542,63,21,5,72,2,162
17043005079,985,777,608,49,19,3,89,0,169
17043005104,1209,1072,798,84,84,13,89,2,274
17043009011,1068,852,678,113,22,13,27,0,174
17163000CS3,939,749,353,37,310,26,35,1,396
171670FC005,1213,927,898,3,4,8,12,0,29
1718300DC10,687,476,231,52,176,14,1,0,245
17019CH1000,290,248,104,32,85,13,16,0,144
1705700CA15,832,660,618,6,8,18,7,0,42
1711100Al26,974,700,457,172,15,38,23,0,243
17083000502,687,565,542,1,2,15,1,3,23
171630ESL12,973,742,7,2,726,6,2,1,735
171630ESL16,715,566,4,4,560,8,1,0,562
171630ESL17,749,603,18,1,579,9,1,0,585
1719700MA04,2561,1758,1558,106,30,27,24,2,200
17101000020,381,278,258,0,5,9,0,0,20
1711100Al38,1201,917,783,94,16,12,20,1,134
1711100Mc20,977,746,598,115,13,24,13,0,148
1711100Nu06,1714,1381,1169,144,14,30,13,0,212
17031040020,2053,1634,733,363,213,13,330,4,901
17031031014,1392,1039,322,628,78,44,34,5,717
17031031033,1227,962,348,523,38,21,55,0,614
17031017002,1259,942,7,13,924,7,8,0,935
17031014015,2728,1947,84,1820,25,135,18,7,1863
1720100Rs06,1356,1080,964,48,11,21,28,0,116
17031800058,1723,1400,1077,67,8,9,239,0,323
17031930026,1834,1486,903,93,33,15,447,0,583
17031930047,1450,1160,917,36,8,8,191,0,243
17001023027,1089,799,737,12,19,16,8,0,62
17043009018,873,662,575,31,10,15,24,1,87
17043009074,1093,937,766,53,60,18,47,0,171
17043003027,659,501,344,31,16,4,103,3,157
17043003033,1011,772,552,105,45,22,43,1,220
17043003032,970,663,592,37,5,2,26,2,71
17043009077,908,676,591,57,1,12,18,0,85
17043009100,1070,828,645,104,10,17,63,1,183
17043004124,485,357,148,40,13,2,154,1,209
17043004053,1728,1329,447,407,278,36,176,0,882
17031042032,2013,1931,1405,168,62,6,290,0,526
17031043009,1377,1073,777,74,108,11,95,2,296
17031037019,1464,1088,18,494,579,33,5,1,1070
17031027029,1193,857,41,425,405,22,0,5,816
17031810013,1954,1449,1073,57,44,15,251,7,376
17119001426,1521,1318,983,36,170,26,96,2,335
17001023038,1181,892,756,25,71,22,4,0,136
17119002214,1289,1023,827,81,80,28,4,0,196
17097Fre123,2444,1875,869,896,37,86,64,0,1006
17107001401,338,251,234,3,2,8,5,0,17
170970Avo28,2532,1806,566,1133,45,102,32,9,1240
170970Ela91,1393,1074,881,81,8,14,92,1,193
17031740030,1339,1049,695,95,29,8,220,0,354
17031740041,991,796,699,22,5,2,62,0,97
17031800013,1731,1546,1136,124,79,15,194,5,410
17031006047,929,696,9,11,670,4,1,0,687
17031024018,1033,769,21,38,711,5,6,1,748
17161000601,1566,1244,1178,23,12,12,6,2,66
17113COB024,1412,1116,961,43,67,24,27,4,155
17031039027,141,101,88,5,2,1,2,0,13
17031030029,1609,1167,151,940,64,72,23,2,1016
17031030016,1113,841,162,596,36,25,48,9,679
17097Wau354,2221,1647,236,899,352,96,152,5,1411
17097Wes391,1510,1083,977,32,11,2,64,0,106
17013000003,454,372,345,1,2,11,2,1,27
1719500PR01,1065,855,795,16,16,15,6,0,60
17031001016,1494,1335,742,435,47,52,109,7,593
17031009010,757,563,0,13,557,2,4,3,563
17031004030,2019,1429,26,32,1357,9,24,1,1403
17031004035,1620,1341,79,40,1110,19,107,1,1262
17031004011,1919,1398,31,19,1328,16,23,2,1367
17031950122,1571,1219,199,93,917,26,10,0,1020
17031830060,1307,1236,1019,24,1,1,187,0,217
17031780030,2227,1745,1081,543,48,44,60,3,664
17031840011,1678,1263,1117,67,11,17,49,0,146
17031800035,1619,1327,865,113,66,9,278,0,462
17031027041,1077,884,63,54,755,8,24,0,821
17031027025,1096,884,235,108,468,13,58,0,649
17031047026,1419,1268,937,142,64,23,104,0,331
17031830025,1492,1131,645,221,34,3,225,0,486
17031800081,1478,1176,453,140,46,28,516,2,723
17031740022,3094,2344,889,878,171,75,403,0,1455
17031740035,3245,2496,1060,886,128,78,410,4,1436
17031003028,784,654,14,37,600,6,6,0,640
17031040009,1566,1270,384,279,224,29,379,2,886
17031047024,1392,1120,887,122,28,19,64,0,233
17031047033,1345,1006,808,97,18,6,80,0,198
17031930014,1485,1158,887,65,30,9,174,4,271
17031830034,901,822,728,8,1,1,75,0,94
17031960080,2619,2121,1134,644,87,50,241,3,987
17031960077,4172,2991,606,1667,53,89,657,3,2385
17031029027,1078,838,7,124,716,15,2,0,831
17113003015,1779,1577,1269,95,121,35,50,0,308
17161000914,1071,794,463,201,112,23,17,0,331
17161000716,1320,1042,800,110,86,10,34,0,242
17161001006,1090,886,730,51,78,14,14,0,156
17031032017,1172,999,687,228,36,24,52,3,312
17161000809,1009,774,617,86,41,12,6,0,157
17043003036,1185,833,774,24,7,4,21,0,59
17031013038,742,562,292,259,3,18,4,0,270
17031710049,989,828,52,43,726,6,4,2,776
1719900CA04,1129,848,762,16,15,18,30,2,86
17031009009,1015,823,3,11,810,9,0,2,820
17031009038,1071,856,2,14,844,5,2,1,854
1710500BP01,142,92,92,0,0,0,0,0,0
1710500AV01,417,302,295,2,1,2,3,0,7
17031980026,2463,1767,98,1637,25,121,10,3,1669
17031980028,3399,2479,161,2174,133,226,12,7,2318
17031950095,906,669,4,61,603,12,0,0,665
17177001701,574,461,447,4,3,3,2,0,14
17043002067,1604,1257,616,294,87,41,251,3,641
17179001812,1138,945,869,25,2,37,8,0,76
17043005106,791,591,540,19,7,4,20,0,51
17031023035,915,754,397,304,34,21,11,0,357
17031039016,1821,1416,476,321,102,22,511,1,940
17031050020,1511,1177,418,319,147,37,275,4,759
17031050021,1324,1014,423,220,150,26,224,4,591
17031950096,1301,953,28,16,909,5,0,1,925
17031900043,1640,1366,74,31,1243,12,22,3,1292
17031830032,1876,1450,1164,35,19,5,216,1,286
17031970096,1817,1602,716,329,488,29,75,0,886
17043008022,1026,809,640,94,25,13,40,2,169
17043005122,747,605,498,26,31,10,44,0,107
17043005017,656,529,425,16,16,5,64,0,104
17043005067,643,488,408,34,13,2,24,0,80
17097Ver284,1809,1456,939,70,20,6,413,2,517
17097Ver285,1959,1491,973,83,11,9,413,0,518
1714300PE07,1446,1070,462,40,557,26,4,0,608
1714300WP02,995,811,607,6,152,25,11,0,204
17031860005,1036,821,685,86,14,8,22,0,136
1719500ST03,1134,823,568,196,30,24,4,3,255
17031024032,540,366,4,10,354,1,1,0,362
17031022010,2512,1848,36,1797,14,147,1,1,1812
17031970069,1711,1320,600,228,459,20,29,3,720
17031019024,654,488,447,33,1,0,5,0,41
17097Shi245,1508,1253,1000,114,55,17,73,1,253
17031001044,1027,918,619,180,40,13,74,0,299
17043003097,860,683,568,42,17,0,57,2,115
17043003090,1053,910,795,39,19,9,43,4,115
17135001802,463,372,347,7,2,7,1,0,25
170970Avo38,2150,1565,832,470,90,39,163,1,733
17097Shi239,1441,1060,906,43,11,3,92,0,154
17097Ver256,2573,1952,807,590,94,35,435,0,1145
17043003016,767,521,451,12,2,5,35,1,70
1718700MN04,881,680,503,103,45,6,20,1,177
17031790046,973,778,665,69,3,6,26,0,113
17031031029,1135,897,114,719,40,27,33,2,783
17031840010,1007,836,742,57,1,2,35,4,94
17097Mor214,1246,957,896,31,11,4,10,1,61
17177001816,1309,1089,964,28,62,12,19,0,125
17031024040,1786,1196,8,54,1147,8,4,1,1188
17031029003,1358,1050,1,44,1008,7,2,0,1049
17161000905,1279,915,265,157,463,36,18,1,650
17161000604,1253,899,209,527,145,41,11,0,690
17097Lak163,2063,1585,1171,162,91,13,143,3,414
17097Gra138,2019,1459,851,342,82,34,159,0,608
17097Mor216,1198,931,788,72,24,16,30,0,143
17179000804,1567,1251,1145,42,18,32,6,0,106
17031003013,1321,1038,564,61,180,15,229,0,474
17031003033,1673,1496,809,130,254,26,291,2,687
17031890091,1268,995,229,340,409,30,37,2,766
1714500PI02,668,556,520,15,4,9,6,0,36
17023001001,460,340,322,2,0,8,4,0,18
17031720065,510,405,5,2,394,1,1,0,400
17031900019,780,765,602,33,107,10,10,1,163
17179000807,1703,1346,1216,32,28,46,7,4,130
17113COB014,878,650,590,2,19,6,26,0,60
17031970018,870,699,632,41,5,7,3,0,67
17179001408,1126,775,725,21,2,10,9,0,50
17031043042,1372,1218,897,84,69,13,146,0,321
17031043036,952,901,727,55,28,5,79,1,174
17031043013,1458,1398,1006,119,80,4,173,2,392
17031960009,2751,2042,703,1007,37,109,281,6,1339
1705300DM04,1017,829,789,12,12,7,7,1,40
17023007001,355,273,259,2,0,12,3,1,14
17031027046,997,869,704,73,27,8,50,2,165
17031960014,1017,758,665,34,15,3,38,0,93
17031930061,2380,1882,1180,169,101,23,420,0,702
17031930007,1723,1366,415,326,60,27,555,0,951
17031007026,626,525,4,8,516,7,5,0,521
17031920006,1520,1144,594,401,101,36,37,1,550
17031024021,598,428,6,29,398,1,0,0,422
17031920010,1452,1040,870,118,10,11,23,1,170
17031048002,465,394,266,40,17,4,66,1,128
17031740025,1105,829,721,23,10,5,64,0,108
1708900KA01,1156,961,864,51,6,19,13,0,97
1708900DU12,1205,843,152,655,20,60,6,3,691
17031038031,1158,953,573,271,29,27,58,0,380
17031002039,1029,978,752,53,65,7,89,0,226
17031002027,1483,1393,954,92,171,9,150,2,439
17031025008,2183,1648,291,1236,102,135,29,5,1357
17031025030,1689,1391,267,1019,61,115,37,0,1124
17031007041,865,662,1,5,657,7,3,1,661
17031018012,870,667,15,70,585,11,4,2,652
17031048023,1111,1034,594,78,116,11,238,1,440
17031026014,1161,828,147,599,69,74,23,4,681
17113COB023,1882,1524,1131,75,286,28,10,0,393
17031013032,755,596,342,236,7,27,6,0,254
17031880017,2739,2129,1759,235,44,17,83,0,370
1710900WG01,458,369,350,4,2,11,4,0,19
17031870003,1038,801,638,32,4,5,114,0,163
17031880020,1882,1536,1172,259,55,12,40,0,364
17031006026,1162,852,16,20,817,4,2,0,836
17031006023,905,648,11,16,620,7,1,1,637
17031034023,656,525,2,7,520,0,1,0,523
17031030001,1467,1192,422,677,49,71,44,0,770
17031031011,1041,795,191,556,29,37,26,0,604
1707500BL02,1091,855,775,35,12,11,5,0,80
17031800019,921,761,516,107,12,23,116,0,245
17031790065,2542,2025,1280,545,94,44,83,1,745
1708900EL05,1377,1037,327,629,53,48,25,5,710
17031046035,1874,1604,720,206,508,14,157,1,884
17031046019,1021,979,706,83,63,9,115,1,273
17031046007,1125,1070,721,100,86,8,138,0,349
1710500WL01,298,218,210,7,1,2,0,0,8
1708900EL26,1560,1113,258,607,218,67,30,3,855
170890AC602,1621,1212,453,513,202,19,43,3,759
17031760021,1019,829,412,56,16,6,343,3,417
17031760039,2552,1984,863,700,83,70,327,2,1121
17031740013,1901,1622,1147,238,62,13,153,1,475
1708700SI01,592,472,450,3,4,10,2,0,22
17031011008,1957,1590,346,430,30,10,787,1,1244
17031754002,1220,1020,698,92,131,19,91,3,322
17031752002,1112,846,401,172,217,23,60,1,445
17031930023,1839,1439,919,200,67,31,235,1,520
1715900OL01,680,516,459,6,10,25,14,0,57
17031021038,1428,981,4,21,957,5,3,0,977
17031021039,1228,853,1,4,846,10,0,0,852
17171000301,253,207,197,4,6,5,3,0,10
17027015003,797,603,507,23,28,27,8,1,96
1707700MK04,964,763,631,23,57,15,40,0,132
17031004014,1405,1208,104,38,896,29,162,4,1104
17097War292,1633,1253,826,125,88,21,186,1,427
17157000501,431,334,318,0,1,3,0,0,16
17031027012,936,875,723,53,36,2,57,2,152
17031028037,1470,1076,30,30,1016,8,2,0,1046
17031011015,850,703,219,82,33,2,370,2,484
17031017037,760,563,0,57,504,4,1,0,563
17031017034,725,531,0,98,436,8,0,0,531
17031026010,1013,864,290,420,156,33,32,2,574
17031037006,1180,936,21,215,710,17,2,0,915
17031930058,1159,858,600,131,16,15,106,0,258
17031930001,4563,3413,1134,1010,182,90,1060,5,2279
17031930015,1532,1190,809,173,37,22,147,4,381
17031740051,1617,1379,1110,139,17,7,98,1,269
17031037001,1269,959,51,55,841,14,5,0,908
17031028041,868,594,5,45,543,2,1,0,589
17031033001,2559,2016,429,1286,97,129,214,1,1587
17031760025,1448,1249,800,156,51,18,231,2,449
1705700CA03,763,581,529,8,16,19,3,0,52
1705700FA02,317,233,224,8,0,1,0,0,9
1705700LS05,385,308,284,4,0,10,0,1,24
17093BR0201,1336,1105,900,105,51,15,34,0,205
17093OS0322,1260,958,747,134,37,14,17,0,211
17201000805,1964,1463,775,377,242,40,44,0,688
17093OS0313,1274,929,614,210,56,20,31,0,315
1719700HO06,1954,1546,1384,98,14,15,40,1,162
17083000407,754,576,537,5,7,13,3,0,39
17093OS0312,635,531,379,113,17,8,15,0,152
17093OS0307,1335,998,654,257,53,29,12,0,344
17093OS0301,734,560,298,175,64,11,15,0,262
1719700DU06,1627,1303,680,208,225,21,174,1,623
1720100Ro35,728,622,443,45,109,16,5,3,179
171670CP009,1126,881,740,18,89,18,10,0,141
171670CP004,1276,1059,630,43,322,16,53,1,429
171670CP003,879,710,247,20,435,8,0,2,463
1711100Mc19,1040,830,734,60,3,23,11,0,96
1710300DX05,542,419,330,38,14,15,19,0,89
17043007006,948,704,538,59,9,9,89,0,166
17043007050,763,602,471,59,13,1,57,0,131
17043009052,1525,1152,571,354,114,36,90,1,581
17043009096,1147,880,715,81,36,7,43,1,165
17043008025,1453,1002,411,461,56,68,60,1,591
1711100Al40,1098,893,758,82,16,18,20,1,135
1710300BK01,266,211,190,12,1,7,2,0,21
17043009089,1350,1035,582,315,79,37,45,0,453
17043002086,935,707,432,81,24,19,165,1,275
17043002049,604,488,342,30,10,4,103,1,146
17043006050,1311,978,412,50,55,6,453,0,566
17043004087,576,403,334,18,2,3,48,0,69
17043004075,875,642,545,15,7,5,65,0,97
17043008017,1066,814,470,307,19,16,14,0,344
17043002096,1674,1190,374,375,163,24,276,0,816
17043002047,807,632,175,72,18,15,373,1,457
17043008018,673,559,476,48,11,10,12,0,83
17043001067,1046,798,378,292,20,23,96,2,420
17119002311,831,664,510,8,135,11,2,0,154
17119000102,1150,901,824,32,7,9,13,0,77
1718300DN11,530,439,388,12,18,18,1,0,51
1709900WA01,575,456,416,22,1,8,2,0,40
1709900MR01,271,220,211,7,2,1,1,0,9
1720300ME04,539,504,482,6,2,11,2,1,22
17043004085,899,670,451,24,16,2,170,1,219
1709900UT02,461,359,310,21,6,13,1,0,49
17043001005,1170,978,758,169,17,11,29,1,220
17043007032,824,674,447,41,24,13,142,0,227
17019CC2100,726,594,509,40,11,9,18,0,85
17019CC0500,4235,4198,1945,610,376,16,1263,2,2253
17073002005,680,475,291,131,51,7,1,0,184
1709900SO01,923,725,645,53,11,5,4,0,80
1711100Al06,1045,843,687,113,5,19,19,4,156
17019CC3200,1553,1240,931,49,149,27,88,0,309
1720100Pe04,1460,1072,977,43,20,18,16,0,95
1709900MN06,1017,806,656,116,10,11,8,1,150
17009000701,163,134,132,1,0,2,0,1,2
1709900VM01,395,309,300,5,0,3,1,0,9
17061001001,188,158,151,0,1,2,1,0,7
17185000007,1141,939,886,20,8,21,8,1,53
17119002003,854,681,658,2,5,5,3,0,23
17009000901,361,284,279,2,0,2,0,1,5
17001011001,192,151,142,6,2,2,0,0,9
17007001010,801,591,266,286,21,32,4,0,325
17001022001,766,610,584,7,11,4,1,0,26
17001020004,656,511,501,0,2,5,3,0,10
17043009026,624,486,425,33,12,2,15,0,61
17043009092,622,462,377,44,10,8,14,0,85
17031026003,1241,1058,814,160,47,15,31,0,244
17031026039,1084,952,604,261,45,31,58,0,348
17031001034,982,865,509,249,36,19,71,0,356
17031001013,909,729,336,323,35,17,30,0,393
17031870021,1897,1562,1150,301,15,42,66,0,412
17031048011,868,731,546,44,22,7,99,0,185
17031960018,1246,996,850,62,9,5,72,1,146
17031038008,1433,1175,651,400,47,17,85,1,524
17031830042,2089,1608,736,646,65,61,157,6,872
17031027023,884,685,19,62,600,7,6,0,666
17085002001,215,167,154,4,1,3,2,1,13
17097Wau378,1562,1111,61,518,510,39,25,3,1050
17031930006,1522,1164,758,199,23,16,178,0,406
1711700SH03,310,234,221,1,1,9,0,0,13
17043002062,873,715,607,26,4,10,65,0,108
17043009121,1053,1011,828,38,54,7,80,0,183
17043009110,582,461,255,19,2,1,177,0,206
17031048019,744,677,462,71,98,13,35,1,215
17031754005,1031,861,575,79,165,23,31,11,286
17031019026,744,574,474,24,77,2,4,0,100
17031870053,1141,937,714,80,21,8,116,1,223
17031870026,1477,1237,1014,88,14,11,109,0,223
17031890055,1092,761,707,24,3,6,15,0,54
17031950002,1035,767,101,268,397,18,2,0,666
1719500FU01,935,731,667,33,6,13,7,0,64
17043006092,708,501,404,19,8,4,64,0,97
17043009076,1058,791,641,51,20,5,69,0,150
17031960021,868,654,567,10,3,2,69,0,87
17161000702,1321,1037,716,177,104,36,22,1,321
17161000718,1460,1125,803,158,89,33,54,0,322
17031033023,1509,1185,674,345,76,40,79,1,511
17031042034,1139,1044,818,56,65,5,104,0,226
17031002043,2178,2068,1663,97,102,23,196,6,405
17031042019,1944,1855,1493,118,62,18,163,4,362
17031043010,1576,1303,1122,67,10,5,103,0,181
17031760011,2558,1936,663,984,142,89,136,0,1273
17043003071,2038,1674,745,141,192,11,566,7,929
1708900AU12,1021,745,255,437,48,25,7,0,490
1708900EL31,1115,842,312,451,48,75,29,2,530
17031001023,1604,1428,898,345,91,21,106,3,530
17031033008,1536,1220,805,239,49,16,124,2,415
17031021003,898,721,3,12,703,9,1,1,718
17031020018,1151,828,11,21,806,5,2,0,817
1719900HE12,1002,791,731,15,10,11,18,1,60
17031890035,1534,1355,983,122,181,17,58,2,372
1710500GM01,66,57,51,3,1,0,0,0,6
17031015022,999,725,6,84,642,19,1,0,719
17031008033,969,792,2,19,768,10,0,0,790
17031023034,1926,1440,95,1322,25,86,7,6,1345
17097Ver278,1264,947,694,32,19,3,200,2,253
17097Ver277,1549,1119,849,44,11,6,208,1,270
17097Shi236,1189,921,593,193,45,22,78,5,328
17043006028,876,669,612,13,7,7,22,0,57
170970Cub66,1221,933,839,27,18,13,34,0,94
170970Cub67,1018,757,666,38,3,10,39,1,91
17043005080,929,859,627,81,45,5,101,0,232
17043006012,738,562,466,22,17,12,42,0,96
17031950013,1410,1039,316,200,498,18,20,3,723
17161001011,1027,834,698,52,37,4,35,0,136
17161000715,797,622,465,85,36,10,24,1,157
1719500ST13,800,622,497,91,21,12,4,0,125
17043001014,1511,1187,530,578,19,78,43,1,657
17043009017,730,538,469,26,4,3,29,0,69
1714500DQ02,465,338,298,3,27,9,3,1,40
1714300LI01,983,776,523,105,121,15,11,1,253
1714300LI02,649,520,476,2,23,11,8,0,44
17113003020,1609,1196,1041,36,59,19,43,0,155
17179000801,1112,851,813,10,3,18,9,0,38
17043003110,1276,1092,829,75,66,7,118,0,263
17043007020,872,663,535,63,11,21,43,2,128
17043007012,813,660,562,47,11,13,34,0,98
17097Fre125,2061,1558,997,370,18,28,161,0,561
1707700MB04,728,605,536,21,12,13,16,0,69
17161000801,1375,1036,413,535,54,31,13,0,623
17191001202,691,568,548,6,1,13,1,0,20
1708900GE14,1026,730,658,38,5,1,25,0,72
17031950067,1400,1108,689,91,292,14,15,1,419
17031960041,2056,1520,1377,59,9,7,66,2,143
17179001405,883,657,612,20,13,5,11,0,45
1708900GE20,1951,1335,1177,57,10,19,65,0,158
17031950078,1415,1098,43,60,1000,4,0,0,1055
17031950070,652,503,36,4,453,3,2,2,467
17031950108,1064,777,24,57,615,5,94,2,753
1708900DU21,2740,1793,170,1558,57,112,17,0,1623
17031050033,957,624,451,82,30,15,47,0,173
17031720025,1974,1546,1022,400,56,50,34,0,524
17031890016,1475,1184,293,496,324,57,53,2,891
17031035020,2120,1673,451,942,85,70,186,2,1222
17031930071,1290,1013,577,59,24,9,342,0,436
17031930012,1740,1304,467,66,29,20,729,1,837
1708900DU23,910,764,457,221,19,25,44,0,307
1708900DU22,1041,848,662,110,32,11,40,0,186
17031810012,1770,1176,1046,39,18,6,60,1,130
17031930031,1998,1560,1058,208,34,22,242,2,502
17031034051,846,694,6,51,635,15,3,3,688
1707700MB12,736,565,519,12,5,16,4,0,46
17031013028,1085,766,114,638,10,28,8,0,652
17043006039,1104,801,537,31,54,10,179,1,264
17043006074,1003,746,368,61,122,6,190,0,378
17031031006,1027,775,131,600,28,60,29,0,644
17031027028,1410,1312,885,121,198,10,107,1,427
17031870039,1922,1623,1242,138,43,24,180,1,381
17031730005,956,771,29,45,688,3,1,0,742
17031019028,972,770,97,12,633,11,19,0,673
17031049017,1952,1835,940,154,289,11,433,1,895
17031970007,1154,955,844,60,13,14,18,2,111
17031860016,1240,1007,801,48,36,9,120,2,206
1708900EL40,1042,759,328,340,57,29,21,5,431
17031970083,1178,904,621,66,159,4,60,0,283
17031710014,1964,1595,549,291,726,37,21,2,1046
17031710044,1436,1149,465,253,408,11,22,0,684
17031780033,1871,1455,565,801,17,72,56,0,890
17031780029,1425,1102,299,619,136,31,46,1,803
17031840009,1166,899,753,82,6,2,46,0,146
17031020014,770,629,18,19,590,7,3,1,611
17031024011,1331,931,10,121,802,14,3,0,921
17031830005,1078,817,569,31,9,7,193,1,248
17031830055,1207,1066,880,58,37,2,86,0,186
17031760012,3566,2449,306,1867,108,106,163,2,2143
17031008018,1722,1339,5,16,1326,11,4,3,1334
17031890086,1268,987,24,154,813,24,4,1,963
1713700SJ03,991,796,729,27,21,6,10,0,67
1713700JK14,864,652,558,13,50,8,18,1,94
17007001015,1506,1131,695,363,30,24,17,2,436
17031790063,1852,1393,1075,89,42,7,176,4,318
17031026008,724,539,93,405,42,28,11,1,446
17031036010,1817,1432,413,889,68,101,84,0,1019
1703300ROB1,1431,1159,1081,16,15,24,19,4,78
17031006019,936,741,0,10,735,3,3,3,741
17031006016,820,658,9,15,637,4,3,1,649
17031720058,1589,1213,959,185,32,23,27,2,254
17031046028,1257,1180,797,132,87,17,142,0,383
17031710019,963,797,325,44,400,3,21,2,472
17007001014,842,629,456,131,21,18,10,1,173
17031043035,1448,1339,1094,87,27,7,104,2,245
17031860031,1178,960,778,82,40,11,48,0,182
17031970094,1934,1485,1025,380,52,49,19,0,460
17031970092,1529,1140,750,277,70,39,39,1,390
17031034021,748,639,4,11,625,5,0,0,635
17031890025,1566,1151,944,135,30,19,31,0,207
17031758004,1336,1041,579,143,258,28,52,2,462
17031720049,880,654,10,9,632,3,0,0,644
17031860054,1924,1452,1215,108,20,17,91,0,237
17031870035,1150,828,668,45,13,4,95,1,160
17031880024,853,694,642,30,5,8,8,0,52
1708900EL44,1740,1252,444,727,49,99,30,1,808
17031004027,1988,1701,604,101,758,31,227,4,1097
17031780028,1332,1058,539,451,16,20,47,2,519
17031790024,982,666,619,19,4,6,21,1,47
17031970051,1229,955,780,106,36,11,12,3,175
17031910003,1408,1111,700,102,188,2,123,2,411
17031740047,1406,1240,1030,81,12,19,95,3,210
17031048025,791,673,519,73,27,8,40,0,154
17031005003,1619,1437,662,111,290,27,357,2,775
17031940005,2719,2078,1255,619,37,76,136,0,823
17031930018,1653,1304,538,259,130,17,368,1,766
17031021014,785,627,0,10,615,1,0,1,627
17031021008,1149,933,2,13,909,5,0,0,931
17169000301,297,236,224,4,2,5,0,0,12
17141000048,765,608,548,11,15,16,7,2,60
171670CP043,1096,860,653,32,141,14,15,0,207
171670CP096,1060,845,713,21,89,9,12,2,132
17043003138,1213,986,585,105,55,3,234,1,401
171670CP046,1003,789,660,14,85,12,9,5,129
17201000404,1360,1106,875,90,67,16,53,0,231
17201000406,1152,958,785,52,61,12,48,0,173
1703700SA03,1754,1324,994,280,23,33,13,3,330
17119001324,1428,1246,1056,25,77,8,68,1,190
17119002404,998,823,732,28,37,12,12,0,91
17119002414,1348,1087,976,33,35,22,13,3,111
1706300SA04,1875,1338,1149,114,22,21,25,5,189
17131000601,758,601,558,17,2,16,2,2,43
1720300WO07,861,659,606,9,9,13,10,0,53
17011014003,894,650,265,351,11,36,13,0,385
17043007059,951,734,610,61,16,17,36,0,124
17043003156,544,426,341,15,6,2,66,0,85
17043003123,543,454,410,12,11,0,18,0,44
1711100Do04,1365,1049,710,291,14,40,10,0,339
17043007046,1005,756,464,49,10,4,227,1,292
17043007013,1256,982,723,64,31,1,162,1,259
17043007052,817,621,469,33,9,5,93,0,152
17043009062,1786,1548,853,122,144,6,406,1,695
17043006089,1020,735,241,65,71,10,350,0,494
17043006030,614,444,270,13,18,3,129,1,174
17043009003,890,684,359,24,12,9,276,0,325
17043006016,699,514,450,11,9,5,31,1,64
17043006094,914,796,623,80,40,4,51,0,173
17043009043,703,575,461,52,25,10,28,0,114
17043009101,731,571,480,54,6,15,12,0,91
17043005101,1159,916,439,135,136,17,198,2,477
17043005049,916,650,489,44,12,4,96,0,161
17043004098,1394,1046,760,43,24,10,195,0,286
1711100Ch01,1463,1062,604,404,25,26,22,0,458
1711100Gr29,1828,1179,939,122,10,20,90,0,240
17073002010,820,597,491,67,24,8,7,1,106
1711100Gr13,2165,1606,1264,190,43,24,85,1,342
17121002001,352,285,265,3,0,11,2,1,20
17031760006,1994,1514,714,705,43,85,32,2,800
17201001406,1748,1302,709,247,226,52,60,2,593
17031026019,1462,1055,46,743,288,40,5,2,1009
17031045006,1364,1074,753,196,40,17,85,1,321
1702900CH15,685,633,384,126,75,3,15,5,249
17043004058,1362,1030,686,77,23,6,231,0,344
17043004084,701,529,440,37,12,2,37,0,89
17031756005,1545,1222,1043,56,40,4,66,1,179
17031800087,850,643,533,37,6,6,50,1,110
17031004019,1063,648,2,7,634,4,11,2,646
17031031010,1347,1069,268,672,84,52,51,0,801
17119002107,1131,836,118,33,678,16,1,1,718
1702900MT13,1173,898,814,22,25,30,6,0,84
17001004001,186,136,132,2,0,0,0,0,4
17113COB033,1257,980,845,40,52,18,22,0,135
17097Shi230,1543,1139,112,712,299,44,20,3,1027
170970Avo35,1455,1014,831,62,50,10,55,0,183
17031830058,712,572,486,7,0,3,77,0,86
17031800055,1398,1165,881,146,16,22,113,0,284
17031027048,2284,1880,885,92,695,18,201,4,995
17031960085,1260,955,728,65,19,6,144,0,227
17031960075,1518,1149,913,68,14,8,143,1,236
17031023019,1762,1248,66,1089,93,39,11,0,1182
17031023031,1355,1022,60,913,38,81,12,3,962
17031038026,1502,1305,893,248,38,14,127,2,412
17031038015,1224,981,511,364,25,45,79,4,470
17031046004,1101,958,517,122,146,28,156,0,441
17031046008,1033,868,306,102,363,18,86,1,562
17031040017,1109,861,478,135,53,23,191,4,383
17031040034,1314,1080,561,161,40,14,305,1,519
17031046036,1055,1017,712,93,59,13,139,2,305
17031048027,3209,3005,1621,335,413,29,587,4,1384
17031800052,1212,927,751,50,6,13,105,0,176
17031890066,1565,1423,838,89,368,16,99,0,585
17031753002,1607,1355,1039,89,99,18,115,3,316
17031960050,1504,1196,523,570,9,43,87,0,673
1718900JH01,500,406,390,7,1,6,3,0,16
1707500MD04,576,460,386,25,10,35,3,2,74
17097Zio407,1658,1136,261,392,435,59,29,3,875
17031870034,1548,1203,903,35,20,13,227,0,300
17031960079,2233,1785,869,292,65,40,540,1,916
17031870065,1245,913,527,24,11,7,346,2,386
17031030013,1420,1127,244,733,52,42,109,1,883
17161000903,1124,732,147,109,452,32,17,3,585
17031005031,1337,996,10,13,967,20,4,3,986
17031810028,1259,897,743,26,9,6,110,1,154
17031830035,1484,1024,852,30,13,3,109,1,172
17031860004,1070,825,672,81,17,16,45,1,153
17097Lib178,1326,1048,841,109,31,12,54,0,207
17097Gra140,1474,1059,650,212,70,16,102,3,409
17031011026,1329,1137,601,239,22,22,264,2,536
17031026044,967,736,31,620,90,28,16,1,705
17031950085,1276,1050,134,79,830,16,9,1,916
17031003034,2009,1856,943,111,432,40,338,1,913
17031038025,1254,1034,610,286,23,7,114,0,424
17043003037,1218,830,700,22,6,0,90,1,130
17113003026,713,557,508,14,8,6,13,2,49
17097Wes401,1208,1070,960,22,9,4,68,0,110
170970Ela97,1382,1030,834,51,11,9,130,0,196
1714300PE06,937,710,200,91,403,12,2,1,510
17031860026,1327,1001,815,108,22,10,32,1,186
17031006005,1198,805,2,50,749,19,1,2,803
17031018002,1578,1136,98,854,174,50,7,0,1038
17031018015,1755,1331,174,752,398,52,6,3,1157
17097War309,1502,1109,708,90,48,8,250,0,401
17097Ver273,1932,1411,957,46,10,10,390,0,454
17043003053,852,645,554,39,6,1,37,0,91
17043003006,826,555,457,15,6,7,70,0,98
17031033006,1621,1263,419,654,72,67,115,4,844
170970Cub68,950,891,799,33,10,10,26,1,92
17179001203,1523,1101,1016,18,22,22,10,0,85
17113003001,1515,1313,976,85,167,22,55,1,337
171630000B4,1096,835,617,20,173,20,5,5,218
17179001801,863,638,595,7,9,11,6,0,43
17113COB015,1808,1346,754,132,291,16,166,0,592
17113COB039,1174,881,702,34,79,11,48,0,179
17113COB049,1029,705,531,23,23,5,123,0,174
1714300PE70,1389,1117,778,52,162,7,113,3,339
17031024001,1009,767,15,70,684,9,2,1,752
17031019040,814,673,392,36,231,7,2,0,281
17031800072,1173,910,754,76,5,14,65,1,156
17031002033,1005,958,835,34,33,12,42,0,123
17031991003,2320,1739,472,1152,59,74,49,0,1267
17031011004,1847,1502,280,341,28,16,857,0,1222
1708900DU34,2271,1863,1326,177,71,10,262,2,537
1708900SC13,952,696,438,195,20,22,24,0,258
17031996004,2665,1926,331,1242,298,98,54,2,1595
17031996003,2260,1720,378,918,358,70,69,3,1342
17031045001,762,604,378,162,25,12,38,1,226
17031950025,1200,930,595,71,240,7,18,1,335
17031850019,1783,1627,1013,140,310,15,161,5,614
17031970011,1479,1140,882,167,51,21,25,2,258
17031013039,1135,814,102,699,10,31,8,7,712
17031019004,1112,803,704,67,24,10,3,1,99
17031042031,1727,1592,1127,107,65,14,269,0,465
17031042011,1091,947,637,62,56,20,175,0,310
17031830002,1253,848,749,21,6,1,61,0,99
17031024002,1360,873,8,35,827,4,4,0,865
17031029002,1520,1182,5,45,1133,5,0,1,1177
17031013005,1518,1104,143,933,20,78,8,1,961
17031950068,1651,1291,448,184,644,24,17,2,843
17031940019,1734,1345,500,752,63,55,26,1,845
17031024025,1005,704,13,44,646,5,2,0,691
17031830017,1212,896,708,34,27,12,119,0,188
17031830014,1194,924,642,25,9,8,236,0,282
17031900012,1624,1241,241,94,898,25,9,1,1000
17031810006,895,643,587,14,5,5,19,1,56
17031850020,2316,2043,1333,171,302,30,227,1,710
17031029042,1611,1167,3,50,1120,9,3,0,1164
1717300PI01,168,141,139,0,0,2,0,0,2
17031024005,752,529,2,16,506,14,0,0,527
1707700CB11,1020,918,465,47,263,30,123,0,453
17171000601,199,153,146,2,2,5,1,1,7
17031044019,1646,1492,1137,90,88,13,152,1,355
17031044015,1219,1124,870,86,78,8,93,1,254
17031007024,1103,815,6,69,747,9,0,0,809
1708900BA04,1135,854,712,77,27,7,24,1,142
17031007042,748,587,0,18,569,6,0,0,587
17031042038,1268,1172,913,75,24,10,141,0,259
17031002040,2316,2204,1555,141,156,18,316,3,649
17031008055,710,610,5,6,600,5,0,0,605
17031790015,1405,1012,915,42,16,8,23,3,97
17031005038,1548,1183,18,14,1157,8,4,0,1165
17031740009,1329,1199,1032,72,11,6,74,1,167
17129000001,692,539,514,2,2,11,6,1,25
17129000002,788,575,556,1,1,11,1,0,19
1719700DU26,2486,1748,627,739,310,77,64,2,1121
17093OS0314,946,656,290,314,36,14,8,0,366
17141000030,1004,796,759,15,1,9,0,0,37
17093BR0208,878,611,510,68,13,0,6,0,101
17093OS0317,677,542,457,50,18,8,15,0,85
1711100Do08,1205,996,736,170,40,23,25,0,260
17043009012,837,655,518,68,29,7,32,0,137
17043002092,693,618,499,14,2,5,90,0,119
1711100Nu05,1086,824,614,165,18,12,6,0,210
17043003002,876,669,611,21,9,4,21,2,58
17043001024,407,348,284,49,7,6,11,0,64
17043003141,458,404,266,20,12,5,103,0,138
17119001402,1029,852,707,10,104,17,11,1,145
1706300FE03,1099,828,724,48,17,31,3,3,104
1706300SA01,1363,1101,860,126,51,24,26,1,241
17127000008,696,536,487,4,34,5,1,1,49
1709900OT05,862,674,551,88,15,22,0,0,123
1709900OT11,1010,774,609,88,16,37,13,0,165
17119002103,255,187,14,8,165,1,0,0,173
17119002323,816,644,297,6,319,13,4,0,347
17119002322,746,509,189,4,305,6,2,0,320
1718300DN03,896,664,624,12,20,8,2,0,40
17059000301,765,606,587,4,4,16,5,3,19
17043009008,891,608,544,27,10,3,18,0,64
17043003100,1271,1084,762,83,99,1,132,3,322
17019CC2000,1145,944,837,37,19,18,30,1,107
1709900SO03,733,570,477,41,21,15,14,0,93
17043006047,1132,876,570,29,39,14,224,9,306
1719700FR10,2131,1612,1199,150,113,13,132,1,413
17019CN2100,1663,1479,650,50,389,15,375,1,829
1715100GOL2,685,581,557,5,7,8,2,1,24
1720100SH01,963,806,770,11,2,7,4,0,36
1711100GR03,478,373,309,47,5,7,4,0,64
17163000SK8,536,427,253,12,136,10,6,0,174
17121016001,1126,888,862,7,1,8,4,1,26
17201000102,1257,973,775,99,54,11,42,1,198
17201000403,1165,927,704,111,64,17,32,0,223
1720100Rt10,1271,983,874,40,12,22,19,1,109
1709900MA02,1235,971,862,42,13,33,9,0,109
1711100Gr09,1146,865,657,128,31,22,32,1,208
1711100Al25,856,684,573,60,8,35,10,0,111
17119002407,1181,969,862,16,38,24,18,1,107
1707900SW01,413,311,302,1,0,3,0,0,9
1707900WA04,707,558,524,10,2,10,3,1,34
17177001817,1506,1251,1016,40,155,8,18,0,235
17031024026,1527,1111,10,41,1065,10,6,4,1101
17031950011,1185,834,87,175,572,11,1,0,747
17007001019,1076,807,736,26,9,6,22,1,71
17007001001,1027,829,577,211,22,30,7,3,252
17043003052,806,616,540,39,16,6,13,0,76
17043003145,911,676,595,32,11,5,27,1,81
17043004068,472,345,243,10,16,2,73,0,102
17001023028,981,792,742,3,19,9,13,0,50
17031037022,1546,1189,30,695,473,53,2,1,1159
17031017020,1049,863,6,17,832,16,10,1,857
17031810023,1368,961,865,30,13,8,45,0,96
17031032032,1360,1074,808,137,26,10,87,1,266
17031760029,2308,1602,311,988,197,63,106,1,1291
17001023030,636,570,538,2,11,8,5,0,32
17031930067,1841,1442,993,103,59,10,269,0,449
17031830062,1372,998,826,26,8,9,131,0,172
17031830029,1159,793,692,23,0,1,72,2,101
17031030030,981,735,84,613,44,37,12,0,651
17031740021,2170,1740,807,407,119,17,403,4,933
17031820004,1616,1244,618,124,29,14,474,0,626
17031042004,4161,3878,2495,199,285,28,842,4,1383
17043008010,932,712,625,35,9,16,18,3,87
17043003038,1056,718,614,18,8,8,60,2,104
17043009116,1040,942,791,51,35,5,63,1,151
17043009071,628,467,394,34,4,5,29,0,73
17031026041,1308,1059,332,534,184,28,25,4,727
17031026002,929,723,166,393,158,25,32,0,557
17031850009,919,666,429,57,124,5,48,2,237
17031019036,1332,1143,330,33,758,17,15,5,813
17031790002,1087,852,560,210,38,20,26,0,292
17031720044,970,760,62,126,568,12,4,0,698
17031023021,828,651,418,209,8,17,13,0,233
17031720001,1329,1010,44,266,697,14,6,0,966
17031759001,1202,950,535,119,223,21,71,1,415
17031780018,1149,907,485,367,10,40,48,0,422
17031820050,2043,1601,871,137,35,7,554,2,730
17031030008,1588,1307,566,640,42,45,50,2,741
17031043012,834,797,658,31,12,0,91,0,139
17031026005,945,758,214,400,154,26,13,1,544
17031047048,117,101,47,37,12,4,2,0,54
17031820043,2426,1936,1289,150,61,19,430,0,647
17031960038,2031,1663,1257,257,22,46,113,2,406
17031005036,1267,1036,9,14,1013,10,7,1,1027
17031820051,1174,929,453,70,13,8,390,2,476
17031047032,1256,1150,829,161,33,29,101,1,321
17043003113,759,647,424,66,64,5,90,1,223
17043003142,1359,1189,864,96,99,1,120,0,325
17031049031,1228,1010,384,160,393,34,54,3,626
17031050006,1857,1512,644,287,331,32,236,4,868
17031050009,1366,995,419,200,136,13,233,1,576
17031890051,1424,1161,628,284,190,28,53,0,533
17031890075,1485,1114,856,147,60,30,37,2,258
17031790037,1245,984,432,498,19,44,17,1,552
17031992003,1970,1477,409,971,58,76,33,1,1068
17177000101,252,204,192,10,1,2,0,0,12
17031910005,1008,747,580,62,60,7,37,0,167
17031910004,1485,1024,793,79,83,13,55,1,231
17031790013,1123,809,53,67,694,3,2,0,756
17043006077,847,599,446,35,27,3,82,0,153
17043006058,701,553,358,47,49,6,99,0,195
17043001019,2076,1582,541,939,26,65,65,0,1041
17097Mor212,1687,1332,1117,144,10,8,60,0,215
17043004114,1597,1252,506,174,224,16,329,3,746
17043002063,1002,769,311,219,45,16,191,0,458
17043006019,912,718,539,31,34,13,95,0,179
17031940006,2793,2154,1318,718,54,71,32,4,836
17031031023,1317,1018,279,685,20,18,29,0,739
17031960048,1254,1021,650,118,28,20,204,0,371
17031006015,1611,1144,20,44,1075,12,2,0,1124
17179000201,1203,977,935,6,4,17,5,2,42
1714300PE41,990,707,339,82,267,27,9,0,368
17113003021,1165,909,638,39,192,15,19,2,271
17113003017,2452,1795,1195,125,352,38,82,6,600
1708900SC05,1704,1378,1138,118,41,42,32,1,240
17031950089,1555,1169,96,61,994,7,20,3,1073
17031710048,880,660,182,43,416,5,23,2,478
17031720048,1097,755,54,34,668,10,9,1,701
17031005035,1770,1598,672,116,461,31,338,1,926
1708900EL57,2169,1697,985,427,95,64,165,0,712
17031021051,902,734,4,11,728,8,0,0,730
17031018040,1441,1094,151,690,241,25,10,0,943
17031013047,1642,1159,71,1053,21,68,12,3,1088
17031890099,1347,1070,48,335,683,16,11,0,1022
17031035019,1864,1387,91,1209,79,104,23,3,1296
17031040025,1207,1025,686,186,52,17,90,1,339
17031018016,820,641,17,60,566,8,1,0,624
17031995002,1867,1425,299,868,236,66,42,2,1126
1714300PE20,881,683,559,20,52,16,35,0,124
17031009019,792,627,2,8,611,7,3,1,625
17031019051,889,659,569,37,39,4,6,0,90
17031870068,1347,986,573,14,7,5,387,0,413
17031040039,907,701,175,223,118,16,183,0,526
17031960027,2257,1955,1439,225,54,18,235,1,516
17031021016,939,777,7,22,748,18,0,0,770
1708900BA03,1765,1370,1037,207,57,23,53,1,333
1708900GE09,1195,944,798,99,10,22,15,0,146
17031050028,2220,1750,429,317,468,20,527,6,1321
17031050035,1669,1281,446,197,412,34,218,2,835
17031740052,1942,1346,341,929,21,87,64,2,1005
17115508008,1151,985,881,29,42,21,9,1,104
17031860032,1071,824,687,95,12,1,22,1,137
17031022025,2723,1969,27,1923,24,132,9,2,1942
17031022009,2512,1758,18,1717,17,100,3,0,1740
17115501066,883,722,507,10,166,20,15,1,215
1708700LA02,396,341,305,8,3,19,2,0,36
17031019054,848,603,524,42,13,4,2,0,79
17031002010,1019,949,710,45,17,9,166,1,239
17031860044,1097,896,783,51,15,19,28,0,113
17031001008,1303,1190,734,207,166,17,72,2,456
17031002024,1463,1234,911,99,110,1,105,2,323
17017000719,68,51,48,1,0,3,0,0,3
17031800091,2171,1712,1397,130,26,17,152,0,315
17031036002,2148,1598,102,1311,139,90,54,1,1496
17031040036,963,826,440,194,119,16,80,1,386
17031870014,1344,1140,901,78,17,17,108,1,239
17031035016,1461,1092,30,997,51,97,20,2,1062
17031720028,1430,1055,538,352,131,40,20,1,517
17031008023,877,652,2,17,636,9,3,1,650
17031025009,1763,1426,264,981,121,143,61,3,1162
17031008012,743,612,5,5,599,2,0,0,607
1713700JK12,928,760,701,14,14,15,8,4,59
17031993005,1750,1419,711,497,151,36,53,2,708
17031710017,1234,896,132,36,723,12,5,9,764
17031970065,1707,1351,1225,74,8,18,18,1,126
17031860030,897,770,683,33,22,2,24,0,87
1708900BA08,1380,1065,936,68,19,19,26,1,129
17163000CT5,1135,872,258,21,582,14,0,0,614
17031044013,1260,1043,889,68,15,3,54,1,154
17031043021,1650,1447,1180,71,39,12,144,0,267
17031001020,1066,901,511,287,77,16,29,0,390
17031870006,1787,1510,1075,186,39,30,195,2,435
17031960090,1371,1128,901,43,10,14,157,1,227
17031007012,1649,1221,9,27,1184,10,8,0,1212
17031950047,1238,936,356,164,401,12,16,2,580
17031004024,1222,942,211,50,638,13,53,0,731
17031800045,909,718,234,94,25,13,359,0,484
17031970074,1001,770,573,134,13,13,42,6,197
17031970047,998,802,573,186,25,17,6,3,229
17031720080,995,744,23,15,700,3,7,1,721
17031950064,775,713,14,8,694,5,0,2,699
17031044008,1938,1835,1360,139,102,18,221,3,475
17031044023,1460,1372,1019,104,77,17,161,6,353
17031025025,1647,1412,579,152,52,12,586,1,833
1705700BK02,612,477,445,6,3,19,2,0,32
1719700HO11,2138,1645,1464,99,8,9,40,0,181
17141000039,718,560,520,26,4,7,2,1,40
171670CP001,715,591,481,15,80,17,4,0,110
17201000401,1428,1175,923,83,96,7,61,0,252
17201000402,1699,1364,940,120,188,28,91,2,424
171670CP011,880,710,578,22,89,13,5,0,132
1711100Mc26,756,660,608,35,0,11,6,0,52
17119002405,1076,879,818,16,22,3,7,0,61
1703700DK04,4809,3320,1083,423,1620,62,159,2,2237
17043009079,558,439,339,36,6,1,54,0,100
1718300GT08,767,601,593,0,4,4,0,0,8
17043006009,777,606,455,16,26,2,97,0,151
17043006042,1118,887,628,70,90,12,88,0,259
17043006081,795,595,466,28,28,9,62,1,129
17083000409,577,476,446,6,0,14,5,0,30
17043009078,1002,778,561,106,44,17,49,3,217
17043001004,1062,762,643,64,10,5,42,3,119
1715100JFSN,376,307,292,3,6,6,1,0,15
1711100GR04,4495,2913,2220,283,112,35,263,1,693
17031930020,964,740,540,42,10,5,142,2,200
17031026047,1193,908,65,785,57,54,7,1,843
1720100Ha16,1177,936,724,84,87,22,24,0,212
17031960058,1511,1241,975,50,38,4,167,0,266
17043001012,1600,1321,743,501,19,22,49,0,578
17043001058,693,574,453,75,5,7,33,0,121
17043006013,1000,748,638,49,13,7,38,0,110
17031050037,1573,1219,477,336,174,28,227,2,742
17031001022,956,800,394,286,59,16,61,6,406
17031001030,1687,1426,616,597,138,60,76,3,810
17031027020,1620,908,41,13,848,7,4,0,867
17119002401,1291,1025,870,9,119,14,8,0,155
17007001004,1621,1208,621,518,28,38,20,2,587
1702900CH17,344,323,163,60,94,0,9,2,160
17001003001,756,562,536,8,2,8,1,0,26
17097Zio406,1980,1498,463,464,436,46,123,4,1035
17031790072,1479,1019,924,45,18,3,19,0,95
17031790025,1366,1076,797,198,34,23,37,0,279
17031046030,1321,1205,645,240,225,27,81,0,560
17031046031,1360,1267,914,141,77,14,136,3,353
1717300SH03,621,490,461,12,3,4,7,0,29
17031870042,1635,1398,1062,109,35,16,175,0,336
17031048046,790,751,394,60,95,13,186,0,357
17031048015,1690,1579,875,181,208,21,277,3,704
17031980003,2490,1902,207,1469,221,76,12,0,1695
17031032019,1373,1032,705,179,41,13,99,9,327
17031044007,834,795,609,49,24,6,110,0,186
17031047006,1528,1314,1026,152,33,24,93,0,288
17031047043,1073,864,696,70,11,9,77,0,168
17031820044,1953,1520,656,165,103,37,584,7,864
17031760043,2251,1754,800,600,76,45,264,1,954
17031930075,1027,809,631,44,9,12,105,1,178
17031930013,1069,825,607,83,11,5,119,0,218
17031930050,1127,891,627,53,23,13,165,21,264
17031870045,1026,796,647,48,18,8,77,0,149
17161001012,1286,1077,912,48,67,8,43,2,165
1701500SA04,673,552,490,33,14,16,2,0,62
17031013045,1298,982,322,607,30,29,15,0,660
17031830015,974,742,604,18,14,7,89,0,138
17031800044,930,652,537,37,9,8,66,0,115
17043002002,626,462,327,41,11,12,77,0,135
17043002071,1071,877,643,26,20,7,177,0,234
17043002102,1403,1202,672,228,136,4,162,0,530
17113COB003,1109,806,688,19,32,8,59,2,118
17031028020,1128,856,43,50,765,7,11,0,813
17031820011,810,571,460,47,6,2,47,0,111
17031710033,879,673,141,31,500,3,1,0,532
17007006002,943,780,701,48,8,18,8,0,79
1703900BA01,396,328,314,8,2,3,3,2,14
17031011038,702,614,240,248,61,28,56,0,374
17031880025,2132,1407,1096,101,46,15,143,0,311
17031049002,893,773,446,136,112,16,79,1,327
17031007029,868,678,7,29,634,4,2,0,671
17031021042,961,788,0,18,775,11,2,0,788
17043003115,968,757,552,61,3,8,139,1,205
17161000812,703,542,374,110,36,15,6,1,168
17031790034,711,560,415,99,15,9,16,2,145
17043002044,636,476,312,30,3,0,130,0,164
17043002056,801,583,455,17,6,2,100,0,128
17043003106,853,697,605,45,12,2,34,0,92
17043004044,744,553,471,26,7,2,45,0,82
17097War310,1667,1297,931,105,51,26,196,4,366
17031820047,861,647,388,35,74,3,151,0,259
17097Zio408,1983,1330,200,583,494,93,52,9,1130
1714300PE05,967,662,165,118,361,16,3,2,497
17179001818,1479,1026,982,4,5,21,7,0,44
170890AC509,1145,885,411,354,115,23,15,1,474
17031017018,814,670,4,16,646,2,4,1,666
1714300PE67,974,747,414,39,197,12,97,0,333
17031830022,1313,1065,850,30,10,6,171,0,215
17031850008,1316,974,475,76,365,15,58,1,499
17031870012,1311,1166,888,38,30,9,202,0,278
17031710005,958,761,338,153,269,10,7,0,423
17179000206,1239,948,922,4,1,7,8,0,26
17031970001,1119,830,595,196,15,21,21,0,235
17031019045,921,682,565,54,49,12,5,1,117
17031970077,1399,1135,824,170,109,13,17,3,311
17031890034,1777,1453,158,142,1138,26,16,0,1295
17031039036,437,381,173,48,44,7,121,1,208
17031930025,2217,1785,984,135,77,16,570,2,801
17031046033,1173,1098,846,128,44,10,77,0,252
17031024013,827,569,20,43,504,9,2,0,549
170890AC410,1624,1141,314,670,111,49,43,0,827
17031005032,1133,1043,43,21,971,4,17,2,1000
1708900DU05,1240,859,197,612,21,47,14,3,662
17031013014,1411,1047,199,823,9,65,14,0,848
17031880028,2024,1640,884,147,559,4,45,0,756
17031044038,1864,1717,1399,119,85,10,112,1,318
17031720066,708,585,5,17,569,3,4,1,580
17031780025,2012,1597,1093,370,33,33,102,1,504
17031003036,758,611,5,43,557,3,1,1,606
17031043044,1411,1162,952,71,28,19,90,1,210
17031740015,1530,1215,756,181,33,27,222,2,459
17031002011,1310,1200,873,65,47,3,200,0,327
17031021035,852,701,0,18,693,1,1,0,701
17031996001,1261,903,191,593,112,28,16,2,712
1711100Nu18,899,686,598,37,7,9,22,0,88
17043009091,609,428,366,29,7,1,17,0,62
1718300DC32,776,626,456,22,126,9,11,1,170
17043005110,984,761,578,53,41,9,84,1,183
17043005033,826,651,501,49,37,2,63,0,150
17127000004,828,624,526,2,78,9,8,1,98
17043007060,854,662,300,65,26,11,261,0,362
17119001921,1257,1038,933,17,45,32,8,0,105
1720300EP01,843,652,624,5,9,6,3,0,28
1711100Al33,1374,1138,1017,67,16,9,23,1,121
1719700FR20,2240,1698,1417,170,59,22,24,1,281
1709900SO04,810,633,577,35,8,17,1,0,56
1711100Nu23,957,760,584,139,2,13,19,1,176
171630000B2,1819,1387,830,35,449,26,47,2,557
1709900OT06,573,449,388,34,7,17,8,2,61
1702900CH11,1000,790,710,22,27,12,16,4,80
17019CC1500,1477,1171,779,77,190,22,98,0,392
17009000101,102,78,75,1,0,1,1,1,3
1714300PE25,1006,768,342,55,344,19,13,0,426
17031780002,1596,1325,783,423,34,33,81,0,542
17115508007,1219,999,846,28,92,15,17,2,153
17043003064,926,719,603,49,32,5,33,0,116
17031840012,1643,1383,940,203,22,16,200,1,443
17043004095,750,583,513,23,4,2,32,0,70
17031960044,1724,1371,1098,83,18,18,159,0,273
17031930021,1956,1478,1116,153,53,16,141,2,362
17031930024,1643,1254,969,89,30,11,151,0,285
17031031020,1327,969,123,757,72,31,14,1,846
17031043020,1524,1350,1094,71,35,10,135,4,256
17031043017,1143,939,767,47,23,6,87,2,172
17031038013,1505,1249,785,332,28,21,94,2,464
17043004121,520,397,301,12,0,2,81,0,96
17043004120,800,586,523,20,9,8,33,0,63
17043004067,809,624,463,25,8,6,117,0,161
1705300DM01,645,504,463,15,2,9,11,0,41
17031759003,1821,1485,979,99,218,15,175,1,506
17031890057,1223,977,526,198,191,28,49,0,451
17031890077,919,760,398,191,114,13,52,0,362
17031045004,1338,1066,703,232,43,21,90,5,363
17031830036,1030,773,606,23,11,4,133,0,167
17177001818,1303,1166,946,30,145,20,24,2,220
17031860035,1489,1134,979,76,25,15,41,0,155
17031720073,1848,1485,1041,178,190,17,62,0,444
17043006014,868,703,453,80,56,13,97,0,250
17161001005,1423,1106,783,105,172,14,37,1,323
17161001008,1204,920,759,58,73,14,9,0,161
17115501028,1068,854,674,17,139,14,13,0,180
17031022005,2194,1600,31,1548,19,84,8,0,1569
17031960065,1676,1316,1069,82,13,12,152,0,247
17191000905,514,412,391,4,1,9,3,0,21
17031880002,856,762,690,47,12,4,10,0,72
17031019014,1137,966,518,48,375,17,9,0,448
1714300PE89,938,712,638,16,14,5,37,0,74
17031870050,1937,1531,1173,66,30,5,250,1,358
17031760003,1519,1106,262,731,56,66,53,8,844
1708900EL15,1079,866,494,288,47,25,29,0,372
1714300RI03,1423,1198,998,34,111,15,33,1,200
1714300PE45,742,642,554,13,56,8,10,0,88
17031800080,1114,943,836,41,5,1,58,0,107
17031910008,1697,1200,926,80,76,12,96,2,274
1708900EL34,1341,1000,273,646,54,29,27,3,727
17031049027,1733,1512,650,195,494,21,135,3,862
17031970052,862,640,484,78,61,4,12,0,156
17031003039,2620,2360,1242,193,282,37,608,1,1118
17031003022,2033,1812,934,158,238,19,476,2,878
17031003032,2675,2505,1201,199,500,28,583,1,1304
17031930053,1270,979,722,79,26,17,130,0,257
17027012001,1234,961,927,12,2,13,3,0,34
17027001002,376,287,278,3,1,5,0,0,9
17031019023,858,636,571,27,29,5,6,0,65
17031790061,1102,936,847,53,5,10,30,0,89
1713700JK16,650,493,466,4,8,9,5,0,27
17031820025,943,754,413,44,45,2,252,2,341
17031009006,685,543,0,11,533,4,1,2,543
17031900011,1238,925,371,64,491,11,8,0,554
17031930069,1037,822,649,26,2,10,135,0,173
17031047018,1220,1041,771,113,69,14,67,1,270
17031800050,1159,855,752,50,7,9,41,1,103
17031720042,1858,1442,1141,188,50,37,27,1,301
17031970085,1391,1071,783,215,37,31,21,7,288
17031970053,1765,1383,995,313,37,31,20,0,388
17031970048,1029,853,575,140,119,10,30,0,278
17031950086,876,687,27,23,633,7,1,0,660
17031740014,1970,1670,1377,89,28,8,176,1,293
17031950098,766,583,28,106,326,17,123,1,555
171670CP080,1051,862,715,21,87,13,21,1,147
17043005068,924,678,542,62,29,10,34,2,136
17043005078,956,804,544,68,94,9,89,2,260
17043007018,682,534,323,55,32,9,109,0,211
17043003034,984,772,713,22,2,12,19,1,59
1711100Al47,1424,1116,965,64,11,18,60,3,151
1720300WO08,573,468,428,16,2,10,7,3,40
17043004039,876,653,426,39,9,9,164,1,227
17043002016,976,843,542,111,39,8,140,0,301
17073002011,687,523,447,40,23,11,6,0,76
17043009028,831,591,522,24,8,6,30,2,69
1711100Al19,885,698,586,74,10,18,16,0,112
1711100Al11,1859,1454,1016,302,24,32,79,0,438
1711100Al60,577,456,366,63,4,18,12,0,90
1711100Nu03,981,755,455,221,43,11,26,0,300
17031930059,1730,1299,1029,68,11,15,178,0,270
17031800089,1583,1330,740,106,47,15,435,0,590
17031007038,854,666,0,4,656,14,2,0,666
17001023036,820,574,473,5,79,11,2,2,101
17031044005,1639,1559,1126,153,87,8,176,2,433
17031050011,1038,668,520,47,27,5,50,0,148
17097Lak164,2163,1621,781,510,137,57,165,2,840
17097Lak165,2255,1649,762,640,88,49,142,0,887
17031950106,837,600,0,29,572,1,4,0,600
17031740016,1354,1028,888,40,11,8,77,0,140
17031022020,2615,1862,32,1813,13,145,8,1,1830
17031029020,1692,1297,21,53,1216,21,9,3,1276
17031930004,1106,872,378,168,70,5,248,1,494
17031960004,1038,855,594,162,14,19,81,1,261
17031980011,2073,1511,215,1247,49,74,21,1,1296
17031016033,888,665,0,73,587,10,3,2,665
17113003007,1701,1440,1094,72,163,20,83,2,346
17031810034,1263,967,622,57,36,15,256,1,345
17031800041,1387,1110,672,340,18,59,67,1,438
17031050017,2259,1653,647,280,149,28,549,0,1006
17043001038,1169,945,696,145,15,19,75,1,249
17031009049,806,663,6,5,653,2,1,0,657
17031720031,1455,1132,215,52,852,7,10,0,917
1714300LI11,1026,801,737,16,24,17,8,0,64
1714300PE29,736,593,519,22,27,12,17,2,74
17031048012,1356,1213,719,154,230,22,106,0,494
17031900024,1700,1275,238,100,920,20,16,0,1037
1708900EL56,1979,1483,953,331,55,36,127,6,530
17031970035,1696,1282,895,287,41,42,16,3,387
17031870030,1293,1030,730,159,50,12,71,1,300
17031700003,1652,1338,990,55,12,3,278,0,348
17031006036,1007,849,2,4,838,2,2,2,847
17031006003,974,868,3,4,863,1,0,0,865
17031013048,846,659,322,316,18,16,6,0,337
17089AC1001,626,598,541,32,13,6,10,0,57
17163000B32,1108,896,726,17,106,27,10,0,170
17031044033,1502,1393,1056,134,68,16,130,1,337
17031047028,1153,917,672,135,35,10,71,1,245
17031890023,563,487,447,29,2,2,8,0,40
17031006006,951,818,9,9,799,4,5,0,809
17031044003,703,615,440,69,21,12,82,7,175
17031760017,1624,1253,613,408,44,47,181,4,640
17031870069,1629,1347,946,160,79,5,155,1,401
17031013023,1247,914,129,770,14,73,7,2,785
1710900MC07,963,790,681,19,66,8,13,3,109
17031047015,1337,1258,853,152,92,15,155,2,405
17031048035,1397,1283,445,118,479,37,233,0,838
17031021045,928,730,10,11,703,2,4,0,720
17031005009,1282,1133,379,89,486,12,185,2,754
17031840014,997,767,660,61,6,4,38,0,107
17031790008,1498,1168,844,193,76,23,47,1,324
17031740028,2670,2050,859,813,88,74,276,0,1191
17031870008,1511,1318,1046,161,30,9,69,1,272
17083000402,1052,808,769,5,1,26,4,0,39
17043005048,844,640,496,50,31,13,43,0,144
17043008014,1096,845,690,72,24,2,37,4,155
17149002301,34,21,20,0,0,1,0,0,1
17131001201,301,224,204,10,0,7,0,0,20
17019CC2300,660,538,414,20,80,6,16,1,124
1711100Al56,987,798,605,145,17,10,27,1,193
17163000SK6,1226,961,803,14,106,12,4,1,158
1716300SC30,909,710,510,20,142,10,26,0,200
17163000SC6,849,676,514,36,83,9,32,0,162
1711100GR25,2172,1512,1097,228,26,19,136,1,415
17019CN1300,1293,1116,667,75,143,14,227,0,449
1705300PT05,760,589,564,11,5,8,0,0,25
17031001015,1250,1061,636,282,110,12,60,2,425
17031026001,1030,904,582,226,62,21,35,0,322
17031039034,1778,1555,753,400,120,21,299,2,802
17031753005,1750,1574,1066,108,108,15,263,1,508
170970Cub64,1071,828,758,21,9,5,22,0,70
17031960067,535,512,450,10,5,3,42,1,62
17043008015,424,360,305,14,12,4,27,0,55
17043004072,900,693,476,17,23,7,163,0,217
17031850022,1467,1291,717,113,295,19,160,2,574
17179000808,919,761,730,16,0,5,4,1,31
17031019037,802,642,267,69,289,17,20,1,375
17031930077,2416,1912,998,175,115,58,646,31,914
17043003015,899,746,573,65,24,7,70,0,173
1708900EL28,1477,1164,444,532,146,51,30,5,720
1708900DU16,2243,1871,1283,309,138,22,124,3,588
1708900GE07,1140,847,771,33,5,11,17,0,76
17031780039,1363,1070,650,366,20,19,37,1,420
17043004011,857,614,524,52,13,0,21,0,90
17113001802,1199,954,912,15,6,4,9,0,42
17031830023,945,762,696,13,0,2,49,0,66
17031021040,751,585,0,6,580,2,1,0,585
17031043007,860,709,531,41,65,4,65,4,178
17031039035,1420,1140,495,244,74,30,311,0,645
17161001007,993,793,606,71,62,11,41,6,187
17031019041,845,648,597,41,7,4,0,0,51
1708900SC09,985,771,706,33,14,6,22,1,65
1708900SC15,1194,907,767,79,10,20,21,5,140
1714300WP01,989,817,574,22,187,19,12,0,243
1714300PE14,1218,821,301,161,339,32,2,0,520
17115508005,656,574,513,11,37,7,6,1,61
17031870051,1039,802,531,181,25,15,60,0,271
17031019027,746,598,209,41,345,12,5,2,389
17031930065,958,737,504,35,9,9,183,1,233
17031007040,707,577,0,9,571,8,1,0,577
1713700SJ01,839,675,609,16,25,15,1,0,66
17031860038,1242,971,685,163,43,15,56,0,286
1708900EL20,1525,1139,411,485,158,41,78,1,728
17031830021,1945,1392,1221,36,9,18,101,0,171
17031038019,1481,1345,922,227,101,13,87,1,423
17031900014,1311,1004,287,96,613,21,14,1,717
17031930051,1865,1345,443,454,198,61,242,4,902
17031860013,1825,1544,1323,86,66,16,51,0,221
17031860046,1072,867,750,62,21,4,29,1,117
17031790075,1724,1346,1038,237,33,15,32,0,308
17031028030,152,119,6,11,97,2,1,0,113
17031720078,921,699,29,10,659,7,4,0,670
17031032008,1733,1430,1208,84,26,11,99,1,222
17093OS0324,1406,1024,700,167,101,11,51,1,324
1720100Ro25,1523,1298,1036,88,114,27,30,0,262
17043002046,1132,887,745,63,4,9,58,1,142
17043002070,825,637,550,56,10,8,8,1,87
17043005066,1244,973,769,58,84,2,54,0,204
17185000003,590,427,407,3,9,6,2,0,20
1711100Ha02,713,608,554,37,1,8,3,1,54
1711100Al12,1223,948,792,106,14,15,21,0,156
17031810040,907,549,486,15,5,10,27,0,63
17043003094,1270,988,745,86,52,14,81,5,243
17031014028,1738,1207,167,997,19,64,22,0,1040
17031002036,1493,1443,1141,90,46,14,146,0,302
17031002029,1574,1497,1125,95,76,11,178,0,372
17031960049,3107,2506,1031,1029,89,63,352,1,1475
17031048039,939,875,518,59,89,11,208,0,357
17031960031,1121,918,745,78,14,10,68,0,173
17031003040,1365,1044,260,50,639,8,98,0,784
17135001105,637,478,464,1,1,5,4,1,14
17031046032,1616,1396,422,161,474,43,328,3,974
17031760022,2052,1569,677,715,56,91,111,5,892
17031930046,1064,855,616,81,38,6,95,0,239
1711700SH02,209,181,175,0,0,2,0,0,6
17031800037,1322,956,843,56,8,4,36,1,113
17043001068,896,768,552,100,12,15,86,2,216
17031044001,2060,1958,1481,174,94,13,187,7,477
17031870028,1011,861,705,44,22,4,85,0,156
17043002006,1278,979,441,304,46,57,173,0,538
17031041007,1035,769,674,52,9,12,14,0,95
17161000813,1044,814,617,124,51,19,18,2,197
17031760035,2970,2126,500,1392,92,112,128,5,1626
17031890065,1154,1041,374,95,507,10,53,0,667
17097Wes397,986,746,662,28,7,3,29,0,84
17113COB034,1532,1151,929,46,85,18,71,4,222
17097Lak151,1157,896,747,70,27,8,39,1,149
17031800070,3021,2411,1064,457,116,44,776,1,1347
17179001815,1135,907,849,21,15,15,4,1,58
17031880009,937,704,620,36,0,2,44,0,84
17031042012,630,569,440,42,36,3,50,0,129
17031042018,2415,2303,1719,129,114,20,306,2,584
17031870038,1201,899,724,34,3,1,135,0,175
17031900016,1214,914,240,80,590,17,4,0,674
17031800039,1683,1307,962,110,13,12,209,0,345
17031950048,1466,1109,17,36,1058,11,2,0,1092
17031800059,1523,1184,905,104,12,15,145,2,279
17031890042,801,629,11,92,525,8,2,3,618
17031041031,962,866,775,42,2,0,41,5,91
17031870022,1219,965,763,104,22,21,58,2,202
17031890096,918,848,632,71,96,7,42,2,216
17031028040,1347,1046,13,56,990,18,6,0,1033
17031025021,3276,3076,1710,274,370,36,684,5,1366
17031960020,1506,1143,909,132,25,13,63,1,234
17031960043,2127,1837,944,107,64,9,707,1,893
17093OS0329,2032,1560,941,274,247,21,86,3,619
1711100Gr18,2095,1602,1188,176,70,31,131,0,414
17043009024,864,675,585,40,22,8,23,0,90
17043005097,724,558,438,33,12,6,64,0,120
17119001904,1020,833,754,13,40,17,3,0,79
17139000701,743,606,587,4,1,10,2,0,19
17019CC1300,1600,1445,1054,69,144,28,153,0,391
17019CC2200,558,445,354,29,18,5,35,2,91
1711100Al36,820,700,626,41,5,14,8,2,74
17031039029,1333,1066,381,333,105,28,242,1,685
17031930040,1259,977,679,74,26,31,182,2,298
17031048037,1131,935,576,186,85,20,78,0,359
17031004028,2265,2124,168,64,1080,17,792,6,1956
17115501064,1154,900,644,23,205,20,7,1,256
17031049022,1643,1321,508,203,470,36,126,7,813
17043006045,956,672,527,31,28,5,81,0,145
17031757001,1804,1444,1203,60,63,9,103,0,241
17001023037,1332,1004,900,19,55,19,10,2,104
17031043019,1275,1143,984,47,27,11,74,0,159
17031002044,1253,1223,1074,43,23,5,63,0,149
17043005070,2628,1915,603,550,252,45,501,4,1312
1714500DQ12,473,357,326,8,17,4,4,0,31
17031015007,768,588,3,77,504,2,1,0,585
17161000710,1222,971,601,232,109,13,23,0,370
17161000726,926,761,507,58,162,20,20,1,254
17031970027,1224,993,684,216,48,23,21,2,309
17031970093,861,704,440,137,105,13,21,2,264
17031800079,2369,1872,530,878,82,85,401,10,1342
17031007004,1008,785,10,11,764,0,3,1,775
17031810026,1023,736,571,22,10,8,124,0,165
17031710013,1846,1535,498,90,928,19,35,2,1037
17031008032,670,501,0,8,499,1,1,1,501
17031008039,801,650,0,11,644,2,0,0,650
17031021032,937,722,1,9,713,1,1,0,721
17031021021,695,539,4,18,519,2,3,0,535
1711100Al22,820,676,554,72,10,8,30,0,122
17073000202,1103,823,789,19,2,5,0,0,34
17019CC1600,924,766,597,29,48,13,74,0,169
17043003047,662,496,356,58,20,2,56,0,140
17019CC0400,3927,3893,2472,301,227,14,889,1,1421
17119002408,859,646,617,6,11,8,5,0,29
1711100Gr22,1848,1320,989,185,17,11,114,0,331
1711100Al66,1023,732,622,42,6,10,48,0,110
1711100Do01,1565,1225,774,355,35,33,30,1,451
17031810017,1265,921,667,29,6,7,204,3,254
17031760030,2629,2041,766,885,246,108,118,3,1275
17097Lib199,1122,947,712,38,16,4,174,3,235
17097Lib198,1925,1492,886,233,42,21,320,1,606
17031960089,1033,917,684,95,8,8,125,0,233
17161000720,1346,1048,649,46,100,11,241,0,399
17031830038,1198,885,674,60,24,9,110,3,211
17031038038,1472,1146,677,382,32,21,63,1,469
17031003026,1228,913,468,42,182,4,217,0,445
17031960074,1593,1294,672,433,21,38,155,2,622
1705100VA07,792,606,578,15,4,7,2,0,28
17043001039,1030,735,515,92,18,7,110,1,220
17043001025,1181,840,650,117,12,14,59,2,190
17043007038,879,708,492,103,14,6,84,0,216
17031760023,2000,1645,1029,332,77,36,186,1,616
17031810039,941,720,508,20,7,4,178,1,212
17031820031,1389,1036,662,53,27,2,290,3,374
17031022007,1690,1194,28,1154,14,90,1,0,1166
17031018048,1004,729,8,175,545,14,4,0,721
17043001027,1456,1039,291,683,18,38,47,5,748
17031046034,1670,1529,1006,255,158,27,90,1,523
17177001814,1352,1061,863,42,120,18,16,1,198
17113003028,1657,1322,1019,53,96,20,131,0,303
17031013024,1293,934,164,738,7,60,18,0,770
17031900045,1294,1046,152,28,814,24,46,0,894
17031930055,1236,973,699,45,30,7,191,0,274
17031780017,1582,1255,802,320,20,30,116,4,453
17031800003,626,522,325,122,19,4,53,0,197
17093BR0210,2041,1485,1065,230,134,23,34,0,420
17043009119,709,566,222,14,1,0,323,0,344
17043005113,567,394,353,15,9,3,14,0,41
17043005013,749,525,477,18,6,7,15,2,48
1711100Gr28,1837,1312,961,215,28,20,81,2,351
17141000026,156,126,121,2,0,3,0,0,5
17011015008,876,722,675,24,7,5,7,2,47
1720100Ch11,1207,950,755,63,48,3,77,1,195
17001023010,559,445,398,8,23,5,2,0,47
17001023014,1145,1003,818,44,117,19,9,1,185
17031048004,1228,1150,739,174,116,18,121,4,411
17031042037,1106,1013,800,45,13,6,139,0,213
17031830026,1204,946,735,58,7,6,129,0,211
17031015011,2996,2152,106,1809,20,123,215,1,2046
17031043014,1273,975,801,52,16,14,80,1,174
17031005022,1316,1171,405,70,526,13,164,2,766
17031780027,551,426,232,154,22,22,36,0,194
17031830006,1299,960,841,34,9,6,68,1,119
17031021007,646,558,3,14,538,4,4,0,555
17031003038,858,737,22,17,702,7,2,1,715
17031025013,2106,1687,272,1291,58,109,81,7,1415
17031940015,2288,1720,898,692,30,65,83,0,822
1708900BA01,1174,855,716,84,28,13,14,3,139
17031007046,341,326,6,40,280,6,0,0,320
17031890038,1168,930,87,100,730,19,7,0,843
17031780044,1894,1543,997,380,34,21,127,1,546
17031027004,661,517,80,81,350,10,12,5,437
17031860006,989,753,613,89,31,1,18,0,140
1713700JK15,878,707,663,6,26,6,2,0,44
17031850007,970,662,479,38,96,12,42,2,183
17031710059,940,703,217,113,372,21,5,2,486
17031046027,1624,1519,987,186,207,31,116,1,532
17031046009,1271,1166,758,178,102,32,114,4,408
17031790043,987,739,648,46,9,9,20,3,91
17031049029,1499,1377,796,177,283,39,105,1,581
1720300ME02,1326,894,855,8,4,12,13,0,39
1716300ESL8,373,321,5,0,316,1,0,0,316
171670CL007,1002,793,752,23,4,9,3,0,41
17031930060,1383,1069,473,195,74,9,328,5,596
17031930036,1209,937,544,213,34,28,133,2,393
17043005019,922,750,611,47,37,4,49,0,139
17031043018,1494,1245,1077,60,33,11,63,0,168
17031032039,1567,1189,995,61,19,5,106,0,194
17043003082,1407,1074,710,78,26,12,251,0,364
17043003009,898,713,596,30,16,7,58,1,117
17179001811,845,623,588,13,6,6,4,1,35
17031019022,778,597,386,51,141,15,9,3,211
17031004010,1492,1168,100,39,1002,3,45,2,1068
17097War295,1562,1263,705,198,161,20,172,7,558
17097Ver249,1618,1273,1035,58,13,5,157,0,238
17031028004,1541,1420,571,117,94,18,615,0,849
17179000815,1058,903,854,21,1,6,12,0,49
17031950050,1151,908,174,71,659,14,3,0,734
17031710051,1013,737,48,322,364,32,2,1,689
17031970041,766,590,441,84,35,10,28,1,149
17031019003,714,519,487,27,1,4,0,0,32
17031710036,1608,1298,100,51,1143,19,6,2,1198
17031830011,800,570,446,21,8,0,93,0,124
17031759006,1258,1023,590,116,220,18,86,1,433
17031850012,784,640,435,65,106,5,38,0,205
17031950091,894,741,76,32,627,7,5,0,665
1710300DX07,659,528,439,33,32,8,7,0,89
17019CN0900,1509,1375,1007,106,77,10,166,4,368
17019CN0200,2037,1986,510,141,80,21,1245,3,1476
1711100Do02,1514,1230,892,244,35,44,18,1,338
17031870002,1801,1293,899,61,9,12,305,0,394
17043005107,741,547,480,28,8,2,23,1,67
17031028016,824,580,4,48,523,10,2,1,576
170970Avo42,1326,953,835,42,39,12,22,1,118
17031048040,909,785,530,148,45,19,37,1,255
1708900GE18,1315,977,813,79,3,11,62,1,164
17031920012,1151,914,573,247,61,14,33,0,341
17031005040,1117,856,15,7,826,8,3,0,841
17031005001,1484,1169,36,13,1125,10,0,0,1133
17031018032,740,624,4,18,605,3,0,0,620
17031031030,1298,996,118,805,37,61,45,1,878
17043003076,1628,1242,574,259,243,18,161,3,668
17031710021,522,335,11,9,310,7,2,0,324
17031019009,754,676,486,85,77,18,20,1,190
17031860019,963,755,612,64,30,13,29,0,143
17031860009,1801,1531,1220,80,76,17,138,1,311
170890AC205,2317,1650,91,1487,76,52,10,0,1559
17031044039,1372,1165,961,61,54,7,86,0,204
17031003006,1378,1101,635,74,154,12,220,2,466
1711700BT01,1145,881,843,3,15,15,2,2,38
17031720062,1993,1627,888,262,284,33,146,0,739
17031003007,873,809,130,41,612,8,27,0,679
17031003041,2372,2280,618,173,957,9,473,11,1662
17031042001,1021,950,834,26,31,9,45,0,116
17043004074,1124,855,421,148,251,7,28,0,434
17011013002,810,658,536,83,13,14,8,0,122
17043006015,1075,951,675,58,90,11,123,0,276
17043001052,695,653,568,49,6,7,26,0,85
1718300DC26,888,562,249,44,271,4,0,0,313
17101000016,941,742,712,3,6,9,8,0,30
1711100Al20,678,516,379,110,8,6,13,1,137
17031020001,1086,870,28,11,825,20,13,5,842
17031960083,1596,1475,1310,49,9,9,100,0,165
17031740019,1620,1260,1110,40,12,10,93,1,150
17031800085,690,563,456,29,2,2,78,0,107
17031002002,863,847,646,52,36,3,102,2,201
17031930048,1613,1300,784,96,65,11,341,0,516
17031720005,1346,1047,497,289,213,38,30,2,550
17031045011,1333,1120,612,325,72,35,109,6,508
17031800068,1016,820,583,118,11,16,104,0,237
1708900SC27,1558,1248,1134,46,11,6,46,0,114
17031005026,1527,1238,27,27,1166,16,23,5,1211
17031018009,849,722,26,27,665,3,0,1,696
17031002013,743,704,578,48,26,3,46,2,126
17031860060,798,697,620,17,25,3,34,0,77
17043009014,1002,773,473,220,37,20,27,0,300
17043009108,1473,1122,385,268,163,20,297,1,737
17119000908,1129,796,762,15,7,4,3,2,34
17043005069,670,536,466,11,11,4,44,1,70
170970Avo45,1087,869,731,61,25,16,29,1,138
17031005018,1127,1027,318,124,485,17,98,3,709
17031005011,1180,1047,396,111,440,24,110,2,651
17031049007,2511,2351,1387,265,257,27,404,6,964
17031800084,1319,1156,675,115,43,9,323,0,481
1714300PE47,972,828,621,19,152,12,23,1,207
17031800012,909,797,615,76,37,11,67,0,182
17031024028,763,556,8,45,509,9,0,0,548
17031970012,995,792,504,190,69,19,29,1,288
17031890085,1527,1259,754,224,227,27,35,1,505
17163000SK3,657,503,379,10,93,13,13,2,124
17065001001,148,119,111,1,0,6,0,0,8
17097Lib202,318,298,223,10,19,6,36,2,75
17031027038,1639,1575,810,112,464,31,176,3,765
17031024037,768,559,4,19,542,4,1,0,555
17031998003,1147,886,236,523,89,35,41,1,650
17113COB021,1466,1311,951,42,139,9,175,0,360
17031820032,699,639,399,41,64,4,136,0,240
17031048043,1819,1687,846,205,315,23,317,10,841
17031018013,980,749,23,145,575,15,7,1,726
17031013029,903,687,121,554,9,41,12,0,566
17031970071,1676,1270,905,222,80,17,39,1,365
17031005029,1301,1121,57,21,1041,23,3,1,1064
17043005108,793,593,466,40,49,14,29,0,127
1718300DC18,682,545,401,27,105,4,15,0,144
17043005039,881,606,555,14,2,2,34,0,51
17043009114,1074,903,703,47,57,4,83,0,200
17031024035,1120,754,6,38,727,6,1,0,748
17031002042,1834,1769,1341,87,111,7,216,0,428
17031044036,1630,1494,1188,131,59,17,117,0,306
17031046021,1416,1152,392,97,397,11,244,1,760
17179000709,963,810,738,29,13,13,8,3,72
17161001014,1299,990,770,34,76,5,100,1,220
17161000725,671,520,429,42,29,9,16,1,91
17031820001,1726,1566,1268,133,24,15,132,3,298
17031009041,613,478,0,9,470,4,1,1,478
17043005062,734,551,440,38,13,8,42,0,111
17031870048,962,707,599,20,10,2,69,0,108
1708900GE05,1753,1369,1180,89,24,13,58,0,189
17031860043,1041,892,772,51,28,3,36,1,120
17031013002,621,516,298,206,7,9,1,0,218
1708900EL54,1441,1162,598,368,83,35,107,0,564
17031007006,1734,1579,77,41,1463,15,9,0,1502
17031044026,1650,1521,1180,130,97,15,102,1,341
17031044034,1315,1201,906,104,58,9,131,3,295
17031870020,2102,1632,950,276,184,16,205,6,682
17113003008,3553,3538,2403,447,483,46,166,0,1135
17031950045,1234,936,13,43,882,8,1,0,923
17031930037,928,758,554,42,26,5,132,0,204
17031790033,697,549,345,168,14,26,12,0,204
1716300CS22,674,555,352,24,134,24,14,3,203
17043006017,1417,1139,709,95,96,11,227,0,430
17031800043,937,705,656,23,4,3,8,0,49
17031046011,1501,1372,791,151,277,30,141,3,581
17031007008,1016,866,60,29,783,10,6,0,806
17179000816,845,666,619,10,6,16,13,2,47
17031890070,739,705,520,33,106,0,46,0,185
17031044037,1341,1178,914,94,40,7,109,9,264
17031044028,1475,1358,951,117,113,6,183,3,407
1719700MO06,1383,991,33,27,937,15,2,1,958
17119002309,1006,753,473,18,225,28,6,2,280
17031970022,1185,944,616,195,81,12,46,1,328
17031780014,1331,1094,673,319,58,17,46,1,421
17031018020,693,565,3,50,512,2,2,1,562
1711100Al29,727,597,508,59,9,9,5,2,89
17031042024,1491,1422,1116,73,83,3,135,2,306
17031005033,1378,1021,8,10,997,2,8,2,1013
17031018038,704,557,4,28,524,2,0,0,553
17031017041,1098,825,4,27,791,3,0,2,821
17031720041,1012,815,468,272,60,21,6,1,347
17043009020,928,696,602,59,13,9,12,1,94
17031026026,874,663,299,258,97,28,21,0,364
17019CN0500,2229,2202,730,445,398,8,642,0,1472
17031003025,2213,1905,1030,78,187,9,576,4,875
17031800028,1934,1530,460,186,124,24,779,1,1070
17031007011,1706,1242,3,27,1219,20,2,3,1239
17031830030,1292,890,792,24,9,8,50,1,98
17097Lib193,694,533,481,13,1,9,25,0,52
17031046018,1462,1396,948,130,101,19,204,0,448
17031757003,2326,2298,1211,227,234,8,621,5,1087
17031050018,255,195,177,3,5,0,0,0,18
17031880032,878,665,604,39,10,4,12,0,61
17031044035,1479,1412,1119,53,59,6,162,0,293
17031043033,1243,1159,1014,60,28,5,57,0,145
17043003045,632,490,453,11,7,2,13,2,37
1708900SC14,432,350,313,19,2,6,5,0,37
17031870055,1010,767,459,40,6,3,257,0,308
17031019016,916,702,631,50,11,2,5,1,71
17031049024,1728,1321,373,281,590,31,77,2,948
1703700SA01,1358,1066,921,109,19,15,6,1,145
171670CP005,1585,1214,439,37,522,20,196,0,775
17031910001,2718,2240,1375,223,205,28,369,0,865
17031850037,872,739,466,67,140,17,56,0,273
17031950023,1068,852,230,55,540,23,12,1,622
17113COB030,748,650,548,25,45,7,21,0,102
17031800015,839,683,363,28,20,6,270,1,320
17031800073,728,618,406,50,20,7,148,1,212
17031044012,1452,1359,1020,92,61,27,135,2,339
17093OS0323,1068,767,487,156,67,10,49,0,280
17043009082,782,597,400,34,11,0,149,0,197
1720100Ha20,971,802,724,33,16,13,6,0,78
17019CN0400,1536,1526,669,333,196,15,331,2,857
17031048026,679,624,338,71,80,2,130,0,286
17031047044,1400,1182,799,127,60,8,185,0,383
17031790001,128,95,85,6,1,2,2,0,10
17043003122,762,600,500,24,7,1,64,0,100
17031043008,1205,1074,823,77,60,12,104,0,251
17031043024,1097,1007,739,82,109,2,59,2,268
17031880021,1315,1090,946,74,23,9,35,3,144
17031720060,1142,976,743,111,89,13,16,1,233
17031048003,1520,1373,678,183,337,27,163,4,695
17031780021,2313,1676,236,1219,194,60,24,4,1440
17031049006,1193,1071,556,135,292,37,71,1,515
17031960055,1632,1443,1068,89,17,14,255,3,375
17031720023,486,354,4,47,298,10,4,0,350
17031930076,1316,1045,757,54,11,5,216,0,288
17031900033,875,698,440,29,213,11,17,0,258
1713700JK07,320,288,255,1,17,10,4,2,33
17031860055,981,763,630,61,20,2,46,0,133
1708900EL45,953,723,264,400,34,50,21,0,459
17031820009,986,926,795,48,12,3,69,0,131
17031042006,1471,1338,950,66,89,10,222,1,388
17043009085,1052,739,674,29,4,2,33,0,65
17031005023,1932,1687,780,109,539,14,250,1,907
17031970073,1293,962,456,262,220,17,12,1,506
17043006006,553,431,340,49,22,2,21,1,91
17031031012,1017,786,239,490,27,29,32,3,547
17031019034,654,481,396,16,63,3,7,0,85
1716300CS14,828,650,448,22,144,24,10,5,202
17031780037,2438,2092,1708,324,15,29,41,0,384
17043007045,864,646,388,105,64,3,87,4,258
17043009056,1441,1251,800,86,110,14,247,0,451
17031049016,1431,1308,688,155,399,27,81,3,620
1719900EM09,762,613,559,12,17,4,15,0,54
1714300PE08,1009,740,143,64,520,23,2,0,597
17031860049,995,846,747,50,15,1,30,0,99
17031860067,936,773,668,46,16,9,25,0,105
17113003010,1054,872,757,27,54,15,9,1,115
17031049009,1396,1290,792,129,247,23,89,0,498
17031005020,1098,999,264,73,570,24,108,2,735
17043004063,937,779,494,71,50,11,159,3,285
1711100Al37,790,602,357,197,11,13,27,1,245
1716300CS15,638,499,248,7,232,2,11,0,251
17031002019,1117,1018,734,81,25,1,159,1,284
170970Avo43,1217,938,740,119,22,11,41,0,198
17043003044,981,797,533,61,54,7,145,2,264
17031950093,853,663,22,23,615,4,1,1,641
17031005007,2373,2106,363,106,939,10,683,0,1743
17019CN0300,1328,1297,502,154,73,10,563,0,795
1708900DU30,1969,1398,1079,89,46,25,155,1,319
17031004002,1832,1698,949,118,201,14,397,6,749
17031043046,869,757,615,48,22,2,70,2,142
17031048008,548,514,400,36,29,2,43,1,114
17031046015,1060,1003,732,83,87,22,87,0,271
17031880006,1898,1431,780,513,47,35,59,0,651
17043002036,1031,810,574,100,44,5,80,1,236
1711100Mc23,994,791,557,190,8,25,17,0,234
17031048016,1968,1682,666,242,372,44,377,6,1016
17031870009,1198,893,636,22,1,3,223,0,257
17031900044,982,742,36,9,681,0,9,0,706
17043004091,992,780,544,42,19,7,170,0,236
17043004090,831,624,521,23,7,0,67,0,103
17031004017,1306,1234,823,112,88,12,202,0,411
17043009039,670,591,392,74,82,2,44,1,199
17043005105,477,367,331,11,6,1,14,0,36
17031046023,1325,1228,537,213,399,23,82,5,691
17031044017,1727,1624,1220,157,65,22,163,0,404
17161000706,1202,950,768,112,43,7,17,0,182
17031002023,627,583,535,14,17,0,17,0,48
17031039002,935,924,403,38,4,1,478,0,521
17031930005,829,824,802,8,3,5,12,0,22
17031048013,1399,1282,804,116,135,17,218,0,478
1711100Al03,1145,845,555,238,14,16,29,1,290
1709900NV02,232,192,167,10,3,7,0,1,25
17031043026,718,649,539,31,19,1,64,0,110
17031043037,1845,1752,1340,105,81,12,206,4,412
17031011035,415,392,82,24,20,3,266,0,310
17031005037,1330,1258,563,63,466,4,153,0,695
17031027047,756,608,113,37,443,10,18,1,495
17161000714,1200,1006,560,72,270,9,99,0,446
17031046003,1299,1216,876,95,105,24,123,3,340
17043009117,1193,992,635,84,70,3,202,0,357
17031039038,402,388,275,30,10,4,74,0,113
17031050027,434,351,248,26,9,0,66,0,103
17031046039,1089,1050,751,93,71,10,133,0,299
17031042027,1015,985,730,66,50,5,124,1,255
17031810035,531,518,503,2,0,1,13,0,15
17031740006,1150,1007,761,46,19,1,177,0,246
17031048022,738,689,424,62,85,6,111,0,265
17031050014,393,341,246,11,13,2,73,1,95
17031002034,820,755,671,31,10,0,41,2,84
17031002018,1245,1194,891,63,65,5,163,2,303
17031050016,356,308,245,4,11,1,44,0,63
17031048029,443,437,332,19,63,7,15,0,105
17031005041,479,450,154,17,198,7,70,0,296
17031960016,1311,1048,476,473,25,44,77,0,572
