GEOID,TOTAL_POP,TOTAL_VAP,WHITE_VAP,HISPANIC_VAP,BLACK_VAP,NATIVE_VAP,ASIAN_VAP,PACIFIC_VAP,MINORITY_VAP
1201100Q090,2176,1744,913,620,104,15,75,6,831
1201100U009,1579,1160,482,449,140,14,81,0,678
1201100U008,999,808,427,207,81,8,95,2,381
1201100C023,9551,8200,4167,2120,1415,72,310,15,4033
1201100D005,4783,3756,1096,1299,1299,47,63,3,2660
1201100D002,3514,2927,1121,1193,525,82,63,7,1806
12009000516,11757,8773,4730,1657,2031,209,262,16,4043
12009000520,8078,6304,3597,1159,1235,153,201,20,2707
12009000517,8844,6942,4035,1225,1346,155,228,13,2907
12009000510,11497,9329,5896,1434,1452,214,355,11,3433
12009000313,12120,9389,5611,1342,2099,204,238,35,3778
12009000105,8277,6626,5150,456,727,179,122,12,1476
12009000100,3005,2492,2089,124,138,83,48,10,403
12009000427,5413,4371,3430,414,183,84,229,8,941
12009000410,1188,989,770,81,55,17,47,6,219
12009000422,7419,6148,4718,605,359,126,334,14,1430
12009000135,3071,2632,2295,121,87,78,37,12,337
12009000512,3950,3227,2672,239,95,107,109,2,555
12009000525,3516,2381,1504,355,181,27,263,2,877
12009000124,5480,4386,3605,348,201,110,103,21,781
12009000125,5269,4218,3405,286,262,102,130,15,813
12009000113,4573,3648,2854,307,222,105,116,17,794
12009000506,3010,2481,2219,126,28,31,56,4,262
1201100M024,3218,2547,684,965,785,18,132,2,1863
12075000004,1592,1398,1298,32,16,37,9,1,100
12075000ZZZ,0,0,0,0,0,0,0,0,0
12075000006,631,508,470,10,10,14,1,1,38
12075000002,4199,3416,2729,355,206,103,24,5,687
12075000003,5561,4278,3098,588,412,155,41,16,1180
12075000008,4630,3786,3149,399,84,94,41,4,637
12075000007,4404,3371,1903,366,996,52,66,4,1468
12045000003,2307,1836,1408,70,309,35,7,2,428
12045000010,842,744,676,18,17,19,8,0,68
12119000130,6021,5987,5674,118,56,50,50,1,313
12119000111,7939,7913,7538,129,70,50,73,2,375
12119000113,1653,1305,770,76,418,26,11,1,535
12119000115,4846,3958,2425,294,1104,76,57,9,1533
12119000112,7771,6092,4812,536,316,102,282,10,1280
12119000129,7561,7324,6813,195,152,67,66,9,511
12057000707,3205,2482,1652,589,135,98,23,10,830
12057000709,5451,4032,2074,1791,79,103,62,6,1958
12057000951,2532,1971,1310,325,216,64,70,4,661
12057000956,4925,3581,1835,919,579,98,187,18,1746
12057000557,3668,3017,1463,1007,450,67,92,6,1554
12057000245,3625,2887,1196,1250,377,50,118,6,1691
12057000555,1545,1268,826,285,97,22,59,3,442
12057000569,3819,3169,1875,855,265,51,152,1,1294
12057000247,1559,1155,293,513,333,32,21,8,862
12057000565,876,711,241,286,179,23,14,3,470
12057000014,13928,12206,5906,3179,2012,260,996,24,6300
12057000319,2942,2455,1100,567,723,76,36,3,1355
12057000318,2127,1756,885,419,413,33,47,11,871
12057000998,18,18,18,0,0,0,0,0,0
12057000116A,2463,2125,1471,340,204,41,100,0,654
12031000140,2479,1809,349,70,1362,11,10,8,1460
12031000021,4370,3383,1825,621,649,113,204,15,1558
12086000348,1056,922,29,890,15,4,4,1,893
12086000368,6064,5086,167,4850,79,21,63,4,4919
12086000360,7911,6463,136,6248,122,33,69,8,6327
12086000257,4006,2762,16,715,2126,18,7,2,2746
12086002581,764,511,7,221,301,1,0,1,504
12086000178,1934,1478,19,579,929,5,1,0,1459
12086000241,4524,3620,64,1863,1828,55,12,5,3556
12086000546,1906,1514,783,597,45,20,51,1,731
12086000582,5679,4683,2346,2007,80,32,116,6,2337
12086000641,3428,2616,1193,1271,65,20,48,1,1423
12009000527,3957,2939,1670,435,668,96,101,8,1269
12009000529,2212,1875,1556,124,105,41,41,6,319
12009000108,8462,6520,3641,506,2129,137,163,18,2879
12009000109,7725,6295,4735,492,784,146,131,14,1560
12009000428,6610,5467,4136,574,428,82,253,12,1331
12009000412,1425,1179,917,79,66,33,61,2,262
12009000322,8025,6323,3428,1207,1417,161,163,20,2895
12095000434,147,92,36,31,16,3,2,0,56
12009000118,9300,7798,6290,430,673,227,115,21,1508
12045000006,1999,1615,1461,65,24,60,10,2,154
12045000005,2089,1737,861,80,742,49,18,2,876
12045000001,0,0,0,0,0,0,0,0,0
12045000002,3796,3122,2504,128,382,94,13,6,618
12045000009,355,297,280,5,6,10,0,2,17
12037000001,2732,2121,1919,81,29,63,6,2,202
12029000009,790,599,524,15,30,19,10,2,75
12055000023,1605,1240,906,182,126,11,7,2,334
1205500020N,374,324,262,41,12,3,6,0,62
12055000013,5374,4397,3194,766,302,73,66,6,1203
12055000010,2564,2169,1536,357,171,40,64,6,633
1205500025D,1612,1556,1436,58,28,21,13,0,120
12055000005,6853,5825,4190,1124,326,84,109,9,1635
12055000022,848,736,591,78,51,9,4,1,145
12055000025,4557,3665,2477,710,360,65,92,10,1188
12055000017,8785,7479,6201,834,262,112,65,10,1278
1205500013L,1791,1323,553,624,113,37,23,2,770
12055000004,1156,1049,835,167,28,8,6,0,214
12055000002,5287,4034,1599,909,1499,66,27,13,2435
1205500004A,166,162,139,18,6,2,1,0,23
12055000019,5389,4471,2738,1131,517,70,42,8,1733
12055000016,6884,5409,2906,1483,631,127,314,8,2503
1205500016A,258,227,113,82,26,1,8,2,114
12057000909,4295,4278,3938,113,95,34,85,7,340
12057000932,6719,4567,1261,2190,1006,115,93,18,3306
12057000139B,1789,1216,374,346,442,25,62,7,842
12057000120,0,0,0,0,0,0,0,0,0
12057000901,4710,3241,1030,1659,525,70,38,1,2211
12057000309,4838,3545,343,402,2819,70,42,7,3202
12057000535,3354,2804,1536,776,413,62,82,7,1268
12057000219,5423,4626,885,3053,612,47,182,9,3741
12057000159,4936,4345,3297,481,159,52,304,4,1048
12057000422,5079,4067,940,2331,438,45,383,4,3127
12057000457A,5887,4691,543,3576,285,57,398,14,4148
12057000423,4666,3929,1079,2388,339,65,157,5,2850
12057000830,3282,2580,1141,739,539,59,183,7,1439
12057000834,3957,3080,1080,1059,785,62,182,8,2000
12045000008,863,790,712,25,17,26,8,1,78
12045000007,322,260,226,7,7,18,4,2,34
12045000011,595,490,455,10,9,13,2,1,35
12045000004,1024,930,866,10,21,23,4,0,64
12075000010,1396,1134,1021,31,34,32,4,5,113
12055000012,1674,1431,1192,183,24,21,9,0,239
1209300P-02,1330,1023,797,136,40,28,21,6,226
12055000021,4454,3738,3189,309,109,92,15,6,549
12097000402,1415,1103,505,486,88,27,32,5,598
12097000403,8775,6428,976,4610,890,111,167,26,5452
12097000408,817,637,356,205,45,15,37,0,281
12097000420,16876,13201,5990,5970,1019,306,285,31,7211
12097000210,8282,6428,442,5188,894,133,177,18,5986
12097000410,7922,6216,1680,3424,975,153,256,19,4536
12097000201,7054,5588,1029,3740,764,89,214,16,4559
12097000211,8677,6883,1766,4278,742,134,207,20,5117
12097000203,2931,2267,412,1558,297,33,60,6,1855
12097000112,11391,8635,1535,6101,1000,115,270,16,7100
12097000110,9832,7040,852,5094,968,128,289,18,6188
12097000523,2416,1802,1000,584,164,50,40,21,802
12097000520,12441,9538,4850,3570,766,260,336,21,4688
12097000506,5793,4444,3297,832,110,95,102,10,1147
12097000521,11743,8661,3957,3755,762,198,230,30,4704
12097000522,9632,6841,2259,3641,848,156,190,16,4582
12097000158,2751,2188,691,955,147,21,236,4,1497
12097000300,5855,4514,884,2482,932,100,283,19,3630
12097000390,172,142,90,28,11,3,10,1,52
12097000105,5379,4299,1734,2067,434,85,133,14,2565
12097000407,2737,2230,1480,501,127,46,94,2,750
12097000451,170,132,18,101,15,3,5,0,114
12097000450,2675,1860,156,1509,201,34,51,3,1704
12097000401,1166,946,438,364,86,35,40,3,508
12097000508,4565,3480,1867,1180,322,72,115,4,1613
12097000504,10009,7503,3380,2918,748,182,413,20,4123
12097000580,118,87,57,16,4,3,3,0,30
12097000400,984,804,616,142,16,9,21,2,188
12097000503,8899,6735,1743,3802,880,155,425,12,4992
12097000202,161,127,90,27,5,2,8,0,37
12057000711,2056,1596,1039,470,32,49,18,0,557
12057000754,4643,3377,1753,1002,465,72,108,12,1624
12057000883,7702,5653,2056,1490,1405,119,693,12,3597
12057000969,792,603,226,256,120,7,7,2,377
12057000961,3072,2378,370,1419,608,34,35,5,2008
12057000973,1970,1536,360,552,603,17,28,5,1176
12057000971,3889,2960,549,1782,639,36,52,8,2411
12057000012,9318,7476,4068,1233,1272,128,863,18,3408
12057000101A,6985,5252,3130,762,932,149,372,36,2122
12057000105A,7643,6135,3175,1403,1046,155,547,29,2960
12057000459,7532,6133,1840,2908,1011,92,445,10,4293
12057000463,4561,3598,626,2324,533,43,171,3,2972
12057000949,8702,6724,3650,1491,1130,167,389,22,3074
12057000713,3970,2908,1147,994,675,112,44,3,1761
12057000583,3460,2951,1557,800,386,31,186,11,1394
12057000595,3766,2953,2165,417,168,62,146,6,788
12057000591,4776,3759,2837,538,176,91,114,5,922
12057000585,3694,2918,2055,519,166,51,129,6,863
12057000891,4203,3150,1833,1071,131,317,77,6,1317
12057000721,7173,5362,2659,2394,119,311,76,5,2703
12057000885,8274,5939,2404,2076,1248,172,149,17,3535
12057000889,3166,2403,1282,595,420,91,72,7,1121
12057000759,6689,5052,3239,1367,298,128,64,9,1813
12057000755,2720,2097,1218,616,205,53,36,3,879
12057000757,8813,6397,2451,3018,724,210,105,9,3946
12057000160,3018,2875,2066,377,140,47,250,0,809
12057000165,5655,5540,4126,696,402,64,239,5,1414
12057000301,2036,1575,402,988,186,35,19,7,1173
12057000303,971,733,86,91,561,21,11,1,647
12057000307,5877,4503,1022,819,2660,45,54,11,3481
12057000601,5394,3929,1196,1076,1615,107,77,4,2733
12009000114,8130,6402,4833,628,518,133,288,21,1569
12009000116,4873,4398,3925,189,99,91,67,7,473
12009000134,0,0,0,0,0,0,0,0,0
12009000111,4368,3613,2695,422,320,93,98,11,918
12009000112,3639,3022,2472,221,181,60,70,7,550
12009000115,5244,4414,3347,397,424,140,124,3,1067
12009000106,3355,2778,2528,65,38,96,23,16,250
12009000400,7351,6083,4238,846,579,117,292,12,1845
12009000403,2142,1714,1299,196,82,58,80,8,415
12009000407,804,646,520,75,13,26,14,2,126
12009000417,6664,5425,4017,531,541,101,219,25,1408
12061000019,3073,2615,1954,365,107,52,123,8,661
12061000005,8134,6110,4330,1125,398,142,88,8,1780
12061000002,4790,3241,437,2566,218,73,5,4,2804
12061000017,5003,4580,4251,177,34,30,51,2,329
12061000014,3661,3525,3320,75,16,30,45,0,205
12061000016,3386,3282,3125,71,17,10,31,0,157
12061ZZZZZZ,0,0,0,0,0,0,0,0,0
12061000015,516,507,492,6,1,1,2,0,15
12119000120,7280,5952,4666,553,471,178,60,14,1286
12119000118,3923,3145,2594,294,128,80,34,4,551
12119000104,3720,3701,3561,64,19,11,34,0,140
12119000103,5645,5621,5376,89,41,38,52,1,245
12119000110,3799,3675,3501,78,28,12,33,0,174
12119000114,5096,4151,3645,186,156,119,27,5,506
12086000777,1093,894,191,659,18,0,31,4,703
12086000727,1876,1523,355,1079,48,26,52,1,1168
12086000618,1511,1254,610,554,20,4,29,0,644
12086000627,2864,2124,899,1034,58,20,120,0,1225
12086000801,2970,2363,35,1004,1371,7,18,2,2328
12086000856,5110,3661,74,1543,2076,29,47,5,3587
12086000833,831,648,9,589,66,1,1,1,639
12086008391,76,64,1,57,3,2,0,0,63
12086000825,6512,5233,965,3611,582,43,147,3,4268
12086008390,3201,2497,135,2015,387,10,28,0,2362
12086000717,4832,4083,843,3020,149,38,75,4,3240
12086000543,10468,8280,302,7726,537,180,67,10,7978
12086000593,7289,5860,156,5560,350,72,23,3,5704
12086000997,921,754,19,726,23,7,2,1,735
12086009340,7329,5191,492,3694,956,59,156,5,4699
12086000888,591,368,21,281,64,7,7,1,347
12086000203,3992,3091,36,751,2338,29,24,2,3055
12105000225,5283,3972,1839,988,1072,81,82,18,2133
12105000224,3941,3138,2314,411,280,52,76,4,824
12105000514,2866,2203,1691,347,85,94,10,2,512
12105000521,2542,1745,619,995,102,30,22,4,1126
12105000513,829,613,249,257,96,11,6,4,364
12105000526,2850,2458,1829,313,251,37,25,2,629
12105000307,3796,2823,1709,614,419,74,35,5,1114
12105000303,6440,5011,3843,608,275,157,107,10,1168
12105000540,1675,1476,1242,138,55,21,16,4,234
12105000231,4767,3820,2542,602,467,98,125,12,1278
12105000233,1865,1495,1026,275,130,38,39,2,469
12105000237,7473,5964,4690,697,331,131,105,8,1274
12105000238,5905,4292,2262,1085,816,79,86,1,2030
12105000234,792,626,440,99,62,18,17,0,186
12105000235,3505,2745,2164,270,132,80,81,10,581
12105000523,1487,1120,232,155,718,16,19,2,888
12105000527,3849,2894,1499,652,669,55,52,3,1395
12105000528,1653,1155,230,339,591,26,13,1,925
12105000229,3391,2910,2145,390,226,65,89,5,765
12105000230,3796,2970,1951,556,337,56,78,7,1019
12105000517,2188,1630,625,474,516,28,3,6,1005
12105000516,2169,1628,1033,435,121,35,13,3,595
12105000250,4338,3157,1981,521,393,61,180,3,1176
12105000232,3206,2404,1434,499,344,61,75,6,970
12105000251,1188,906,653,120,80,30,28,1,253
12105000504,5131,3833,2122,574,1000,73,92,8,1711
12105000501,823,594,59,56,471,7,2,0,535
12105000532,2339,1718,991,180,502,34,22,7,727
12105000531,1961,1581,1138,294,117,44,14,6,443
12105000530,5848,4435,2412,1048,914,95,36,3,2023
12105000329,6716,5265,2890,1252,898,120,133,8,2375
12105000330,3298,2590,1438,466,587,62,53,7,1152
12105000323,3552,2813,1488,511,733,61,52,3,1325
12105000326,6996,5361,2681,1141,1379,117,116,15,2680
12105000336,4155,3285,2493,408,217,64,129,5,792
12105000111,9504,7417,5464,1035,597,139,178,10,1953
12105000110,6983,5545,3724,1051,558,129,138,12,1821
12105000242,4331,3400,2357,481,288,69,203,5,1043
12105000215,154,119,94,19,0,4,1,0,25
12105000321,4667,3576,2401,569,455,66,64,7,1175
12105000327,7885,5857,3178,1060,1387,93,211,12,2679
12105000107,7094,5691,4283,965,231,178,70,10,1408
12105000301,2476,2004,1369,364,168,53,53,4,635
12105000108,3628,3145,1909,350,820,50,27,4,1236
12105000411,6750,6638,4876,638,763,42,334,3,1762
12105000420,1172,1105,686,209,161,7,55,0,419
12097000412,3731,2871,340,1797,784,66,68,22,2531
12097000391,4687,3395,580,2032,704,62,143,17,2815
12097000307,7237,5157,773,3539,821,94,200,25,4384
12097000353,57,28,8,18,6,6,0,1,20
12097000309,3776,2841,636,1594,538,36,139,6,2205
12097000502,6380,5035,3877,793,162,111,87,10,1158
12097000505,2117,1706,1272,312,52,28,44,3,434
12097000553,633,587,390,110,47,15,26,5,197
12097000552,283,206,59,107,19,7,21,1,147
12061000013,8648,7712,6465,542,468,62,142,7,1247
12061000029,401,332,265,22,16,15,7,1,67
12061000012,1835,1519,1261,106,116,11,14,2,258
12061000022,5235,4511,3730,397,148,63,160,3,781
12061000035,4028,3728,3197,252,118,46,90,2,531
12061000023,4328,3506,2554,452,305,71,106,4,952
12061000031,4389,3623,3037,341,86,42,90,5,586
12119000123,3908,3017,2196,356,311,98,42,5,821
12031000061,4712,3788,2194,553,812,94,177,4,1594
1200300003A,5934,4445,3513,340,425,89,50,4,932
1200300002A,5624,4275,3198,126,816,85,43,12,1077
12007000019,1152,888,752,16,81,26,10,0,136
12007000009,641,494,463,5,13,13,0,0,31
12043000009,139,128,113,6,7,2,4,0,15
12043000006,1080,788,275,272,226,12,2,0,513
12043000007,1492,1401,1013,135,243,14,11,2,388
12043000005,2633,2082,1155,860,22,32,9,3,927
12043000013,1110,872,641,179,23,17,11,0,231
12085000050,7198,6007,4977,500,339,84,82,7,1030
12085000026,7879,7084,6133,379,331,106,104,10,951
12085000066,3417,3183,2901,153,41,29,46,2,282
12029000004,4014,3202,2909,80,70,103,23,8,293
12119000117,14683,14285,8980,1761,3389,178,129,6,5305
12105000522,4889,4100,2554,675,583,82,229,4,1546
12105000332,5722,4579,3062,708,552,112,178,8,1517
12105000105,3870,2982,1451,1068,342,62,94,10,1531
12105000104,4887,4108,2543,1083,339,68,105,13,1565
12105000103,7236,5805,2975,1981,710,91,93,2,2830
12105000123,4926,3989,2256,1149,395,74,149,8,1733
12105000124,9580,7251,3447,2690,801,146,264,28,3804
12105000505,3301,2297,948,599,718,46,36,8,1349
12105000509,2806,2177,840,189,1104,33,11,5,1337
12105000408,10160,7930,3453,3050,1271,142,209,17,4477
12105000314,6224,5318,3684,1081,517,74,73,8,1634
12105000306,4127,3660,2727,628,226,62,37,6,933
12105000409,6635,4808,1281,2488,962,107,86,3,3527
12105000247,5425,4190,2740,661,673,119,52,24,1450
12105000244,7720,5285,2778,2042,368,295,31,9,2507
12105000245,8611,6437,4210,1274,710,102,184,6,2227
12105000507,3168,2522,1913,313,185,75,58,5,609
12105000312,7552,5825,3364,1303,953,151,129,9,2461
12105000310,1479,1288,984,190,81,39,10,0,304
12105000340,1490,1198,734,256,169,44,17,1,464
12105000117,7880,6545,4499,1082,707,106,192,6,2046
12105000304,6927,5391,4060,723,384,111,111,13,1331
12105000313,5927,4523,2111,1344,1026,70,56,0,2412
12105000319,6059,4798,2845,725,1052,111,122,7,1953
12105000338,3320,2321,1241,745,258,82,44,10,1080
12105000510,3290,2269,807,1202,195,81,26,2,1462
12105000334,2237,1828,1377,290,114,47,5,3,451
12105000503,521,401,154,47,185,18,4,2,247
12061000003,1799,1436,1106,267,26,22,9,0,330
12119000119,1953,1475,1023,272,101,30,15,5,452
12119000102,4881,4823,4613,81,33,34,55,1,210
12119000101,2943,2835,2619,86,42,30,39,1,216
12119000108,3587,3568,3428,46,21,16,33,2,140
12031000249,1582,1385,1220,70,28,28,41,0,165
12031000079,2900,2504,1939,219,214,53,83,4,565
12031000283,2464,1939,1787,62,37,42,12,3,152
12031000109,3937,3142,2454,217,208,78,162,2,688
12031000120,1534,1265,644,67,507,18,35,6,621
12021000067,3324,2977,2612,206,51,17,53,4,365
12007000006,572,422,343,18,45,10,4,1,79
12021000108,2718,2394,2135,149,40,18,39,1,259
12021000089,3755,3456,2888,338,80,28,107,2,568
12021000134,24134,16161,522,11826,3754,533,59,31,15639
12021000056,3529,2837,2054,553,109,30,71,6,783
12021000072,8638,6700,1788,3997,865,102,74,8,4912
12021000100,1435,1324,1241,40,3,7,25,0,83
12021000086,2241,1954,1612,251,22,17,33,5,342
12021000071,8662,6244,959,4216,1033,141,71,8,5285
12021000118,9602,7658,4863,2044,411,121,202,1,2795
12021000105,1462,1408,1357,25,4,8,11,1,51
12021000104,1323,1086,505,236,338,7,17,0,581
12021000113,4684,3961,2669,1002,179,49,64,0,1292
12021000021,2568,2377,2210,99,17,10,23,2,167
12021000017,312,294,277,10,1,1,4,0,17
12075000009,3731,3224,2979,95,34,81,28,2,245
120170100.1,4111,3488,3124,155,41,80,53,5,364
12075000012,2635,2075,1807,118,52,67,13,3,268
12075000020,664,531,448,48,9,16,7,0,83
12041000004,2412,1904,1716,78,33,53,16,2,188
12075000001,3829,2960,2219,308,281,124,15,5,741
12119000106,4009,3998,3804,67,32,20,50,4,194
12119000105,5589,5536,5234,85,105,34,39,2,302
12119000109,3296,3284,3180,43,9,12,21,4,104
12119000127,4084,4067,3900,56,36,16,43,0,167
12031000273,5608,4208,1927,573,1323,73,336,10,2281
12031000241,12723,9203,3619,1041,4019,194,486,18,5584
12031000222,1909,1496,1179,75,167,50,22,2,317
12031000281,2541,1923,1767,55,23,29,33,1,156
12061000021,6254,4540,1027,383,3053,51,28,3,3513
12061000025,2193,2033,1813,101,60,16,29,2,220
12061000026,3949,3196,2095,512,466,53,65,6,1101
12061000009,8018,6767,5557,588,304,108,154,6,1210
12007000016,1706,1277,874,37,326,33,10,3,403
12055000015,7852,6522,5213,683,322,105,124,13,1309
12055000001,3936,3060,1635,912,474,69,42,5,1425
12055000003,2614,2136,1639,303,113,59,37,5,497
12075000005,4504,3661,3354,119,72,79,30,3,307
12075000013,3363,2534,1729,149,522,67,56,2,805
12097000304,12245,9077,1136,5538,2461,161,244,43,7941
12097000200,15670,12332,1370,9197,1876,260,334,48,10962
12097000500,1131,896,765,62,21,19,14,8,131
12097000501,2190,1667,1246,243,49,70,34,8,421
12031000016,6739,5187,2227,732,1875,91,273,11,2960
12031000142,2738,2166,69,24,2061,15,9,2,2097
12031000182,2143,1946,887,166,759,25,128,7,1059
12031000178,2545,1841,210,79,1527,24,12,11,1631
12031000288,2921,2745,2238,170,186,42,110,7,507
12031000186,2518,2200,1429,193,403,58,119,5,771
12031000155,1839,1321,52,42,1225,8,1,1,1269
12031000123,1926,1397,71,58,1268,5,9,0,1326
12031000201,4150,3098,1512,302,1083,100,175,12,1586
12031000145,2260,1767,693,55,942,35,32,0,1074
12031000151,5453,4116,639,171,3265,34,46,4,3477
12031000027,4089,2920,1416,557,779,67,122,14,1504
12031000122,1478,1112,190,45,862,6,4,0,922
12031000096,4499,3546,2493,377,310,57,186,6,1053
12031000090,3523,2738,1726,332,401,43,239,4,1012
12001000009,3636,2901,2203,287,261,45,96,4,698
12001000034,5290,4114,2157,465,1284,65,151,3,1957
12001000036,2274,1976,912,219,711,57,89,2,1064
12001000031,12984,11586,6837,1876,1571,158,1139,26,4749
12001000023,4184,3219,650,80,2432,43,27,1,2569
12097000107,9147,6872,2046,3828,587,187,355,22,4826
12097000104,8542,7015,2820,3155,536,148,419,20,4195
12097000411,11999,9064,1242,6795,1060,159,272,20,7822
12097000160,2184,1608,257,994,155,43,166,5,1351
12055000011,2924,2444,1833,392,136,68,28,0,611
1205500017L,131,117,79,31,5,2,2,0,38
12061000010,8450,7299,6064,536,472,106,83,7,1235
12061000011,1894,1797,1534,55,158,23,13,2,263
12061000027,6287,5474,4411,479,386,105,80,3,1063
12061000028,21449,16957,11728,2224,2205,327,398,33,5229
12061000030,5198,4219,3279,479,192,91,126,2,940
12131000430,10173,7804,6456,728,209,261,139,12,1348
12131000340,1643,1285,915,71,229,46,19,5,370
12131000330,2574,1966,1562,195,124,73,30,7,404
12131000320,3068,2482,1908,159,262,99,55,4,574
12131000110,1788,1372,1159,43,72,76,8,0,213
12057000633,2755,2278,1751,268,154,42,53,0,527
12057000355,1358,1158,641,213,178,13,139,1,517
12057000929,4412,4328,3894,193,120,34,68,1,434
12057000149,710,496,168,130,188,4,8,2,328
12057000905,1287,948,517,365,37,39,10,8,431
12057000904,3341,3318,3025,156,66,18,40,0,293
12057000927,1076,1057,1027,10,18,0,2,0,30
12057000429,5400,4384,1555,2282,312,53,239,14,2829
12057000430,2491,1983,503,1300,133,39,64,2,1480
12057000819,2023,1796,1387,231,126,21,45,3,409
12057000867,7065,5189,2522,1469,776,145,409,9,2667
12057000821,5463,4282,2169,1193,619,82,286,6,2113
12057000131B,940,635,252,143,84,12,160,1,383
12057000813,5638,4362,2795,746,516,109,260,10,1567
12057000154,15697,10192,7350,1416,605,145,677,26,2842
12057000702,1148,795,527,127,61,29,73,8,268
12057000405,3721,3193,1023,1207,603,44,383,8,2170
12057000225,0,0,0,0,0,0,0,0,0
12057000566,8269,5498,581,2464,2492,172,69,17,4917
12057000559,5773,4722,1398,1176,1624,46,656,19,3324
12057000853,3208,2452,804,851,794,38,81,8,1648
12057000852,7776,6624,2967,1475,1697,132,532,14,3657
12123000006,850,679,625,14,7,29,3,3,54
12123000003,1845,1670,1249,95,278,17,4,0,421
12127000032,8044,6568,4343,1078,737,107,306,4,2225
1205500015S,765,644,503,71,33,14,20,1,141
12055000024,3170,2817,2393,227,104,43,44,3,424
12055000018,637,511,430,58,5,13,1,2,81
12057000857,4677,3227,1061,1074,1019,60,151,5,2166
12057000305,7473,5758,1522,1161,2985,96,89,8,4236
12057000107A,7370,6081,4049,857,598,101,469,31,2032
12057000347,7339,5592,1208,2012,2288,114,152,30,4384
12057000560,798,708,342,124,236,24,28,3,366
12057000317,4296,3431,686,1232,1504,58,22,14,2745
12057000415,5767,4576,1411,2607,470,59,128,16,3165
12057000106,2105,1399,548,179,369,30,296,1,851
12057000363,1912,1319,410,486,341,17,90,2,909
12057000673,5791,4359,1782,911,875,75,772,5,2577
12057000368,575,405,153,38,39,1,176,0,252
12057000223,6432,5260,943,3468,734,110,225,7,4317
12057000962,2942,2148,903,640,495,54,152,7,1245
12057000953,5951,4744,2929,951,612,103,197,11,1815
12057000144,486,349,90,106,109,1,57,0,259
12057000136,996,651,176,196,231,22,39,2,475
12057000939,4874,4145,3296,558,143,54,82,6,849
12047000002,1390,998,324,23,629,20,12,3,674
12047000004,2013,1548,1063,58,418,13,6,0,485
12131000230,2813,2577,1667,179,664,39,20,1,910
12131000540,3056,2549,2339,82,27,56,42,7,210
12131000310,9227,6937,5152,578,780,334,90,17,1785
12131000120,1158,907,820,25,14,43,6,2,87
12131000420,1033,845,748,42,7,30,15,5,97
12097000406,5355,4308,944,2614,653,90,171,18,3364
12097000152,82,62,28,22,2,1,5,3,34
12097000100,1567,1331,825,346,103,22,51,5,506
12097000151,11000,8803,6548,1181,211,101,424,9,2255
12097000138,0,0,0,0,0,0,0,0,0
12063000011,2251,1749,1411,22,243,60,3,2,338
1200300006A,1937,1834,798,44,964,16,3,4,1036
1200300001A,3632,2724,1838,45,750,61,14,2,886
1200300005A,5355,4056,3717,98,84,92,26,3,339
12007000020,1082,858,781,20,38,13,7,2,77
12057000135A,4592,3457,2539,525,97,62,230,8,918
12061000034,5409,4806,4025,467,173,86,44,6,781
12061000033,3379,3007,2678,164,69,33,53,5,329
12061000004,50,32,21,4,7,1,1,0,11
12001000070,4842,3586,2637,416,362,96,77,7,949
12001000011,2817,2125,1696,159,113,40,101,0,429
12001000069,4957,3629,2427,386,572,98,123,3,1202
12001000066,5836,4475,3545,325,446,109,51,3,930
12001000037,5459,4098,932,395,2736,29,33,3,3166
12001000050,4592,3246,824,210,2066,72,106,3,2422
12001000032,4846,3765,1333,244,2138,56,24,4,2432
12001000013,37,32,26,0,4,0,2,0,6
12001000004,1177,978,755,47,144,27,10,1,223
12001000053,4009,3305,2274,377,415,78,175,3,1031
12001000054,3784,3056,1850,389,470,64,323,6,1206
12061000024,1757,1460,930,276,141,33,76,1,530
12061000006,1906,1730,1555,80,29,46,17,1,175
12061000007,2476,2209,1982,119,65,29,11,0,227
12001000071,2213,1812,1359,103,278,65,26,4,453
12001000049,3521,3032,1986,255,629,55,83,2,1046
12001000067,2952,2382,1648,117,496,58,35,2,734
12001000038,7203,5760,4198,426,436,102,555,4,1562
12001000045,2888,2326,1605,219,263,35,199,3,721
12031000183,2754,2024,1107,181,586,75,88,2,917
12031000247,3051,2606,2303,101,63,37,73,8,303
12031000280,3168,2620,1804,274,403,44,105,10,816
12031000009,3283,2417,973,178,1133,30,130,9,1444
12031000228,2694,2177,1427,145,462,52,81,5,750
12031000278,4384,3497,1772,493,899,105,275,12,1725
12031000030,3645,2588,698,476,1338,54,76,12,1890
12031000176,2037,1548,397,107,1002,24,35,4,1151
12031000127,986,729,127,43,535,18,15,1,602
12031000131,5570,4906,1644,182,3044,35,51,7,3262
12031000250,3157,2801,2230,150,257,60,106,3,571
12031000082,2938,2217,1966,118,35,24,69,3,251
12086000705,4583,3869,222,3550,91,11,44,1,3647
12086000749,2875,2261,582,1540,97,7,50,0,1679
12086000747,3671,3184,282,2716,166,40,61,5,2902
12086000556,6670,5778,167,5471,211,24,57,1,5611
12086003450,12,7,0,6,3,0,0,0,7
12086000551,5973,5020,111,4840,240,11,38,4,4909
12086000462,20836,15105,878,13364,328,86,438,7,14227
12086005340,4785,4311,931,2770,385,51,187,4,3380
12086006580,16,13,4,6,2,0,2,1,9
12086005360,284,212,55,70,91,2,0,1,157
12086000142,7424,5704,466,1867,3354,58,131,6,5238
12086000628,1627,1250,498,641,38,5,67,2,752
12086000965,12763,9429,642,8272,197,81,246,1,8787
12086000366,6603,4976,527,4074,109,33,207,4,4449
12086005880,19,11,0,8,1,0,1,0,11
12086005881,0,0,0,0,0,0,0,0,0
12086000589,682,520,6,488,58,2,1,0,514
12086000285,486,400,8,386,27,2,0,0,392
12031000078,2848,2131,1728,156,100,32,112,5,403
12031000264,3171,2664,2248,132,152,41,79,2,416
12031000168,2963,2082,416,93,1532,26,26,1,1666
12031000181,2552,1875,633,114,1075,43,37,2,1242
12031000054,4632,3589,2197,394,523,50,397,19,1392
12031000248,3496,2789,2527,115,38,43,33,1,262
12031000028,5075,4050,2501,608,528,84,348,7,1549
12031000069,4077,3381,2304,338,468,62,224,4,1077
12021000112,7510,6467,3978,1677,670,74,54,3,2489
12021000109,819,746,614,74,18,7,25,0,132
12021000107,1630,1522,1443,31,5,17,28,0,79
12021000020,2448,2052,1644,317,24,15,49,4,408
12021000127,851,721,650,57,2,16,4,3,71
12021000111,308,249,187,18,22,23,2,5,62
12021000135,363,313,268,34,2,2,7,0,45
12021000003,1727,1695,1577,81,19,13,11,0,118
12029000008,3931,3441,1946,256,1198,43,11,5,1495
12029000011,442,369,336,15,1,10,5,2,33
12027000003,1377,1152,977,104,26,25,4,1,175
12119000128,4453,4435,4256,64,39,31,29,0,179
12119000107,3277,3266,3126,63,18,20,24,3,140
12027000009,1006,855,766,56,14,17,3,1,89
12027000016,4157,3768,2213,738,774,32,16,4,1555
12027000013,2545,2229,1945,124,111,33,10,5,284
12031000134,376,359,136,17,193,8,3,0,223
12031000242,5846,4438,1547,544,2075,72,256,14,2891
12083000037,1909,1639,1296,105,164,49,12,2,343
12083000039,2514,2121,1425,166,472,46,15,2,696
12083000042,3409,2949,2311,333,222,56,13,5,638
12083000093,5320,4013,1267,1315,1309,81,100,11,2746
12083000071,6223,4696,2732,981,821,97,94,9,1964
12083000066,3885,3046,2083,449,390,93,56,15,963
12083000021,5413,4200,3021,680,315,112,60,15,1179
12083000091,4275,3281,1090,1154,964,77,71,21,2191
12083000105,5318,4280,3309,630,182,111,38,6,971
12086000228,4670,3433,26,1107,2425,17,6,2,3407
12086000913,6160,4830,1271,2970,501,54,117,3,3559
12086000903,11139,7832,334,4924,2634,90,177,3,7498
12086000642,1236,1008,246,490,26,17,233,0,762
12086000625,3555,2862,948,1487,118,35,287,3,1914
12086000616,2017,1541,663,734,37,3,82,1,878
12086000744,5768,4706,635,3770,232,38,126,2,4071
12086000951,6599,4462,246,2886,1403,83,19,1,4216
12086000920,6113,4069,131,2388,1581,191,31,14,3938
12086000426,7233,6061,467,5413,194,52,63,4,5594
12086000602,2016,1562,433,1039,43,19,50,1,1129
12086002812,0,0,0,0,0,0,0,0,0
12086002810,612,484,11,457,39,5,0,0,473
12086002811,477,363,8,338,42,1,1,0,355
12086000346,2576,2078,524,1494,38,13,31,2,1554
12086000383,0,0,0,0,0,0,0,0,0
12086000362,4674,3973,65,3880,73,7,15,5,3908
12086000848,1975,1656,469,1054,86,24,46,0,1187
12086000422,1970,1651,114,1516,27,21,19,1,1537
12086000418,1632,1318,75,1217,16,10,17,0,1243
12086000507,2957,2096,15,558,1601,29,6,1,2081
12086000505,2979,2288,60,399,1892,9,25,4,2228
12086000506,2506,1911,61,395,1511,24,14,0,1850
12086000910,5906,4514,307,3734,498,80,56,1,4207
12086000911,7189,5310,306,4478,571,56,69,1,5004
12086000343,5214,4344,499,3705,126,29,55,5,3845
12031000057,5152,4356,3410,374,275,79,178,30,946
12031000279,1983,1654,1434,66,51,36,52,1,220
12001000065,3865,3072,2445,211,280,70,48,5,627
12001000001,1902,1579,1150,103,260,41,19,1,429
12001000055,3238,2840,1633,386,619,60,154,11,1207
12086000242,5369,4119,64,1183,2944,54,36,8,4055
12086000160,2259,1869,186,458,1105,16,51,2,1683
12086000243,2198,1633,38,375,1273,12,8,0,1595
12086000221,3403,2697,54,513,2185,15,26,5,2643
12086000295,4678,3586,48,743,2899,16,20,3,3538
12086000223,3623,2831,42,773,2058,41,74,9,2789
12086000226,2684,2085,31,724,1341,10,14,11,2054
12086000225,4172,3302,77,1516,1852,22,18,12,3225
12086000230,4164,3348,110,2562,746,7,55,0,3238
12086000152,2848,2314,329,834,1111,30,88,2,1985
12086000144,377,298,14,80,207,1,3,0,284
12086000177,2382,1899,782,816,219,38,85,7,1117
12086000129,5005,3876,243,902,2652,45,143,22,3633
12086002390,5445,4144,116,675,3428,13,27,9,4028
12086000579,4960,4196,596,3406,154,45,87,7,3600
12086000052,37,34,22,9,1,1,1,0,12
12086000051,14809,10670,3112,6947,66,50,127,13,7558
12086000854,4274,3350,771,2148,395,43,101,0,2579
12086000822,3391,2789,1036,1418,245,47,84,1,1753
12086000615,2272,1708,669,952,29,4,36,0,1039
12086000953,3696,2780,655,1858,225,46,49,9,2125
12086000693,3102,2499,151,2138,169,36,94,5,2348
12086000694,6901,5206,446,4386,309,64,137,0,4760
12086000764,7252,5957,300,5333,189,63,223,3,5657
12086000451,4341,3544,139,3359,45,8,37,1,3405
12086000456,934,925,196,277,481,2,4,1,729
12086000445,21,16,2,10,4,1,4,1,14
12086000370,10943,8667,747,7264,277,60,370,3,7920
12086000812,3796,3083,365,1887,779,42,105,2,2718
12086000806,2148,1633,761,707,69,8,105,0,872
12086000810,4208,3198,1522,1369,128,15,156,1,1676
12031000019,1339,1101,931,47,34,33,43,1,170
12031000244,7033,5102,1706,750,2355,103,288,21,3396
12105000537,6424,5536,3763,811,858,94,28,7,1773
12105000539,2530,2120,1454,335,291,43,11,1,666
12105000536,2474,2019,1588,207,157,44,19,6,431
12105000533,3477,3040,2294,537,114,57,67,5,746
12105000416,6468,4882,2180,1426,1108,110,112,6,2702
12105000525,609,515,418,48,35,10,3,1,97
12105000519,2656,1990,1037,570,317,50,50,4,953
12105000216,2146,1733,1207,287,204,31,28,2,526
12105000222,3004,2522,1716,488,248,36,49,3,806
12105000214,4059,2990,1262,783,869,71,26,9,1728
12105000221,4692,4056,2978,662,244,63,114,6,1078
12105000213,3049,2073,834,940,241,88,9,6,1239
12105000204,5165,3592,268,609,2712,68,23,13,3324
12105000209,3620,2734,1104,778,811,77,17,2,1630
12105000212,4047,3230,1941,897,336,71,39,4,1289
12105000210,2039,1654,441,306,880,41,20,1,1213
12105000201,7204,5738,3213,1342,1027,151,100,9,2525
12105000116,2164,1655,1090,318,200,22,43,0,565
12105000125,716,564,333,120,94,16,8,0,231
12105000403,5685,4428,2099,1420,610,97,245,8,2329
12105000401,8055,6525,3200,2282,818,152,215,12,3325
12105000421,2487,2142,1386,506,163,36,68,4,756
12105000406,4453,3405,1584,1370,316,93,80,11,1821
12105000404,11505,8515,3171,3920,1193,232,203,21,5344
12105000419,14285,9868,1329,5657,3047,212,145,22,8539
12105000412,12707,9278,1070,5826,2386,164,224,22,8208
12105000538,3890,3290,1548,968,735,41,7,2,1742
12105000541,45,40,11,28,0,0,0,0,29
12105000518,3674,2835,2081,549,138,45,27,5,754
12105000506,2199,1668,1266,238,124,32,20,1,402
12105000508,2464,1936,1472,306,83,53,24,4,464
12031000051,3185,2633,2259,139,62,44,116,7,374
12031000194,2700,1940,84,34,1825,23,5,3,1856
12031000197,3239,2527,51,31,2431,31,13,1,2476
12031000086,3761,3116,2075,410,445,48,142,4,1041
12031000269,4077,3080,1526,428,1010,54,121,8,1554
12031000271,4229,3130,1500,415,991,83,178,16,1630
12031000004,2585,2031,976,247,559,57,211,6,1055
12031000232,2147,1707,1181,144,293,30,83,0,526
12031000292,1842,1453,927,126,304,35,67,5,526
12031000255,3832,3140,2759,167,59,65,71,5,381
12001000028,7173,6379,2901,1396,1240,84,848,5,3478
12001000027,7062,6219,2872,886,1292,96,1121,9,3347
12001000058,11961,10873,4688,2009,1809,125,2374,36,6185
12001000024,5964,4624,2165,845,1192,114,335,7,2459
12001000059,4819,4014,2712,403,469,68,333,4,1302
12001000007,4278,3259,1798,274,1021,81,86,6,1461
12001000008,6262,4889,3500,515,619,124,145,12,1389
12001000039,3941,3233,2315,300,209,44,350,8,918
12086000311,8210,6796,145,6565,193,42,44,5,6651
12061000008,6111,5257,4431,435,211,88,80,8,826
12086000259,3129,2452,40,1467,1005,27,6,2,2412
12086006590,653,560,284,207,20,9,24,0,276
12086006591,1,1,1,0,0,0,0,0,0
12086000111,7173,5811,2588,2482,305,31,157,2,3223
12086000099,2305,2076,1348,552,47,14,33,1,728
12086000614,1660,1301,493,742,22,10,32,3,808
12086000611,2612,2025,629,1255,50,17,67,1,1396
12086000634,393,321,37,60,223,3,2,0,284
12086000798,8192,6215,323,5584,142,30,219,2,5892
12105000205,4282,3010,377,601,2033,57,27,3,2633
12105000121,5532,4080,1835,1010,910,61,310,7,2245
12105000407,8876,6432,935,3222,2273,126,94,14,5497
12105000405,3347,2262,511,1520,228,82,15,7,1751
12105000218,5106,4238,2509,903,686,101,78,4,1729
12105000309,6338,4728,3055,935,491,154,89,8,1673
12105000322,4490,3323,1448,730,1100,83,26,4,1875
12105000316,2125,1678,713,323,610,30,14,6,965
12086000728,5086,4327,658,3440,164,16,92,3,3669
12086000928,8768,6162,1177,3547,1375,77,149,12,4985
12086000923,466,373,184,142,35,5,16,0,189
12086000759,3154,2442,225,1870,249,21,121,0,2217
12086000700,1891,1427,119,1076,155,6,95,0,1308
12086000425,2051,1794,75,1701,34,6,13,0,1719
12086000427,2536,2157,94,2035,37,7,10,1,2063
12086000284,3564,2845,66,2738,181,25,12,1,2779
12086007190,2667,2076,509,1406,90,31,88,2,1567
12086000720,2631,2172,434,1583,63,19,91,0,1738
12086000891,7368,5379,291,3766,1366,43,142,6,5088
12086000905,2837,1863,127,1205,555,21,24,1,1736
12086000695,5146,3944,290,3312,273,22,117,0,3654
12086000794,3590,2861,458,1992,332,25,95,4,2403
12086000786,4624,3663,286,3039,254,43,136,3,3377
12086000851,6069,4803,116,3584,1228,38,57,5,4687
12086008270,2302,1877,61,1537,280,22,38,2,1816
12086000702,3511,2825,225,2480,115,32,59,3,2600
12086000697,3529,2956,204,2607,102,21,56,2,2752
12086000565,4813,3971,200,3596,263,86,37,3,3771
12086000669,8289,6710,424,6062,334,122,63,1,6286
12086000566,6775,5899,901,4622,359,137,124,7,4998
12086005310,4371,3402,137,2131,1239,31,61,3,3265
12086000276,2619,2041,62,502,1518,19,35,5,1979
12086002391,0,0,0,0,0,0,0,0,0
12031000103,3090,2555,2132,152,118,55,84,1,423
12031000211,9644,7427,3772,740,2472,198,318,28,3655
12031000275,2680,2236,1696,168,248,42,77,9,540
12031000106,3011,2367,1935,146,128,39,100,4,432
12057000567,4978,3668,616,1739,1326,113,51,10,3052
12057000573,928,732,313,275,124,29,24,0,419
12057000207,3026,2187,383,590,1231,33,47,4,1804
12057000753,7488,5231,1419,1649,2050,76,86,5,3812
12057000635,4044,3166,1702,474,845,67,119,7,1464
12057000138,848,527,166,101,252,8,6,1,361
12057000948,2593,1980,960,924,52,36,27,6,1020
12057000911,1992,1724,1316,345,22,27,14,4,408
12057000150,21,11,6,5,0,4,0,0,5
12057000146,0,0,0,0,0,0,0,0,0
12057000037,11699,8806,6222,1142,484,83,779,11,2584
12086000529,8067,6146,173,5317,1146,88,35,0,5973
12086000980,1858,1529,43,1306,265,38,7,0,1486
12086000535,3028,2378,200,1820,399,40,41,4,2178
12086000940,1754,1304,65,1105,139,11,16,0,1239
12086000931,2676,2036,101,1702,255,24,17,0,1935
12086000901,2776,2205,628,1411,92,63,63,4,1577
12086000974,3158,2665,62,2573,60,7,26,0,2603
12086000971,2345,2008,37,1940,78,9,14,0,1971
12086004341,1498,1233,89,1122,31,16,10,2,1144
12086004340,1724,1388,110,1263,16,8,9,2,1278
12086000723,3009,2426,383,1976,35,6,57,0,2043
12086000716,2403,1993,214,1744,19,21,9,1,1779
12086000307,3111,2522,385,2061,49,13,32,0,2137
12086000713,4072,3434,205,3174,65,21,29,0,3229
12086000842,627,532,83,290,116,0,43,0,449
12086000463,501,501,206,98,198,5,0,0,295
12086000453,1746,1706,432,487,807,1,6,1,1274
12086000298,3149,2534,550,1902,60,15,49,5,1984
12086000465,3912,3400,110,3238,104,30,41,1,3290
12086000557,5606,4750,154,4544,97,32,36,1,4596
12086000643,1916,1573,286,1247,37,14,24,0,1287
12086000603,711,581,83,469,26,5,5,0,498
12086000601,2260,1796,508,1193,32,12,68,0,1288
12086000575,7064,6146,326,5695,170,16,50,3,5820
12086000377,7436,6194,120,6021,127,24,22,2,6074
12086000448,4090,3424,205,3057,80,22,130,2,3219
12086000919,5856,4035,571,2766,723,75,91,3,3464
12086000895,3182,2241,283,1406,487,42,111,4,1958
12086000938,12,8,3,5,3,0,0,1,5
12086000939,0,0,0,0,0,0,0,0,0
12001000026,2538,1928,555,215,1058,55,56,3,1373
12001000015,4301,3219,2235,330,286,65,297,7,984
12001000016,5016,3720,2496,336,368,35,459,6,1224
12001000064,2986,2326,1487,89,642,75,26,1,839
12001000005,818,668,591,18,26,22,3,0,77
12001000068,2049,1730,1335,82,234,65,23,5,395
12009000220,952,873,775,44,11,15,23,0,98
12009000226,4181,3891,3390,208,102,79,83,5,501
12009000200,2340,2029,1671,138,101,45,67,6,358
12009000239,10,4,4,0,0,0,0,0,0
12009000201,3982,3248,2746,201,79,65,140,10,502
12009000240,1439,1190,995,58,20,33,64,2,195
12009000202,4167,3467,2883,235,93,105,134,6,584
12009000214,4417,3501,1958,490,962,86,50,4,1543
12009000234,520,415,283,43,67,12,8,1,132
12009000102,1182,1014,907,44,29,17,9,1,107
12009000404,6984,5922,5123,321,91,126,208,12,799
12009000205,8569,7107,6088,438,118,149,257,15,1019
12009000217,4199,3582,3044,209,70,48,146,11,538
12009000303,11628,9779,6181,1388,1781,278,267,21,3598
12009000507,7846,6227,4647,749,387,163,268,15,1580
12086004300,2399,2014,178,1797,37,15,45,2,1836
12086004301,1359,1129,81,1025,34,3,19,1,1048
12086000224,3434,2608,44,1277,1445,15,13,6,2564
12086000592,4611,3633,131,3300,312,78,35,4,3502
12086000526,1673,1341,43,1265,66,19,16,2,1298
12086000249,3325,2691,20,1225,1542,18,9,0,2671
12086000632,3051,2325,957,1098,87,10,138,0,1368
12057000151A,2316,2076,1570,223,120,29,128,8,506
12057000153A,862,750,607,72,21,6,44,2,143
12057000157,1182,1079,835,116,41,19,76,0,244
12057000221,169,143,30,108,4,1,2,0,113
12086000143,6953,5689,685,2100,2845,44,137,2,5004
12086000461,5247,4183,168,3906,71,25,77,3,4015
12086000402,5013,3928,155,3685,51,17,59,2,3773
12086000721,6882,6044,1156,4497,202,31,192,2,4888
12099000239,8435,5956,762,3298,1814,172,128,9,5194
12099000240,19,18,0,7,11,3,1,0,18
12099000241,3520,2388,432,1754,170,121,24,6,1956
12099000087,2542,2065,1816,150,25,27,31,4,249
12099000084,172,127,109,5,7,1,8,0,18
12099000083,505,417,319,57,16,9,15,1,98
12099000781,2635,2112,488,219,1353,19,68,5,1624
12099000780,2462,2155,1246,376,460,11,77,4,909
12099000229,4188,3585,1599,602,1200,49,156,4,1986
12099000213,4860,3905,1369,738,1553,43,237,5,2536
12099000214,2261,1986,1239,307,337,28,99,8,747
12099000727,4162,2906,895,836,941,29,232,5,2011
12099000052,2739,2621,2399,92,48,8,71,1,222
12099000172,2215,1753,1218,235,143,27,132,1,535
12099000048,2260,2155,1917,125,38,9,52,0,238
12099000046,2914,2581,2227,198,66,18,58,0,354
12099000319,1574,1246,440,454,305,36,32,3,806
12099000318,558,447,189,146,86,10,6,0,258
12099000251,2826,2257,1470,633,89,42,46,0,787
12099000581,4686,3256,2483,358,132,13,164,3,773
12099000729,1542,1138,472,194,310,12,141,0,666
12099000726,0,0,0,0,0,0,0,0,0
12099000682,2402,1864,849,465,429,8,126,3,1015
12099000689,3214,2547,1259,588,578,46,92,11,1288
12099000095,3369,2463,974,1370,44,145,42,3,1489
12099000643,2598,2035,1203,419,248,39,110,6,832
12099000658,3454,2708,1564,442,499,40,168,16,1144
12099000641,3249,2566,1470,484,446,59,121,4,1096
12099000645,4275,3060,81,383,2597,10,25,0,2979
12099000303,2996,2389,763,445,991,35,170,1,1626
12099000223,2505,2067,778,483,697,13,96,6,1289
12099000273,3605,2596,519,1610,401,58,78,0,2077
12099000270,4537,3628,1204,1676,676,37,119,7,2424
12099000283,2773,2390,1139,736,431,7,74,1,1251
12099000652,433,358,253,58,25,14,9,0,105
12099000656,3635,2807,1704,492,460,38,111,8,1103
12099000669,906,675,305,191,139,9,47,2,370
12099000731,881,681,416,190,50,21,17,1,265
12099000736,97,80,36,30,4,7,3,2,44
12099000253,1347,1150,421,354,280,21,77,2,729
12099000277,11,8,0,3,2,3,0,3,8
12085000003,8628,7568,6081,769,509,114,108,5,1487
12085000061,6536,5701,5201,294,40,53,76,5,500
12061000032,8327,6841,5766,607,193,90,144,1,1075
12055000006,2502,2273,2071,105,41,17,19,0,202
1205500002N,392,307,91,39,166,4,9,1,216
1205500004D,5220,4277,2663,838,406,49,328,0,1614
12057000943,4010,2927,1372,1031,439,92,66,6,1555
12057000945,1982,1477,855,500,57,48,21,4,622
12057000960,1471,1184,839,260,45,24,24,5,345
12057000942,7732,5303,1652,1831,1642,128,203,17,3651
12057000959,2255,1828,759,504,524,26,61,3,1069
12057000111,2777,2248,1807,267,50,22,86,2,441
12057000175,3608,2975,1178,1294,387,101,132,5,1797
12057000827,3502,2754,1674,563,358,56,131,1,1080
12057000344,6731,4751,859,1279,2626,88,59,4,3892
12057000335,2207,1802,1041,396,262,46,67,5,761
12057000338,4568,3216,557,1037,1632,43,47,4,2659
12099000809,3755,2768,688,961,1119,70,30,7,2080
12099000874,10,1,1,0,0,0,0,0,0
12099000351,1045,862,614,139,64,30,37,2,248
12099000886,37,36,32,4,0,0,0,0,4
12099000634,3142,2347,338,1447,542,37,30,4,2009
12099000638,1755,1242,145,857,245,13,3,0,1097
12099000630,857,591,41,245,306,13,5,0,550
12099000751,2061,1741,1297,240,146,12,59,2,444
12099000076,3111,2515,1808,457,124,46,84,7,707
12099000072,1557,1091,339,546,182,32,21,0,752
12099000654,801,655,403,133,86,16,15,1,252
12099000361,3828,2984,1992,528,281,29,158,3,992
12099000326,4440,3394,1023,2038,311,67,69,6,2371
12085000063,9284,7670,5456,1423,553,110,161,6,2214
12009000318,3840,3489,3209,136,26,23,54,8,280
12009000219,6151,4752,2872,481,1170,104,155,15,1880
12009000132,0,0,0,0,0,0,0,0,0
12009000223,1308,1009,646,147,151,24,63,11,363
12009000126,0,0,0,0,0,0,0,0,0
12009000315,7076,5864,3430,1117,994,115,216,6,2434
12009000409,7509,6295,5495,348,91,129,181,12,800
12009000522,525,445,309,21,89,14,11,0,136
12009000203,5752,4763,3685,417,303,125,177,33,1078
12009000231,2806,1959,605,582,726,49,35,6,1354
12009000233,1350,943,205,111,613,20,4,4,738
12009000208,2505,2211,1925,115,40,52,59,5,286
12009000222,3906,3463,3053,181,45,56,95,3,410
12009000509,1130,1014,738,134,104,23,18,2,276
12009000310,3910,3422,2514,428,206,62,210,5,908
12009000323,995,954,660,109,93,12,75,2,294
12009000523,1387,1168,880,136,53,26,54,10,288
12009000502,4748,3855,3011,395,219,111,138,15,844
12009000312,3127,2938,2735,87,27,35,31,4,203
12009000320,132,112,75,10,22,1,4,2,37
12111000091,263,184,110,37,35,7,2,0,74
1211100091A,804,573,162,191,220,7,14,0,411
12111000085,11687,8628,3750,2029,2476,138,268,23,4878
12111000013,6072,4631,2237,1388,842,127,84,12,2394
12111000028,2810,2234,1871,211,51,54,45,9,363
1211100043A,3803,3559,2895,264,177,28,196,8,664
12111000024,2669,1955,264,165,1507,30,7,4,1691
12111000006,3611,2704,1204,556,814,66,85,3,1500
1211100006B,128,84,16,27,30,6,8,2,68
12111000092,1472,1368,662,98,592,11,9,0,706
1211100006A,429,351,125,50,140,5,34,0,226
1211100006C,0,0,0,0,0,0,0,0,0
12086007071,0,0,0,0,0,0,0,0,0
12086007070,1233,981,86,861,34,9,8,0,895
12086000970,951,740,59,654,16,14,9,6,681
12086000836,0,0,0,0,0,0,0,0,0
12086000604,4540,3980,1183,2544,101,31,149,6,2797
12086000644,1051,866,294,525,18,7,29,1,572
12086002660,180,155,1,91,77,0,0,0,154
12086000553,3722,3216,95,3098,83,25,5,1,3121
12086000552,2208,1903,43,1829,28,10,22,1,1860
12086002481,1754,1439,20,769,692,16,4,3,1419
12086002480,3960,3276,49,2712,649,44,18,3,3227
12086000246,5909,4986,85,4546,482,28,18,5,4901
12086000001,961,725,470,237,2,1,4,1,255
12086000832,2822,2213,357,1528,326,17,39,1,1856
12086000646,265,195,123,63,0,3,2,0,72
12086004700,5365,4475,277,3976,157,28,141,3,4198
12086000447,5819,4705,182,4348,120,45,120,4,4523
12086000030,4208,3614,2388,947,86,21,114,3,1226
12086004370,1609,1366,64,1283,25,9,9,1,1302
12086004371,1415,1233,57,1165,8,2,16,2,1176
1208600463A,0,0,0,0,0,0,0,0,0
12086000394,0,0,0,0,0,0,0,0,0
12086000468,3858,2937,249,2437,101,39,108,1,2688
12086003411,0,0,0,0,0,0,0,0,0
12086003451,7,6,0,5,1,4,1,0,6
12086000347,2364,2024,239,1733,37,17,32,0,1785
12086003140,395,359,46,271,29,1,13,1,313
12086000395,0,0,0,0,0,0,0,0,0
12086000577,5970,5100,859,4002,179,58,130,5,4241
1200300004B,922,713,642,23,12,30,2,2,71
12099000181,120,117,34,26,57,0,1,1,83
12099000183,375,329,246,35,25,15,14,2,83
12099000853,404,399,353,32,13,0,4,0,46
12099000182,0,0,0,0,0,0,0,0,0
12099000659,2533,2010,1049,330,435,45,128,7,961
12099000724,3479,2724,1470,756,367,46,109,5,1254
12099000719,3467,2587,1008,907,512,46,126,10,1579
12099000341,1971,1612,841,439,272,24,43,3,771
12099000339,2181,1770,1063,452,206,41,41,5,707
12099000807,4990,3900,1649,903,1243,72,78,12,2251
12099000806,3137,2422,1091,499,734,54,57,3,1331
12099000194,1648,1570,1468,60,9,5,27,1,102
1209900NP02,5,2,0,2,0,0,0,0,2
12099000449,1458,1312,1060,143,31,6,46,1,252
12099000452,2803,2354,1633,357,121,16,181,10,721
12099000111,2630,2004,1620,194,62,25,106,0,384
12099000108,3183,2581,1934,274,109,28,202,4,647
12086000594,2933,2336,25,2247,185,50,10,0,2311
12086000595,2015,1608,23,1552,178,22,2,1,1585
12086000779,1542,1263,148,1061,26,7,40,4,1115
12086000778,1159,962,94,822,27,13,44,1,868
12086000726,1499,1237,139,1083,12,12,12,1,1098
12086000521,3818,2918,51,979,2040,25,12,7,2867
12086000520,4699,3513,56,1241,2317,35,13,1,3457
12086000514,3453,2674,61,876,1825,25,27,2,2613
12086000519,3031,2402,158,700,1623,17,13,3,2244
12086000126,3621,2896,141,808,1869,12,126,0,2755
12086000122,39,26,6,11,10,0,3,0,20
12083000086,3090,2868,2571,146,63,58,30,5,297
12083000085,2580,2245,1888,130,177,32,21,3,357
12083000074,2179,1731,1380,172,93,27,61,3,351
12083000072,1807,1463,1166,131,92,43,15,2,297
12083000069,6171,4653,2722,963,734,118,125,11,1931
12083000068,2703,1947,938,436,485,36,77,9,1009
12083000067,8919,6889,3575,1312,1733,161,188,21,3314
12083000028,2395,2145,1978,44,16,59,10,4,167
12083000029,3067,2480,2185,118,45,97,11,7,295
12083000025,784,702,622,30,13,32,7,1,80
12083000035,3975,3137,2481,244,285,91,41,2,656
12001000044,2537,2176,1802,146,110,34,85,2,374
12001000047,5574,5104,3677,759,206,54,365,9,1427
12001000041,4393,3716,2387,426,657,48,228,2,1329
12105000228,2952,2315,1641,374,216,31,45,1,674
12086000523,2942,2225,38,1791,637,56,11,0,2187
12086000979,1765,1419,206,1159,40,7,24,1,1213
12086000130,6446,5132,432,1089,3565,66,111,11,4700
12086001381,0,0,0,0,0,0,0,0,0
12086001820,1086,902,140,327,436,6,30,9,762
12086001821,590,471,49,138,299,2,8,2,422
12086000215,3926,3107,124,561,2477,26,35,1,2983
12086000216,4360,3380,89,580,2801,11,22,2,3291
12086000280,2236,1567,14,346,1259,4,2,0,1553
12086000706,4891,4071,218,3816,75,14,21,4,3853
12086000617,4261,3504,1431,1878,43,22,91,4,2073
12086000626,737,571,282,260,12,5,15,1,289
12086000205,3914,2773,39,499,2301,19,34,8,2734
12086000356,4521,3601,110,3159,366,43,83,6,3491
12086000351,7811,6149,344,5046,797,64,143,2,5805
12086000482,0,0,0,0,0,0,0,0,0
12086000623,841,689,262,384,22,9,20,5,427
12086000636,4026,3274,1074,1999,81,15,112,4,2200
12086000607,2442,2071,732,1277,16,12,36,0,1339
12086005330,4044,2986,99,751,2220,27,18,0,2887
12086000518,2440,1992,250,958,851,26,21,1,1742
12086000667,2120,1758,207,1473,61,17,34,3,1551
12086000609,2601,2237,736,1341,50,17,65,0,1501
12009000316,6199,4772,2874,781,891,105,132,7,1898
12031000076,6921,5894,3276,869,779,101,886,17,2618
12031000295,3062,3046,1508,546,971,1,103,5,1538
12099000702,59,38,5,13,10,3,7,4,33
12099000885,768,572,298,121,99,6,50,3,274
12099000732,1146,841,515,142,107,3,79,2,326
12099000728,686,511,266,115,98,1,17,2,245
12099000701,345,324,149,36,139,0,1,0,175
12099000873,1194,912,542,109,166,11,96,2,370
12099000871,149,118,76,14,16,3,6,0,42
12099000872,2041,1392,608,307,320,22,151,4,784
12099000748,1896,1657,1254,221,80,3,94,0,403
12099000208,1417,1390,929,176,260,6,33,2,461
12099000207,3716,2769,748,695,1094,34,242,7,2021
12099000857,660,496,83,106,297,1,15,0,413
12099000858,20,14,0,11,2,3,1,1,14
12099000259,3847,2642,350,2103,164,96,57,2,2292
12099000487,3617,2518,1979,259,107,13,54,1,539
12099000448,3224,2788,2157,256,171,29,154,1,631
12105000106,2071,1639,1252,223,92,64,15,4,387
12105000114,6634,4979,2838,1130,857,101,115,10,2141
12057000240,6435,5280,1600,2979,564,83,199,5,3680
12057000241,20,17,3,7,6,3,1,0,14
12057000407,6276,4899,808,3675,448,57,108,8,4091
12057000947,8415,6094,2687,1501,1681,102,235,23,3407
12057000359,5813,4340,1872,774,820,34,882,4,2468
12057000047A,11221,8433,3480,1308,1325,86,2291,13,4953
12086000007,3701,2840,1392,1245,99,15,39,1,1448
12086000008,2221,1747,742,883,66,17,34,1,1005
12086000770,4792,3894,242,3454,118,14,103,3,3652
12086000765,6206,5165,523,4301,302,28,122,2,4642
12086000349,6696,5449,131,5293,157,28,26,3,5318
12086000218,2228,1672,16,455,1216,19,6,1,1656
12123000014,1954,1520,1375,26,46,53,21,1,145
12065000012,1022,822,551,18,222,24,5,0,271
12123000010,1103,851,704,24,62,36,21,1,147
12123000012,1703,1298,816,31,403,23,19,0,482
12057000625,2477,1797,680,752,311,52,58,5,1117
12057000659,2687,2302,1365,333,402,48,184,4,937
12057000321,6014,4333,461,705,3198,72,28,5,3872
12057000116B,4068,2934,1842,430,408,75,208,17,1092
12057000142,445,360,237,69,32,9,14,1,123
12057000933,578,433,259,71,81,2,22,0,174
12057000061,3236,2415,1419,476,386,46,128,4,996
12057000233,4247,3212,1340,1010,811,79,75,10,1872
12001000040,5025,4394,2848,658,511,55,326,13,1546
12001000051,4335,3551,2237,416,583,74,242,3,1314
12001000052,2038,1673,1363,139,84,11,69,1,310
12001000020,3697,2868,1944,230,190,51,458,8,924
12099000403,1769,1678,1252,204,173,12,22,2,426
12113000014,1278,1023,922,16,14,50,17,3,101
12113000011,1925,1527,1317,68,51,71,24,5,210
12113000007,441,340,297,4,5,23,5,0,43
12113000017,1448,1122,1011,21,9,53,12,3,111
12113000042,5348,3821,3237,165,135,115,140,7,584
12113000020,4044,2975,2452,130,140,123,128,17,523
12113000033,10299,9228,5059,940,3000,179,64,19,4169
12113000009,4393,3490,2920,74,207,185,58,7,570
12113000001,2221,1690,1243,69,235,71,82,8,447
12113000004,2659,2066,1890,21,13,113,21,8,176
12113000002,5826,4188,3630,143,109,160,113,11,558
12031000209,8476,6436,3653,565,1732,186,333,31,2783
12031000157,4257,3148,1495,117,1415,59,47,6,1653
12031000112,5019,3881,2543,301,410,45,585,8,1338
12031000125,2375,1882,233,59,1577,29,24,7,1649
12031000066,2192,1687,842,429,342,55,54,2,845
12009000306,2891,2299,831,209,1145,25,106,2,1468
12009000300,4171,3478,1816,326,1228,50,86,6,1662
12083000099,12695,12627,11532,513,259,84,168,10,1095
12083000100,3183,2792,2195,314,180,32,61,4,597
12083000108,1092,1028,894,61,35,21,19,4,134
12083000009,6149,4933,1722,900,2309,84,33,4,3211
12083000010,2279,1762,512,153,1054,40,10,3,1250
12083000087,4496,3654,2710,523,258,109,59,2,944
12083000022,1928,1637,1361,118,112,30,17,0,276
12083000089,1948,1587,1230,252,40,50,23,4,357
12083000103,3961,3278,2585,425,144,81,40,3,693
12083000004,7189,5673,3670,758,989,129,160,11,2003
12083000032,3629,3021,2628,156,117,71,30,2,393
12083000078,5172,3999,3214,360,218,99,110,7,785
12083000014,4862,3723,2863,406,171,69,224,11,860
12083000006,5192,4344,3274,520,391,86,107,6,1070
12123000002,3598,3161,1823,289,990,34,11,1,1338
12123000005,1296,1178,1091,24,5,42,12,1,87
12123000007,2075,1614,1474,34,47,54,8,4,140
12107000024,4163,3231,2683,220,172,119,30,9,548
12107000027,2599,2053,1743,74,163,45,33,4,310
12107000028,2553,1997,1289,97,531,56,23,0,708
12057000704,1382,954,642,170,53,30,63,1,312
12057000217,3474,2981,1661,861,359,66,68,6,1320
12057000946,8300,6001,2199,1920,1628,94,256,16,3802
12057000462,446,394,207,128,32,4,23,3,187
12057000504,5426,4382,1312,2268,556,81,276,1,3070
12057000503,5828,4617,1648,2051,504,59,390,7,2969
12057000579,3252,2723,2008,421,158,41,109,10,715
12057000571,3051,2470,1215,790,349,71,95,1,1255
12107000037,2607,1961,1033,122,755,37,15,2,928
12107000011,4725,3890,2906,222,675,50,29,6,984
12037000005,3487,3143,2133,213,718,68,6,1,1010
12035000201,6214,4862,3223,633,736,71,168,13,1639
12035000215,1075,883,633,83,93,8,57,0,250
12035000212,0,0,0,0,0,0,0,0,0
12035300000,4118,3275,2929,144,69,88,28,1,346
12035310000,61,42,32,3,1,3,0,0,10
12035110000,107,79,54,6,17,1,1,0,25
12035130000,2077,1635,1021,85,483,35,12,1,614
12035100000,649,531,336,89,81,34,6,0,195
12035940000,3897,3045,2276,296,320,58,66,5,769
12035920000,635,532,384,58,62,8,9,0,148
12107000033,1395,1050,614,61,348,23,12,3,436
12049000011,2541,1804,693,1037,51,28,9,1,1111
12103000101,1256,1030,178,51,781,15,21,1,852
12103000219,2600,2078,1502,297,144,54,82,2,576
12103000223,5961,4978,3555,755,338,107,190,12,1423
12103000218,2876,2480,2074,209,68,51,73,4,406
12103000070,8831,7685,4914,1022,1222,161,400,13,2771
12049000007,4166,3172,1798,1234,56,74,43,8,1374
12103000190,4848,4173,3517,294,171,79,90,10,656
12103000269,2873,2451,1732,302,221,46,126,4,719
12103000281,2916,2816,2555,106,66,33,48,0,261
12103000102,3063,2406,920,136,1304,38,43,2,1486
12103000074,2054,1814,1225,248,98,30,201,0,589
12103000155,3500,3028,2269,246,171,85,261,3,759
12103000154,3474,2804,1766,294,300,62,377,3,1038
12113000026,11317,8538,6386,712,596,295,517,53,2152
12113000010,2498,1825,1463,110,88,62,84,7,362
12113000006,242,195,169,3,2,13,2,1,26
12113000016,5382,4147,3340,182,315,209,81,11,807
12057000067,2462,1712,789,405,425,31,90,6,923
12057000981,21,16,6,6,1,2,0,3,10
12057000076,3483,2339,1061,469,577,67,209,10,1278
12057000761,5844,4480,3153,1078,79,121,68,8,1327
12057000817,5354,4177,2703,763,421,70,243,9,1474
12031000217,5349,4221,2840,487,545,143,227,30,1381
12107000023,2372,1892,1541,185,100,47,11,2,351
12107000022,2439,1925,1542,215,69,74,12,3,383
12107000021,1401,1079,738,221,87,30,3,3,341
12035000332,2951,2659,2388,103,45,52,49,3,271
12035000331,775,682,591,43,24,2,19,1,91
12035000370,2370,2084,1894,80,33,33,28,0,190
12035000372,9,6,0,0,0,0,3,0,6
12035000350,2137,1981,1856,65,6,28,8,0,125
12035000371,1063,917,718,65,95,13,14,0,199
12107000036,1598,1222,668,74,439,23,19,0,554
12107000039,2550,1809,419,71,1289,23,7,2,1390
12107000032,701,553,73,20,453,5,4,0,480
12107000003,2589,2097,1641,308,69,44,21,6,456
12107000014,863,657,626,7,1,14,1,1,31
12105000413,2385,1795,764,471,482,45,27,4,1031
12105000542,4428,3624,2789,539,191,69,55,4,835
12105000207,2742,2080,1168,575,255,71,28,4,912
12105000203,4866,3625,2403,750,369,80,51,2,1222
12105000333,5772,4453,3004,648,635,94,97,9,1449
12105000502,187,145,62,43,36,3,1,0,83
12105000511,3613,2724,2029,446,173,73,18,1,695
12105000325,3821,2895,388,252,2245,25,11,0,2507
12105000324,2590,2166,1345,336,419,57,43,5,821
12105000331,2743,2364,1791,283,226,31,42,2,573
12105000410,2688,1934,583,1198,120,74,21,14,1351
12105000227,1260,977,755,169,26,25,3,2,222
12105000315,1417,1074,800,214,25,33,2,2,274
12105000208,4984,4258,3426,502,219,107,32,4,832
12105000524,4181,3502,2546,591,308,71,18,1,956
12105000248,7906,6136,4598,708,343,83,374,7,1538
12125000010,258,173,164,2,6,2,2,0,9
12125000002,1748,1294,981,62,198,37,8,1,313
12111000046,6121,4789,2313,1174,1051,123,171,17,2476
12111000026,6922,5470,3213,1029,984,114,126,10,2257
12111000051,7228,5375,2474,1381,1265,112,177,10,2901
12111000075,3960,3018,1528,738,620,54,86,12,1490
12111000017,6163,4135,194,316,3631,62,12,5,3941
12111000014,4676,3471,557,404,2468,68,19,0,2914
12111000015,4988,4885,4628,141,23,24,57,10,257
12111000084,8249,6498,3539,1270,1439,89,138,32,2959
12111000021,4319,3916,2818,495,468,65,71,7,1098
1211100021A,302,278,209,36,12,0,12,0,69
12031000243,4970,3800,1450,475,1515,81,341,17,2350
12031000056,5495,4395,3654,236,176,73,227,4,741
12031000266,882,675,472,63,55,16,80,1,203
12031000039,2377,1975,1577,107,128,20,127,4,398
12031000038,3101,2534,1736,231,282,56,258,5,798
12031000088,4731,3617,2019,349,531,35,667,13,1598
12031000091,5176,3875,2248,428,679,67,447,1,1627
12031000150,1478,1077,40,30,996,18,3,2,1037
12035000231,6125,5283,4158,529,365,89,129,10,1125
12107000002,2911,2174,857,949,264,53,68,0,1317
12107000007,2845,2240,1630,445,77,75,22,8,610
12113000027,6814,5187,4384,269,186,148,173,25,803
12083000043,5742,5406,3164,515,1683,43,15,2,2242
12083000036,4526,3491,2413,375,566,78,54,7,1078
12083000011,2253,1491,541,181,749,33,12,3,950
12083000084,2981,2315,1970,169,92,43,35,2,345
12083000003,4908,3729,2545,470,559,66,89,11,1184
12083000012,4356,3271,2193,439,513,94,48,6,1078
12083000051,3383,2627,2239,215,42,97,14,2,388
12083000047,8262,6658,4200,1684,558,154,86,9,2458
12083000106,1509,1224,826,158,187,40,20,2,398
12083000026,1541,1239,1072,66,13,62,9,1,167
12083000058,6051,4968,3933,569,202,102,131,10,1035
12083000060,3284,2565,2067,253,141,65,8,5,498
12083000059,3476,2807,2353,190,165,94,23,6,454
12113000029,5209,3909,2979,329,211,111,247,23,930
12113000034,14792,11030,8385,866,850,383,515,74,2645
12113000036,3162,2400,2098,89,52,68,67,6,302
12113000019,2336,1771,1554,51,22,110,22,9,217
12113000028,4844,3756,3245,186,73,91,126,7,511
12113000024,11137,8366,6853,429,396,327,306,24,1513
12107000025,1747,1421,1267,64,35,48,7,2,154
12107000020,3450,2914,2317,100,401,67,17,1,597
12107000016,2609,2077,1772,106,151,46,13,8,305
12037000006,1022,938,867,17,28,27,1,1,71
12037000003,1899,1519,901,111,480,30,11,3,618
12035000110,4924,3801,2550,450,567,84,149,17,1251
12035000107,3666,3187,2530,270,263,40,102,4,657
12035000100,543,415,172,106,134,8,4,2,243
12035910000,82,65,50,6,2,1,6,0,15
12035000104,550,439,295,36,82,7,11,0,144
12113000008,3026,2408,1796,150,310,104,73,20,612
12113000012,6555,5032,3988,178,461,203,141,31,1044
12125000008,266,204,195,1,3,3,0,0,9
12057000342,5616,4365,1158,1400,1684,75,169,18,3207
12057000806,2944,2244,1585,285,183,47,135,5,659
12057000055,2239,1517,931,238,120,19,194,0,586
12035000130,3898,3073,1908,424,542,100,136,6,1165
12035000134,916,774,536,94,100,13,24,0,238
12107000018,3186,2632,2296,86,152,64,26,1,336
12107000026,2839,2253,2065,52,58,44,23,7,188
12107000035,2585,1909,818,268,780,44,24,5,1091
12107000012,3025,2487,2234,99,43,58,41,7,253
12107000001,1653,1292,676,212,367,27,17,7,616
12111000012,6961,5811,4894,478,217,120,75,4,917
12111000073,10870,8570,5065,1619,1547,123,257,5,3505
12111000042,6412,5649,4572,546,276,103,125,6,1077
12057000855,4503,3546,1558,1073,673,55,273,19,1988
12057000345,5779,4209,1089,1666,1407,77,84,16,3120
12057000131A,4355,3392,2824,337,73,27,118,2,568
12057000145A,1935,1661,1097,403,76,20,65,1,564
12057000935,3632,2862,1881,673,164,94,92,13,981
12057000928,1162,1053,889,106,24,28,15,1,164
12057000151B,0,0,0,0,0,0,0,0,0
12057000087,230,206,163,29,3,5,5,0,43
12057000922,226,219,195,18,2,0,3,0,24
12057000924,74,58,37,17,2,1,2,1,21
12057000073,1314,1044,674,163,153,8,53,1,370
12057000931,0,0,0,0,0,0,0,0,0
12057000431,4808,3732,2030,938,348,80,386,12,1702
12057000658,3028,2507,999,348,626,39,507,9,1508
12057000636,817,664,463,90,78,22,29,3,201
12083000005,2589,1934,1615,146,84,48,37,2,319
12083000002,1634,1137,58,154,924,18,2,2,1079
12083000064,2989,2396,1935,236,114,71,31,5,461
12105000418,4070,3394,2595,538,159,76,34,6,799
12086000947,10199,7264,505,5313,1404,124,205,13,6759
12086000168,6797,4915,174,3823,936,52,117,6,4741
12009000235,3043,2581,2182,167,34,65,115,6,399
12009000206,3660,3138,2537,287,106,95,109,6,601
12009000408,2310,1918,1478,205,129,55,52,4,440
12009000402,5936,4987,3938,455,324,96,169,5,1049
12009000304,6484,6177,5846,120,54,80,27,5,331
12009000426,2148,1792,1542,88,39,27,70,2,250
12009000511,3344,2795,2298,231,76,59,107,2,497
12009000418,4478,3255,2390,363,181,46,268,13,865
12113000013,2065,1606,1408,28,22,103,34,6,198
12105000339,6248,4979,3512,724,478,72,228,6,1467
12105000402,8946,7478,4269,2292,683,150,221,10,3209
12105000302,4307,3302,1318,1545,390,93,83,7,1984
12105000239,4647,3726,3010,398,160,62,92,9,716
12105000512,1134,863,506,75,257,11,13,0,357
12111000082,4717,3729,2132,636,757,62,161,3,1597
12111000023,6163,4747,2583,976,965,89,159,7,2164
1211100082A,659,547,482,26,26,5,9,0,65
1211100082D,0,0,0,0,0,0,0,0,0
12111000056,5490,4498,2712,964,617,84,110,11,1786
12111000008,4465,3610,2800,370,294,68,61,6,810
12111000019,7894,5548,1223,2138,2096,104,56,8,4325
12111000007,4308,3374,1350,814,1130,61,62,6,2024
12111000040,5478,4020,1742,1253,877,120,74,3,2278
12111000018,4273,3096,361,208,2522,54,8,4,2735
12086000135,3861,3033,49,905,2142,11,31,5,2984
12086000134,3133,2464,55,632,1817,5,32,4,2409
12086000136,4390,3551,227,1022,2322,34,56,6,3324
12086000133,2529,2030,71,801,1187,20,31,5,1959
12099000830,3226,2974,2130,240,503,21,62,6,844
12099000832,3683,2629,505,1057,1028,140,32,16,2124
12099000803,6257,4405,770,2020,1566,281,51,12,3635
12099000828,4037,2980,130,296,2536,34,25,2,2850
12099000829,3753,3063,788,306,1922,35,28,1,2275
12099000818,1978,1745,1170,197,317,24,35,2,575
12099000409,2404,1930,1222,184,362,31,98,3,708
12099000819,3833,3160,1800,466,758,42,88,5,1360
12099000626,168,151,61,16,66,0,6,1,90
12035000160,1858,1489,1029,187,209,26,56,3,460
12035000161,2140,1709,1147,232,256,29,51,5,562
12035000180,4895,4195,3008,437,567,84,127,12,1187
12035000290,3101,2882,2573,148,26,58,52,2,309
12035000292,12,6,0,0,4,1,0,0,6
12035000133,6,4,3,1,1,0,0,0,1
12035000132,2,2,0,1,0,1,1,0,2
12035000211,0,0,0,0,0,0,0,0,0
12035000131,0,0,0,0,0,0,0,0,0
12035120000,186,153,66,5,79,0,0,0,87
12035000217,21,11,6,3,3,0,0,2,5
12035000210,0,0,0,0,0,0,0,0,0
12037000004,428,382,347,13,17,7,1,0,35
12083000070,5419,3860,1502,1036,1215,117,113,17,2358
12083000050,1350,959,235,190,494,28,26,4,724
12083000018,7506,5872,3157,1356,726,106,580,8,2715
12083000054,2486,2435,2251,87,30,26,39,1,184
12083000053,3710,3667,3397,106,73,30,42,5,270
12083000077,3361,2876,2611,105,29,98,11,7,265
12083000046,1889,1438,700,162,540,32,9,3,738
12083000031,3321,2775,2440,107,35,134,22,2,335
12083000101,5319,4172,2350,896,646,74,183,7,1822
12083000102,3494,2857,2081,466,223,63,31,3,776
12083000109,3003,2432,1613,403,230,45,162,4,819
12083000090,3543,2678,761,1257,623,84,48,10,1917
1209500240B,3232,2459,850,693,852,61,63,5,1609
1209500240A,5263,3882,1327,801,1494,64,240,9,2555
12095000226,4594,3334,599,1045,1635,66,53,7,2735
1209500615A,7057,5694,1469,2191,1027,77,442,7,4225
12095000622,9475,7163,1279,3016,2439,90,342,18,5884
1209500615B,300,203,70,43,92,7,8,1,133
1209500616A,2466,1851,87,384,1360,30,33,1,1764
12095000227,6801,5331,2045,1651,1469,109,164,12,3286
12095000210,3898,2964,967,773,1110,69,89,6,1997
12009000505,4311,3626,3186,206,44,36,109,1,440
12009000309,16444,13141,9321,1502,948,260,1128,24,3820
12009000209,4082,3050,1733,556,659,103,32,7,1317
12009000519,9545,7390,3977,1300,1833,159,229,13,3413
12009000513,869,836,765,42,18,15,7,0,71
12095000323,4973,3923,1672,1545,580,115,141,17,2251
12095000336,6494,5369,2218,2310,657,112,254,7,3151
12095000324,5182,4265,1842,1850,458,96,169,16,2423
1209500316Z,16,7,0,3,3,0,1,1,7
12095000510,4068,3397,2332,429,409,55,183,15,1065
12095000511,3126,2751,1991,382,194,57,111,5,760
12095000219,5608,4478,1711,806,1458,58,332,13,2767
1209500220A,7781,5962,2919,1871,782,148,279,22,3043
1209500220B,0,0,0,0,0,0,0,0,0
12095000104,7149,5553,2368,1336,1281,86,451,20,3185
12095000303,4189,3611,2760,510,160,69,133,7,851
1209500342B,226,206,50,95,36,9,16,1,156
1209500301B,509,491,315,106,34,7,28,1,176
1209500301A,2468,2163,1481,441,160,32,71,2,682
1209500433A,7031,5057,2330,1765,577,93,363,10,2727
1209500433B,2770,1861,532,897,217,44,215,10,1329
1209500433C,36,32,9,14,2,0,0,1,23
12095000222,7731,5825,2161,1210,1903,107,403,15,3664
12095000223,8796,6530,1910,1086,2680,123,746,22,4620
12095000218,5342,4096,1616,786,1191,54,400,6,2480
12113000015,5978,4597,3462,235,559,171,150,30,1135
12091000012,6519,4720,3338,411,576,166,230,29,1382
12091000071,7820,5708,3587,679,974,239,291,32,2121
12091000076,3919,2941,1844,376,365,103,273,29,1097
12091000014,10972,8681,5252,1206,1270,318,705,69,3429
12091000023,4679,3563,2688,239,277,111,219,30,875
12091000039,3167,2001,1123,405,345,50,139,20,878
12091000052,5924,4544,3758,226,173,149,217,15,786
12091000043,3480,2652,2181,176,100,73,133,14,471
12091000047,2928,2342,1813,168,187,60,108,8,529
12091000050,2479,2103,1782,100,75,56,77,3,321
12086000966,689,532,6,313,227,3,2,1,526
12086000852,86,67,20,37,11,2,7,0,47
12086000960,975,780,29,626,130,8,10,0,751
12086000830,4258,3303,191,2470,694,27,51,1,3112
12086000834,229,178,3,120,62,6,4,0,175
12086008291,1637,1299,37,947,337,8,11,1,1262
12086000831,1321,1044,29,917,104,9,16,1,1015
12086008271,2307,1853,77,1214,539,27,56,2,1776
12086000342,3610,3077,99,2940,69,17,16,2,2978
12086000340,10404,8847,178,8536,328,39,40,9,8669
12086000933,1,0,0,0,0,0,0,0,0
12086000945,15,10,7,3,0,0,0,0,3
12086000509,3714,3196,89,3075,108,25,17,0,3107
12086005500,4135,3470,101,3333,115,22,13,4,3369
12086000549,3995,3330,89,3192,85,21,13,1,3241
12086000419,2029,1715,90,1585,43,6,31,3,1625
12086000420,3919,3337,133,3173,31,9,22,2,3204
12086000417,3594,3027,174,2741,64,22,80,0,2853
12086000233,4827,3745,148,2625,1045,27,30,0,3597
12086000110,3020,2324,872,1082,248,12,78,0,1452
12086000104,943,709,215,332,136,1,5,0,494
12086001101,38,27,0,13,16,0,0,0,27
12086000125,1481,1175,181,847,149,35,12,1,994
12086000123,8600,6833,1037,3267,2419,102,236,12,5796
12086000254,4635,3340,61,1125,2214,22,12,0,3279
12086000754,2697,2120,778,1211,85,8,75,1,1342
1209500430C,6443,4584,2245,1426,374,66,494,7,2339
1209500430A,8856,6391,2309,2548,741,67,753,18,4082
1209500430Z,213,189,80,58,12,0,35,0,109
12095000516,2153,1611,1318,158,49,25,51,9,293
12095000502,5890,5198,3437,1011,390,97,281,10,1761
12095000115,6284,5089,2896,878,276,61,691,16,2193
12095000128,4442,3607,2445,494,162,46,391,4,1162
12095000607,5054,3770,358,412,2859,59,148,29,3412
12095000617,6443,4608,329,1023,3136,54,206,14,4279
12095000140,12607,9209,5389,1956,546,143,754,20,3820
12097000101,8440,6677,3112,2521,620,147,258,15,3565
1209500126A,6511,4855,2983,1039,319,73,288,18,1872
12095000135,9078,6728,3610,1702,350,90,783,18,3118
12095000124,15002,12940,5263,5699,1027,216,748,39,7677
1209500126Y,0,0,0,0,0,0,0,0,0
12095000133,8457,6076,3750,1132,374,102,497,9,2326
1209500126Z,0,0,0,0,0,0,0,0,0
1209500440D,2580,1748,745,643,171,48,189,2,1003
1209500440C,2367,1791,385,1113,241,13,70,1,1406
1209500431A,9196,6794,3264,2112,531,95,735,9,3530
12095000432,6835,4785,1778,2187,434,75,367,6,3007
1209500419A,5610,4395,1254,2433,500,108,240,17,3141
1209500430B,276,215,82,115,3,0,8,1,133
1209500440B,2638,1853,645,819,216,33,166,3,1208
1209500431Z,0,0,0,0,0,0,0,0,0
1209500430D,0,0,0,0,0,0,0,0,0
12095000627,3954,2860,68,290,2510,36,14,6,2792
12086000653,1071,789,305,417,17,10,39,1,484
12086000146,5971,5026,1592,2626,456,50,163,8,3434
12086000157,2006,1632,865,565,110,16,78,1,767
12086000159,1986,1622,400,545,628,24,54,7,1222
12086000162,3721,2743,99,962,1731,33,16,0,2644
12086001610,2929,2275,169,794,1376,26,28,0,2106
12086000674,1292,1022,357,603,25,5,28,2,665
12086000621,4411,3778,985,1519,986,43,273,9,2793
12086000515,3368,2667,213,1084,1401,34,32,3,2454
12086000824,2546,2062,443,1384,211,24,60,1,1619
12086008490,1091,933,89,690,162,3,20,2,844
12009000406,7829,6244,4890,613,300,111,324,14,1354
12009000212,2818,2307,1086,334,822,54,29,11,1221
12009000213,1669,1274,567,175,487,43,19,4,707
12086005331,2172,1632,59,808,876,8,9,0,1573
12086000502,4754,4019,880,1952,1075,42,136,0,3139
12086000032,3796,3456,1184,1991,124,34,102,5,2272
12086000811,3375,2609,638,1423,320,23,244,4,1971
12086000846,6070,4976,271,4223,442,40,82,4,4705
12099000406,2038,1987,1636,155,154,9,36,3,351
12099000716,3188,2406,1354,678,279,56,78,1,1052
12099000717,2959,2347,1470,514,234,32,117,3,877
12099000379,1545,1449,1249,97,63,12,32,0,200
12099000672,1077,931,624,150,93,21,39,0,307
12099000744,3020,2213,1393,347,269,12,190,3,820
12099000031,0,0,0,0,0,0,0,0,0
12027000014,2532,1808,724,612,450,17,15,2,1084
12009000500,3148,2848,2187,306,211,48,93,10,661
12009000528,2075,1576,1114,170,206,43,45,2,462
12009000314,6093,4852,3078,702,832,104,169,15,1774
12009000518,5280,4264,3068,573,305,101,233,6,1196
12009000103,4328,3583,3083,193,128,95,77,4,500
12009000210,1550,1210,902,112,140,51,23,4,308
12086001380,4047,3094,98,577,2419,35,39,5,2996
12083000098,4642,3750,2249,699,552,74,96,7,1501
12083000063,3836,3007,2382,304,152,93,46,8,625
120170110.1,7589,5901,4793,535,313,127,122,14,1108
120170110.2,78,67,64,1,2,0,0,0,3
120170103.1,3520,2711,2186,261,182,60,46,4,525
120170103.2,252,199,160,10,15,7,3,1,39
120170403.1,7565,6367,5317,497,286,115,151,4,1050
12113000038,1123,1015,893,36,16,31,24,4,122
12113000021,6165,4802,3952,233,228,215,140,14,850
12113000030,3759,3047,2649,94,99,78,94,9,398
12057000887,5368,4049,2133,1044,725,74,137,6,1916
12057000123,4118,3650,2844,469,109,34,169,7,806
12099000418,1700,1404,1004,187,114,11,69,1,400
12099000646,2252,1685,274,875,527,8,22,2,1411
12099000639,18,7,1,4,2,0,0,0,6
12099000125,2052,1948,1808,88,16,6,22,1,140
12099000179,2692,2223,1068,368,534,22,233,2,1155
12099000180,1274,892,211,320,333,16,59,2,681
12099000NP3,2,1,0,0,1,0,0,1,1
12099000050,3044,2445,1680,320,203,21,223,5,765
12099000761,3391,2492,438,277,1560,41,237,2,2054
12099000714,3049,2375,1290,580,360,27,112,2,1085
12099000188,3678,2759,953,271,1421,16,123,7,1806
12099000769,3027,2350,543,207,1543,20,71,11,1807
12099000185,1491,1293,1023,132,72,23,28,4,270
12099000800,7168,5165,984,3427,704,953,57,7,4181
12099000801,3800,3153,1734,972,371,139,49,9,1419
12099000802,2934,2020,456,963,584,141,24,2,1564
12099000040,1988,1772,1666,30,13,10,47,5,106
120990000NP,4,4,0,2,2,0,2,1,4
12099000508,4928,3226,2080,487,344,24,273,3,1146
12099000519,2405,2367,2225,61,42,8,20,2,142
12099000515,1830,1219,732,187,126,8,126,1,487
120170405.1,8205,7037,6260,352,132,131,113,5,777
12089010101,2723,2197,1190,267,656,53,27,5,1007
12089010201,6701,5895,5344,210,149,72,68,17,551
12089020101,1902,1696,1562,60,28,24,21,4,134
12089020103,1716,1582,1457,41,49,15,25,5,125
12089010200,735,653,575,36,19,15,9,0,78
12089020100,1744,1506,1372,42,39,19,23,2,134
12089020102,1711,1504,1344,61,35,30,26,0,160
12086000381,3726,3235,84,3117,76,10,17,0,3151
12086000400,11,4,0,2,2,0,2,1,4
12086000338,2906,2459,69,2375,38,9,10,1,2390
12086003690,201,142,3,135,4,0,4,0,139
12086000364,5402,4279,187,3798,365,34,97,3,4092
12086000516,2362,1853,773,799,202,19,69,0,1080
12086000037,2034,1829,1002,598,109,15,69,0,827
12086000570,3727,3113,259,2740,133,78,61,2,2854
12086000750,4049,3257,754,2299,93,22,111,4,2503
12086000751,2152,1703,488,1121,51,11,36,2,1215
12086000808,1307,971,467,409,33,11,47,0,504
12086000809,450,368,191,141,21,0,20,0,177
12095000505,3072,2708,1941,313,196,45,225,18,767
12095000503,2788,2488,1810,340,101,46,191,2,678
12083000038,647,545,472,20,42,2,7,0,73
12083000023,463,391,353,11,14,13,6,3,38
12083000040,2452,2017,1217,158,598,37,13,3,800
12083000082,1970,1734,1517,93,43,24,40,0,217
12083000007,4780,3840,2367,592,429,77,388,4,1473
12083000056,3329,2797,2351,342,86,26,11,2,446
12111000094,16,12,4,7,1,3,0,0,8
12111000031,2180,2147,1963,107,45,16,4,3,184
12111000001,8036,6525,4897,652,641,178,116,15,1628
1211100094A,7,5,2,1,2,0,0,0,3
12111000052,3564,2857,2113,283,366,37,56,14,744
12111000009,3599,3436,3125,161,42,39,52,0,311
12111000998,0,0,0,0,0,0,0,0,0
12111000010,1362,1023,486,383,129,10,17,6,537
12099000281,3533,3212,2151,738,232,44,61,1,1061
12099000721,318,272,193,40,14,2,19,0,79
12099000522,1706,1673,1564,48,38,4,19,0,109
12099000071,1284,924,228,274,347,31,49,3,696
12099000069,1608,1038,801,96,29,7,100,0,237
12099000287,3021,2758,1644,677,327,42,81,1,1114
12099000049,1271,1195,1084,57,27,4,23,2,111
12099000489,1050,1022,906,64,13,1,27,1,116
12099000509,1842,1711,1484,122,30,3,35,0,227
12099000627,3169,2476,241,907,1317,27,25,3,2235
12099000628,2355,1686,191,405,1092,25,2,0,1495
12099000629,1840,1123,98,38,988,3,1,1,1025
12099000624,492,381,129,180,68,3,2,0,252
12086000804,2434,1919,679,1021,159,19,92,0,1240
12086000331,6782,5789,149,5620,122,22,21,8,5640
12086000328,5700,4883,157,4695,72,18,22,1,4726
12086000803,2414,1934,30,618,1295,6,17,0,1904
12086000240,4521,3514,50,1209,2352,31,21,2,3464
12086001721,10,3,0,0,3,0,0,0,3
12086002580,1336,959,14,280,688,13,1,0,945
12086002611,2884,2075,13,694,1436,14,3,1,2062
12131000360,1165,908,761,16,80,33,8,0,147
12131000530,5588,4487,4032,185,57,92,87,5,455
12131000520,11868,9272,7554,1063,186,205,207,28,1718
12131000410,1779,1490,1281,50,29,48,64,5,209
12083000075,3813,3054,2324,376,199,63,86,3,730
12089030201,177,119,62,30,22,10,8,1,57
12089030200,7656,5967,4974,277,482,145,83,9,993
12089050100,3928,2670,1952,215,353,85,58,6,718
12089030100,3081,2488,2084,121,195,50,53,8,404
12089010100,1043,880,778,40,35,10,12,0,102
12089020200,4702,4420,4167,87,82,31,30,0,253
12089040101,2967,2174,1826,55,201,67,20,10,348
12089040100,5560,4288,3917,69,157,101,33,4,371
12089050102,0,0,0,0,0,0,0,0,0
12089050103,0,0,0,0,0,0,0,0,0
12089050101,763,482,373,27,77,10,8,1,109
12131000240,537,452,432,3,6,7,4,1,20
12131000130,2807,2151,1878,82,57,106,26,3,273
12105000337,4789,3874,2848,449,368,66,142,8,1026
12105000112,7063,5795,3181,1250,920,110,407,8,2614
12105000414,3119,2564,1611,598,323,60,37,7,953
12105000236,5855,4653,3554,520,325,99,128,2,1099
12105000241,5682,4322,2968,498,275,71,508,10,1354
12105000415,6299,5118,3333,835,707,97,188,6,1785
12105000226,4530,3385,2068,747,438,111,52,5,1317
12105000118,11875,9053,6154,1372,1182,236,129,19,2899
12105000119,1653,1328,1016,181,73,31,40,0,312
12105000535,1545,1200,891,220,64,21,8,4,309
12095000632,12721,10436,2381,2950,4731,166,316,22,8055
12095000633,11238,8359,1231,2730,4191,128,222,38,7128
12095000621,8303,6167,571,3323,2063,123,319,35,5596
12095000529,4234,3579,1821,943,501,75,290,8,1758
12095000530,5480,4427,1980,1448,698,92,287,9,2447
12095000111,4027,3029,2151,288,203,61,302,8,878
12095000103,4327,3256,1718,598,445,43,334,7,1538
12095000214,9656,7279,1260,1503,4339,183,206,19,6019
1209500202B,166,129,74,34,14,4,2,0,55
1209500431X,64,48,14,25,8,2,0,0,34
1209500419B,6,4,0,2,3,0,0,0,4
1209500419Z,0,0,0,0,0,0,0,0,0
1209500339A,3857,2823,634,1832,340,80,106,5,2189
12095000321,10652,8200,1523,5399,1101,139,342,17,6677
1209500601A,6068,4758,794,823,2943,54,231,18,3964
12095000602,4367,3635,544,474,2588,65,84,10,3091
12095000629,6144,4541,409,661,3460,62,72,7,4132
12095000507,2937,2351,1867,251,132,49,80,7,484
12095000508,4742,3942,3099,438,157,69,146,8,843
12095000549,5379,5187,2973,1115,581,66,420,9,2214
12095000318,5842,4633,897,3260,459,78,151,30,3736
1209500319A,1202,961,155,700,115,30,24,4,806
12095000317,6557,5082,1061,3371,609,140,213,34,4021
12095000238,6625,5266,3491,747,772,92,176,14,1775
12095000531,3289,2638,1761,449,149,49,227,9,877
12095000235,4778,3968,2717,558,439,86,188,13,1251
12095000229,6957,5321,2579,1938,638,107,175,12,2742
1209500544A,8004,6337,3331,1729,738,143,455,30,3006
12095000120,4649,3615,1580,1254,306,53,388,5,2035
12095000121,6013,4699,1697,2184,391,77,314,12,3002
12095000412,4441,3361,1291,1154,503,49,381,11,2070
12095000438,7725,5802,1632,2882,920,133,465,16,4170
12095000415,6027,5137,2246,1329,1452,42,165,9,2891
1209500433Z,0,0,0,0,0,0,0,0,0
12095000416,187,168,73,41,55,0,6,1,95
12095000326,5907,4776,3274,950,283,128,194,12,1502
12095000302,3941,3193,2389,445,172,69,133,18,804
12095000325,7363,5941,2616,2308,864,120,238,25,3325
12095000408,4536,3513,2120,686,364,53,336,17,1393
12125000003,3679,3227,2029,165,997,32,9,0,1198
12107000009,1263,960,749,105,69,37,9,2,211
12107000008,2141,1813,1537,139,76,45,12,0,276
12037000007,994,907,863,21,1,17,3,0,44
12095000519,3516,3338,2676,348,166,26,122,3,662
1209500522A,3399,2669,2250,204,41,14,152,7,419
1209500504A,1609,1359,1127,120,29,24,55,3,232
12095000604,7003,5050,412,712,3810,61,193,14,4638
12095000215,8054,5965,667,869,4241,80,158,32,5298
12095000603,4673,3283,373,458,2416,29,51,5,2910
12095000520,3683,3078,1940,651,303,42,141,2,1138
12095000521,4232,3406,2372,532,320,60,158,7,1034
12095000139,13184,9232,5276,1751,684,151,911,13,3956
1209500130A,5811,4247,2580,477,356,46,688,7,1667
1209500131C,2138,1564,765,313,218,22,210,1,799
1209500138B,412,338,204,63,23,2,32,0,134
1209500130B,1447,992,663,117,100,11,87,1,329
12095000414,6308,4501,2237,1525,461,81,307,11,2264
1209500333A,3982,3266,2046,903,180,79,79,2,1220
1209500333Z,9,1,0,0,0,1,0,0,1
12095000543,6156,4804,3026,1292,268,123,162,21,1778
12095000545,2502,2006,1589,269,59,81,34,6,417
1211100028A,332,232,122,54,53,2,3,0,110
12111000041,6558,5157,2989,996,922,105,123,11,2168
12105000120,4011,3529,2484,511,396,51,109,0,1045
12105000529,3965,3191,2046,494,465,33,136,3,1145
12105000211,3231,2411,1067,530,729,56,56,11,1344
12091000034,3338,2755,1676,289,559,71,181,2,1079
12091000060,3595,2900,2309,173,209,44,160,11,591
12091000051,3296,2690,2189,190,107,95,111,14,501
12091000083,5899,4298,2993,408,519,171,233,30,1305
12091000082,3528,2737,2295,164,130,69,59,6,442
12083000016,2520,1957,1680,145,69,39,22,2,277
12067000004,1501,1232,1108,85,4,20,4,5,124
12123000011,1013,784,740,5,3,30,1,0,44
12123000008,1708,1281,939,74,184,30,57,2,342
12111000049,8140,6340,3387,1379,1306,102,171,26,2953
12111000071,10542,8090,3865,2013,1902,137,209,12,4225
12111000043,59,54,32,9,11,1,0,0,22
12103000132,3650,3114,2359,359,146,70,191,5,755
12103000212,5086,4106,2734,650,450,102,142,31,1372
12103000244,3383,2431,905,509,904,60,55,2,1526
12103000240,3662,3294,2966,177,27,51,49,5,328
12103000211,2275,2001,1775,90,62,28,40,2,226
12103000210,2710,2333,2088,117,32,33,48,1,245
12103000136,2783,2208,1415,319,191,39,251,2,793
12103000142,4048,3273,2291,383,273,69,236,12,982
12103000145,6996,5606,3459,830,535,125,635,15,2147
12103000087,3344,2881,2140,202,405,70,53,18,741
12049000006,1820,1296,677,480,116,24,19,3,619
12103000267,6952,5651,3628,905,759,172,281,31,2023
12103000146,4454,3469,2218,493,209,106,431,12,1251
12103000150,10591,8342,5354,1219,598,186,986,21,2988
12103000170,3863,3188,2672,236,77,69,94,7,516
12103000171,5535,4743,3992,311,152,109,174,8,751
12103000166,1370,1348,1272,35,10,7,18,1,76
12091000040,5037,4094,2563,530,583,143,305,7,1531
12091000069,3267,2553,1984,205,156,78,139,18,569
12091000001,3737,2852,2491,106,96,100,34,7,361
12091000025,4752,3880,2933,301,247,143,248,30,947
12091000021,6583,4839,3529,329,638,185,139,23,1310
12091000019,6773,4987,3182,469,922,142,300,33,1805
12091000020,2389,1707,570,177,857,62,84,9,1137
12091000073,6343,4809,4030,284,181,92,210,14,779
120170109.1,3429,3093,2676,159,112,39,91,3,417
120170109.2,503,445,397,11,12,12,9,0,48
120170108.1,3902,3515,3001,135,121,48,183,5,514
12091000006,6197,4566,3629,278,326,167,142,15,937
12095000225,6332,4569,735,940,2783,79,132,7,3834
12095000224,3728,3017,1746,644,428,120,95,6,1271
12095000134,8007,5724,3096,1264,369,63,558,6,2628
12095000141,13089,9533,4774,2496,617,134,816,20,4759
1209500630B,1289,1119,568,248,215,38,55,2,551
1209500630A,2677,2102,403,483,1191,36,31,8,1699
12095000631,18,13,2,4,6,0,2,0,11
1209500630Z,0,0,0,0,0,0,0,0,0
1209500630C,0,0,0,0,0,0,0,0,0
12095000328,3824,3292,1507,725,908,63,121,15,1785
12095000239,6317,4971,2886,974,826,120,179,8,2085
12095000209,4194,2949,1177,690,916,59,160,4,1772
12095000233,6611,4888,1731,1843,1071,99,200,10,3157
12095000234,5550,4434,2862,793,539,112,165,6,1572
12095000539,12872,10987,5180,3622,1284,224,748,25,5807
1209500435A,5995,4808,1584,2079,848,96,344,21,3224
12095000403,6040,4569,1630,1818,776,77,404,17,2939
12091000035,3471,2795,2355,189,64,64,91,3,440
12091000056,4194,3402,2792,251,90,78,160,2,610
12091000070,3240,2545,1768,313,168,72,164,6,777
12091000080,3026,2689,2341,151,48,50,72,5,348
120170305.2,1044,928,877,23,3,18,8,0,51
120170305.1,6415,5351,4857,217,53,142,49,2,494
12019070600,5293,4069,3637,170,119,133,26,8,432
1209300P-07,2316,1676,851,313,456,46,11,1,825
1209300P-04,6912,4806,1982,2415,313,155,28,8,2824
1209300P-01,2438,1825,1400,281,88,46,10,3,425
1209300P-06,5630,4320,2830,934,419,93,68,4,1490
12095000410,6423,4898,1653,1938,560,84,793,18,3245
12095000340,5607,4388,1034,2518,597,72,339,8,3354
12095000315,5841,4549,937,3027,591,163,130,15,3612
12095000307,10678,8046,1762,4715,1334,139,426,16,6284
12095000306,7394,5741,1210,3920,514,179,249,15,4531
12095000314,8158,6322,1432,4055,792,123,191,24,4890
12095000322,8766,6752,1316,4628,824,102,135,21,5436
12125000006,2203,1634,1325,49,212,34,16,4,309
12125000001,886,670,544,24,76,16,7,1,126
12071000021,3295,2881,2424,350,24,50,28,4,457
12071000115,10493,7879,5206,1839,525,148,190,10,2673
12071000030A,3514,3446,3228,133,14,45,16,0,218
12071000037,4398,3913,3320,442,83,56,24,1,593
12071000084,4804,4320,3908,245,78,39,53,6,412
12071000083,3732,3671,3536,20,11,12,25,4,135
12071000119A,0,0,0,0,0,0,0,0,0
12071000113,7276,5394,3211,1630,387,81,115,6,2183
12071000114,7423,5854,3513,1692,454,58,180,2,2341
12071000110,7611,5785,2985,2161,472,104,139,10,2800
12071000056,7336,5506,3064,1939,358,96,105,8,2442
12071000091,4642,3943,3229,377,145,49,106,6,714
12071000090,4078,3414,2958,220,75,46,76,3,456
12071000135,0,0,0,0,0,0,0,0,0
12071000013B,8352,6769,4263,2101,103,129,122,16,2506
12071000089,7207,4878,2237,1801,776,92,59,1,2641
12071000078,10485,7687,2986,3174,1355,144,155,2,4701
12071000028,6318,5155,3712,950,281,75,119,6,1443
12071000097,6021,5424,4377,710,156,73,77,7,1047
12071000035,4710,4253,3600,421,93,47,67,8,653
12071000218,0,0,0,0,0,0,0,0,0
12071000049,3978,3700,3307,240,32,49,48,4,393
12071000003,8872,6331,1760,2926,1500,116,136,8,4571
12071000051B,14020,9699,2348,4863,2279,162,176,18,7351
12071000042B,13333,8830,2055,4124,2583,214,118,13,6775
12071000054,1852,1519,1337,114,20,22,17,2,182
12071000025,6744,6329,5778,352,48,28,100,7,551
12071000024,4718,4060,3066,846,42,49,51,6,994
12071000104,6340,5271,3748,1108,189,91,100,4,1523
12071000103,7646,6103,4094,1452,291,92,177,5,2009
12071000096B,5298,4578,3748,594,98,60,68,15,830
12071000026,6676,5088,2914,1367,675,86,58,3,2174
12071000053,11125,7897,2721,3682,1353,152,114,16,5176
12071000058,7048,5439,2198,2163,901,85,120,15,3241
12071000019,991,768,537,154,36,23,8,2,231
12115000094,12050,10481,9193,490,196,99,418,11,1288
12115000003,2640,2139,1822,135,48,37,67,6,317
12115000071,5047,4021,3256,344,91,42,229,1,765
12115000070,3561,3032,2639,183,55,52,87,1,393
12081000219,1437,1299,1075,113,31,16,53,2,224
12115000088,9187,7215,6159,449,169,73,293,4,1056
12115000095,10756,8484,6576,921,547,155,203,23,1908
12115000079,13977,10641,8262,1138,776,206,220,18,2379
12115000106,823,790,718,25,21,5,24,0,72
12115000018,5486,4886,4385,267,85,51,74,5,501
12091000054,5971,4723,3201,426,606,142,348,49,1522
12091000067,4000,3037,1614,329,838,63,236,12,1423
12091000030,6639,5251,3068,1007,723,224,320,28,2183
12091000004,2105,1592,1408,41,38,79,17,2,184
12091000042,3120,2409,1834,186,150,81,168,8,575
12111000063,745,600,357,178,56,13,3,0,243
12111000060,697,593,534,37,15,9,3,2,59
12095000320,3815,3309,1320,1593,285,45,149,6,1989
12095000337,4727,3885,2814,676,196,80,118,7,1071
12095000634,8166,5750,367,1792,3493,81,268,13,5383
12095000538,8246,8154,4779,1544,1051,73,698,14,3375
12095000537,6014,5511,2809,1342,799,119,482,13,2702
12095000536,8008,7426,4496,1456,782,83,595,17,2930
12095000506,8748,8128,4344,1606,1212,120,773,21,3784
1209500138A,5129,3494,2198,552,300,51,321,12,1296
12095000132,8140,6118,3781,1001,860,89,310,9,2337
1209500137A,2444,1892,551,794,151,28,322,14,1341
1209500137B,3600,2552,528,1268,220,17,298,5,2024
120170400.1,3071,2512,2272,105,38,65,20,0,240
120170202.2,1174,1011,886,70,12,15,22,0,125
120170202.1,6189,5657,4788,227,182,56,381,5,869
120170206.1,4051,3255,2573,346,194,66,66,2,682
120170200.1,3593,3036,2749,115,34,71,35,8,287
120170201.1,4862,4222,3813,149,81,91,54,6,409
120170402.1,5877,4827,4151,255,193,121,78,7,676
12019041200,3700,3045,2566,167,117,69,120,4,479
12019041400,2773,2248,1821,151,110,52,104,2,427
12019040000,3123,2542,2019,160,128,46,177,11,523
12019021600,4970,3988,3146,322,283,103,143,16,842
12019021000,4228,3453,2446,358,419,95,152,9,1007
12019020600,2580,2146,1432,146,438,56,95,16,714
12019070400,2539,2020,1820,61,46,43,24,2,200
12019070200,2500,2013,1788,77,42,84,17,0,225
12019060601,6003,4842,3344,460,833,103,80,10,1498
1201960601a,0,0,0,0,0,0,0,0,0
12019010600,6227,4822,4223,217,111,192,48,10,599
12019011001,2547,2038,1686,132,75,58,59,7,352
12019050000,5485,4005,2702,543,561,99,129,14,1303
1201950400a,197,166,148,8,2,4,1,2,18
12019050400,1717,1370,1193,55,32,55,30,6,177
12019010200,5577,4239,3560,207,216,188,49,12,679
12019050800,4702,3738,3303,144,89,99,76,9,435
12019010000,4372,3371,3032,115,40,122,40,9,339
12019060000,6365,4448,3338,415,412,169,112,22,1110
1201950601a,373,267,229,15,13,9,3,0,38
12019031000,3760,2979,2357,236,206,86,67,13,622
1201960000a,364,273,229,23,12,7,4,2,44
12019041001,6956,5218,3732,468,544,108,340,29,1486
12023000025,1139,888,744,20,96,19,3,3,144
12023000009,554,400,345,20,18,17,3,1,55
12019011201,5347,3955,2755,439,518,113,152,12,1200
12019011300,3384,2220,697,406,895,51,233,6,1523
12019020200,6047,4626,2767,662,879,111,225,19,1859
120170101.1,4408,3711,3322,156,65,80,29,4,389
120170104.1,3317,2753,2426,110,79,87,11,2,327
120170301.1,7359,6287,5670,216,154,132,88,11,617
120170302.1,5069,4203,3746,172,65,160,36,5,457
120170302.2,2846,2576,2397,75,13,43,33,5,179
12109000014,3143,2560,2190,161,82,59,53,1,370
12109000017,9891,8109,6509,693,515,155,187,8,1600
12109000088,374,330,273,27,13,13,8,0,57
12109000041,4134,3715,3412,154,25,39,48,0,303
12109000020,3844,3211,2216,270,587,73,51,6,995
12109000030,2278,1881,1632,123,29,52,34,4,249
12109000026,3624,2769,2327,198,149,62,13,3,442
12099000678,3355,2786,2009,516,104,55,84,1,777
12099000712,3155,2362,1571,523,165,42,78,2,791
12099000718,2672,2043,1348,484,163,15,35,0,695
12057000623,4491,3165,749,600,1626,38,232,8,2416
12057000913,11865,9073,3776,4607,446,333,187,23,5297
12057000129B,1035,808,394,169,177,7,45,2,414
12057000907,1599,1332,1121,152,3,32,25,1,211
12057000152,9,7,0,6,1,3,0,0,7
12057000914,1261,900,356,281,233,29,42,3,544
12057000205,6260,5190,840,3761,642,48,112,5,4350
12057000955,7792,6051,3232,1634,986,141,215,8,2819
12079000010,3336,2902,1212,220,1440,21,9,0,1690
12111000022,6223,4995,3024,889,876,85,136,10,1971
1211100022A,1539,1275,802,196,220,29,36,1,473
12111000016,4577,4294,3838,222,89,57,56,5,456
1211100089J,1905,1520,982,278,175,23,70,1,538
1211100089K,2090,2042,1796,136,59,6,27,3,246
1211100089O,2125,1758,1220,251,187,11,78,2,538
1211100089Q,35,35,23,4,3,0,5,0,12
1211100089R,331,304,258,19,14,5,7,1,46
1211100089C,1509,1172,594,251,282,17,36,2,578
1211100089M,2978,2484,1776,402,213,20,63,1,708
1211100089U,0,0,0,0,0,0,0,0,0
1211100089L,11,7,3,0,2,0,0,0,4
1211100089T,0,0,0,0,0,0,0,0,0
12111000089,1032,987,821,71,59,8,28,5,166
1211100089E,0,0,0,0,0,0,0,0,0
1211100089P,478,412,290,51,49,4,14,0,122
1211100043B,1317,1266,1044,108,59,7,45,0,222
1211100089I,0,0,0,0,0,0,0,0,0
1211100089D,0,0,0,0,0,0,0,0,0
1211100089N,0,0,0,0,0,0,0,0,0
1211100089G,0,0,0,0,0,0,0,0,0
1211100089A,114,105,92,8,1,0,4,0,13
1211100089S,0,0,0,0,0,0,0,0,0
1211100089H,0,0,0,0,0,0,0,0,0
1211100089B,0,0,0,0,0,0,0,0,0
1211100089F,0,0,0,0,0,0,0,0,0
12111000050,14310,10665,4896,2498,2751,195,316,21,5769
12103000024,5380,3997,853,193,2881,53,45,6,3144
12103000293,6966,5640,4850,349,113,130,132,10,790
12103000292,6596,6067,5582,230,79,68,77,9,485
12103000323,3048,2602,2165,201,91,43,79,3,437
12049000002,2326,1666,690,798,168,28,8,4,976
12049000003,1355,991,529,404,33,21,7,0,462
12103000177,3083,2594,2212,186,74,48,68,7,382
12103000042,3428,2805,2475,163,34,21,95,4,330
12103000066,1276,1048,942,46,7,11,40,0,106
12103000065,6099,5145,3834,528,502,83,197,5,1311
12103000051,11178,9194,5590,1252,1225,228,892,21,3604
12103000062,5773,4813,3609,413,289,96,396,5,1204
12103000050,2763,2189,1364,243,189,34,358,1,825
12103000038,2601,2142,1171,334,259,54,355,4,971
12103000039,2755,2309,1618,204,207,58,218,3,691
12065000011,1143,936,687,32,189,19,4,0,249
12065000010,1042,860,633,24,190,15,2,0,227
12063000031,2152,1577,502,37,1011,21,8,1,1075
12063000027,4947,3912,2854,150,702,95,101,10,1058
12063000014,2394,1944,1503,84,256,54,46,1,441
12063000006,1616,1287,1133,41,59,30,18,4,154
12131000350,1130,877,775,32,28,42,5,3,102
12029000010,554,438,411,6,3,7,2,0,27
12111000011,3159,2635,1862,384,251,77,68,5,773
12103000327,4472,3707,3112,278,92,63,145,5,595
12103000328,1980,1613,1271,179,83,48,52,2,342
12103000325,3453,2846,2423,184,55,58,111,6,423
12103000104,2825,2399,1684,200,361,66,91,6,715
12103000216,3951,3436,2740,355,125,53,133,13,696
12103000248,3480,2817,2024,386,264,43,115,3,793
12103000119,5098,4156,2567,760,288,60,466,9,1589
12103000041,2337,1978,1708,121,48,34,53,0,270
12103000034,4415,3859,3353,225,114,50,90,4,506
12029000007,680,520,397,27,77,16,4,3,123
12029000001,3824,3129,2901,70,28,94,18,3,228
12063000026,1362,1074,955,24,41,45,6,2,119
12063000022,5289,4511,2759,320,1342,68,23,3,1752
12063000005,2105,1745,1593,44,29,46,15,2,152
12057000584,3338,2818,1245,488,711,60,371,11,1573
12063000013,3706,3198,1585,308,1266,47,3,2,1613
12063000025,2650,2088,1160,45,802,49,12,0,928
12063000016,1684,1361,677,71,584,31,9,1,684
12063000003,2351,1809,1354,54,327,80,13,2,455
12073001321,6585,4614,689,236,3663,62,53,13,3925
12073001311,539,496,25,17,454,1,2,0,471
12073005103,1369,1272,945,100,165,31,36,4,327
12073005204,7,2,1,1,0,0,0,0,1
12073002506,4643,4216,2546,678,665,56,320,17,1670
12073002507,8594,7677,2847,977,3121,86,691,16,4830
12073003403,1141,863,739,54,25,7,26,0,124
12095000304,4977,4260,2729,1031,349,87,133,11,1531
12095000305,5887,4808,1586,2637,543,132,129,10,3222
12095000614,13556,10698,3336,3236,1888,123,786,32,7362
1209500612B,6184,4897,891,1659,1974,68,143,15,4006
12095000114,5872,4615,1826,1397,482,73,526,7,2789
12095000623,10454,7929,1268,3127,2875,97,198,18,6661
12095000518,1680,1366,1153,87,58,13,43,3,213
12095000514,4838,4146,2888,565,444,60,196,3,1258
12095000610,5155,4003,902,842,1722,70,364,14,3101
12095000527,3436,2712,1782,532,255,42,147,7,930
1209500522B,187,138,103,11,10,3,9,0,35
12095000605,6591,4754,490,770,3448,81,133,6,4264
12019011200,0,0,0,0,0,0,0,0,0
12019011000,301,253,220,11,2,10,8,2,33
12019041401,970,706,497,70,92,13,44,6,209
12019070201,1446,1067,920,55,18,40,26,1,147
12019070000,423,352,330,10,5,10,3,3,22
12019021800,4271,3453,2570,347,271,92,161,7,883
12019030200,7012,5390,3662,597,816,139,199,34,1728
12125000004,2391,1754,1504,53,124,55,6,2,250
12073004458,1452,1142,920,52,138,25,13,0,222
12073004456,385,291,248,14,13,10,9,0,43
12073004408,2619,1934,1428,74,212,18,196,4,506
12073004457,81,71,37,2,22,0,11,0,34
12065000007,2160,1868,813,143,874,33,23,8,1055
12071000042A,889,873,813,29,3,13,9,11,60
12071000082,1618,1539,1436,45,17,25,10,1,103
12071000022,3657,3584,3417,94,8,32,24,7,167
12071000052,8703,6755,2382,3361,937,115,67,4,4373
12019011600,6973,5057,2199,765,1644,145,446,23,2858
12019011601,269,185,53,27,80,2,20,0,132
12019030400,6019,4538,3051,578,548,132,254,16,1487
12019011800,5531,4428,3345,375,391,93,188,15,1083
12019020400,4093,3382,1991,458,706,70,213,23,1391
12019012800,4342,3217,1623,552,873,77,101,11,1594
12095000424,5569,4431,897,2207,733,57,571,20,3534
12095000421,7690,5937,1224,3512,741,111,419,25,4713
12091000008,2940,2203,1862,94,103,104,28,10,341
12079000007,1503,1216,937,40,214,13,2,0,279
12079000006,337,284,221,7,45,11,1,0,63
12125000005,3332,3129,1716,230,1166,21,2,3,1413
12023000020,2325,1822,1333,73,366,34,20,4,489
12073005203,2226,1885,1384,137,286,42,48,7,501
12073003475,302,235,114,5,109,3,4,0,121
12073003414,85,54,44,7,2,0,0,0,10
12073003473,2278,1780,1121,61,553,25,11,1,659
12073001327,1441,961,78,20,841,14,16,1,883
12073001255,1429,1121,466,66,523,25,35,2,655
12073001231,0,0,0,0,0,0,0,0,0
12073002307,19,18,16,1,1,1,1,0,2
12073004173,953,754,566,24,143,22,4,1,188
12023000023,2158,1630,1277,136,130,67,15,1,353
12079000004,596,464,355,13,75,16,7,1,109
1201960600a,86,71,49,10,3,9,1,1,22
12015000087,2817,2386,2147,101,26,59,32,2,239
12015000038,4203,4039,3853,86,20,41,21,5,186
12015000072,6674,6196,5773,188,61,86,59,9,423
12015000098,4256,3572,2920,258,220,64,84,4,652
12015000096,3283,2789,2017,230,403,71,55,1,772
12015000090,2656,2278,2043,104,34,54,42,2,235
12015000036,1935,1543,1140,178,183,22,23,1,403
12015000084,5097,4344,3282,410,432,99,120,10,1062
12015000016,3605,3175,2571,213,321,39,22,0,604
12015000062,4192,3705,3383,118,68,62,45,6,322
12015000018,3041,2646,2393,111,44,32,44,0,253
12015000131,2939,2537,2286,103,42,42,29,1,251
12079000005,1768,1381,647,39,662,22,17,3,734
12103000361,3359,2771,2442,152,58,30,59,6,329
12103000205,3392,2923,2148,388,182,66,106,12,775
12023000022,5949,4689,3724,273,447,87,134,16,965
12023000013,3305,2611,1698,243,496,40,129,9,913
12115000060,1079,958,808,100,21,21,9,0,150
12115000057,1272,1082,757,242,45,30,16,3,325
12115000019,9290,6913,1329,1006,4070,118,473,10,5584
12115000039,1525,1226,643,282,239,41,36,6,583
12115000017,1040,883,603,137,84,18,24,0,280
12115000016,3706,2949,1497,1120,203,72,62,2,1452
12115000025,6577,5985,5506,191,67,48,96,5,479
12103000222,4266,3769,3440,150,32,28,87,3,329
12049000001,2210,2058,890,320,838,14,7,1,1168
12103000333,3378,2678,2065,321,75,51,160,1,613
12103000035,4363,4144,3466,294,163,36,140,11,678
12103000182,3607,3128,2809,141,41,49,58,4,319
12047000007,1225,967,634,80,222,20,7,2,333
12111000083,10936,8154,3640,2022,2122,177,252,26,4514
1211100083A,2228,1570,579,355,458,6,108,1,991
12111000053,6156,4961,3081,911,722,64,146,14,1880
12023000017,2815,2201,1639,104,381,43,21,2,562
12023000021,4979,3909,2623,279,748,74,156,12,1286
12023000005,2561,1820,1121,141,469,53,49,1,699
12023000004,3353,2604,2140,187,204,54,28,3,464
12115000081,3886,3142,2620,264,64,48,110,3,522
12115000032,3090,2420,1804,454,63,58,50,3,616
12115000037,9903,8386,6955,654,364,138,184,4,1431
12115000076,4073,3714,3300,216,68,41,76,0,414
12115000035,3791,3396,3179,112,29,31,43,3,217
12115000022,4092,3430,2714,423,98,71,98,0,716
12115000059,3974,3454,2784,458,80,41,80,4,670
12115000008,2569,2196,1995,98,19,12,53,0,201
12115000007,4010,3399,3025,157,56,34,109,2,374
12115000029,7152,6882,6500,167,44,58,65,6,382
12111000038,2830,2532,1699,380,347,36,48,9,833
1211100085A,5569,5263,4552,361,212,34,75,3,711
12111000067,4096,3483,2257,684,361,37,129,7,1226
12103000200,2815,1903,670,251,865,38,64,12,1233
12103000208,2790,2236,1687,210,194,49,86,4,549
12103000300,3782,2888,1199,633,929,76,80,20,1689
12103000266,3027,2507,1661,240,470,64,70,25,846
12103000265,6144,4844,1986,709,2019,124,109,17,2858
12007000013,1116,877,802,30,27,15,3,0,75
12103000199,3161,2622,2045,217,262,50,46,1,577
12103000224,5247,4384,3323,465,276,89,192,10,1061
12015000103,833,742,682,17,16,7,12,0,60
12015000041,4552,4414,4088,120,46,49,73,4,326
12015000068,3344,2992,2783,93,19,50,36,1,209
12015000070,4049,3790,3457,134,85,27,64,8,333
12015000008,3852,3560,3302,96,35,54,36,1,258
12015000026,1543,1360,1163,85,66,21,17,0,197
12015000003,1115,827,466,149,180,18,13,1,361
12015000057,3615,3055,2249,360,293,51,80,6,806
12015000055,3437,2821,1983,385,348,38,50,3,838
12015000030,5292,4406,3355,426,421,86,107,6,1051
12071000005,7334,6206,5024,675,261,99,122,6,1182
12071000001,3442,2856,2411,208,138,58,23,2,445
12071000002,6662,5411,3631,1335,266,123,94,3,1780
12071000060B,4428,3889,3436,230,65,23,108,4,453
12071000066,8012,7581,5700,969,618,80,228,9,1881
12071000122,5467,4802,4194,311,112,43,115,10,608
12071000099,5265,4413,3176,889,160,61,111,10,1237
12071000046,7976,6298,3646,1192,1169,136,166,7,2652
12071000048A,6296,5434,3959,764,509,79,115,10,1475
12071000032,13389,9762,2738,2220,4303,116,200,10,7024
12071000112,8961,6796,4710,1461,391,119,114,18,2086
12071000111,5798,4260,2402,1420,297,72,103,11,1858
12071000055,8349,6484,4310,1552,390,86,162,6,2174
12071000023,3822,3695,3527,74,19,27,31,4,168
12071000124,5527,5107,4427,359,70,55,130,5,680
12071000236,715,691,646,22,1,3,18,0,45
12071000120,7281,5634,3531,1678,223,105,119,9,2103
12071000016,1830,1760,1672,37,10,9,15,5,88
12071000117,2468,2263,2155,57,11,9,19,2,108
12071000030B,313,297,285,10,1,1,0,2,12
12071000077A,7194,5730,2953,1801,798,88,114,8,2777
12071000105,7531,5876,3859,1457,308,91,155,5,2017
12071000116B,7833,6181,4085,1532,329,115,127,3,2096
12071000063,5704,4663,3384,878,247,91,51,4,1279
12071000064,6342,5464,4614,501,144,78,97,4,850
12103000011,3374,2654,946,139,1470,45,57,2,1708
12103000111,1895,1527,1264,102,38,40,68,1,263
12103000164,4424,3668,3068,270,103,54,163,10,600
12103000362,5258,4565,4033,261,83,77,76,4,532
12103000055,6995,5939,4648,587,324,87,268,3,1291
12071000108,8187,6539,4134,1798,389,70,152,8,2405
12071000109,6825,5621,3606,1403,386,96,146,9,2015
12071000092,6513,5451,3608,1341,228,82,170,5,1843
12071000087B,0,0,0,0,0,0,0,0,0
12071000045,4233,3541,2685,655,115,62,31,1,856
12071000088,3883,3422,2976,215,56,28,128,3,446
12071000304,1316,1172,1020,89,22,7,24,3,152
12071000118A,5259,4567,3725,401,170,71,159,5,842
12071000050,10038,7357,2887,3009,1347,138,119,16,4470
12071000043,3835,3805,3640,36,31,8,67,1,165
12071000214,0,0,0,0,0,0,0,0,0
12071000040,3311,3242,3129,35,11,5,32,2,113
12071000044,6022,5530,4850,435,63,31,111,3,680
12115000108,12599,11785,11094,269,79,146,129,11,691
12115000089,5055,4662,4410,84,29,38,59,2,252
12115000033,4578,4206,3855,138,55,41,93,2,351
12115000041,1536,1246,1088,54,21,16,55,3,158
12115000078,3846,2961,2479,222,126,58,55,3,482
12115000064,10200,7815,5963,915,598,145,158,15,1852
12115000098,5529,5271,4258,551,234,78,141,6,1013
12115000006,2317,2267,2162,45,5,15,44,0,105
12071000029,7172,5622,3840,1233,284,103,182,2,1782
12071000047,9900,7891,4304,1753,1356,120,235,10,3587
12071000079A,0,0,0,0,0,0,0,0,0
12099000363,4324,3176,1094,775,998,41,285,1,2082
12099000340,6290,4236,620,2403,1186,124,75,3,3616
12099000868,799,618,158,173,287,8,9,4,460
12099000347,2142,1866,1594,141,45,1,67,1,272
12099000606,3591,2605,1646,482,174,37,168,0,959
12099000159,2263,1935,1720,127,22,17,13,3,215
12099000166,2661,2156,1735,228,71,34,94,3,421
12099000158,953,850,556,156,80,11,37,0,294
12099000156,1141,1100,995,56,22,5,17,1,105
12099000160,292,252,210,30,1,6,4,0,42
12099000476,3945,3245,2345,464,161,47,164,4,900
12063000002,1514,1253,394,38,790,31,5,0,859
12063000007,2316,1761,1201,57,467,30,11,3,560
12099000190,1245,1167,925,120,65,12,32,0,242
12103000288,2384,1989,1753,98,42,35,63,2,236
12049000004,1883,1291,638,584,42,25,12,1,653
12049000005,871,694,541,96,52,10,2,0,153
12103000198,1569,1402,1246,75,30,21,19,3,156
12103000037,4102,3432,2359,288,413,76,289,5,1073
12103000030,2617,2370,1738,184,326,57,64,1,632
12103000093,1706,1407,819,161,361,17,51,6,588
12103000308,5115,4602,3558,343,302,89,234,3,1044
12103000311,2465,2181,1794,189,75,25,76,6,387
12103000310,3587,3154,2180,516,310,75,126,5,974
12103000309,0,0,0,0,0,0,0,0,0
12103000251,2496,2083,1547,297,139,59,62,1,536
12103000026,6008,5812,4442,514,517,46,221,3,1370
12103000237,1511,1384,1223,78,31,20,21,2,161
12103000238,2160,1995,1755,117,30,21,56,0,240
12103000072,7166,6475,4268,836,723,103,540,1,2207
12103000077,7809,6571,4660,746,663,123,391,19,1911
12103000159,1541,1241,816,146,120,44,105,13,425
12071000094,4594,4041,3303,501,108,53,49,5,738
12071000144,0,0,0,0,0,0,0,0,0
12071000087A,3706,3475,3150,140,64,34,64,1,325
12071000014,1942,1757,1592,106,12,11,23,0,165
12071000140,0,0,0,0,0,0,0,0,0
12071000067,5391,4571,4061,258,45,87,78,2,510
12071000041,4482,3834,3078,553,52,50,86,3,756
12071000061,8552,6678,3494,2905,109,178,98,11,3184
12071000034,6775,5335,3694,1212,191,70,141,4,1641
12071000076A,0,0,0,0,0,0,0,0,0
12071000008,6892,5474,1887,873,2640,87,72,12,3587
12071000076B,3644,2956,2261,361,173,58,118,7,695
12071000075,6735,5360,4092,612,311,78,205,9,1268
12071000106B,5735,4844,3344,1006,226,102,142,10,1500
120170408.1,3971,3332,2978,180,46,80,27,7,354
120170107.1,3876,3459,3119,105,90,62,77,0,340
12073001257,1345,1081,811,38,174,42,11,3,270
12073001258,10,7,0,3,1,0,0,0,7
12073001259,92,80,78,0,2,0,0,0,2
12073003402,0,0,0,0,0,0,0,0,0
12073003453,1903,1562,1308,68,117,43,39,4,254
12073003551,4836,3800,1753,319,1544,77,169,8,2047
12073003507,3487,2813,1378,169,1144,44,90,8,1435
12073003509,3256,2697,1798,179,563,66,93,4,899
12073004167,3510,2722,2256,132,220,36,76,2,466
12073004168,155,121,58,3,59,2,0,0,63
12073004161,3332,2549,1897,103,463,39,37,1,652
12073004119,5532,4290,3418,270,330,71,187,2,872
12071000015,3660,3495,3275,96,17,68,18,1,220
12071000101,4640,4173,3673,324,62,40,53,5,500
12071000018,973,934,911,6,7,3,5,0,23
12071000085,4066,3490,2763,353,106,39,175,8,727
12071000305,1577,1541,1477,31,7,3,23,1,64
12071000086,6223,5602,4934,359,80,73,129,9,668
12071000119B,3795,3570,3324,118,38,27,65,4,246
12071000217,108,101,90,9,1,1,1,0,11
12071000081,2706,2667,2591,29,9,17,12,2,76
12071000068,7537,6431,5496,652,71,161,40,1,935
12071000010B,4395,3696,2108,1025,374,42,154,6,1588
12071000033,4723,3728,2320,936,200,78,165,7,1408
12071000007,11350,7780,1147,3750,2900,366,26,9,6633
12071000060A,0,0,0,0,0,0,0,0,0
12071000059,8607,6719,3446,2409,674,125,112,4,3273
12015000024,2621,2393,2232,85,16,32,15,4,161
12015000091,1608,1505,1369,66,40,1,25,1,136
12015000127,5617,4941,4432,217,88,81,80,11,509
12015000006,3393,3239,3061,53,45,21,25,1,178
12015000094,3494,3288,3105,85,18,36,20,0,183
12071000073,6251,5584,4280,641,223,64,350,9,1304
12099000370,1156,914,477,194,181,22,45,0,437
12099000767,4298,3109,84,121,2895,31,12,14,3025
12099000773,3369,2429,78,125,2247,41,10,4,2351
12099000768,3612,2611,234,263,2105,39,45,5,2377
12099000464,952,735,570,98,15,2,33,0,165
12099000460,539,449,368,50,8,4,10,2,81
12099000776,3140,2437,246,167,2017,45,23,5,2191
12099000764,3850,3020,985,484,1429,30,124,6,2035
12099000320,3363,2552,765,1261,444,107,61,5,1787
12099000778,3340,2543,947,841,709,96,37,7,1596
12099000783,2676,2218,873,225,1059,15,58,0,1345
12099000708,1021,699,65,210,429,8,5,4,634
12099000706,813,619,179,222,196,15,23,1,440
12099000248,3315,2620,840,1574,141,57,48,9,1780
12099000005,0,0,0,0,0,0,0,0,0
12099000204,0,0,0,0,0,0,0,0,0
12099000762,2186,1690,350,247,935,10,153,5,1340
12099000855,5,2,0,0,2,0,0,0,2
12099000759,783,566,87,63,374,0,44,1,479
12099000262,2459,1882,354,1257,209,44,65,4,1528
12099000261,3229,2227,281,1671,263,58,47,4,1946
12099000272,6300,4606,689,2996,824,142,180,13,3917
12099000314,398,311,75,207,16,13,12,1,236
12099000315,2863,2329,515,1272,482,15,58,6,1814
12071000017,0,0,0,0,0,0,0,0,0
12103000188,2049,1709,1431,107,54,45,54,4,278
12103000047,3093,2490,2128,173,25,45,81,3,362
12015000010,1551,1408,1329,28,8,16,21,1,79
12015000022,2479,1931,1338,300,206,52,43,3,593
12015000020,3448,2873,2260,251,183,56,90,8,613
120170407.1,3474,3106,2857,84,57,57,17,10,249
12087000033,3074,2538,1646,733,49,38,38,0,892
12087000034,1459,1352,1226,86,10,14,18,2,126
12087000014,2274,1953,1578,240,48,45,37,2,375
12081000168,9983,7359,5129,971,874,107,267,7,2230
12081000235,0,0,0,0,0,0,0,0,0
12081000136,3130,2395,2000,262,27,66,25,5,395
12081000158,2746,2639,2491,64,6,26,31,4,148
12053000014,11206,8625,6257,1496,478,172,263,17,2368
12053000009,2921,2457,2169,131,73,41,27,6,288
12053000036,6526,5078,3709,595,542,125,72,14,1369
12081000202,5260,4382,3856,212,122,41,127,5,526
12081000037,1160,855,120,243,468,21,10,3,735
12081000048,1683,1276,412,445,387,27,13,1,864
12081000043,1067,741,47,357,333,9,4,2,694
12081000179,436,430,401,15,1,11,2,0,29
12081000042,438,317,155,94,58,2,6,2,162
12081000241,0,0,0,0,0,0,0,0,0
12081000242,51,38,1,23,9,6,1,0,37
12081000238,0,0,0,0,0,0,0,0,0
12081000239,16,12,5,5,2,0,0,0,7
12081000240,0,0,0,0,0,0,0,0,0
12081000237,0,0,0,0,0,0,0,0,0
12133000003,830,647,584,9,19,25,4,0,63
12133000009,1561,1176,1004,28,100,36,5,2,172
12127000093,3678,2954,2072,479,252,63,65,4,882
12127000090,5281,4262,2076,1564,544,111,83,13,2186
12127000095,4252,3338,1713,1117,461,98,60,4,1625
12127000119,1699,1430,1061,89,233,23,13,0,369
12127000148,7906,6909,4511,540,1404,81,331,16,2398
12127000117,0,0,0,0,0,0,0,0,0
12127000182,5546,4801,4308,163,88,79,118,13,493
12127000108,1414,1155,837,81,152,28,55,2,318
12127000118,4997,3958,3191,233,120,37,355,6,767
12127000154,3140,2336,545,225,1524,63,29,9,1791
12127000087,4892,3829,1962,1304,515,113,68,12,1867
12127000206,4306,3531,2896,220,250,96,67,4,635
12127000205,5431,4591,3593,153,665,108,46,3,998
12127000203,6462,5718,5254,191,120,90,54,3,464
12127000221,1516,1271,1149,47,33,19,18,0,122
12127000244,1532,1353,1132,20,167,21,14,0,221
12127000217,5388,4517,4052,157,115,104,71,6,465
12127000075,6805,5168,2940,1366,624,95,171,5,2228
12127000058,900,715,474,142,47,26,24,1,241
12127000076,5754,5024,4109,471,225,89,110,2,915
12127000074,5258,4005,2996,603,226,119,60,6,1009
12127000236,2678,2448,2274,56,30,51,27,4,174
12127000257,11,10,9,0,0,1,0,0,1
12127000256,0,0,0,0,0,0,0,0,0
12127000248,0,0,0,0,0,0,0,0,0
12127000269,5,5,2,3,0,0,1,0,3
12127000219,5499,4559,4091,153,113,85,35,5,468
12127000200,1799,1500,1371,45,12,40,24,2,129
12127000013,5052,4383,3426,483,290,70,81,5,957
12127000018,1481,1201,837,217,66,40,33,1,364
12127000188,28,19,8,10,0,1,0,0,11
12127000195,2546,2146,1872,89,66,36,75,3,274
12033000114,1041,879,450,29,350,17,28,5,429
12033000034,1325,974,576,58,223,41,86,8,398
12033000077,1327,1166,1000,43,72,17,31,7,166
12033000104,2034,1652,1015,94,395,51,81,6,637
12033000231,2100,1686,1011,188,363,48,79,11,675
12071000004,11447,8084,2413,3052,2073,144,403,5,5671
12127000121,5688,4762,3708,319,523,71,96,9,1054
12127000134,25,24,23,0,0,0,1,1,1
12127000125,4848,4119,3511,225,154,102,97,1,608
12127000123,2790,2410,2178,90,25,31,64,1,232
12127000192,5614,4705,4010,318,150,56,139,10,695
12127000180,3760,3182,2674,224,164,57,49,4,508
12081000003,146,101,80,9,9,2,2,0,21
12081000014,2520,1957,1465,211,190,59,54,0,492
12081000206,2348,1869,1573,183,31,43,18,4,296
12081000190,5876,4917,3897,458,251,97,178,13,1020
12081000077,4407,3791,2859,442,280,52,143,6,932
12081000170,2320,1859,1228,235,265,44,63,3,631
12081000118,4025,2916,1194,1160,493,84,44,11,1722
12081000071,769,508,115,265,123,8,11,0,393
1209300P-05,2522,2067,1800,149,26,45,19,0,267
1209300P-08,5915,4903,4118,457,128,73,68,3,785
1209300P-09,3402,2447,1592,710,53,45,39,0,855
12127000091,5338,4197,2298,1215,555,115,88,14,1899
12127000080,4035,3360,2940,176,97,91,24,1,420
12127000122,3036,2573,2260,128,46,43,71,1,313
12127000077,4063,3216,1538,1196,373,64,99,1,1678
12127000083,5676,4344,1954,1786,522,155,91,20,2390
12127000137,3586,2748,1784,230,651,68,36,1,964
12127000059,1339,1100,683,304,78,18,28,3,417
12081000120,8013,6826,5225,724,483,93,252,7,1601
12081000107,5493,4939,4254,299,181,70,98,10,685
12081000105,660,616,566,32,8,2,3,1,50
12081000196,3128,2447,1412,741,208,58,48,2,1035
12081000193,1557,1234,534,598,94,16,10,2,700
12081000198,1696,1550,1347,95,51,13,46,3,203
12033000128,986,736,324,39,350,21,16,3,412
12071000009,10923,9001,4369,2463,1667,104,390,5,4632
12071000074,4637,4205,3760,248,60,23,89,9,445
12053000042,4080,3313,2605,475,136,59,65,2,708
12091000032,4726,3739,2410,518,456,133,245,29,1329
12091000063,4580,3538,2099,679,498,127,194,7,1439
12071000080,3480,3165,2564,429,53,28,81,10,601
12071000107,7898,6282,5098,791,162,65,124,11,1184
12073002363,970,777,477,83,190,28,14,1,300
12073002366,565,481,368,23,69,17,4,1,113
12073005225,5501,4048,2504,306,504,67,683,1,1544
12073001230,930,828,426,60,197,11,132,3,402
12073001251,90,70,16,0,51,2,2,0,54
12073002502,2076,1937,1131,257,400,32,155,1,806
12073002504,1233,1148,534,148,406,22,73,0,614
12073004401,832,681,527,41,47,4,63,3,154
12073004455,3266,2380,2027,96,140,40,69,4,353
12073003467,3687,2917,1795,205,798,62,82,3,1122
12073003457,954,769,523,62,134,18,24,3,246
12073005260,5149,4131,2226,246,1430,84,181,8,1905
12073005258,3,1,0,0,0,0,1,1,1
12073005264,137,112,43,16,47,0,4,0,69
12073005263,2295,1923,1467,57,330,16,29,7,456
12073001361,1469,1167,383,55,692,27,5,1,784
12073001362,144,113,56,1,55,0,0,0,57
12073001359,262,190,62,16,113,6,1,0,128
12073004103,3530,2785,2088,171,352,48,122,3,697
12081000195,2657,2060,1181,680,130,52,36,6,879
12081000049,2394,1896,1359,411,93,52,10,2,537
12133000002,1599,1215,1071,24,73,29,7,3,144
1213300004E,400,314,296,7,2,9,0,2,18
12133000026,296,213,187,5,5,13,0,0,26
12133000025,2767,2617,1443,204,930,40,12,1,1174
1213300009D,240,186,155,9,7,7,3,0,31
1213300007A,539,445,398,4,7,20,4,0,47
1213300004C,1086,781,471,23,228,44,12,2,310
12087000020,3481,2891,1834,880,156,24,20,0,1057
12087000021,1689,1437,1082,273,28,22,31,2,355
12087000019,2096,1803,984,630,131,36,30,7,819
12087000003,2006,1775,1343,297,55,31,45,5,432
12087000009,2872,2421,1548,628,173,37,66,7,873
12087000017,2412,2140,1817,215,27,40,30,5,323
12073001203,4504,3405,1069,268,1813,51,251,5,2336
12073001201,23,20,10,5,3,5,0,0,10
12073003101,1897,1555,1332,79,71,7,51,3,223
12073002365,6156,4767,3574,439,503,178,43,9,1193
12073002358,619,512,263,56,189,4,3,0,249
12073004459,5091,3776,3055,197,309,61,145,3,721
12069000041,672,526,416,64,16,30,7,4,110
12069220022,1242,1009,777,152,15,25,16,1,232
12069000004,2957,2309,2043,122,23,79,11,0,266
12069000040,3033,2250,1040,673,383,61,111,6,1210
12069000033,2337,1961,1613,220,49,57,29,0,348
12069000079,3914,3348,2633,368,218,70,63,6,715
12069000076,1398,1151,815,106,172,37,18,2,336
12069000103,1938,1794,943,218,587,28,34,5,851
12069001060,1700,1691,1381,122,122,21,39,1,310
12069000023,3656,3154,2539,283,178,79,41,2,615
12069000236,1426,1410,1289,63,35,18,6,0,121
12069000126,1319,1312,1184,39,55,15,7,0,128
12069000018,3530,2646,1732,368,471,52,39,6,914
12069000071,520,416,325,47,17,25,14,1,91
12069000095,1849,1838,1752,24,20,10,22,1,86
12069000115,1847,1419,852,260,194,36,61,2,567
12069000058,3477,2843,2303,231,159,52,102,0,540
12069000035,2568,2234,1769,190,135,51,80,2,465
12069000054,4544,3717,2862,385,292,64,93,10,855
12069000053,2316,2028,1572,177,150,31,85,0,456
12115000096,6037,4648,3659,460,363,93,86,7,989
12115000027,5953,5082,4515,272,71,115,79,3,567
12087000025,2092,1848,1504,281,11,38,21,1,344
12041000005,2213,1734,1461,161,17,68,15,3,273
12069000057,3443,2828,2294,274,169,58,36,0,534
12069000061,1697,1689,1624,9,11,24,23,2,65
12069002000,3640,2981,2515,223,101,32,91,0,466
12069000073,4555,3737,2894,399,304,52,70,6,843
12069000091,2334,2324,2263,33,14,8,11,0,61
12069000085,3362,2691,1883,263,359,60,114,15,808
12069000128,1720,1686,1469,70,78,18,46,2,217
12069000036,2137,1816,1436,218,108,41,33,4,380
12053000006,5459,4497,3823,239,261,122,48,11,674
12053000023,8959,7316,5432,667,997,168,82,6,1884
12053000010,6377,5198,4125,384,426,135,80,5,1073
12053000025,13293,10495,8434,1183,446,326,162,24,2061
12053000017,5693,5124,4599,266,77,79,71,8,525
12053000031,10964,9222,7256,995,589,176,203,7,1966
12053000038,4258,3547,2685,455,245,65,99,4,862
12053000024,6780,5622,4297,902,228,131,64,15,1325
12053000022,4867,3905,2781,731,221,137,74,11,1124
12053000040,8834,6885,4584,1571,462,172,126,9,2301
12053000034,8331,6553,4364,1502,464,156,111,8,2189
12053000033,5998,4703,3435,781,279,120,67,24,1268
12053000019,9824,7987,6120,1166,379,164,140,7,1867
12053000018,3873,3544,3163,239,51,37,30,6,381
12133000007,854,714,460,21,190,40,6,0,254
12127000081,6000,4560,1943,1802,765,74,67,16,2617
12127000212,3899,3293,2903,134,80,119,39,2,390
12127000178,5465,4829,4149,256,194,95,105,12,680
12127000170,4180,3531,3083,166,177,59,50,5,448
12127000151,4030,3159,1307,314,1488,57,54,6,1852
12127000181,5357,4414,3386,284,387,60,279,6,1028
12127000039,2218,1816,1467,153,65,51,69,1,349
12127000026,8965,7376,5617,922,517,97,249,12,1759
12127000052,1102,924,812,65,21,19,10,0,112
12033000255,791,633,164,21,413,19,14,5,469
12033000125,3259,2413,513,54,1801,35,18,4,1900
12033000102,741,535,304,39,162,14,12,3,231
12115000049,2430,2030,1640,194,98,29,49,6,390
12069000011,7888,6468,4679,677,874,148,101,4,1789
12069330033,752,611,491,56,35,21,12,0,120
12069000016,5947,4780,3617,513,419,109,101,7,1163
12069000050,2417,1862,1171,248,386,44,17,3,691
12069000069,4423,3576,2065,786,620,87,44,13,1511
12069000112,2619,2050,1328,388,210,37,100,3,722
12069000013,4284,3377,2772,222,245,101,33,6,605
12069000042,2881,2170,1745,175,193,29,27,2,425
12069000220,4211,3977,3577,129,132,34,73,5,400
12069000250,3636,2768,1787,366,515,57,35,9,981
12069000026,8027,5765,2328,2267,845,183,179,20,3437
12069000012,2967,2373,1959,276,68,55,13,2,414
12069000064,3317,2975,2148,298,440,53,43,9,827
12069000077,1625,1155,740,148,236,28,31,3,415
12087000007,2408,2220,1822,215,120,44,46,4,398
12115000020,5302,4418,2276,1534,401,63,133,6,2142
12115000073,5300,5014,4750,103,20,34,71,2,264
12115000082,7277,6553,5726,458,126,46,164,9,827
12115000075,5581,5290,4989,139,56,58,58,5,301
12053000030,2902,2673,2412,129,16,58,35,1,261
12053000015,7753,6044,4368,1071,368,155,110,12,1676
12115000066,5996,5023,3619,787,348,82,131,1,1404
12073004403,2599,1963,1292,78,132,17,435,5,671
12073001301,1517,1236,300,93,812,5,20,2,936
12073001302,2409,2306,1295,225,632,32,129,6,1011
12087000016,3078,2723,2273,288,51,31,45,3,450
12091000027,4370,3501,2374,400,374,101,253,28,1127
12117000037,7195,5914,2996,1630,1083,123,250,13,2918
12117000038,3570,3037,2306,438,153,67,90,6,731
12117000056,8500,6543,3488,1843,884,134,277,14,3055
12117000076,6167,4460,2976,788,318,46,329,11,1484
12117000014,4915,3945,2317,881,391,88,328,7,1628
12117000073,5816,4512,3546,507,188,92,162,9,966
12073003455,1920,1563,1328,46,120,15,45,5,235
12073003109,1056,890,655,42,134,7,41,1,235
12073003110,2984,2532,1622,132,602,54,141,3,910
12073005105,3241,2737,2258,160,192,40,74,5,479
12073005221,4102,3390,1557,348,1222,87,208,8,1833
12073005251,2440,1981,1457,98,274,36,124,0,524
12133000001,666,501,343,5,136,11,5,1,158
12015000012,1643,1475,1158,119,88,23,75,1,317
12015000005,2832,2476,2128,133,132,35,31,2,348
12015000004,489,453,411,15,7,6,8,0,42
12015000043,1578,1360,1260,42,10,24,18,0,100
12073003459,2140,1753,1325,75,253,26,48,7,428
12073005110,2105,1734,1185,94,323,34,84,10,549
12073005219,3051,2221,1428,129,252,37,374,2,793
12073001502,924,845,603,74,119,17,30,0,242
12043000008,1632,1453,1310,64,31,26,10,1,143
12043000001,531,426,313,88,22,0,0,0,113
12043000010,438,281,94,42,34,115,1,1,187
12133000006,1567,1249,966,44,144,72,17,4,283
12115000048,5359,5105,4812,139,29,40,41,3,293
12115000036,6021,5739,5217,255,140,36,55,2,522
12069000008,4281,3334,2667,399,128,106,51,9,667
12069000117,1134,940,801,82,17,19,15,3,139
12069000052,3141,2647,2049,196,265,47,71,3,598
12117000010,7927,6310,3765,1155,671,104,625,15,2545
12117000013,7870,6203,3343,1414,735,104,646,15,2860
12117000004,8917,6434,2187,1838,1777,130,664,11,4247
12117000024,8424,6839,4810,946,796,111,215,15,2029
12117000040,6405,5293,2889,1484,681,101,264,11,2404
12117000020,12237,9912,5728,2516,1180,244,410,12,4184
12117000006,7393,5466,1166,904,3306,90,97,12,4300
12117000055,3208,2450,1276,667,414,81,69,12,1174
12115000038,7179,5774,4556,552,421,88,120,13,1218
12115000080,6435,5141,4213,515,152,90,150,4,928
12015000110,2211,1768,1405,219,99,25,18,2,363
12015000067,4776,4299,3692,225,189,72,84,18,607
12033000267,4403,3696,1749,217,1641,78,17,12,1947
12033000263,5803,4527,3811,91,313,208,55,12,716
12033000111,404,348,269,9,63,11,3,0,79
12033000055,1845,1742,1569,57,20,49,37,7,173
12133000013,617,482,434,5,26,14,3,0,48
12133000023,1560,1251,1061,47,74,43,18,8,190
1201100V048,1838,1460,364,798,220,14,65,5,1096
1201100X003,3542,2739,452,1370,804,27,151,2,2287
1201100Q091,5460,4374,1952,1858,278,61,228,5,2422
1201100X034,2121,1650,557,770,205,26,124,3,1093
1201100C028,5110,3676,135,478,3043,53,45,9,3541
1201100C015,5779,3971,129,887,2941,88,42,3,3842
1201100R053,3411,2754,1593,595,409,39,79,7,1161
1201100D010,2166,1627,390,581,618,24,38,7,1237
12081000025,1990,1604,1285,167,62,53,34,3,319
12081000030,982,858,690,83,67,6,9,1,168
12081000088,3736,2984,2074,549,231,80,46,6,910
12081000110,2180,1897,1534,212,79,25,37,2,363
12081000192,1861,1438,1036,231,73,44,55,8,402
12081000079,1566,1355,1195,67,22,18,39,4,160
12081000080,3288,3106,2869,86,84,33,34,3,237
12081000056,1464,1421,1320,41,19,8,10,0,101
12081000013,936,707,452,121,93,20,30,2,255
12081000245,911,830,735,42,33,6,18,0,95
12081000022,2802,2565,1594,472,432,30,31,4,971
12081000247,0,0,0,0,0,0,0,0,0
12081000244,0,0,0,0,0,0,0,0,0
12081000246,0,0,0,0,0,0,0,0,0
1209300P-11,1562,1438,1308,60,22,50,13,1,130
12059000004,2301,1827,1743,24,7,42,5,4,84
12059000006,3744,2897,2614,52,69,125,12,7,283
12059000007,3579,2742,2428,72,148,55,35,4,314
12053000037,5898,4690,3743,514,186,164,62,1,947
12053000039,3736,3038,2149,539,243,57,57,9,889
12081000122,8875,6630,3571,2116,740,155,108,8,3059
12081000062,2328,2213,1841,155,117,20,48,5,372
12081000085,5310,4359,3688,374,119,62,73,14,671
12081000061,1041,869,800,30,11,12,10,1,69
12081000108,557,488,438,31,9,5,6,0,50
1201100R032,7063,6494,4466,1081,557,84,279,9,2028
12011000011,47847,34647,19266,7069,4069,286,3618,48,15381
12011000009,1992,1514,258,869,295,13,86,1,1256
1201100X024,4005,3220,968,1479,567,30,205,7,2252
1201100W012,5849,4274,174,1539,2574,40,125,8,4100
1201100X051,9,7,2,4,4,0,1,0,5
1201100E003,3678,2682,1193,637,641,36,173,2,1489
1201100E004,7127,5154,1561,1509,1862,67,204,22,3593
1201100X033,4799,3551,723,2126,492,28,194,1,2828
1201100X011,1614,1274,290,916,45,23,35,0,984
1201100G003,4829,3957,1612,1003,1121,44,172,0,2345
12011000002,3087,2345,542,532,989,24,253,11,1803
1201100D001,2488,2067,1140,590,214,46,90,5,927
1201100D014,2792,2273,863,854,404,37,84,4,1410
1201100V006,2057,1737,894,593,177,21,48,0,843
1201100C013,1647,1542,1278,161,46,7,15,1,264
12059000002,1819,1427,1353,18,3,41,12,0,74
12081000191,7265,5312,4287,476,222,74,229,9,1025
12081000018,6188,4736,3604,487,386,93,157,5,1132
12081000229,1767,1205,913,120,112,14,45,0,292
12081000228,8,8,1,1,1,2,4,0,7
12081000131,79,53,3,10,40,4,0,0,50
12081000130,7603,6673,5192,669,294,70,371,2,1481
12071000093,4777,4145,3466,448,109,48,56,2,679
12071000139,0,0,0,0,0,0,0,0,0
12091000049,1977,1793,1512,115,61,33,47,13,281
12069000106,4387,3912,1978,1512,331,70,99,5,1934
12069000081,3072,3031,2855,53,59,28,17,2,176
12069000047,6700,4881,1973,794,1994,93,51,12,2908
12069000044,3481,2879,1762,358,619,54,101,33,1117
12085000045,8796,6912,2450,3128,1276,359,50,8,4462
12085000102,3155,2630,2186,261,62,54,56,6,444
12053000028,8043,6323,4428,1169,443,109,175,4,1895
12053000044,9883,7476,5095,1206,746,156,313,14,2381
12053000001,1952,1625,1463,72,20,42,14,3,162
12127000101,2948,2639,2274,133,94,25,86,6,365
12127000153,4847,3896,1411,388,2003,59,116,5,2485
12127000156,3266,2708,524,207,1909,57,33,5,2184
12117000039,8138,6516,3393,1404,1427,122,269,8,3123
12097000204,13105,10075,1090,7513,1525,167,315,39,8985
12097000103,472,328,151,113,39,23,16,5,177
12097000102,889,720,391,283,27,22,12,3,329
12097000351,2388,1807,200,800,686,25,135,4,1607
12097000132,1335,1081,247,677,98,15,53,1,834
12097000111,3654,2804,761,1410,400,67,203,6,2043
12069000068,1922,1538,1090,228,130,22,55,2,448
12069000118,6503,4934,3542,795,366,101,139,4,1392
12069000100,8594,6832,3985,1234,1018,89,450,16,2847
12069000028,5548,4237,1916,1179,917,106,144,24,2321
12069000005,2190,1827,1592,157,22,58,8,1,235
12069000087,1342,1196,1037,57,70,24,13,3,159
12071000039,4984,4476,4041,276,44,51,40,2,435
12071000010A,0,0,0,0,0,0,0,0,0
12127000249,10,7,7,0,0,0,0,0,0
12127000017,3362,2743,2232,347,53,89,25,3,511
12127000199,6794,5695,4519,424,287,95,340,3,1176
12127000159,4696,4039,2852,296,687,75,125,11,1187
12127000169,4557,3652,2566,262,650,102,71,1,1086
12127000176,5109,4895,4371,197,108,65,127,1,524
12127000034,5987,4775,2616,959,1054,99,65,13,2159
12127000043,2752,2269,1913,110,164,64,5,2,356
12117000060,6936,5586,3894,923,405,81,301,15,1692
12117000016,4997,3841,2142,946,524,87,213,4,1699
12069000021,0,0,0,0,0,0,0,0,0
12081000217,4383,3531,2834,300,138,55,135,1,697
12081000069,4847,3912,3135,315,158,66,231,1,777
12081000134,9371,7563,6103,672,235,91,397,9,1460
12069000275,696,669,628,20,3,11,6,1,41
12069000090,861,848,767,40,13,9,9,1,81
12069000092,3078,2618,2051,256,180,56,76,5,567
12069000065,2665,2270,1785,265,113,45,45,5,485
12069000038,10286,7482,4025,1860,993,157,458,23,3457
12069000114,4176,3153,1981,662,331,52,135,5,1172
12069000029,3196,2521,2026,272,100,46,61,4,495
12127000107,4041,3342,2900,162,85,59,122,3,442
12127000109,174,144,131,6,5,2,0,0,13
12127000106,3517,2945,2628,130,62,21,89,2,317
12127000157,3771,3424,2269,333,725,67,46,6,1155
12127000070,4908,4323,3456,540,175,85,70,3,867
12069000031,2438,1941,1391,449,36,37,25,3,550
12069000006,2199,1777,1501,142,47,50,18,0,276
12127000102,892,739,662,24,9,21,16,2,77
12091000046,505,414,355,19,8,16,14,0,59
12091000038,3425,2711,1803,302,368,97,174,14,908
12069000059,8387,6789,4661,1174,660,167,144,22,2128
1209300P-03,3323,2640,2137,310,72,68,51,4,503
1209300P-10,4294,3787,1773,649,1325,36,5,2,2014
12069000062,3012,2469,1813,287,149,198,41,4,656
12011ZZZZZZ,49,35,6,8,5,8,8,0,29
1201100Q064,3697,2930,792,1862,149,29,120,3,2138
1201100Q062,6393,4934,857,3612,240,47,226,4,4077
1201100V041,2945,2231,315,1152,666,74,112,5,1916
1201100V038,4076,3182,604,1844,657,145,122,10,2578
1201100V043,2434,1878,389,1056,365,92,67,0,1489
1201100U004,5997,4553,2479,1433,247,69,351,7,2074
1201100R030,4753,3261,79,168,3021,28,20,6,3182
1201100R040,5496,4743,3490,793,207,48,169,7,1253
1201100V058,980,929,667,192,29,5,24,3,262
1201100R014,1890,1775,1401,196,95,7,60,0,374
1201100R055,1389,1332,1092,142,34,0,31,0,240
1201100E030,1701,1219,170,366,655,18,32,2,1049
1201100W011,4049,3106,225,936,1941,37,91,13,2881
1201100Q082,3162,2404,66,462,1890,34,13,1,2338
1201100Q081,3285,2519,254,1133,1207,66,54,6,2265
1201100V036,1363,1157,288,434,434,18,43,5,869
1201100Z002,4430,3146,91,232,2842,38,17,1,3055
1201100L016,2188,1653,15,85,1560,17,11,2,1638
1201100R051,1886,1449,48,112,1277,15,13,6,1401
1201100R064,2328,1732,195,687,854,15,31,2,1537
1201100E007,6315,4788,1972,1286,1294,40,197,5,2816
1201100Q083,3270,2427,44,235,2131,17,36,2,2383
12087000029,2012,1833,1398,342,21,30,37,5,435
12087000028,2430,2068,1319,654,46,31,26,1,749
12081000057,2863,2407,2217,82,22,29,34,3,190
12081000033,2644,2101,1472,368,199,34,40,3,629
12081000096,2477,1872,658,474,666,58,43,2,1214
12081000031,2005,1526,1030,280,168,14,34,1,496
12081000236,0,0,0,0,0,0,0,0,0
12121000013,3347,2627,2263,171,81,79,30,2,364
12127000009,5662,4556,3088,1124,202,62,40,9,1468
12127000010,3163,2655,2244,190,107,63,41,3,411
12127000085,4969,3793,1776,1360,581,82,69,7,2017
12127000038,0,0,0,0,0,0,0,0,0
12081000156,3010,2820,2630,85,9,38,31,4,190
12081000155,0,0,0,0,0,0,0,0,0
12133000004,2111,1616,1347,46,126,73,28,3,269
12133000020,1173,870,626,32,171,38,0,3,244
12103000086,3548,3293,2988,135,44,20,80,1,305
12103000088,2414,2133,1795,114,106,35,53,3,338
12103000307,1013,975,817,71,23,7,49,0,158
12103000122,4153,3437,2584,364,176,77,222,9,853
12103000275,8288,7114,5830,583,304,138,223,9,1284
12103000252,4810,3943,2644,747,335,132,132,9,1299
12103000116,2164,1783,1446,117,53,40,120,3,337
12103000120,2593,2120,1376,315,185,34,205,6,744
12103000123,2650,2204,1667,290,97,31,106,10,537
12103000130,4603,3892,2864,493,285,80,157,6,1028
12103000287,2919,2568,2325,88,31,37,49,4,243
12103000313,2445,1971,1418,292,138,60,81,3,553
12103000230,2419,2287,2072,108,24,22,32,3,215
12103000234,1319,1242,1155,52,17,17,2,0,87
12103000068,3547,3098,2482,199,228,64,118,3,616
12103000318,9426,8494,7595,470,180,70,144,8,899
12051000001,4811,3429,644,2076,640,53,86,14,2785
12051000025,4009,2888,727,2044,91,49,25,0,2161
12051000014,1939,1369,385,848,101,35,19,0,984
12051000024,2956,2579,1136,1372,36,31,12,2,1443
12051000012,4545,3193,1089,1857,190,79,36,4,2104
12051000022,1774,1425,88,1302,17,38,5,1,1337
12051000013,2860,2235,1089,939,155,53,15,5,1146
12051000010,1035,842,425,369,22,22,9,0,417
12051000018,3215,2425,501,1824,82,61,5,1,1924
12051000011,1516,998,358,528,72,31,23,2,640
12051000007,959,708,425,218,40,26,21,0,283
1201100V016,3339,2827,1288,1036,464,29,78,9,1539
1201100V011,3081,2393,217,496,1668,11,36,8,2176
1201100R037,1597,1450,1251,122,30,13,30,0,199
1201100D015,2929,2470,1406,766,201,32,78,2,1064
12087000018,2249,1942,1540,285,48,39,26,2,402
12069000119,1143,889,728,92,25,22,21,3,161
12069000007,1556,1245,1088,108,15,18,8,0,157
12069000107,2528,2493,2284,61,92,18,17,3,209
12069000072,5609,4604,3207,411,486,80,404,9,1397
12069000120,5898,4603,3218,701,468,80,163,3,1385
12069000020,1437,1067,697,150,154,40,24,1,370
12069000127,1337,1283,974,158,94,23,45,0,309
12069000030,778,584,437,71,39,5,18,3,147
12117000043,6499,5410,3167,1419,586,96,210,17,2243
12117000080,4995,3850,2346,695,295,58,462,11,1504
12117000058,6442,5173,3030,1401,587,122,184,13,2143
1201100K003,3868,3301,212,159,2850,17,88,3,3089
1201100A012,3590,3164,1805,597,280,25,90,4,1359
1201100A019,2695,2202,1319,395,219,28,73,6,883
1201100J003,2308,2046,869,609,479,34,82,6,1177
1201100N009,1763,1503,636,503,246,7,99,0,867
1201100N025,4653,3702,1712,1040,661,27,302,3,1990
1201100N015,5309,4754,2526,1136,872,41,194,6,2228
1201100N014,4873,3894,999,1184,1555,26,219,8,2895
1201100N024,2319,1837,1236,326,171,19,69,3,601
12069000051,1920,1624,1120,193,249,47,13,4,504
12129000009,836,683,646,5,8,19,5,2,37
12129000008,1114,956,858,19,37,30,5,0,98
12127000218,5671,4677,4191,195,144,75,49,6,486
12103000298,5160,4445,3729,331,195,62,136,7,716
12103000018,5359,4004,951,270,2733,66,51,7,3053
12103000019,1634,1462,1069,98,200,23,53,6,393
12103000090,5361,5171,4670,215,155,44,65,11,501
12103000305,3607,3102,2389,246,124,33,277,3,713
12103000304,10235,8384,4253,1768,1825,161,409,23,4131
12103000339,7836,6533,4439,801,725,159,423,8,2094
12033000097,897,745,522,17,99,24,79,5,223
12033000094,2303,1707,887,97,583,62,81,1,820
12033000025,2489,1956,1246,89,408,75,137,4,710
12121000008,1821,1444,1236,136,21,37,11,2,208
12103000235,3883,3603,3200,182,56,70,63,3,403
12103000175,3557,2811,2454,128,49,43,99,0,357
12103000176,3486,2925,2535,190,59,47,75,0,390
12103000349,4231,3221,1648,875,551,103,122,7,1573
12103000186,2359,1928,1697,116,29,20,40,2,231
12103000207,3839,3213,2520,295,194,93,104,21,693
1201100A009,4444,4369,3436,571,148,24,70,7,933
12011000012,871,690,446,103,99,3,28,1,244
1201100C010,2968,2389,1353,424,498,30,60,4,1036
1201100N022,5199,4364,2122,1252,751,22,217,3,2242
1201100T024,1736,1336,626,518,84,14,114,1,710
1201100R060,3297,3055,2049,578,283,38,125,3,1006
1201100R018,4062,3603,2231,760,404,63,126,7,1372
1201100R033,3857,3138,796,518,1716,32,81,6,2342
1201100R034,4542,4082,3091,643,188,29,122,1,991
1201100V021,2338,1923,935,756,167,20,66,0,988
1201100M004,2610,2008,227,329,1378,15,90,8,1781
1201100L009,3418,2850,570,495,1660,18,144,5,2280
1201100L011,2749,2119,184,252,1639,8,70,7,1935
1201100N002,2777,2158,224,331,1565,37,73,11,1934
1201100N019,1902,1558,652,279,549,25,66,1,906
1201100N008,4527,3743,1742,1056,755,42,200,7,2001
1201100G006,6088,4881,1665,1472,1440,91,207,14,3216
1201100G014,4116,3218,1039,927,1007,34,183,5,2179
1201100K004,3780,2795,114,146,2441,18,104,6,2681
1201100D009,4388,3676,1178,709,1641,32,116,14,2498
1201100K005,3755,2605,46,121,2455,16,30,9,2559
1201100H001,5137,3633,365,716,2449,42,139,3,3268
1201100H009,1832,1368,200,314,825,25,47,1,1168
1201100H003,7823,5763,595,1171,3826,74,236,8,5168
1201100J011,5898,4523,1244,1808,1336,66,168,9,3279
1201100M002,5063,3732,277,479,2892,30,112,25,3455
1201100X038,5498,4366,935,2109,854,38,499,16,3431
1201100F001,3836,3009,1351,672,876,31,79,6,1658
1201100C009,2921,2607,570,1370,560,10,51,1,2037
12127000002,1663,1296,711,511,42,37,4,0,585
12127000001,1689,1311,830,325,103,37,8,1,481
1201100X010,3844,3108,1273,1401,340,42,91,3,1835
1201100U006,4790,3562,2152,805,282,28,282,6,1410
1201100L006,6503,5011,256,296,4368,53,149,7,4755
1201100Q070,6538,4669,1403,2330,283,27,528,6,3266
1201100T017,2081,1613,704,627,139,20,149,0,909
1201100A001,5751,5161,4162,503,175,57,114,5,999
12103000046,5168,4074,3481,278,88,56,123,1,593
12103000253,5650,4972,3301,790,661,119,163,9,1671
12103000353,2400,2177,1986,97,38,17,27,4,191
12103000016,2960,2255,575,117,1509,31,37,7,1680
12086000837,3574,2740,1048,1358,163,33,187,6,1692
12086000733,4683,3791,412,3189,109,22,106,0,3379
12086000788,2975,2446,325,1857,152,20,129,2,2121
12086000715,3303,2714,282,2385,39,20,30,1,2432
12086000714,3095,2535,282,2221,28,11,21,0,2253
12086004381,2063,1739,77,1647,12,7,13,5,1662
12086004380,2307,1948,65,1864,46,9,8,4,1883
12086000472,2470,2106,114,1965,19,11,19,1,1992
12086000330,3939,3323,127,3133,51,4,30,0,3196
12086000414,3110,2566,114,2411,40,3,20,0,2452
12086000558,3787,3184,75,3091,97,25,9,3,3109
12101000170,7444,5858,3834,1161,427,137,358,9,2024
12101000204,3799,2970,1617,732,412,62,191,6,1353
12101000020,1524,1183,1000,117,9,31,4,0,183
12101000007,16806,13688,9876,2071,1216,292,298,24,3812
12101000071,2083,1691,1423,126,67,24,41,11,268
12101101086,302,269,232,31,2,4,2,0,37
12101000212,1692,1429,1204,141,42,26,16,2,225
12101000208,4980,3841,2010,906,573,54,359,6,1831
12101000173,9938,7136,3652,1524,1051,113,837,10,3484
12101000198,7879,5617,2933,1250,923,86,484,15,2684
12101000190,6568,5008,3106,945,611,74,294,5,1902
12101000004,6702,4944,2694,1790,346,104,26,6,2250
12101000001,7551,5739,3281,1286,1033,142,58,13,2458
12101000031,4581,3785,2896,507,183,84,107,7,889
12101000141,0,0,0,0,0,0,0,0,0
12101000091,6975,5489,3661,1084,520,193,114,16,1828
12101000090,4401,3358,2388,596,238,98,54,1,970
12101000113,7053,5458,3866,1079,292,126,95,10,1592
12101101106,4429,3218,2420,357,139,43,260,5,798
12101000213,9299,6935,4666,1164,457,124,543,24,2269
12101100111,6259,4720,3770,441,212,66,243,7,950
12101000195,7470,6091,5006,441,213,69,336,11,1085
12101000070,1070,841,685,94,29,17,11,4,156
12101000014,1297,1024,813,114,34,38,15,2,211
12101000010,12113,8759,4267,2381,1427,193,626,15,4492
12069000121,2679,2532,2291,108,73,18,32,1,241
12069000067,4588,3447,1707,584,1065,56,52,2,1740
12069000225,1213,903,415,113,342,11,15,2,488
12069000122,4287,3262,1332,755,693,103,309,16,1930
12069000070,4906,3828,2629,645,345,95,117,12,1199
12086000278,521,413,11,376,34,3,0,1,402
12086000640,4652,4430,897,1789,1388,9,247,27,3533
12086000771,3223,2622,656,1724,147,11,110,4,1966
12086000548,3657,3145,86,3017,92,26,16,1,3059
12086000606,3863,3001,1024,1528,321,47,141,5,1977
12086000739,2574,2164,264,1694,129,14,95,5,1900
12086008491,25,15,2,13,1,4,0,0,13
12086000649,1449,1106,489,520,31,13,36,1,617
12086000376,5809,4795,200,4494,76,28,76,1,4595
12086000613,2316,1866,639,1052,52,18,97,1,1227
12086000612,2087,1827,477,795,431,10,101,4,1350
12086000332,4728,3846,89,3728,109,7,6,1,3757
12086000334,224,202,5,190,8,0,1,0,197
12086000392,184,173,36,66,76,2,5,0,137
12101000012,1148,898,723,130,18,8,6,5,175
12081000075,5174,4107,3406,321,156,60,150,7,701
12081000074,1643,1345,1118,129,38,34,32,5,227
12081000024,1679,1290,853,319,91,15,17,0,437
12081000141,3497,2705,1418,1016,254,66,12,2,1287
12101000111,2943,2784,2560,119,40,46,20,1,224
12101000099,3394,2683,2080,336,120,43,95,4,603
12101000019,12498,9920,7426,1460,515,224,299,15,2494
12101000089,7848,6769,5838,557,200,103,91,9,931
12101000015,3755,2935,2202,448,131,96,58,1,733
12101000082,5087,4253,3210,621,252,111,106,17,1043
12101000174,3403,2520,1380,668,259,42,177,17,1140
12101000161,3401,2522,2015,238,108,41,119,5,507
12101000199,4967,3901,3154,380,156,78,135,6,747
12101000106,7424,5983,4191,1086,406,184,159,6,1792
12101000193,2750,2666,2327,165,76,47,44,2,339
12101102001,0,0,0,0,0,0,0,0,0
12101101019,0,0,0,0,0,0,0,0,0
12101000043,4525,3639,2894,427,156,64,79,3,745
12101000128,5131,4239,3648,300,86,122,58,2,591
12101000194,4274,3950,3538,203,53,88,52,6,412
12101000057,3078,2539,2063,263,135,57,36,1,476
12109000073,18958,13172,11000,823,328,160,743,23,2172
12109000013,5515,3960,2952,380,291,64,261,4,1008
12109000065,3452,2584,2159,171,70,44,122,1,425
12109000085,293,211,167,11,13,5,14,0,44
12109000072,1850,1371,1115,98,74,17,59,3,256
12109000011,4668,3890,3167,321,181,48,161,9,723
12109000012,3250,2372,2064,117,36,37,113,0,308
12109000025,1905,1419,841,81,468,8,8,1,578
12109000043,1805,1682,1406,143,68,28,47,3,276
12109000042,2358,2128,1888,102,50,27,31,1,240
12069000116,2744,2160,1748,198,113,77,26,7,412
12069000224,725,585,423,76,50,21,11,0,162
12069000214,584,473,313,70,36,34,11,2,160
12069000039,10817,7987,3959,2253,1357,160,267,9,4028
12069000101,1307,988,759,105,66,41,18,0,229
12081000164,3955,3421,2669,312,153,62,223,6,752
12081000126,2936,2528,2104,192,82,44,93,2,424
12081000222,784,735,646,46,10,4,26,0,89
12081000135,2698,2535,2275,85,75,10,65,1,260
12101000175,7583,6166,4395,885,582,113,201,6,1771
12101000110,314,278,223,28,15,8,5,3,55
12101000081,7862,6334,5363,539,134,149,124,6,971
12101000157,6354,5385,4580,337,176,139,118,8,805
12101000137,4012,3154,2231,534,171,78,142,5,923
12101103063,386,267,127,112,27,1,0,1,140
12101000153,2976,2215,1874,192,63,29,44,2,341
12101000166,3812,3320,2926,179,82,53,64,1,394
12101000037,3052,2624,2149,267,114,50,64,4,475
12101000092,0,0,0,0,0,0,0,0,0
12101103023,0,0,0,0,0,0,0,0,0
12101103033,5,5,0,1,1,4,0,0,5
12101000024,2267,1828,1398,244,80,35,61,0,430
12101000207,7486,5184,2927,1019,583,88,619,11,2257
12101000172,5954,4401,1996,1061,755,64,549,9,2405
12101000023,6500,5707,4954,389,192,116,46,6,753
12101102069,203,148,105,22,10,11,8,1,43
12101104006,6,4,1,3,1,0,0,0,3
12101113069,14,10,9,0,0,0,1,0,1
12101105006,0,0,0,0,0,0,0,0,0
12101103006,11,7,3,3,1,1,0,0,4
12101111069,24,16,12,2,2,0,0,0,4
12101000066,11047,7758,4730,1609,659,135,666,20,3028
12101000216,8151,5889,3420,1356,791,119,275,8,2469
12101101008,8212,6044,3967,1113,546,161,293,8,2077
12101000042,11509,9644,7742,1094,429,234,159,20,1902
12129000001,6607,5883,3653,496,1573,119,42,7,2230
12103000335,3037,2716,2192,262,86,36,125,3,524
12103000334,6184,4967,3602,628,320,102,316,15,1365
12103000140,2455,1958,1393,173,76,40,262,10,565
12103000079,3967,3653,3176,215,96,30,129,8,477
12103000001,2486,2221,1474,148,539,19,57,1,747
12103000006,5785,4796,1798,254,2619,52,96,17,2998
12103000332,4609,3575,2386,649,228,67,260,6,1189
12103000117,3153,2588,1988,274,97,43,154,4,600
12103000010,3918,3316,1967,254,972,48,72,3,1349
12081000034,1522,1396,1204,79,57,52,10,1,192
12103000204,2838,2414,1875,267,135,22,106,4,539
12103000250,3174,2588,1970,328,126,58,111,1,618
12103000194,3176,2867,2181,315,258,87,39,4,686
12103000206,5090,4602,3713,373,258,93,161,6,889
12103000083,3174,2321,494,116,1687,38,19,13,1827
12103000258,4186,3348,1923,964,276,73,132,2,1425
12109000029,6719,5589,4726,365,234,130,119,7,863
12109000031,7454,6433,5635,376,178,107,126,14,798
12109000032,7027,5943,5132,360,207,86,112,8,811
12109000046,5753,5070,4506,247,84,89,96,2,564
12109000081,706,480,347,56,17,12,48,0,133
12109000054,785,544,341,68,41,7,95,4,203
12109000052,742,592,412,68,71,42,21,0,180
12109000076,758,554,337,59,71,28,56,1,217
12109000049,662,475,317,56,57,10,31,1,158
12109000091,0,0,0,0,0,0,0,0,0
12109000006,6039,4236,3120,386,254,54,384,10,1116
12109000058,1633,1023,697,145,72,9,86,5,326
12109000068,2573,1732,1490,86,45,35,71,1,242
12013000302,834,652,598,12,7,28,6,3,54
12035000150,4112,3276,2133,467,506,51,109,8,1143
12035000151,872,695,470,103,86,20,19,3,225
12035000141,3310,2635,1843,302,352,43,86,4,792
12035000142,2043,1796,1277,198,257,17,36,1,519
12035000140,1144,962,686,123,140,19,14,1,276
12035000241,4728,4108,3220,374,281,65,143,3,888
12035000240,9,8,4,2,2,0,0,0,4
1201100D016,5409,4307,1848,1869,377,99,135,16,2459
1201100R002,3800,3287,2254,648,175,51,115,6,1033
1201100M025,5391,4110,1454,2186,297,29,190,12,2656
1201100M001,2769,2203,967,789,342,22,80,4,1236
1201100L001,7107,5701,1276,1167,2928,73,363,19,4425
1201100M015,3415,2658,617,962,878,19,233,6,2041
1201100R013,4948,4212,3391,458,130,33,127,14,821
1201100X028,2616,1965,530,1092,239,10,111,2,1435
1201100T029,3540,3101,1576,1091,264,50,141,11,1525
12101105069,0,0,0,0,0,0,0,0,0
12101112069,18,16,15,0,0,0,1,0,1
12101000187,3803,3428,2910,261,90,76,79,5,518
12101101063,0,0,0,0,0,0,0,0,0
12101102063,0,0,0,0,0,0,0,0,0
12101000196,4176,3188,1869,628,369,60,278,8,1319
12077000006,936,728,694,7,6,21,1,1,34
12013000501,1322,1047,829,41,95,81,11,6,218
12013000101,1744,1342,1101,55,122,56,13,6,241
12077000004,1359,1054,924,53,22,53,10,0,130
12013000502,277,209,190,0,4,16,2,2,19
1201100C007,798,647,446,106,71,14,13,1,201
1201100C030,4199,3372,1457,997,613,73,94,2,1915
1201100J008,624,575,212,127,200,7,30,0,363
1201100W018,4075,3118,389,1661,841,20,287,4,2729
1201100T003,7831,6070,2441,2089,809,87,635,2,3629
1201100R059,1381,1267,1029,151,39,10,34,5,238
1201100P003,3115,2817,1572,496,626,53,101,6,1245
1201100R025,3354,2598,178,166,2222,28,31,10,2420
1201100D007,2377,1760,236,390,1099,27,46,5,1524
1201100E011,1665,1364,550,346,330,16,98,4,814
12011000021,4262,3254,1231,828,932,31,195,4,2023
1201100G011,4649,3779,1438,997,1015,50,197,1,2341
1201100F010,5105,4031,1737,1035,714,39,233,3,2294
1201100E006,8694,6593,2622,1946,1709,71,304,11,3971
1201100E008,5591,4022,1435,1356,936,44,283,6,2587
1201100E020,5536,4303,1448,1525,947,40,329,10,2855
1201100R069,3374,2480,54,130,2304,16,15,2,2426
1201100E001,1520,1031,135,301,550,7,22,5,896
1201100T001,5610,4082,1196,2110,604,118,190,23,2886
1201100T014,3499,2660,1398,755,240,40,235,5,1262
1201100T005,1724,1381,493,519,235,14,134,1,888
1201100J002,2920,2249,732,901,552,17,94,0,1517
1201100J015,2351,1973,665,381,810,16,136,3,1308
1201100J018,3430,2756,968,827,853,34,94,8,1788
1201100J023,2760,2140,711,653,690,27,113,7,1429
1201100A020,5809,4774,1502,1466,915,66,139,7,3272
1201100C026,2087,1491,314,709,213,77,22,0,1177
1201100R035,1769,1616,1219,238,83,17,60,2,397
12103000005,5407,4305,1358,212,2599,48,100,8,2947
12103000020,755,674,393,32,218,9,21,0,281
12103000289,4559,3842,3004,406,160,93,203,4,838
12103000290,1672,1538,1320,120,54,13,25,3,218
12103000282,3525,3130,2671,251,90,44,59,5,459
12103000193,8198,6930,5462,507,684,114,164,12,1468
12103000049,2064,1790,1518,143,71,38,41,0,272
12103000032,4150,3625,2725,348,335,76,144,9,900
1201100X023,6235,4774,572,2335,1649,49,335,3,4202
1201100X020,4097,4053,1052,2466,484,26,77,4,3001
1201100X046,3237,2557,332,1521,550,18,182,2,2225
1201100X019,3304,3268,762,2016,469,22,67,0,2506
1201100M030,6665,5233,1664,2225,879,46,495,11,3569
1201100M022,5562,4657,1461,1902,907,25,365,10,3196
1201100C034,5624,4490,1728,1380,913,69,136,11,2762
1201100A022,3958,2884,406,578,1740,36,27,2,2478
1201100Q060,6817,4832,1651,2490,254,51,362,4,3181
1201100Q065,11122,7692,1845,4648,433,99,605,11,5847
12103000169,4098,3550,3064,206,90,60,97,5,486
12103000098,1027,870,741,59,47,15,12,1,129
12103000057,1781,1480,1122,148,89,51,72,4,358
12103000004,2218,1820,635,82,1025,14,64,3,1185
12103000314,3297,2689,2092,333,79,83,144,1,597
12103000271,1865,1538,1108,219,131,26,67,3,430
12103000172,1569,1276,1117,74,23,15,33,3,159
12103000168,2897,2503,2153,122,95,33,76,5,350
12103000160,3338,2822,1993,327,233,49,206,10,829
12103000129,2468,1959,1328,219,112,51,249,7,631
12077000003,1591,1180,983,77,75,48,10,1,197
12077000008,404,281,221,11,28,18,7,0,60
1201100V027,1089,847,442,306,68,21,26,1,405
1201100H004,2423,1790,259,412,1025,34,99,2,1531
12005000027,4951,3791,2798,275,378,136,194,12,993
12005000012,6995,5949,4988,325,280,198,133,29,961
12005000011,9647,7824,5986,561,726,172,354,27,1838
12005000026,3647,2866,2268,169,182,89,137,7,598
12005000031,5516,4563,3281,335,676,127,115,13,1282
12103000262,2815,2613,2285,143,39,30,97,4,328
1201100V044,3620,2797,437,1659,527,155,192,8,2360
1201100C031,4500,3574,1338,1029,883,54,73,2,2236
1201100C035,3191,2356,265,553,1490,47,35,10,2091
1201100M027,1324,1012,422,275,246,8,58,0,590
1201100M028,3606,2694,551,941,1070,30,180,6,2143
1201100T015,3001,2296,1163,831,178,27,128,5,1133
1201100R044,587,513,267,112,104,16,18,1,246
1201100R054,1635,1463,1021,265,118,16,40,4,442
1201100C024,4365,3884,2187,964,434,24,223,7,1697
12109000047,6803,5758,5185,267,64,95,104,10,573
1201100B002,2165,1852,1611,154,14,12,60,2,241
1201100X030,1922,1470,435,717,202,11,125,3,1035
12033000165,1762,1357,844,160,254,73,34,8,513
12033000070,1666,1294,864,70,277,40,44,6,430
12033000253,1149,889,684,29,137,17,25,5,205
12033000024,2595,2008,1378,118,317,89,95,9,630
12103000246,2392,1941,1622,160,58,36,63,0,319
12103000100,3074,2225,287,82,1851,29,13,8,1938
12095000112,3418,2667,1776,305,169,28,348,15,891
1209500108A,4560,3596,2068,1015,299,98,132,8,1528
1209500512A,1963,1594,688,278,548,5,68,4,906
1209500512B,2722,2442,1409,352,549,16,91,2,1033
12095000203,3384,2548,405,439,1649,38,77,3,2143
12095000213,8780,6401,1052,877,4368,96,166,8,5349
12081000008,372,270,19,95,151,2,2,0,251
12081000067,2914,1931,231,1057,627,52,19,6,1700
12081000073,724,529,126,199,189,18,11,1,403
12117000005,8213,6504,3454,1352,969,103,706,11,3050
12117000069,9088,6579,4600,859,472,152,471,9,1979
12117000028,3465,2728,1139,1040,457,62,117,11,1589
12095000546,5081,4253,1884,948,964,89,407,7,2369
12095000513,2796,2297,1624,252,254,28,93,2,673
12095000205,590,504,333,69,62,12,38,2,171
12095000206,4823,3715,1572,919,1006,73,219,6,2143
12117000072,4558,3178,2026,559,188,58,335,4,1152
12117000047,4502,3491,2094,720,291,29,354,10,1397
12117000030,2770,2298,1422,453,297,65,100,4,876
12117000068,5368,4217,2606,990,271,58,294,9,1611
1201100M019,2002,1565,448,521,509,25,107,5,1117
1201100M012,3450,2706,1145,852,635,43,106,5,1561
1201100M009,3433,2688,688,883,1009,34,161,11,2000
1201100V032,3377,2777,870,1158,698,50,110,2,1907
1201100V020,2150,1761,536,756,405,31,77,4,1225
1201100W023,14210,11073,979,4970,4722,96,684,20,10094
12059000001,2000,1540,1417,46,17,44,11,5,123
12059000008,3841,3288,2052,247,887,80,32,4,1236
12013000301,2071,1640,1475,41,16,94,8,5,165
12013000402,80,69,64,1,2,1,1,0,5
12013000503,742,594,540,10,5,33,6,5,54
12077000005,2581,2410,1274,236,867,28,11,2,1136
12103000040,2821,2413,2029,159,78,42,94,0,384
1201100B004,3029,2567,2202,222,40,22,48,0,365
1201100T020,2567,2011,947,723,168,18,161,6,1064
1201100L004,15342,10679,472,574,9628,68,117,24,10207
12103000360,3233,2774,2373,211,65,55,35,9,401
12099000036,1602,1260,1025,160,26,12,29,2,235
12099000655,4551,3509,2093,676,571,54,80,3,1416
12099000132,1566,1312,1047,173,35,3,43,3,265
12099000047,3162,2579,1931,319,115,34,153,6,648
12099000028,2168,1629,1241,233,63,11,77,4,388
12099000670,2916,2289,1351,571,236,76,58,5,938
12099000664,3499,2781,1646,544,378,40,111,3,1135
12039000019,3632,3063,1406,172,1417,64,31,8,1657
12039000018,803,659,467,72,112,15,1,0,192
12039000021,273,225,99,27,95,5,0,3,126
12039000022,1412,1067,76,118,871,8,0,0,991
12039000035,1637,1395,954,97,296,26,10,0,441
12039000043,505,351,68,79,205,0,1,0,283
12005000016,2108,1645,1446,51,41,29,55,4,199
12005000004,5282,4163,3716,151,77,138,35,17,447
12005000025,2810,2278,1903,143,83,49,90,3,375
12005000028,3916,3096,2018,385,504,90,84,8,1078
12005000001,4062,3130,2683,131,45,216,34,2,447
12005000040,3142,2563,1688,207,476,71,143,3,875
12005000022,5539,4355,3400,305,382,123,155,12,955
12005000024,2466,1963,1508,125,182,50,87,7,455
12005000021,5625,4262,3490,193,273,123,167,13,772
12005000017,7937,6199,4544,399,873,182,200,13,1655
12005000029,5337,4182,2374,873,764,105,91,10,1808
12069570057,1699,1213,200,306,705,19,9,2,1013
12069000078,2052,1826,1370,200,184,40,42,4,456
12069000017,2250,1910,1746,107,20,26,11,2,164
12069000105,4161,3241,1674,1114,343,51,100,8,1567
12067000001,2768,2487,1520,261,697,13,4,2,967
12079000003,2991,2315,1893,165,164,69,7,3,422
12079000008,1512,1218,932,39,224,15,7,0,286
1201100M014,3322,2636,1034,871,582,46,150,3,1602
1201100M029,2752,2179,890,793,353,24,118,9,1289
12005000010,6186,5171,4268,371,162,162,193,8,903
12005000018,3129,2484,2158,84,70,79,85,2,326
12005000019,2421,1874,1329,80,353,42,51,6,545
12005000036,1834,1402,870,119,326,41,64,1,532
12005000033,4090,2920,1206,256,1328,75,95,6,1714
12005000037,5827,4479,2545,405,1150,146,243,13,1934
12107000005,1308,1081,903,68,25,58,4,0,178
12107000004,711,624,457,31,109,11,6,5,167
1201100W019,5884,4477,335,1765,1727,32,762,7,4142
1201100F006,4109,3350,1331,725,954,37,187,9,2019
1201100K011,3942,3029,296,186,2513,21,46,3,2733
12011000022,2643,1905,119,1073,663,22,119,1,1786
1201100W020,4215,3139,175,1750,1050,40,224,6,2964
1201100W021,9524,7313,662,4179,1893,67,690,5,6651
12011000008,4814,3274,1155,1249,449,30,377,7,2119
1201100U011,986,748,471,141,41,3,87,0,277
1201100R052,2682,2018,620,816,498,46,61,4,1398
1201100J010,2841,2248,774,680,697,41,98,5,1474
1201100S008,5987,4616,1615,2067,766,63,205,8,3001
1201100T016,661,523,176,207,112,11,25,2,347
1201100R047,3866,3130,1495,1155,316,66,142,8,1635
1201100V055,935,662,432,167,24,19,26,1,230
1201100S005,3308,2642,1286,940,337,40,95,5,1356
1201100T027,1216,930,608,206,50,9,72,0,322
12121000015,1804,1385,1206,47,69,41,16,5,179
12121000005,2462,1852,1392,229,185,37,10,3,460
12121000001,4611,3311,1323,532,1353,80,53,12,1988
12117000046,6572,5315,3390,1136,345,114,347,13,1925
12117000048,8103,6256,3479,1548,687,122,518,5,2777
12117000026,2291,1845,1116,349,242,71,98,6,729
1201100M005,2425,2141,510,661,903,28,90,0,1631
1201100M031,1436,1127,137,267,673,14,63,5,990
1201100V042,4442,3518,436,2036,1020,115,111,24,3082
1201100X001,2970,2360,515,992,793,25,108,0,1845
1201100V037,1835,1417,264,647,488,27,52,0,1153
1201100J004,3589,2837,742,862,1123,24,131,6,2095
1201100N001,3962,3063,290,447,2217,37,102,16,2773
1201100T012,2313,1890,839,753,168,28,92,3,1051
1201100T025,3382,2658,1179,1126,163,32,167,10,1479
1201100V024,3308,2690,1478,841,283,35,67,0,1212
1201100V023,1184,916,451,372,54,28,47,3,465
1201100Q051,2031,1667,459,930,278,27,41,6,1208
12011000024,1557,1244,838,286,50,8,22,0,406
1201100V057,2856,2598,1747,596,148,26,72,5,851
1201100V053,2794,2128,1679,323,59,9,50,1,449
1201100U010,2955,2169,1049,669,183,27,242,5,1120
1201100S004,4311,3760,2284,1035,288,45,83,13,1476
12121000006,2198,1791,1494,181,21,51,7,1,297
12011000003,594,475,123,94,214,4,36,5,352
1201100G002,4662,3682,1392,875,1099,51,265,10,2290
12077000007,281,221,203,2,6,15,3,0,18
1201100R004,2407,2314,1864,281,47,11,76,3,450
1201100Y006,9961,8460,3404,3908,955,114,232,14,5056
1201100A023,1827,1395,220,331,779,14,15,1,1175
1201100A024,3063,2332,365,478,1038,24,46,2,1967
1201100G016,5335,4476,1538,1223,1279,54,373,9,2938
1201100E019,3249,2408,779,650,840,18,135,4,1629
1201100E014,4703,3646,1927,671,646,30,331,5,1719
12069000056,1022,823,687,49,33,45,14,3,136
12069000141,7300,5526,2425,2163,780,105,151,19,3101
12069000109,7266,5589,2887,1586,795,126,250,12,2702
12099000535,1385,1385,1345,22,10,0,5,0,40
12099000609,2759,2143,1080,498,255,39,141,2,1063
12099000015,2218,1760,1497,161,31,33,35,0,263
12099000594,4043,3132,1882,766,221,27,137,2,1250
12099000399,1648,1307,718,188,352,27,25,5,589
12099000875,2912,2494,1336,532,465,13,120,0,1158
12099000402,1403,1245,761,226,153,18,57,0,484
12099000404,270,248,192,33,15,2,5,0,56
12099000317,1399,1053,347,560,126,18,37,1,706
12099000310,962,762,337,384,40,10,16,3,425
12099000282,0,0,0,0,0,0,0,0,0
12099000316,3752,3076,866,1729,436,27,53,1,2210
12099000268,737,533,113,318,101,21,13,0,420
12099000553,944,937,806,81,37,4,7,0,131
12037000008,1417,1112,986,50,37,28,7,1,126
12035000291,2613,2488,2256,53,61,22,76,4,232
12035510000,45,42,36,2,4,0,0,1,6
12035500000,460,365,290,25,23,16,4,0,75
1201100C002,1404,1195,922,122,46,29,33,6,273
1201100L015,1199,915,16,35,855,7,10,3,899
1201100Z001,2749,1979,50,127,1809,15,7,5,1929
1201100R028,2842,2052,15,72,1981,5,1,3,2037
12099000443,2324,2214,2077,70,14,7,23,7,137
12041000006,2269,1826,1635,100,26,45,6,0,191
12129000012,3918,2777,2223,94,343,72,25,3,554
1201100S009,2812,2305,1427,602,173,44,71,1,878
1201100L010,8670,7185,1390,1210,4363,51,240,20,5795
1201100K009,3635,2940,515,292,2079,19,79,6,2425
1201100N004,4868,3807,1449,1581,578,29,241,3,2358
1201100T002,3676,2879,1002,1264,351,22,273,6,1877
1201100T019,4458,3235,1040,1848,169,72,181,3,2195
12005000044,919,818,766,17,16,17,6,5,52
12005000042,1662,1378,1075,115,111,47,44,11,303
12005000038,3307,2534,1677,249,441,78,88,14,857
12005000039,4892,3953,2904,228,440,122,273,9,1049
12005000032,2476,1963,374,91,1434,51,27,6,1589
12005000023,6562,5075,3771,394,511,130,273,19,1304
12005000020,2333,1786,1429,87,128,76,59,1,357
12005000003,994,760,667,31,22,16,12,0,93
12005000030,2767,1972,1112,296,471,59,55,5,860
12005000006,5770,4579,4059,155,95,172,58,17,520
12005000005,4863,3639,3208,153,82,133,65,10,431
12005000002,1923,1547,1387,56,26,61,7,3,160
12051000016,4042,2917,1454,1385,30,180,14,0,1463
1201100V040,2546,2001,601,1090,243,37,77,3,1400
1201100V050,2845,2185,613,1138,342,30,92,4,1572
1201100L007,1695,1287,195,137,919,16,38,1,1092
1201100D004,1834,1688,1110,348,149,7,39,1,578
1201100D006,2219,1990,1319,406,132,35,87,1,671
1201100E015,1961,1511,886,317,197,16,72,10,625
1201100E024,6613,5007,1783,1494,1200,56,530,0,3224
1201100G012,2820,2401,972,643,665,18,119,0,1429
1201100G004,4049,3713,1374,1182,940,51,179,13,2339
1201100X032,2176,1624,460,727,247,18,195,2,1164
1201100J019,5851,4626,1431,1554,1386,63,285,6,3195
1201100H008,3379,2608,378,562,1610,16,80,7,2230
1201100V004,3145,2598,1033,870,669,17,43,9,1565
1201100R009,2809,2329,1532,472,229,24,58,3,797
12005000014,6548,5300,4215,355,309,174,207,15,1085
12005000008,4396,3833,3391,202,52,119,62,1,442
12005000007,949,732,609,44,19,38,9,4,123
1201100R050,3974,3016,269,1220,1547,48,29,7,2747
1201100R049,3004,2444,1147,1026,171,44,76,8,1297
1201100R065,1120,977,594,222,116,8,23,2,383
1201100R066,1597,1249,585,482,110,19,65,19,664
1201100G008,5938,4492,932,925,2430,39,192,12,3560
1201100G009,1605,1262,178,409,608,29,58,3,1084
1201100P002,1832,1776,1326,256,117,29,50,0,450
12127000161,6000,5346,3543,438,1119,114,167,6,1803
12127000160,6164,4408,1275,406,2629,88,86,8,3133
12127000028,9179,7058,3596,1495,1721,113,191,12,3462
12127000040,52,41,35,4,0,0,2,0,6
12127000049,3409,2703,1601,315,689,66,30,1,1102
12127000051,64,48,29,11,5,3,0,0,19
12127000050,28,15,9,2,3,3,0,0,6
12127000037,4479,3478,2516,533,251,90,83,3,962
12127000237,384,323,307,8,3,0,2,1,16
1201100L008,3309,2557,96,147,2305,14,33,11,2461
1201100R048,3493,2662,780,1419,390,50,75,10,1882
1201100X008,1758,1425,350,701,274,11,110,2,1075
1201100X016,3053,2440,612,1297,472,26,95,2,1828
1201100T013,2097,1720,776,677,160,34,108,4,944
12039000012,1359,1058,37,85,935,12,6,3,1021
12039000013,1239,861,28,61,769,7,4,0,833
12069000252,7994,6352,3632,1511,857,159,237,10,2720
12069000111,2486,1919,1139,359,247,29,168,1,780
12069000093,1917,1837,1691,62,33,29,23,11,146
12069000001,1473,1262,1046,172,2,35,5,0,216
12039000047,479,372,120,11,237,5,0,0,252
12039000024,1344,1035,467,360,194,7,8,2,568
12101000078,7440,5816,4163,997,385,183,126,16,1653
12101000218,14,11,9,0,0,2,0,0,2
12101000140,4468,3891,3283,362,100,97,44,6,608
12101000130,1898,1513,1250,138,22,34,30,6,263
12101000030,1986,1450,860,345,207,36,7,1,590
12101101033,105,79,52,26,0,3,1,0,27
12005000015,3625,3059,2769,99,47,71,70,7,290
12005000043,2498,1958,1332,167,289,21,155,10,626
12005000034,1344,1143,979,37,64,30,15,0,164
12047000003,1362,1086,632,12,409,23,9,0,454
12117000018,4790,3595,2861,396,126,59,121,4,734
12117000008,4535,3619,2054,449,326,41,758,8,1565
12117000012,5792,4633,3206,492,298,56,567,10,1427
12117000009,4741,3888,2633,497,296,35,429,2,1255
12005000041,3513,2796,1811,186,547,70,173,12,985
12013000202,1488,1115,907,23,136,40,9,3,208
12109000036,8374,7157,6488,325,82,78,158,8,669
12109000038,3525,2813,2559,109,22,33,67,3,254
1201100D008,2762,2237,973,491,640,46,91,4,1264
12021000046,6146,5168,3969,774,119,49,205,8,1199
12021000117,8627,7030,5292,1182,230,93,218,9,1738
12021000120,15354,11221,4464,5441,962,181,227,9,6757
12021000005,973,925,841,51,9,3,21,0,84
12021000040,1169,1089,1000,57,12,14,3,0,89
12021000050,5409,4683,3496,839,116,72,115,5,1187
12021000114,5242,4188,2467,1414,162,76,61,3,1721
12021000078,3745,3459,2902,369,142,22,30,1,557
12021000073,8021,5912,845,4040,1016,145,43,3,5067
12009000325,591,501,406,26,28,29,8,0,95
12009000326,610,502,419,18,33,10,11,0,83
12009000327,644,565,446,50,31,19,10,1,119
12009000301,610,516,414,34,23,7,32,2,102
12009000328,494,437,395,16,9,12,1,0,42
12009000237,58,56,46,7,0,0,2,0,10
12021000019,2393,2327,2195,57,11,20,22,0,132
12021000042,1227,1221,1191,11,10,2,5,0,30
12021000066,8084,5747,3637,1395,413,56,223,10,2110
12021000131,275,272,237,29,3,0,4,1,35
12021000023,2190,2128,2014,53,4,12,30,2,114
12021000022,2181,2096,1923,92,13,7,37,0,173
12021000103,1563,1462,1333,73,20,5,15,0,129
12021000102,1483,1373,1277,67,13,11,6,0,96
12021000098,2456,2408,2314,32,1,10,34,2,94
12021000101,1761,1702,1654,32,4,8,1,1,48
12021000076,4483,3673,2154,1076,350,21,98,1,1519
12021000128,1552,1479,1379,51,15,12,18,1,100
12021000069,2839,2248,1190,883,147,37,16,1,1058
12021000053,1717,1431,1262,112,7,13,25,0,169
12021000121,690,500,112,343,34,23,3,3,388
12021000070,2572,2017,1402,471,63,36,41,3,615
12021000035,1236,1185,1029,113,8,18,19,0,156
12021000122,203,147,55,59,30,9,5,0,92
12021000026,1746,1290,1051,112,34,12,68,0,239
12021000116,8399,6408,2801,3000,451,108,100,5,3607
12021000124,105,58,4,44,13,1,0,0,54
12021000123,6242,4803,2916,1229,463,64,153,0,1887
12021000062,3221,2340,1646,411,143,18,94,1,694
12021000051,4655,4587,4420,78,14,17,39,0,167
12021000010,2027,1664,966,376,287,32,26,7,698
12055000020,2298,2016,1574,307,95,24,16,3,442
12009000521,7703,5988,3481,1070,1143,151,209,26,2507
12009000307,1953,1777,1578,107,32,37,33,2,199
12009000308,6245,5203,3805,591,580,123,126,5,1398
12009000414,6889,5537,3857,718,623,141,229,15,1680
12009000436,0,0,0,0,0,0,0,0,0
12009000136,0,0,0,0,0,0,0,0,0
12021000099,1304,1157,1104,24,2,8,16,0,53
12021000085,2253,1758,1088,533,73,17,47,2,670
12021000015,1723,1542,1078,354,83,33,18,1,464
12021000093,1874,1467,679,602,150,52,18,0,788
12021000045,2395,2312,2187,51,7,15,32,0,125
12021000013,5804,4070,303,2802,940,73,17,8,3767
12009000515,4381,3619,3010,266,54,49,175,6,609
12009000434,2,1,1,0,0,0,0,0,0
12009000405,6025,4826,4176,302,83,101,102,8,650
12009000421,5120,4265,3521,299,120,51,250,5,744
12009000416,2448,2047,1688,148,80,45,82,2,359
12009000420,3828,3306,2753,252,135,41,132,0,553
12009000415,4478,3395,2799,242,99,75,152,17,596
12009000437,723,566,447,47,24,19,40,7,119
12009000211,4997,4131,2961,358,613,87,113,6,1170
12009000238,78,65,56,1,4,2,1,4,9
12009000216,9280,7550,5704,581,818,151,321,21,1846
12055000008,3635,2946,1857,559,449,71,40,8,1089
12055000007,2867,2110,928,786,350,44,34,4,1182
12009000227,212,187,168,8,8,0,2,1,19
12009000129,13,11,3,2,2,2,2,0,8
12009000207,3302,2792,2198,237,187,61,79,8,594
12085000014,6510,5420,4542,511,133,75,115,2,878
12097000134,0,0,0,0,0,0,0,0,0
12097000251,5278,3958,908,2308,636,54,188,15,3050
12097000302,6389,4971,1470,2243,935,120,370,12,3501
12097000308,1452,1146,330,638,135,11,38,4,816
12097000301,1131,925,287,467,134,13,34,0,638
12097000352,1684,1175,144,702,307,40,46,5,1031
12097000135,0,0,0,0,0,0,0,0,0
12097000159,548,481,254,154,44,4,24,1,227
12097000154,2319,2046,1237,507,191,30,81,0,809
12085000013,5097,4171,3643,314,53,58,83,3,528
12085000049,7268,5873,5113,389,105,73,151,7,760
12085000039,5914,4929,3575,763,502,89,44,2,1354
12085000035,2014,1220,24,736,464,88,7,2,1196
12085000100,10077,8329,5972,1936,247,208,63,9,2357
12085000042,5342,4263,2837,1048,209,134,65,14,1426
12065000001,861,714,520,36,138,15,7,5,194
12065000005,1620,1294,520,22,714,25,21,7,774
12065000006,985,830,438,27,333,23,10,1,392
12065000008,1282,1074,689,51,309,22,2,1,385
12065000009,1155,959,747,28,176,12,7,2,212
12073002305,11702,9830,3667,942,4899,130,336,24,6163
12073002303,438,335,27,18,283,4,3,0,308
12073004453,1535,1165,1013,33,67,9,47,3,152
12073004125,5726,4465,3647,215,324,76,174,3,818
12073001317,1547,1207,49,43,1114,14,5,1,1158
12073001319,2032,1553,70,51,1429,17,8,3,1483
12085000055,5056,4235,3691,260,129,61,64,4,544
12085000025,7584,6399,5410,453,238,68,169,7,989
12085000027,5667,4740,4229,251,71,71,80,7,511
12085000030,4144,3302,2811,295,62,44,65,7,491
12117000019,9805,7657,5132,1288,521,123,574,18,2525
12117000071,12795,9688,5428,2193,1379,172,586,25,4260
12073001313,6008,4714,1135,347,3187,54,47,0,3579
12073001303,895,782,490,119,141,19,30,0,292
12073005207,4820,4033,2161,313,1340,79,164,14,1872
12073005209,661,561,372,32,114,21,39,2,189
12073004451,1004,827,708,34,37,14,28,0,119
12063000030,4309,3805,2440,170,1124,54,9,6,1365
12057000554,1740,1409,818,359,164,19,80,0,591
12057000575,2917,2411,1556,569,156,54,98,4,855
12057000912,720,664,570,84,1,5,4,1,94
12057000820,4503,3514,2210,728,385,67,155,5,1304
12057000218,1501,1227,381,707,135,9,21,1,846
12057000227,4343,3559,1359,1693,470,60,71,14,2200
12057000329,5539,4291,693,920,2669,63,53,3,3598
12057000161,3159,3012,2098,415,224,35,246,3,914
12057000070,2688,1758,509,324,340,24,579,7,1249
12057000411,5415,4312,1150,2714,456,45,67,10,3162
12057000413,2530,1969,874,797,168,54,111,3,1095
12057000502,3262,2608,1143,1069,236,30,161,3,1465
12057000500,9,8,2,5,1,0,0,0,6
12123000013,2051,1416,284,18,1062,16,40,2,1132
12089050302,1496,1057,898,30,91,15,22,1,159
12089050300,7072,5486,4682,161,408,115,82,8,804
12057000118,3516,2831,1120,732,699,48,321,2,1711
12057000972,1000,833,361,224,199,20,73,3,472
12057000512,2640,1937,972,380,155,12,403,7,965
12057000613,2590,1815,254,330,1224,43,21,10,1561
12057000769,3370,2689,2082,423,79,54,54,5,607
12057000765,2992,2275,1823,272,51,73,43,2,452
12057000763,1923,1398,898,408,58,26,17,0,500
12057000816,2624,1937,1413,260,147,29,80,1,524
12057000137A,3523,2535,1991,320,56,40,111,6,544
12063000028,160,132,49,0,82,1,0,0,83
12105000246,2300,1587,911,590,76,31,12,0,676
12057000169,4644,3956,1657,650,1452,75,139,4,2299
12057000209A,3276,2645,1000,626,956,40,83,6,1645
12057000079,320,219,112,20,21,5,61,0,107
12057000122,8,6,0,3,2,2,2,0,6
12057000750,4883,3622,2460,612,330,77,163,13,1162
12057000751,4649,3542,2483,575,294,63,112,10,1059
12057000869,2282,1795,1161,339,199,46,59,3,634
12057000875,6257,4871,2873,990,642,107,326,6,1998
12057000868,2564,2045,1025,586,320,46,117,6,1020
12105000220,4281,3353,2378,522,308,64,83,9,975
12105000217,3587,3129,2255,475,322,48,51,7,874
12105000243,8560,6675,4546,1199,671,116,150,14,2129
12105000109,7651,6254,4667,738,638,130,112,8,1587
12089050400,5586,4370,3923,116,100,132,59,11,447
12089040300,3851,3030,2746,70,58,89,29,5,284
12089040200,2005,1567,1448,27,27,35,12,1,119
12001000033,7342,5492,3376,591,709,96,682,12,2116
12001000012,1059,886,700,36,118,11,18,1,186
12001000042,3042,2387,1815,216,196,32,125,3,572
12001000014,1416,1081,851,61,78,12,79,1,230
1201100R067,2179,1768,792,682,187,47,91,4,976
1201100G015,2839,2715,1216,851,491,25,93,0,1499
1201100E010,6413,4970,2067,1521,1109,40,237,6,2903
1201100S001,3824,3026,922,712,1359,29,54,9,2104
1201100S002,3135,2302,226,266,1805,26,24,7,2076
1201100S007,988,841,567,197,55,6,20,0,274
12075000011,1776,1417,1017,99,263,30,8,1,400
12007000017,659,534,430,29,54,13,13,2,104
12007000011,1753,1373,1075,67,181,36,15,3,298
12063000004,2847,2187,1749,65,267,71,22,2,438
12001000056,3458,2862,1649,316,736,61,105,9,1213
12001000019,5184,3730,1409,464,1587,63,263,9,2321
12001000046,3968,3564,2012,595,582,34,357,5,1552
12001000048,2040,1783,1445,160,59,24,89,2,338
12061000020,1078,966,770,36,149,6,7,1,196
12086000813,6138,5007,305,2701,1947,36,168,5,4702
12086000217,3041,2406,39,466,1955,11,17,0,2367
12086000269,2535,1880,26,537,1357,9,6,1,1854
12086000365,5246,4225,226,3558,368,47,151,7,3999
1201100R021,2576,2331,1443,447,354,42,85,10,888
1201100R057,1687,1402,543,308,506,29,37,1,859
1201100R022,2509,2051,754,284,964,35,48,6,1297
1201100P006,1535,1447,1150,153,69,20,44,2,297
1201100W024,4870,3801,318,1378,2089,50,125,1,3483
1201100X018,1566,1252,283,712,220,6,68,2,969
12057000135B,3873,2735,958,721,880,57,192,6,1777
12057000944,4053,2849,1148,777,802,63,178,1,1701
12057000147,307,232,110,47,29,10,37,0,122
12001000010,3152,2419,1477,163,659,62,54,6,942
12027000007,3670,2790,1759,681,265,46,28,4,1031
12057000139A,2959,2262,1774,292,41,29,120,2,488
12119000121,4317,3777,2684,307,701,77,17,1,1093
12061000018,3703,3290,3090,117,11,18,30,6,200
12057000519,3233,2546,1438,773,167,35,132,6,1108
12057000517,2738,2247,1223,653,204,44,146,7,1024
12057000237,3095,2623,1959,413,151,71,57,4,664
12057000507,4870,3682,1721,928,354,53,598,6,1961
12057000137B,1293,892,274,187,377,19,42,2,618
12057000140,1840,1361,496,320,479,28,69,3,865
12057000134,526,372,184,66,96,7,28,0,188
12057000145B,1520,1072,440,273,319,23,63,5,632
12057000128,1243,833,247,258,293,13,46,0,586
12057000094,1437,1036,405,304,284,16,59,4,631
12057000097,5057,3358,1063,993,1167,74,136,6,2295
12057000213,3508,2567,874,529,1140,55,39,3,1693
12057000451,6626,5511,679,4577,281,52,128,7,4832
12001000035,6743,4924,2123,771,1791,115,214,7,2801
12121000002,4772,4099,2408,406,1222,38,15,5,1691
12121000003,2775,2106,1464,269,264,48,44,9,642
12007000005,2462,1919,1261,97,500,25,28,2,658
12007000015,1772,1377,1214,62,59,27,7,2,163
12083000095,1653,1598,1345,121,67,22,16,2,253
12083000065,3013,2502,2242,113,30,72,18,4,260
12086000760,2244,1766,531,1040,104,21,87,0,1235
12086000753,875,713,225,447,28,2,20,0,488
12086000374,63,41,5,13,15,0,13,0,36
12086000371,7024,5605,670,4454,165,50,241,1,4935
12086000373,46,27,0,12,10,1,9,0,27
12086000487,167,129,8,111,14,0,4,0,121
12086000853,3508,2854,484,2262,96,38,44,3,2370
12086000572,3062,2560,195,2269,92,26,45,5,2365
12086000564,7443,6028,155,5706,383,116,18,1,5873
12086000793,2788,2290,183,1885,115,28,132,2,2107
12086000522,4794,3753,84,1823,2043,40,14,4,3669
12086000256,4048,3413,225,1121,2047,25,140,4,3188
12086000316,3202,2708,126,2575,57,2,9,0,2582
12086000471,3435,2881,108,2714,47,2,45,1,2773
12086000353,3332,2786,135,2588,45,16,48,1,2651
12086004401,1301,1073,67,993,9,0,14,0,1006
12086000423,2969,2496,186,2281,34,20,29,1,2310
12086000454,4158,3198,358,2556,65,30,145,3,2840
12086000599,2592,2403,1024,1017,190,18,90,5,1379
12086000703,6037,5036,316,4546,171,47,90,3,4720
12086000410,4558,3865,101,3698,105,19,55,3,3764
12086000409,5113,4312,102,4025,158,29,124,3,4210
12086000458,4274,4123,668,1950,1162,18,294,7,3455
12086000191,1415,1133,120,832,161,12,32,0,1013
12086000757,4672,3692,613,2679,347,34,89,8,3079
12086000857,5821,4598,352,3726,426,47,153,4,4246
12086000738,6528,5264,414,4325,324,42,248,8,4850
1205500009N,747,564,115,119,320,8,4,0,449
12083000111,2477,1988,1466,207,119,54,134,5,522
12083000052,2986,2446,2011,162,179,61,42,1,435
12083000079,1308,1044,933,35,11,51,3,0,111
1201100K001,2781,2080,59,111,1896,17,26,3,2021
1201100W013,6173,4820,297,1204,3201,27,255,9,4523
1201100R043,3105,2678,1902,485,143,49,89,3,776
1201100V005,1504,1263,875,292,50,17,37,0,388
12086000823,4000,3056,661,1904,380,35,137,3,2395
12086000847,7613,5957,923,4158,837,79,167,18,5034
12086000574,4451,3748,238,3414,123,22,47,2,3510
12086000672,1964,1600,422,1108,38,20,27,0,1178
12086004310,1666,1373,233,1092,22,10,33,1,1140
12086004311,623,507,55,433,7,3,5,0,452
12086000282,5194,3938,72,1945,2070,20,15,2,3866
12057000077,5071,3539,1024,1092,1338,45,140,5,2515
12057000605,785,622,325,122,141,11,27,0,297
12057000066,2383,1606,1109,141,65,10,262,8,497
12057000970,697,520,147,305,39,12,25,4,373
12057000966,2011,1472,739,600,97,34,30,4,733
12086000112,923,769,345,334,44,5,25,0,424
12086000797,4911,3738,221,3141,181,29,240,4,3517
12086000699,2400,1778,248,1257,132,19,163,2,1530
12086000389,5299,4056,236,3616,171,26,56,3,3820
12086000227,4328,3251,50,1590,1719,34,12,6,3201
12086000608,2535,2060,735,1231,28,19,35,0,1325
12086003000,5729,4421,150,4091,200,38,82,2,4271
12086000326,1896,1620,57,1550,19,2,10,1,1563
12086000297,5188,4300,80,4167,119,37,35,1,4220
12086000149,3417,3033,1585,1076,264,15,66,0,1448
12086000469,6906,5231,273,4703,111,46,181,3,4958
12086000156,2349,1793,863,667,192,23,65,4,930
12086000904,11672,8728,505,6890,1408,130,157,17,8223
12086000167,1249,859,103,586,199,22,21,4,756
12086000584,2868,2343,493,1088,724,30,48,2,1850
12086000524,3261,2734,576,1952,133,25,67,0,2158
12086000563,4490,4014,750,2811,299,60,186,12,3264
12086000993,314,244,76,159,7,0,6,0,168
12086000210,2643,2137,248,706,1140,24,77,4,1889
12086000209,7564,5808,539,1998,3201,68,170,5,5269
12086000009,5689,4382,1976,2052,127,28,99,1,2406
12086000010,84,74,37,21,0,2,5,1,37
12086000163,1973,1573,78,405,1106,10,18,0,1495
12086000153,148,115,8,28,80,5,3,0,107
12086000154,3688,3289,815,1103,1338,29,91,2,2474
12086000412,3407,2834,185,2585,37,15,49,6,2649
12086000488,7763,6486,127,6264,145,73,43,4,6359
12083000033,3553,2637,1676,322,540,79,31,6,961
12083000015,3274,2684,1997,369,214,59,70,11,687
12083000034,3422,2687,1998,261,315,73,27,3,689
12086000303,5781,4668,432,3807,451,30,98,3,4236
12086000909,9515,6863,348,5035,1565,105,114,0,6515
12086000115,5972,4871,605,3055,1011,92,346,8,4266
12086000121,3559,2887,383,1479,903,43,174,1,2504
12086000028,2409,1763,1189,462,57,12,26,0,574
12086000729,4537,3977,879,2867,141,18,143,1,3098
12086000503,1527,1447,56,1302,138,19,20,0,1391
12086000315,3748,3164,131,3022,54,2,8,1,3033
12086000800,3745,3131,96,2950,109,23,24,0,3035
12086000916,7141,5233,310,4413,539,416,22,14,4923
12086000900,2022,1606,504,928,156,15,14,0,1102
12086000792,2911,2335,365,1719,131,32,102,0,1970
12086000769,2282,1852,394,1272,114,26,72,2,1458
12086000914,2045,1644,645,861,79,41,47,3,999
12086000235,1466,1170,32,864,319,12,2,2,1138
12086000924,630,524,90,384,23,13,33,1,434
12086000841,7021,5997,474,4833,822,54,104,5,5523
12086000198,2766,2123,92,1889,155,26,49,1,2031
12086000776,6732,5405,362,4521,447,42,178,5,5043
12086000859,5199,3895,370,3123,229,32,238,1,3525
12086000696,7573,6698,1482,4051,371,76,725,3,5216
12086007191,25,24,6,9,2,0,5,0,18
12086000915,6512,4586,791,3464,310,216,66,7,3795
12086000704,3498,2947,133,2753,44,7,51,1,2814
12086004130,4078,3445,160,3234,29,5,41,1,3285
12083000096,5460,5365,4905,202,116,58,52,4,460
12086000935,4478,3575,865,1545,1168,66,15,1,2710
12086000344,2920,2357,531,1719,38,30,71,3,1826
12086000309,4726,4001,95,3842,54,15,57,2,3906
12086000245,3220,2581,57,1220,1374,30,9,3,2524
12086002502,2641,2044,15,771,1331,16,7,0,2029
12086002501,1524,1179,9,442,769,13,9,0,1170
12086000890,6377,4658,285,3062,1310,54,88,6,4373
12086009910,2001,1738,59,1673,31,8,8,0,1679
12086000554,3739,3232,73,3133,97,18,11,0,3159
12083000110,1018,975,855,57,29,8,17,1,120
12083000008,3500,2816,1127,1041,513,49,133,2,1689
12086000310,4431,3690,164,3472,80,10,11,3,3526
12086000145,1877,1335,24,101,1207,13,19,2,1311
12086000561,7313,6233,797,5074,229,69,190,10,5436
12086000213,5568,4164,83,704,3449,39,45,4,4081
12083000030,4095,3297,2721,259,229,71,20,2,576
12083000044,4888,3769,2222,563,861,70,41,1,1547
12083000073,4397,3309,2270,664,225,90,61,2,1039
12083000094,5977,4541,1364,1941,1212,117,98,8,3177
12001000030,3314,3046,1803,441,327,47,423,3,1243
12031000276,3167,2648,2275,155,76,36,87,10,373
12031000139,2704,2044,104,57,1893,20,4,2,1940
12031000085,3318,2657,1970,332,205,75,110,3,687
12031000235,5164,3848,1410,355,1733,67,314,9,2438
12031000258,1868,1604,1031,74,87,8,394,1,573
12031000162,4104,3011,916,260,1727,56,56,1,2095
12031000204,5263,3660,724,580,2188,56,233,12,2936
12031000049,5161,3989,2781,373,344,53,423,17,1208
12031000190,2735,2057,180,58,1830,24,1,1,1877
12086000390,5616,4469,331,3924,150,38,105,2,4138
12086000363,13415,10236,427,9261,446,71,301,4,9809
12086000270,3957,2926,32,806,2184,21,26,12,2894
12086000018,5407,4622,874,3378,322,56,93,7,3748
12086000019,1430,1195,390,696,81,15,29,0,805
12086000752,5523,4494,919,3127,254,60,219,0,3575
12086000791,975,826,71,643,101,1,20,0,755
12086000814,5875,4631,591,3197,627,45,256,13,4040
12086000560,2488,2159,100,2025,69,11,24,4,2059
12001000018,5311,3864,2691,356,130,48,606,13,1173
12031000253,3306,2776,2542,106,25,37,50,2,234
12031000072,3204,2492,1171,530,469,60,291,12,1321
12031000240,5219,3934,1313,637,1519,107,449,22,2621
12031000012,2312,1807,1155,218,349,43,76,2,652
12031000160,4407,3249,1089,210,1907,53,44,10,2160
12123000001,1389,1041,715,35,258,18,16,2,326
12083000045,1798,1688,1365,156,127,23,22,0,323
12086000041,6701,5989,2214,3146,350,86,193,11,3775
12086004390,1753,1465,52,1387,26,6,10,1,1413
12086004670,1336,1096,64,1007,8,4,12,1,1032
12086004391,1436,1229,64,1115,23,0,43,0,1165
12086004671,2133,1795,78,1683,24,11,29,0,1717
12097000303,6846,5094,609,3235,1265,104,145,16,4485
12031000274,2210,1862,1607,117,57,39,35,4,255
12001000006,1633,1365,1162,65,86,40,13,0,203
12086000541,10339,8757,3164,4579,289,62,349,4,5593
12086000568,25,14,2,5,9,1,0,0,12
12086000312,5080,4119,108,3972,101,19,16,5,4011
12086000999,1087,980,301,519,118,9,37,3,679
12099000348,2832,2214,896,462,747,30,78,4,1318
12099000337,1488,1164,562,337,199,17,42,3,602
12099000368,3112,2350,925,423,799,22,157,3,1425
12099000558,1367,1350,1268,49,20,8,11,3,82
12099000846,167,146,128,16,1,1,1,0,18
12099000120,2433,2192,2029,68,28,7,42,1,163
12099000061,6605,5557,4376,572,218,60,321,11,1181
12099000060,1293,1064,777,165,68,6,43,0,287
12099000456,1810,1461,1125,196,66,18,36,2,336
12099000461,5586,4613,3262,731,246,44,246,11,1351
12086004400,1283,1085,84,989,11,4,8,0,1001
12086000708,4699,3922,259,3591,69,23,52,2,3663
12086000333,5258,4352,69,4244,179,27,10,0,4283
1209500618C,1283,992,208,532,266,23,18,2,784
1209500618A,547,445,128,195,66,16,49,2,317
1209500618B,3852,2794,229,1900,663,106,98,13,2565
12095000620,4015,2904,305,1875,685,65,105,3,2599
12031000188,2326,1868,52,34,1780,25,11,0,1816
12031000113,4223,3478,2444,462,395,84,103,12,1034
12031000284,1202,962,770,66,61,34,26,1,192
12031000291,5120,4317,2595,448,605,62,611,28,1722
12031000226,2312,1819,1402,100,207,58,68,3,417
12031000166,2647,2081,120,103,1825,19,27,7,1961
12031000207,500,415,340,25,26,14,24,1,75
12113000039,2480,2049,1798,63,51,68,48,1,251
12086000807,2067,1661,697,768,85,4,106,3,964
12086000335,4026,3437,36,3237,256,10,6,2,3401
12086002510,3704,2899,67,1053,1852,20,17,7,2832
12086000325,2273,1892,60,1803,45,16,16,1,1832
12086000120,1434,1155,457,497,171,11,48,2,698
1209500616B,2379,2204,1094,595,281,29,165,11,1110
1209500616C,121,107,42,38,14,1,9,5,65
12027000010,6973,5259,2359,2201,612,106,38,8,2900
12055000014,601,500,366,118,7,1,2,1,134
12027000006,931,688,96,90,494,7,1,2,592
12083000062,5467,5390,5111,122,61,41,47,1,279
12083000081,3175,2433,1577,252,495,47,67,6,856
12083000055,7124,7096,6702,157,87,49,73,9,394
12086000029,2376,1722,1019,566,48,11,49,1,703
12086000701,4667,3949,164,3684,83,22,46,0,3785
12086000782,2515,2071,160,1839,41,17,40,3,1911
12099000488,3583,2847,1646,768,161,38,158,6,1201
12099000503,2357,1950,1485,286,46,8,62,2,465
12099000501,2786,2363,1759,378,58,17,82,0,604
12099000814,3235,2300,112,154,2020,26,19,3,2188
12099000321,2417,1937,1169,540,159,58,33,9,768
12099000436,954,833,784,40,3,3,6,1,49
12099000434,176,147,127,14,4,1,3,0,20
12099000882,217,193,137,21,9,10,9,0,56
12099000506,3104,2304,1873,238,46,29,86,2,431
12099000495,2400,1930,1585,211,28,14,51,0,345
12099000884,1943,1809,1326,253,145,21,59,1,483
12099000445,1433,1237,919,142,92,19,52,2,318
12099000571,3170,2810,1894,489,281,22,73,1,916
12099000444,2775,2495,1970,275,117,31,56,5,525
12095000228,6080,4447,1728,1918,697,127,105,8,2719
12095000231,4689,3443,1027,1689,633,101,81,1,2416
12095000230,2471,1886,857,763,222,48,42,0,1029
12095000509,3293,2635,2166,250,91,39,84,2,469
1209500201A,1096,871,720,78,51,13,20,4,151
12095000624,4363,3267,121,240,2905,46,33,7,3146
12095000625,6341,4362,201,576,3531,48,101,5,4161
12095000626,3906,2995,40,238,2734,28,25,14,2955
12095000606,5083,3726,425,516,2652,44,157,16,3301
12095000613,7841,5985,1263,1680,2408,93,270,21,4722
12031000025,5935,4467,1307,1060,1782,84,334,16,3160
12031000198,3253,2531,1428,103,864,102,47,3,1103
12031000268,3148,2633,1435,332,428,55,353,16,1198
12031000119,2388,1685,113,52,1520,22,3,1,1572
12031000212,1411,1066,726,43,252,25,8,1,340
12031000161,2081,1579,389,39,1119,20,14,2,1190
12031000174,1679,1301,101,40,1148,12,8,6,1200
12031000074,6248,4781,2188,1455,657,127,439,14,2593
1209500105A,3912,2942,606,1025,1152,65,111,2,2336
1209500105B,1323,1016,394,355,196,13,47,2,622
12095000106,6046,4591,2758,668,783,88,280,16,1833
1209500202C,411,303,118,90,76,17,7,2,185
1209500202A,2463,2054,1604,232,119,51,61,10,450
1209500202Z,0,0,0,0,0,0,0,0,0
12095000216,4779,3581,440,803,2182,48,210,15,3141
12095000547,1949,1586,671,396,401,17,108,2,915
12095000207,6084,4731,1955,1345,1291,116,160,9,2776
12095000204,2737,2160,317,286,1560,32,21,6,1843
12095000119,6247,4802,1775,1819,351,65,708,5,3027
120170103.3,135,109,93,9,3,4,1,1,16
120170402.2,539,446,397,17,4,20,6,0,49
12083000019,2872,2023,981,515,263,31,264,9,1042
12083000107,1991,1591,1099,279,102,30,65,2,492
12083000048,1672,1662,1504,63,71,8,14,0,158
12031000121,1362,1111,604,80,400,26,18,2,507
12031000220,3280,2515,1845,154,407,81,37,2,670
12095000236,3995,2914,1718,827,249,85,61,10,1196
1209500441B,2926,2281,527,1018,319,23,415,13,1754
12095000129,3715,2922,2278,216,120,53,209,9,644
1209500342A,1179,1102,732,171,131,7,71,2,370
12095000402,8985,7273,1991,3728,1145,132,583,11,5282
12095000401,6156,4948,1686,2485,536,127,303,19,3262
12095000411,4427,3486,1628,1085,354,53,426,5,1858
1209500312B,2660,2058,597,949,295,26,215,8,1461
12095000501,5284,5053,3497,852,312,86,308,13,1556
1209500601Z,0,0,0,0,0,0,0,0,0
12086000103,6181,5078,2367,2189,183,18,168,3,2711
12086000511,3313,2352,36,668,1701,20,26,16,2316
12086000862,6893,4946,620,3433,790,72,188,6,4326
12086003980,1926,1439,88,1289,39,20,26,0,1351
12086000164,3916,3010,197,1145,1680,41,63,4,2813
12099000813,3845,2960,306,347,2302,52,34,14,2654
12099000391,2643,2173,904,286,956,18,32,10,1269
12099000507,3204,2810,2190,372,119,29,80,1,620
12099000544,2047,1793,1359,199,141,8,77,4,434
12099000511,466,380,280,48,25,5,25,0,100
120170200.2,559,487,413,21,31,2,9,1,74
120170300.2,715,637,434,39,151,7,3,0,203
120170300.3,3014,2534,2195,122,94,70,36,8,339
120170404.1,3631,3192,2918,115,39,61,28,0,274
12031000005,4860,3799,1599,694,1218,75,270,7,2200
12031000260,3093,2690,2330,171,71,57,62,5,360
12031000236,4738,3694,2784,151,609,76,58,8,910
12031000167,1573,1196,19,13,1154,18,8,7,1177
12031000221,2835,2318,1916,89,180,58,43,3,402
12031000070,3982,3195,1858,555,578,62,165,5,1337
12031000251,3385,2838,2565,109,32,42,53,6,273
12031000110,3575,2872,2006,272,242,69,292,10,866
12031000192,2544,1735,833,164,650,59,55,3,902
12095000628,2019,1589,342,156,1036,22,49,1,1247
1209500110B,2074,1577,783,231,198,7,292,0,794
1209500110A,3403,2722,1826,302,255,39,227,5,896
1209500109A,5459,4085,2107,622,715,44,507,11,1978
12095000524,5291,4382,2850,826,297,81,367,19,1532
1209500330A,1758,1419,1113,188,63,19,38,1,306
12095000423,5227,4170,994,2227,520,87,425,17,3176
12095000136,2927,2371,1547,289,146,11,300,9,824
12099000352,993,785,518,204,35,9,14,0,267
1209900NP30,24,13,0,6,1,1,3,0,13
12099000675,3409,2620,1500,660,327,49,78,5,1120
12099000677,823,661,332,198,82,25,21,4,329
12099000640,2183,1671,91,859,721,8,8,2,1580
12099000647,4860,3719,572,814,2358,25,6,2,3147
12099000607,551,475,204,136,141,6,2,0,271
12099000636,5263,3805,103,527,3175,36,18,5,3702
12099000671,2666,2133,1316,546,177,59,66,3,817
12099000667,2615,2070,1409,331,180,46,70,3,661
12099000534,2061,1811,1438,176,120,10,48,0,373
12099000065,1934,1484,1094,185,57,32,111,3,390
12099000057,1777,1501,1224,183,34,26,35,0,277
12099000053,591,430,255,72,71,6,24,0,175
12099000033,916,745,365,185,93,15,85,0,380
12099000191,1512,1389,1244,72,32,12,29,3,145
12099000196,2779,2709,2397,133,64,13,90,7,312
1209900NP33,0,0,0,0,0,0,0,0,0
12095000427,9346,6952,1046,4533,1033,94,475,13,5906
12095000426,13198,9808,1395,6231,1602,199,798,62,8413
12041000010,1840,1447,1252,86,39,47,10,1,195
12031000068,3141,2521,1800,274,188,36,218,7,721
12099000485,1227,1073,860,117,20,15,32,1,213
12099000477,3361,2844,2025,324,357,26,80,3,819
1209500319C,2004,1500,477,583,238,28,229,10,1023
1209500439A,4206,3204,826,1503,428,28,464,11,2378
12095000102,3920,3182,1522,580,500,59,365,18,1660
1209500101A,3667,2868,1187,620,579,33,238,4,1681
12095000429,7808,5921,736,3963,962,86,333,6,5185
12095000420,10139,7521,1186,4622,1082,113,707,39,6335
12095000107,4537,3612,2737,516,221,69,74,6,875
12095000221,7197,5415,2254,2323,545,168,201,12,3161
1209500439B,1355,1083,281,532,232,11,39,1,802
1209500108B,3028,2250,792,946,414,37,61,10,1458
12095000517,4429,3531,2929,285,87,52,165,6,602
12057000325,5717,4096,236,716,3192,45,33,12,3860
12057000957,3294,2466,1198,695,442,57,118,15,1268
12057000815,1433,1099,841,132,52,21,58,4,258
12057000577,6065,4914,2377,1708,523,77,286,14,2537
12047000001,2427,1795,1117,390,245,34,19,0,678
12099000211,1499,1129,189,173,636,7,140,4,940
12099000826,1048,985,850,70,35,9,26,0,135
12099000430,2158,2059,1776,159,74,8,20,0,283
12099000432,1323,1302,1190,68,27,0,13,1,112
12099000439,2461,1996,1703,162,69,9,33,4,293
12099000422,17,11,0,2,8,1,0,0,11
120170307.1,10726,9725,8723,403,196,176,179,11,1002
12099000549,4922,4392,3514,478,217,27,127,2,878
12099000521,24,22,13,4,2,1,3,1,9
12099000815,3950,2985,869,519,1534,22,53,2,2116
12099000816,2912,2583,1532,446,507,29,79,0,1051
12099000383,3504,2702,1895,423,228,22,127,4,807
1209500319B,650,518,212,226,40,14,30,1,306
1209500417A,5819,4533,1131,2325,696,63,458,18,3402
12095000418,3529,2920,1054,1424,300,54,170,16,1866
1209500417Z,0,0,0,0,0,0,0,0,0
1209500201B,664,550,475,38,15,6,11,0,75
12079000011,1543,1150,403,39,700,9,4,2,747
12079000001,3183,2553,1483,100,922,42,17,3,1070
12023000012,1488,1092,294,30,753,18,9,1,798
12099000109,4124,3030,2447,317,54,37,172,5,583
12099000107,1259,890,738,97,17,14,22,3,152
12099000102,3264,2567,1957,395,77,18,104,2,610
12099000105,2066,1609,1247,238,44,18,43,1,362
12099000625,526,526,142,84,299,5,0,0,384
12099000633,0,0,0,0,0,0,0,0,0
12099000623,20,14,0,10,4,0,0,0,14
1209900NP22,0,0,0,0,0,0,0,0,0
12031000263,3878,3149,2168,301,489,91,119,7,981
12031000214,7550,5608,2805,446,1993,118,298,13,2803
12067000005,1093,844,520,92,205,27,7,2,324
12079000009,382,329,209,7,105,7,0,0,120
12099000177,1794,1516,1304,117,34,13,37,3,212
12099000136,25,24,20,3,1,2,0,0,4
12099000154,1239,1221,1129,46,16,3,18,2,92
12099000157,219,197,161,23,3,0,3,0,36
12099000189,805,789,703,37,11,1,21,0,86
12099000142,820,754,655,34,54,2,10,1,99
12099000162,432,358,233,66,33,6,19,0,125
12099000145,242,198,152,18,26,5,1,1,46
12099000478,2353,2281,2059,138,12,12,41,1,222
12099000710,1741,1299,967,190,47,9,79,2,332
12099000713,2906,2206,1285,617,226,35,52,1,921
12099000271,6597,4731,822,3014,887,129,74,8,3909
12099000017,3410,2628,2158,284,78,53,47,2,470
1209500441A,1428,1035,114,786,91,18,25,4,921
12095000532,5975,4774,1641,1964,721,142,529,17,3133
12095000528,6476,5484,2230,1909,935,136,444,26,3254
12095000548,3274,2716,1350,793,293,64,280,10,1366
12095000341,5146,4163,1021,2411,474,126,269,14,3142
12095000334,4117,3354,2550,421,169,62,180,6,804
12095000217,7081,5385,730,583,3598,65,463,28,4655
12057000403,5907,4738,1168,2935,505,85,204,17,3570
12095000515,6024,4522,3646,487,197,47,137,11,876
120170205.1,3351,2741,2216,260,140,56,51,1,525
120170204.1,2531,2239,1967,109,74,45,35,1,272
12099000600,3443,2617,1944,325,109,14,160,1,673
12099000616,4215,3138,1183,877,364,50,177,7,1955
12099000468,3052,2292,1754,334,73,5,68,3,538
12099000473,1533,1206,934,119,41,11,91,2,272
12099000598,1903,1864,1779,56,15,0,6,1,85
12099000137,3699,3331,2490,465,167,37,175,5,841
12099000151,2775,2457,1944,226,68,23,169,0,513
12099000150,171,137,121,13,4,0,0,0,16
12099000252,6458,4866,1165,2753,912,77,96,7,3701
12099000827,3044,2482,870,381,1153,34,53,7,1612
120170301.2,1768,1480,1338,64,26,21,14,0,142
120170105.1,3369,2912,2448,112,225,57,59,8,464
12057000119B,2732,1865,832,456,467,22,122,6,1033
12057000950,3862,2795,1610,884,164,96,64,6,1185
12057000239,4797,3871,1021,2376,407,61,106,4,2850
12057000550,1257,1033,675,239,39,4,68,1,358
12057000127,4018,3249,2601,371,68,43,157,1,648
12057000125A,1591,1157,942,135,24,8,49,0,215
12057000133A,2000,1528,1257,161,30,15,57,2,271
12019071000,447,353,221,12,95,19,4,1,132
12019060100,0,0,0,0,0,0,0,0,0
1201960100a,1162,909,817,34,23,27,11,1,92
12019061200,931,716,638,28,10,23,16,1,78
12019070801,0,0,0,0,0,0,0,0,0
1201971000a,167,135,125,9,0,2,0,0,10
1201961200a,211,168,142,5,0,5,1,0,26
12113000032,4617,3624,3150,195,42,99,112,11,474
12099000471,6828,6288,3057,1265,1670,79,252,17,3231
12099000601,3297,2546,1714,456,114,17,166,2,832
12099000610,3141,2559,1879,324,117,14,154,2,680
12099000528,2244,1567,742,291,362,16,150,3,825
12099000465,1373,1276,1166,49,20,6,17,2,110
12099000466,2339,1986,1388,244,85,13,198,1,598
12099000578,1337,1140,743,222,83,15,73,3,397
12099000579,112,112,100,2,8,0,2,0,12
12099000442,3545,3251,2466,420,246,20,61,1,785
12099000417,473,393,306,25,45,0,9,1,87
12099000155,258,211,195,11,5,0,1,0,16
1209900NP31,0,0,0,0,0,0,0,0,0
12099000407,1331,1114,730,129,190,17,54,1,384
12099000876,3351,2493,816,279,1340,22,45,1,1677
12099000567,1759,1677,1362,141,112,7,38,1,315
12099000577,2357,2122,1852,166,62,6,26,0,270
12099000687,678,532,223,134,119,3,61,3,309
12099000178,1605,1194,575,466,86,58,63,0,619
12099000051,1238,1079,809,135,83,12,40,4,270
12057000117,4106,2971,2326,388,58,40,164,2,645
12057000511,4799,3924,1751,1491,457,72,235,12,2173
12057000862,480,346,212,115,6,5,8,1,134
12057000103A,6376,5431,3476,957,576,136,332,26,1955
12057000098,1016,920,616,139,93,4,81,9,304
12057000876,3558,2773,1547,620,388,37,188,4,1226
12095000237,4677,3498,2074,395,779,56,196,11,1424
1209500526B,2809,2330,840,970,372,70,162,11,1490
1209500526A,2971,2329,760,1087,336,54,187,2,1569
1209500525A,8965,7106,4994,1039,265,103,639,16,2112
12057000505,7486,5777,2051,2786,603,89,345,8,3726
12057000531,4970,3656,2639,570,185,63,195,10,1017
12057000108A,3365,2625,1926,318,152,58,158,9,699
12057000552,2601,2171,1226,654,203,33,78,3,945
12057000343,5208,4612,2331,883,958,65,417,12,2281
12057000346,35,31,20,6,4,2,2,0,11
12057000858,2843,2124,863,883,320,47,51,4,1261
12057000856,5527,4311,2585,1040,526,89,132,4,1726
12073002359,1162,895,379,147,336,10,16,0,516
12073002451,1805,1384,808,134,408,47,9,0,576
12057000249,4202,3449,2051,1013,214,81,124,0,1398
12057000250,191,144,63,62,17,1,4,0,81
12057000095,2423,1734,718,361,604,29,44,13,1016
12115000065,1975,1729,1500,133,24,24,30,1,229
12115000028,248,180,165,6,4,0,3,1,15
12115000013,3690,3481,3210,105,60,31,55,3,271
12115000062,6268,5808,5368,176,53,45,123,1,440
12115000011,4759,4675,4435,84,33,19,69,2,240
12115000077,3654,3342,3099,139,23,35,33,2,243
12115000050,2916,2413,2043,196,40,50,61,5,370
12115000067,4024,3323,3009,150,45,49,55,0,314
12115000074,3658,3065,2243,467,117,47,126,8,822
12047000005,3910,3578,1590,354,1610,33,17,3,1988
12115000051,3005,2747,2545,87,22,35,38,2,202
12115000045,3314,2867,2524,115,131,46,37,0,343
12115000101,5390,4603,4180,224,50,56,67,3,423
12115000087,4246,3936,3616,152,41,31,65,4,320
12115000047,4518,4306,3976,166,45,48,51,6,330
12073005201,1805,1531,1037,87,326,27,59,2,494
12073004163,2416,1822,1524,89,122,31,58,2,298
12073001355,2991,2131,465,135,1471,40,21,0,1666
12073001205,1916,1532,590,113,725,28,99,2,942
12073003513,4125,3140,1346,247,1441,39,106,10,1794
12073003409,2516,1940,1015,132,680,44,86,0,925
12073003411,3416,2490,905,154,1320,34,80,5,1585
12019050601,357,267,209,15,24,12,6,0,58
12019050603,280,205,146,27,25,5,9,0,59
12019041000,1099,832,645,60,45,31,61,2,187
12019041002,2696,2014,1535,197,152,26,106,1,479
12019011302,4242,2933,1372,294,951,56,285,13,1561
12019011303,109,77,27,8,29,0,13,0,50
12019011501,8105,5524,2516,803,1650,120,554,20,3008
12023000006,7659,6114,5120,327,398,167,44,5,994
12111000047,5807,4459,2251,930,1094,111,110,7,2208
12111000066,1154,998,789,108,68,5,29,3,209
12111000065,1112,1043,960,38,11,13,17,1,83
12007000004,496,381,343,6,22,7,3,0,38
1209500608B,1827,1491,221,410,803,27,79,5,1270
12095000609,8924,6440,449,797,4946,71,255,4,5991
12103000247,3928,3198,2494,362,161,43,122,2,704
12103000366,5997,4924,3510,533,689,90,79,5,1414
12103000358,2196,1930,1648,127,50,33,52,0,282
12103000296,3193,2490,2123,186,32,55,77,3,367
12103000270,5420,5113,4251,441,180,48,187,6,862
12103000273,2562,2434,2149,136,52,12,57,4,285
12023000015,6278,5438,3410,423,1548,60,28,2,2028
12019061000,1416,1147,1016,66,14,31,11,1,131
12071000095,6498,5400,3605,1276,324,80,135,13,1795
12023000024,2476,1855,1003,106,689,39,25,0,852
12023000010,1276,983,153,35,778,18,0,0,830
12023000011,1065,834,665,43,78,26,22,1,169
1209500608A,2391,1771,216,235,1215,6,101,9,1555
12095000523,1766,1308,1079,110,22,23,57,2,229
12095000309,4577,3582,1025,1934,510,78,186,11,2557
12095000310,1930,1454,316,899,226,23,67,2,1138
12015000045,3690,3195,2868,135,76,52,46,3,327
12015000023,3246,2912,2184,361,215,59,97,7,728
12071000126,2084,1976,1881,36,11,19,13,0,95
12071000079B,5336,4901,4374,235,122,59,88,3,527
12071000098,4598,4017,3183,557,99,61,85,3,834
12089020300,5277,4107,3469,216,238,88,56,14,638
12089020301,376,343,319,1,11,0,7,0,24
12089030102,266,218,206,11,1,1,0,0,12
12089030300,6421,4999,4263,167,314,169,71,12,736
12023000002,2076,1624,1228,72,289,26,8,1,396
12019040801,3569,2678,2248,144,131,28,120,4,430
12019040800,1886,1465,1213,95,61,29,58,2,252
12019012200,5701,4434,2820,513,722,123,277,20,1614
12019040601,2485,1949,1567,146,97,28,116,3,382
12015000065,3645,3064,2407,278,271,52,47,13,657
12071000102B,5275,4756,4040,465,104,58,70,2,716
12071000151,0,0,0,0,0,0,0,0,0
12115000043,3144,2720,2372,198,53,35,40,5,348
12115000024,3506,2988,1804,802,274,53,51,2,1184
12115000105,3149,2742,2462,143,35,23,55,2,280
12115000004,2206,1990,1385,259,299,23,27,0,605
12115000100,1888,1612,1265,235,59,19,25,0,347
12115000061,3503,2917,2163,553,105,73,23,1,754
12089020400,5681,4497,3690,279,301,85,124,5,807
12089020403,707,561,481,20,38,10,12,1,80
12089020402,798,534,428,31,42,6,23,2,106
12089020401,1675,1442,1230,73,86,38,24,1,212
12089030101,1948,1383,1004,140,132,24,68,4,379
12089050301,84,71,66,5,0,0,0,0,5
12057000651,2483,1933,1167,289,346,56,80,3,766
12057000650,2207,1663,474,327,826,36,47,4,1189
12057000626,1972,1514,536,408,523,35,65,3,978
12057000652,2590,2008,975,358,492,35,177,5,1033
12057000622,2287,1602,491,368,632,31,127,4,1111
12057000088,3750,2697,1020,579,938,62,188,1,1677
12057000075,1872,1383,568,350,394,15,92,0,815
12057000455,5166,4193,800,3030,342,69,120,3,3393
12057000631,2892,2216,1476,346,258,93,46,0,740
12015000113,1495,1380,1264,57,26,9,27,0,116
12015000027,2971,2526,2083,251,107,40,51,4,443
12071000121,6368,5609,4592,532,221,47,190,8,1017
12071000036,12645,11480,10066,614,271,59,424,13,1414
12071000065B,4917,4765,4547,108,24,33,30,0,218
12087000032,1798,1527,1119,352,21,23,12,1,408
12087000011,4614,3627,1713,1036,712,53,145,10,1914
12087000001,2429,2088,1372,473,153,45,63,4,716
12087000024,1884,1655,1335,250,46,19,7,0,320
12087000030,3260,2750,1935,671,46,46,51,9,815
12095000329,5769,4434,779,2761,830,152,189,37,3655
12091000066,2022,1616,1210,137,119,41,118,1,406
12071000123,4544,4112,3633,317,31,33,87,3,479
12071000302,681,648,596,38,0,10,8,0,52
12071000125,4468,4394,4231,62,28,6,49,0,163
12071000011,5327,4928,4230,330,134,51,173,5,698
12071000072,4625,3813,3214,222,126,32,183,3,599
12095000116,5579,4593,2256,867,295,68,999,7,2337
12095000313,4130,3326,944,1855,378,57,209,10,2382
12127000158,3542,3116,2447,271,273,59,82,8,669
12127000011,3636,2893,2183,520,72,78,25,2,710
12127000235,0,0,0,0,0,0,0,0,0
12127000211,2332,2145,2000,64,17,33,21,1,145
12127000232,3,3,1,2,0,0,0,0,2
12127000230,0,0,0,0,0,0,0,0,0
12127000098,4105,3167,1467,1135,529,68,93,12,1700
12033000123,1096,806,343,62,332,33,36,2,463
12033000173,2941,2582,2166,114,162,61,74,6,416
12033000112,445,354,207,18,108,12,12,1,147
12127000208,19,16,7,6,2,1,0,0,9
12127000130,4292,3507,2800,276,218,123,73,7,707
12127000082,4408,3452,1797,1155,403,98,74,12,1655
12127000078,3603,2812,1495,908,297,60,65,1,1317
12053000029,6212,4932,3480,890,370,91,105,6,1452
12071000012,4231,3822,3287,400,40,18,55,2,535
12071000266,0,0,0,0,0,0,0,0,0
12071000038,7258,6216,4884,899,197,156,64,4,1332
12071000102A,0,0,0,0,0,0,0,0,0
12127000099,3334,2618,1290,935,329,73,59,6,1328
12033000261,1124,831,616,29,115,44,31,6,215
12033000075,366,299,191,34,37,9,18,7,108
12033000157,1238,964,612,57,212,25,56,1,352
12127000204,4956,4616,4334,143,23,56,35,8,282
12127000210,4619,4169,3834,155,60,61,59,5,335
12127000177,6888,5950,5201,305,160,159,110,16,749
12127000207,430,363,314,23,2,5,9,0,49
12127000088,3604,2865,1548,900,367,76,47,1,1317
12127000168,3652,3343,2549,229,284,53,225,2,794
12127000084,3989,3178,1435,1222,483,72,56,6,1743
12033000120,557,486,410,17,51,5,3,0,76
12033000248,3587,2828,2187,96,320,118,99,5,641
12033000245,3160,2459,1832,119,332,57,109,3,627
12033000051,3479,2735,2166,115,223,58,164,1,569
12033000118,826,642,250,30,342,18,13,0,392
12033000086,159,150,129,6,11,1,4,0,21
12033000087,550,503,452,23,11,9,15,0,51
12033000093,3099,2699,1446,433,618,55,175,23,1253
12033000110,772,611,207,139,204,24,50,0,404
12033000226,1137,939,732,74,74,30,35,4,207
12033000124,946,715,240,64,368,25,36,2,475
12033000069,1234,977,676,77,135,44,50,8,301
12033000044,775,612,459,28,62,31,27,0,153
12033000116,1007,809,586,38,154,13,18,0,223
12033000043,457,395,315,24,34,8,14,2,80
12081000220,2492,1805,1461,162,55,24,96,3,344
12081000208,1864,1564,1276,108,67,17,86,1,288
12081000165,3885,3175,2609,260,100,70,111,6,566
12081000101,1107,1028,958,33,12,17,16,1,70
12081000157,908,858,795,24,10,8,10,0,63
12053000048,5808,4712,3420,835,295,103,112,9,1292
12041000007,1164,983,893,57,9,21,3,2,90
12033000081,386,330,185,12,108,8,6,0,145
12033000234,2341,2047,1468,116,333,35,87,2,579
12033000053,3345,2634,2025,123,211,114,156,4,609
12033000138,1731,976,128,37,799,18,5,0,848
12033000141,337,234,152,14,65,12,4,0,82
12099000613,3642,3095,2271,440,138,10,100,0,824
12099000058,235,205,178,6,11,1,3,3,27
12033000045,1410,1209,878,45,175,38,79,3,331
12081000058,1685,1397,1250,90,12,16,22,0,147
12091000009,9454,7494,5167,525,1374,194,201,35,2327
12091000002,998,773,716,4,6,29,8,7,57
12071000062B,7936,6064,3964,1522,234,132,238,6,2100
1209900NP18,0,0,0,0,0,0,0,0,0
12099000413,184,161,134,13,2,0,8,0,27
12099000808,1319,1173,850,135,139,10,31,5,323
12099000788,4924,3486,306,375,2791,41,33,8,3180
12127000127,131,116,101,8,1,4,2,1,15
12127000008,2129,1710,1414,203,11,30,29,1,296
12033000103,1200,947,598,59,190,49,55,2,349
12033000169,1267,1088,987,37,22,24,21,1,101
12033000171,1213,1034,930,38,24,30,14,2,104
12033000175,1305,1105,716,49,273,25,28,1,389
12033000160,2414,1922,219,53,1622,28,19,1,1703
12033000166,347,284,221,14,28,0,11,1,63
12127000104,4887,4509,4127,152,55,64,75,4,382
12127000120,4494,3669,3104,219,170,57,98,7,565
12069000009,747,582,484,57,8,8,13,0,98
12081000197,1551,1466,1334,57,42,21,6,0,132
12081000076,2867,2523,2158,189,73,24,58,1,365
12081000019,7477,5786,4585,555,345,104,179,6,1201
12081000225,183,145,100,26,10,1,7,0,45
12081000232,757,633,566,42,17,1,8,0,67
12081000185,4497,3587,2919,320,162,71,99,6,668
12081000227,353,281,196,33,24,14,14,1,85
12081000148,1150,912,580,166,107,24,35,1,332
12081000186,1689,1353,984,268,54,33,8,1,369
12099000556,2170,1927,1332,273,242,2,69,3,595
12099000514,15,14,7,4,2,1,2,0,7
12099000441,746,620,339,105,75,8,101,0,281
12099000284,0,0,0,0,0,0,0,0,0
12099000328,3464,2409,405,1390,518,102,98,5,2004
12099000866,1804,1278,207,844,209,75,18,2,1071
12099000329,1030,747,203,497,50,45,12,2,544
12099000867,0,0,0,0,0,0,0,0,0
12087000035,5768,4540,2072,1673,739,52,68,3,2468
12087000002,2918,2508,1685,545,117,44,95,6,823
12081000150,1959,1684,1310,225,86,31,28,3,374
12127000100,3691,2882,1216,1190,393,87,82,7,1666
12127000096,6181,4927,2405,1823,539,107,133,6,2522
12127000023,5425,4235,3230,560,260,132,66,6,1005
12127000012,3251,2800,1997,245,466,55,11,3,803
12127000015,0,0,0,0,0,0,0,0,0
1201100G010,3009,2532,1167,642,572,40,104,3,1365
1201100A004,3173,2530,1185,563,322,27,65,8,1345
1201100W002,3683,2825,201,904,1741,12,68,5,2624
1201100Q050,4259,3024,246,554,2222,26,59,0,2778
1201100S003,3853,3406,1941,983,340,32,96,11,1465
1201100F002,2470,2057,895,605,302,20,127,1,1162
1201100E028,3081,2481,923,933,470,46,130,7,1558
12127000149,4808,3770,1248,301,1997,33,179,9,2522
12127000143,3620,2876,1991,347,383,80,63,1,885
12127000005,2102,1699,1239,354,24,53,25,1,460
12127000183,33,27,15,3,2,2,2,0,12
12033000096,671,570,418,29,72,12,43,2,152
12033000181,1371,1200,971,79,71,21,48,1,229
12033000108,246,190,122,13,38,13,8,0,68
12033000153,3205,2199,615,139,1382,26,53,14,1584
12033000207,704,612,401,46,122,23,19,0,211
12033000218,2840,2359,1594,231,362,74,83,7,765
12033000241,2409,1929,1377,112,276,80,68,3,552
1201100V009,4416,3625,1171,1563,783,78,129,4,2454
1201100V007,3161,2660,1696,664,161,43,97,1,964
1201100V056,1963,1718,650,609,409,38,35,3,1068
12127000197,6155,4950,4383,215,119,111,89,5,567
12127000241,0,0,0,0,0,0,0,0,0
12087000008,1783,1514,1083,254,128,35,31,3,431
12053000002,2594,2099,1884,94,31,66,15,1,215
12033000193,1430,1215,1038,53,41,19,61,0,177
12033000254,2627,2033,1536,65,285,105,25,3,497
12033000032,2007,1519,934,80,400,63,63,9,585
12127000142,3176,2689,1962,254,333,69,74,2,727
12127000150,6334,5648,4648,407,286,125,145,4,1000
12127000167,3635,3009,2060,218,531,69,129,5,949
12117000041,6968,5661,3259,1303,884,123,198,6,2402
12117000033,5744,4698,1853,1470,1037,112,337,8,2845
12117000049,3478,2922,1543,422,858,76,63,7,1379
12087000027,2776,2410,2016,306,20,32,34,0,394
12087000026,2266,1963,1630,248,37,35,6,0,333
12087000023,790,751,627,85,24,4,9,1,124
12127000086,5203,4000,2086,1298,491,121,73,11,1914
12127000124,3102,2733,2335,178,52,65,85,8,398
12127000193,4856,4059,3352,306,135,105,113,8,707
12127000233,0,0,0,0,0,0,0,0,0
12127000056,2509,1946,1416,318,120,43,39,6,530
12107000038,1093,853,440,56,338,22,13,6,413
12081000210,1335,1092,861,97,72,9,46,0,231
12081000231,874,743,683,47,9,4,5,0,60
12081000167,2900,2513,2111,165,108,59,52,2,402
12081000111,6048,5017,2912,1243,746,110,65,7,2105
12081000114,2882,2237,1042,858,290,47,39,2,1195
12081000099,2177,1568,504,693,343,26,16,1,1064
12033000149,4206,2949,1213,222,1346,89,92,9,1736
12033000107,1995,1582,1006,67,384,79,75,6,576
12033000167,219,181,132,5,40,2,1,2,49
12033000251,1874,1513,1199,54,152,59,46,3,314
12081000216,3042,2231,1727,221,166,42,68,1,504
12081000194,2575,2082,1522,267,118,59,121,0,560
12081000045,2974,2041,228,757,1033,33,16,6,1813
12081000102,795,744,694,16,6,15,10,1,50
1201100T018,9296,7101,3556,2316,600,70,586,13,3545
1201100U007,2404,1878,1048,543,109,14,161,6,830
12081000171,2759,1837,361,1026,431,27,13,2,1476
1201100V018,6967,5617,1414,2024,2106,69,135,14,4203
12109000024,2081,1688,1275,160,199,48,49,47,413
12109000034,3034,2541,2228,137,59,46,39,2,313
12109000027,1992,1643,1363,112,85,43,19,1,280
12109000022,5001,3691,1538,235,1829,65,41,7,2153
12109000045,4144,3677,3246,198,51,59,102,2,431
12109000086,422,375,328,17,6,1,20,0,47
12109000067,2766,1841,1433,197,103,26,71,1,408
12109000009,4125,3065,2486,207,150,55,173,5,579
12109000057,7861,4818,3389,441,313,49,600,5,1429
12109000050,5175,3273,2277,371,272,59,253,10,996
12109000078,2063,1354,1028,151,66,18,76,4,326
12109000010,2056,1533,1132,125,149,58,69,3,401
12129000004,284,238,218,4,6,9,3,0,20
12129000003,1787,1454,1181,25,180,42,8,2,273
12129000007,5427,4230,3380,258,362,140,57,6,850
12117000011,9693,7310,2885,2566,1653,189,246,20,4425
12117000062,3922,2972,1912,644,192,48,185,15,1060
12117000023,1594,1264,1012,126,44,21,52,1,252
12117000051,2394,1932,1344,274,227,59,59,9,588
12109000003,4014,3335,2926,150,89,50,113,5,409
12109000007,6014,4463,3664,305,216,83,149,9,799
12127000079,6241,4664,2325,1580,666,124,94,12,2339
12127000097,612,481,442,16,7,13,6,0,39
12129000005,459,404,353,13,9,13,10,0,51
12129ZZZZZZ,0,0,0,0,0,0,0,0,0
12129000002,8422,6258,4962,224,761,194,81,19,1296
12013000102,1063,817,695,21,47,51,9,3,122
12109000039,3622,2991,2712,117,34,29,74,11,279
12109000040,991,832,755,27,12,13,20,2,77
12109000035,8146,6574,5586,410,170,97,251,8,988
12109000015,2590,2063,1643,193,83,43,105,6,420
12109000059,3891,2480,1896,292,151,41,66,0,584
12109000084,1194,776,586,87,70,40,15,1,190
12109000028,8098,6518,5527,492,183,108,140,6,991
12109000083,626,511,423,45,9,8,22,2,88
12109000090,17060,12277,9764,984,510,183,733,13,2513
12109000001,567,406,328,20,28,6,16,0,78
12109000008,7051,5036,3704,433,296,142,472,17,1332
12101000006,4117,3429,2791,355,153,80,38,3,638
12101106006,0,0,0,0,0,0,0,0,0
12101000107,1818,1546,1231,176,103,25,13,0,315
12101000068,3858,3511,3110,258,35,59,28,5,401
12101000225,487,415,322,47,17,14,11,0,93
12101000169,8536,6535,4782,1004,427,122,207,3,1753
12101000132,1673,1234,798,250,97,37,47,1,436
12101000048,10571,8478,7058,803,191,242,138,16,1420
12109000033,2465,2247,2095,75,28,30,18,2,152
12101000060,6042,4744,3587,639,308,83,116,10,1157
12033000262,4730,3604,2734,96,551,158,53,12,870
12033000133,940,672,125,29,508,7,14,4,547
12101000016,4775,4403,3876,224,80,114,68,2,527
12101000183,1679,1434,1173,130,36,22,61,0,261
12101000062,5260,4396,3697,386,119,98,80,10,699
12101000126,5701,4848,3829,588,230,80,99,6,1019
12109000060,1729,1328,1084,95,78,20,38,0,244
12121000011,2593,2038,1730,177,65,51,5,1,308
12121000012,3171,2623,2122,149,238,76,28,5,501
12109000023,1827,1416,965,101,311,20,13,0,451
12101000103,9904,8325,6495,1176,364,175,140,1,1830
12013000401,2580,2324,978,230,1073,41,16,2,1346
12121000010,2417,1934,1643,133,89,48,12,5,291
12101000003,1420,1090,767,146,133,24,11,1,323
12101109069,34,29,26,2,0,0,0,1,3
12101103069,24,15,14,0,1,0,0,0,1
12101104069,8,6,5,1,1,0,0,0,1
12101107069,82,72,56,11,4,1,0,1,16
12101110069,16,10,6,4,0,0,0,0,4
12101108006,0,0,0,0,0,0,0,0,0
12101108069,0,0,0,0,0,0,0,0,0
12101107006,13,8,8,0,0,0,0,0,0
12101000205,10240,8216,6067,1367,364,170,282,20,2149
12101000206,4199,3291,1993,815,314,56,147,12,1298
12033000152,1288,968,460,56,374,42,36,1,508
12127000163,317,261,217,14,11,9,6,0,44
12033000127,780,621,109,29,465,13,9,2,512
12101000067,6481,5094,3573,730,241,111,425,12,1521
12103000255,4675,3637,1837,1154,462,87,116,8,1800
12103000064,3406,2874,2094,337,235,63,127,6,780
12103000114,2509,2175,1515,223,163,34,246,2,660
12103000228,2401,2201,1972,116,26,28,54,2,229
12103000359,4598,3687,2841,349,291,74,115,16,846
12103000226,3839,3506,3156,138,48,48,87,1,350
12101000122,5282,3873,2720,588,383,42,157,16,1153
12101101070,4703,3811,3075,412,168,56,93,4,736
12069000046,4528,3252,1791,444,776,54,180,12,1461
12069000066,4674,3524,2354,456,524,60,126,6,1170
12053000054,2007,1978,1762,129,56,11,20,1,216
12103000260,4816,4045,2762,799,306,87,135,14,1283
12103000174,3165,2967,2704,113,51,39,60,1,263
12103000295,3871,3082,2674,189,72,71,82,7,408
12103000321,2154,1724,1318,198,86,37,60,2,406
12103000338,3801,3169,2695,217,85,46,101,4,474
12103000125,2559,2046,1603,194,90,43,121,1,443
12103000149,2891,2512,2080,136,92,45,150,2,432
1201100W005,2307,1793,56,380,1347,6,50,9,1737
1201100F005,7171,5323,2229,1308,1079,48,363,15,3094
1201100F012,8142,6366,2908,1707,720,100,265,20,3458
1201100V046,1180,936,229,598,82,16,36,1,707
1201100N018,4356,3607,1401,1122,873,37,239,7,2206
1201100N017,3720,3074,1231,1032,615,25,197,8,1843
1201100N026,4572,3617,1178,1231,983,41,255,7,2439
12103000274,4268,3499,2578,478,216,97,132,9,921
12103000322,2412,2143,1900,102,32,32,60,2,243
12103000249,3447,3004,2361,290,148,61,117,3,643
1201100L013,5201,4104,973,347,2590,27,178,3,3131
1201100A021,5677,4185,967,1007,1374,54,158,2,3218
1201100A017,1382,1272,746,271,120,14,28,5,526
1201100W001,6292,4883,273,1066,3623,62,58,12,4610
1201100W004,2380,1851,102,420,1340,10,45,6,1749
1201100C033,2000,1543,575,524,270,40,43,1,968
1201100A018,3497,2596,446,726,1288,29,14,1,2150
1201100Z004,1299,1003,378,259,69,288,46,5,625
1201100X021,9975,7664,802,3212,3392,76,428,21,6862
1201100X014,4330,3380,572,1665,968,30,177,12,2808
1201100R024,1764,1324,53,111,1148,15,18,1,1271
1201100F007,4959,3760,1579,1019,657,49,241,15,2181
1201100F013,1879,1464,643,337,339,10,99,5,821
12081000123,2686,2377,1811,268,170,63,64,3,566
1201100R038,567,500,385,61,18,9,26,0,115
1201100R039,2673,2492,2102,243,46,18,54,0,390
1201100W008,6667,4995,173,1548,3293,34,146,9,4822
1201100R029,2230,1592,36,92,1481,15,7,1,1556
1201100R023,2885,2052,75,198,1787,22,17,5,1977
1201100R031,3907,3077,860,694,1440,25,69,2,2217
1201100A008,1069,784,50,90,625,9,9,2,734
1201100A011,3264,2442,88,231,2085,47,20,3,2354
1201100A010,1792,1543,1070,229,118,13,35,1,473
1201100A002,2597,2171,1169,360,234,34,48,0,1002
1201100R026,3058,2258,120,144,2010,20,10,7,2138
1201100W010,2375,1836,126,749,981,12,50,1,1710
1201100N012,3117,2513,705,933,727,27,190,9,1808
1201100N011,1828,1425,942,261,157,16,49,3,483
12103000356,0,0,0,0,0,0,0,0,0
12103000239,1201,1129,1014,69,9,7,27,0,115
12103000345,4369,3631,3082,262,83,44,152,5,549
12053000026,4505,4075,3572,276,109,73,39,0,503
1201100A006,5342,4342,1424,1236,1205,59,101,4,2918
1201100A015,3875,2842,228,298,2269,23,10,2,2614
12011000005,1227,958,414,372,120,9,25,2,544
12117000022,7197,5891,4208,925,459,92,222,6,1683
12117000053,8802,6580,2807,2247,1277,154,231,11,3773
12069000003,2092,1690,1573,47,26,25,4,1,117
12069000025,1385,1216,946,102,94,36,44,0,270
12069000037,4357,3323,2045,686,368,97,149,5,1278
12069000104,4116,3165,1741,688,544,63,120,6,1424
1201100R007,1968,1725,1249,307,95,12,42,5,476
1201100R010,1793,1576,1117,277,88,17,45,6,459
12039000045,602,449,19,29,399,8,3,1,430
12039000040,357,308,95,28,182,4,0,0,213
12101000112,6629,5235,3905,769,263,133,190,9,1330
12101101022,119,112,96,13,0,1,0,0,16
12117000054,7625,5791,2941,1294,967,136,566,23,2850
12117000003,8584,6831,4047,982,701,104,1039,13,2784
12005000009,4999,4373,3591,345,160,141,122,9,782
12051000029,2516,1946,1172,558,111,16,87,1,774
12117000045,4173,3293,2050,690,311,67,183,8,1243
12099000350,4779,3892,2006,931,731,30,164,11,1886
12099000371,1341,1048,470,207,270,21,94,0,578
12099000244,2275,1862,1234,460,105,46,39,2,628
12099000243,4836,3748,829,2488,393,154,58,9,2919
12099000242,77,47,10,19,15,0,0,0,37
12099000796,645,470,92,232,134,8,8,0,378
12039000033,1433,1017,158,142,723,15,7,3,859
12117000057,3882,3043,2186,450,165,43,179,8,857
12039000005,906,774,381,25,359,14,0,0,393
12117000052,3037,2232,480,371,1281,35,109,1,1752
12117000044,8085,6732,3620,1921,845,150,325,17,3112
12117000031,8730,6783,3967,1723,692,129,317,9,2816
12117000050,6594,4971,1950,825,2051,86,142,11,3021
12039000009,3470,2436,135,121,2150,18,18,5,2301
12039000016,1805,1477,1098,152,193,28,7,5,379
1201100K002,2879,2220,184,216,1826,12,32,3,2036
1201100A005,2283,2117,1796,191,41,12,26,2,321
1201100X035,3434,2668,508,1215,610,21,351,1,2160
1201100X040,5401,4066,1129,1733,656,37,582,18,2937
12099000247,3962,3117,640,2226,217,72,57,1,2477
12099000349,4546,3107,763,1744,513,98,53,3,2344
12099000384,2768,2204,1175,416,448,37,112,3,1029
12099000286,1961,1372,257,915,174,76,42,4,1115
12099000782,3868,2827,398,688,1751,55,33,4,2429
12099000786,3304,2360,223,390,1772,38,10,4,2137
12099000238,4434,3218,679,1034,1458,51,72,8,2539
12099000862,3189,2332,384,842,1050,72,67,5,1948
12099000237,3491,2682,916,1409,335,62,32,6,1766
12099000110,1862,1271,1030,129,23,9,72,1,241
1201100V045,2538,1957,410,1163,326,37,102,0,1547
1201100X022,4283,3645,597,1301,1650,32,153,13,3048
1201100X002,2138,1648,346,754,468,34,99,2,1302
1201100X009,3847,3310,911,1000,1252,32,155,4,2399
1201100T004,3712,3273,1285,1102,481,57,393,27,1988
1201100V047,1979,1378,975,289,73,11,27,3,403
1201100R003,1761,1618,1269,207,52,14,60,4,349
12103000089,1341,1174,975,88,43,28,34,1,199
12103000092,1548,1348,1241,60,8,13,19,0,107
12103000315,1951,1602,1326,145,22,17,66,5,276
12103000303,5369,4876,4147,395,113,50,131,9,729
12103000317,2724,2233,1837,206,100,48,59,2,396
12103000044,2776,2237,1938,152,39,14,77,1,299
12103000215,2929,2750,2329,175,129,27,91,1,421
1201100X026,2394,1868,517,1032,275,14,61,3,1351
1201100R063,7421,5745,449,751,4540,64,87,11,5296
1201100H006,3404,2656,495,536,1568,43,67,6,2161
1201100J001,2224,1900,630,546,627,30,93,6,1270
1201100Z003,5436,4168,795,2787,533,109,104,6,3373
1201100N006,2625,2120,1307,500,186,21,116,0,813
1201100N003,1939,1530,731,448,232,33,97,4,799
1201100N005,1068,831,354,225,182,10,48,2,477
1201100X044,3477,2634,490,1289,597,40,299,4,2144
1201100X043,4681,3597,696,1823,807,33,335,3,2901
1201100X047,2190,1665,161,817,629,20,83,6,1504
1201100V013,2690,2083,632,913,501,31,48,4,1451
1201100R041,3326,3130,1277,1241,457,18,93,2,1853
1201100R056,1864,1384,215,185,979,11,22,0,1169
1201100L012,2441,1800,53,134,1573,24,39,5,1747
12129000006,2228,1756,1487,30,152,51,24,3,269
1201100A016,3591,3147,2083,511,374,16,73,6,1064
12009000000,0,0,0,0,0,0,0,0,0
12009000225,43,41,24,5,9,0,6,3,17
12009000504,1027,962,868,43,16,16,12,2,94
12009000215,1585,1447,1280,52,22,32,35,5,167
12009000221,3358,3166,2870,145,33,34,62,6,296
12009000122,3309,2556,2030,223,166,50,62,20,526
1201100F004,5304,5236,4009,713,328,24,82,3,1227
12057000333,1893,1569,887,384,259,19,37,2,682
12031000210,3328,2599,1913,176,368,85,73,5,686
12031000213,5456,4280,1988,299,1863,107,81,16,2292
12086008290,2202,1824,53,1386,402,11,27,2,1771
12086000244,5358,4036,122,1628,2371,33,17,1,3914
12086002610,1144,855,34,228,607,6,2,2,821
12009000508,2537,2128,1896,113,23,37,42,0,232
12009000432,202,189,160,16,2,1,11,1,29
12009000411,1510,1274,1086,95,30,22,32,3,188
12009000531,8,3,0,2,1,0,0,0,3
12009000305,3231,2663,2396,146,28,43,40,5,267
12055000009,595,401,58,52,291,6,1,1,343
12057000538,4563,3316,1995,613,200,38,472,8,1321
12057000537,1117,852,573,152,32,17,85,3,279
12057000541,404,321,238,32,2,0,44,1,83
12057000589,3135,2514,1748,384,122,34,242,2,766
12057000065,2345,1649,1111,213,93,15,215,2,538
12057000506,0,0,0,0,0,0,0,0,0
12057000526,2015,1578,1123,260,59,13,109,3,455
12057000860,2293,1724,928,364,332,29,74,4,796
12057000877,724,620,367,177,57,8,19,0,253
12021000096,2277,1903,1297,480,58,49,33,5,606
12021000001,4098,3562,2054,1092,369,45,40,2,1508
12021000011,4086,3600,2631,450,427,32,63,0,969
12097000360,3046,2304,441,1126,586,38,156,8,1863
12057000304,412,248,31,71,160,1,0,1,217
12057000130,832,714,100,337,270,2,9,0,614
12057000163,2002,1892,987,533,253,33,107,0,905
12086000710,3287,2741,297,2416,33,7,15,2,2444
12086000858,4015,3266,303,2721,232,6,79,1,2963
12086000758,3149,2579,160,2277,152,17,36,0,2419
12086000379,5156,4386,109,4247,91,17,8,0,4277
12086000512,2967,2227,31,927,1362,27,12,0,2196
12043000011,1654,1516,493,469,549,11,8,1,1023
12105000102,1885,1477,1165,226,52,22,32,4,312
12097000305,9973,7446,889,4143,2455,155,177,34,6557
12097000550,3152,2183,1534,438,139,40,46,1,649
12097000551,0,0,0,0,0,0,0,0,0
12031000083,3495,2857,2138,294,246,52,124,10,719
12007000001,3099,2641,1887,157,549,37,8,1,754
12007000012,1622,1228,1011,34,142,19,16,1,217
12105000101,4249,3274,2637,340,101,76,124,5,637
12031000246,2548,2256,1939,132,52,35,76,2,317
12021000115,4552,3578,1997,1267,186,59,61,2,1581
12021000004,5344,4759,3439,867,309,53,72,7,1320
12021000012,4058,3716,3132,363,148,31,34,0,584
12021000097,6469,5339,3118,1585,464,132,84,7,2221
12021000009,2042,1857,1427,274,78,16,49,9,430
12021000008,21,0,0,0,0,0,0,0,0
12021000060,2321,2123,1909,134,17,17,32,0,214
12021000094,1217,1084,852,156,40,24,12,0,232
12031000132,1068,752,38,23,694,7,5,0,714
12097000405,1808,1361,213,989,134,19,61,3,1148
12097000109,782,599,76,435,76,13,27,3,523
12097000133,170,112,15,54,28,18,13,0,97
12097000156,476,333,166,80,39,15,32,2,167
12097000136,185,184,146,7,19,0,5,0,38
12043000004,242,189,164,16,3,3,4,4,25
12031000107,5314,4261,2722,678,504,113,189,12,1539
12031000215,5217,3810,1506,202,1978,76,76,8,2304
12031000008,2259,1770,930,382,378,49,78,5,840
12031000175,2773,2060,472,92,1439,30,22,3,1588
12031000170,2270,1745,817,140,664,42,95,4,928
12031000036,7054,5421,2638,627,876,70,1229,28,2783
12031000137,3819,2895,684,437,1689,59,70,10,2211
12057000356,26,19,3,8,9,0,6,0,16
12057000357,0,0,0,0,0,0,0,0,0
12057000908,4136,4113,3860,87,72,26,61,2,253
12031000126,1333,974,224,56,678,28,6,1,750
12031000195,2897,2123,65,28,2020,14,6,4,2058
12031000116,2545,1965,717,267,927,36,59,5,1248
12031000029,2384,1880,909,350,564,24,67,3,971
12086000789,168,127,7,114,3,0,5,1,120
12086000784,4483,3522,224,3089,161,21,95,3,3298
12031000060,1304,1237,525,81,563,29,53,3,712
12021000075,3302,2929,2254,429,122,29,77,4,675
12021000068,3883,3664,3358,152,55,12,61,0,306
12021000088,2391,2123,1759,263,35,8,51,1,364
12021000065,4872,3905,2773,775,132,33,158,6,1132
12027000001,2362,2158,1984,88,26,34,23,6,174
12031000171,1804,1397,27,27,1348,11,3,1,1370
12031000196,2286,1737,35,28,1657,25,3,2,1702
12031000265,9303,7919,5173,730,1002,106,899,18,2746
12086000907,3105,2399,635,1300,454,30,68,6,1764
12086000948,7052,4810,349,2727,1828,71,69,2,4461
12086000718,3329,2683,297,2272,69,14,67,4,2386
12086000573,4019,3406,375,2914,102,35,75,8,3031
12086000013,5142,4537,916,3242,302,43,86,5,3621
12086004241,1047,880,33,842,19,0,2,0,847
12086004240,4344,3645,134,3471,64,15,15,1,3511
12031000234,3323,2592,1124,197,1159,58,94,0,1468
12031000073,6168,4903,2258,1080,1112,78,426,11,2645
12031000062,7840,6961,3873,745,1270,103,1011,60,3088
12086000388,7210,5822,113,5649,120,16,37,14,5709
12086000202,3763,3063,64,2129,995,12,23,8,2999
12086000358,3098,2567,66,2469,77,18,21,5,2501
12086000826,2765,2002,43,860,1096,6,28,1,1959
12086000838,1864,1508,68,1250,186,26,23,0,1440
12086000955,2452,1712,87,602,1045,25,13,3,1625
12086000930,1477,1115,316,666,101,35,36,0,799
12086000936,1831,1261,43,1043,189,94,6,7,1218
12086004410,1988,1665,107,1544,23,8,8,3,1558
12086000446,33,26,5,16,3,3,1,0,21
12031000058,6962,5567,3340,754,663,81,740,26,2227
12105000206,3226,2564,1255,454,786,44,60,4,1309
12031000081,4660,3596,2153,514,679,65,131,8,1443
12031000189,2241,1694,60,20,1610,17,3,0,1634
12031000033,1741,1358,911,166,221,32,69,10,447
12031000002,2566,1928,985,351,495,72,50,10,943
12031000017,3544,2875,1653,255,718,27,247,9,1222
12031000287,3617,2881,1471,224,965,68,153,9,1410
12031000208,6414,4883,2921,447,1131,114,277,11,1962
12031000148,1346,1008,39,33,947,8,4,0,969
12031000034,3225,2559,1553,276,540,69,144,13,1006
12131000510,10939,9274,8156,449,166,198,275,7,1118
12061000036,2576,2206,1916,125,82,40,38,1,290
12086000184,4965,4308,2213,1668,206,26,122,4,2095
12086000102,7137,5656,2904,2212,187,37,140,8,2752
12086000148,4816,4009,1197,2198,461,36,107,3,2812
12086000586,2530,1958,1096,705,70,18,46,5,862
12086000942,2312,1638,43,1113,498,10,34,0,1595
12086000433,3055,2553,178,2329,38,3,32,0,2375
12086000238,2342,1744,25,400,1381,24,14,1,1719
12086000995,10769,9625,3728,4644,418,70,480,16,5897
12057000528,3367,2765,2246,293,56,52,109,4,519
12057000518,877,721,608,64,28,9,16,0,113
12057000662,1152,962,648,144,87,15,72,1,314
12057000657,2349,2005,1162,232,423,16,148,1,843
12057000828,13856,11084,4643,2637,2605,240,1186,39,6441
12086000596,6432,5306,214,5031,213,41,29,2,5092
12086000547,1642,1426,83,1277,98,17,11,8,1343
12086000421,3347,2803,131,2633,44,4,17,1,2672
12086000375,1935,1697,38,1643,57,6,11,0,1659
12009000127,1387,1168,951,86,80,15,25,0,217
12086000922,4034,2751,37,1056,1681,32,9,7,2714
12086000941,1519,1244,387,775,48,29,39,1,857
12086000272,3797,3054,127,2585,442,24,31,2,2927
12086000229,4426,3445,67,2361,1126,23,21,2,3378
12099000004,1004,796,660,87,13,16,20,1,136
12099000531,2967,2420,1250,352,730,33,73,1,1170
12099000332,1591,1213,492,623,77,84,18,0,721
12099000338,2034,1581,248,850,478,31,26,3,1333
12099000699,3041,2320,805,740,576,34,204,1,1515
12099000684,1314,1060,411,335,260,15,44,6,649
12099000697,2130,1578,539,443,486,29,81,3,1039
12057000617,4801,3593,650,702,2237,36,79,20,2943
12099000290,590,514,187,251,47,17,30,4,327
12099000753,0,0,0,0,0,0,0,0,0
12099000099,1633,1605,1560,24,5,4,10,1,45
12099000106,2677,2532,2367,106,17,13,21,1,165
12099000737,4605,3456,573,2085,753,26,61,6,2883
12085000043,6888,5699,4801,448,174,82,163,11,898
12009000123,4491,3537,2784,268,287,97,95,12,753
12009000424,6027,4576,3244,578,314,57,364,19,1332
12009000441,3934,2777,1940,315,186,41,286,14,837
12009000419,2857,2409,1955,202,115,32,100,6,454
12009000425,737,693,621,32,17,5,9,2,72
12099000294,4175,2855,499,2013,338,84,48,6,2356
12086000457,2657,2296,78,2189,53,7,16,2,2218
12086000455,4522,3806,136,3544,93,36,71,1,3670
12086000386,7296,6253,125,6055,215,27,25,2,6128
12086000498,4788,3873,204,1369,2397,31,43,1,3669
12086000580,346,246,2,173,88,4,2,0,244
12086000501,3076,2354,52,749,1596,23,28,2,2302
12086000819,2416,1921,636,949,251,21,97,7,1285
12086000820,4881,3786,1531,1766,277,38,211,2,2255
12086000024,2286,1713,1103,500,36,12,33,1,610
12009000229,523,432,372,28,5,5,19,0,60
1200300004A,330,245,221,2,8,8,0,1,24
1200300004D,1665,1233,1190,9,14,13,3,4,43
12099000688,3600,2766,1230,632,767,35,131,4,1536
12099000041,3508,2774,2278,269,90,22,85,6,496
12099000066,2058,1495,1235,127,15,21,93,1,260
12099000074,456,372,280,56,7,10,20,0,92
12099000042,2956,2383,1837,353,57,32,94,4,546
12099000103,1631,1291,958,249,34,20,30,3,333
12099000797,757,697,599,53,5,5,28,1,98
12099000195,1188,1140,1085,31,6,1,15,0,55
12086000815,3385,2819,168,2416,266,28,34,2,2651
12086000264,2552,1886,27,1023,897,16,4,1,1859
12086000860,1931,1550,159,1196,179,21,56,3,1391
12086000033,2792,2497,1012,1199,169,33,94,10,1485
12086000031,1937,1594,930,500,79,16,63,2,664
12086000817,2937,2420,174,1321,880,25,81,4,2246
12086000926,2709,2007,398,1394,183,53,27,8,1609
12099000696,1843,1512,640,480,352,9,38,1,872
12099000735,3184,2436,1013,845,525,46,85,6,1423
12099000738,1162,827,137,242,372,3,76,1,690
12099000739,12,9,4,2,3,0,1,0,5
12099000258,4805,3641,899,1487,1024,83,266,5,2742
12099000474,2333,1801,1388,244,58,15,61,1,413
12057000527,7782,5696,3946,700,297,61,645,14,1750
12057000917,603,472,369,63,10,13,7,3,103
12086000975,854,770,40,427,268,0,80,0,730
12086005311,341,327,34,128,192,5,6,3,293
12086000025,2480,2123,967,991,45,13,81,2,1156
12086000131,3885,3214,326,1096,1737,48,135,8,2888
12086000231,3735,3180,128,2664,458,7,33,3,3052
1205500011S,298,291,232,30,15,9,4,0,59
12123000009,1022,825,748,12,39,31,1,0,77
12057000124,3440,2160,1445,298,136,31,266,3,715
12057000712,525,360,235,85,35,11,4,2,125
12099000114,301,275,267,4,0,0,2,1,8
12099000122,1,1,0,0,1,1,0,0,1
12099000199,628,522,464,42,2,1,6,1,58
12113000031,2880,2184,1868,121,68,83,29,14,316
12031000048,5851,4754,3646,332,261,49,451,12,1108
12031000282,4251,3038,1183,436,1273,77,92,3,1855
12031000020,1527,1282,906,77,202,10,92,6,376
12031000187,2270,1735,649,87,915,44,51,6,1086
12031000233,5495,3915,1578,557,1487,64,245,7,2337
12031000064,2015,1640,1231,177,146,35,57,6,409
12031000237,3690,2760,1401,259,895,69,161,12,1359
12031000108,2216,1866,1406,171,140,34,94,0,460
12083000027,2811,2298,1918,132,125,67,22,7,380
12083000041,1702,1319,815,121,350,19,7,2,504
12107000006,784,595,430,89,54,15,2,1,165
12035000271,91,70,45,10,9,0,4,0,25
12035000272,1824,1549,1230,159,130,10,25,1,319
12035000270,5315,4805,4042,344,197,70,128,5,763
12035520000,123,115,104,3,2,2,5,0,11
12103000180,5993,4862,4266,248,71,106,147,4,596
12103000189,766,591,524,28,4,8,15,0,67
12103000354,5041,4126,3513,278,92,41,191,5,613
12103000076,1048,932,746,79,33,19,42,2,186
12113000035,6736,5172,3628,422,612,136,360,27,1544
12113000023,5445,4198,3430,267,206,121,155,13,768
12057000937,3146,2793,2354,223,69,56,87,3,439
12057000062,2311,1825,1486,158,80,20,78,2,339
12057000919,2170,1602,1056,387,86,43,37,8,546
12057000231,4062,3491,2180,736,429,81,103,2,1311
12031000223,6702,5220,2215,667,1911,139,425,9,3005
12031000272,3956,3087,1436,402,909,63,324,14,1651
12031000111,15597,12580,7552,1569,1834,224,1257,39,5028
12031000267,3065,2323,1184,305,407,75,364,5,1139
12031000035,1898,1478,1100,121,115,54,100,6,378
12107000010,4027,3352,2820,163,245,69,23,7,532
12107000019,1106,892,535,69,253,38,11,1,357
12105000115,6029,4680,2871,1032,542,94,159,5,1809
12125000007,1232,891,703,29,123,25,9,3,188
12031000052,5446,4070,2239,1181,366,101,241,21,1831
12031000087,2075,1640,1422,83,51,23,58,2,218
12031000158,2400,1971,1710,80,71,58,37,1,261
12031000238,4166,3081,1358,416,1143,86,144,3,1723
12031000169,1445,1131,84,78,959,13,16,12,1047
12083000076,2704,2123,1625,230,187,40,28,3,498
12113000040,2764,2250,1717,190,150,42,116,14,533
12035000171,2747,2215,1536,270,303,45,80,0,679
12035000170,0,0,0,0,0,0,0,0,0
12057000639,1497,1178,922,164,35,60,19,0,256
12057000818,4855,3699,2091,871,500,91,200,6,1608
12035000213,3735,2844,1925,418,338,51,97,15,919
12083000001,1603,1304,982,165,96,41,25,2,322
12105000240,2563,1986,1623,169,57,43,87,7,363
12086000845,637,452,22,338,69,6,29,0,430
1208600845A,2594,2010,193,1405,306,16,90,3,1817
12009000104,6829,5545,4497,157,613,162,73,6,1048
12086000783,3282,2652,741,1536,244,23,122,3,1911
12099000490,2834,2242,1678,332,70,30,89,7,564
12099000482,1395,1183,860,194,45,6,49,0,323
12099000494,2595,1978,1609,226,51,26,51,0,369
12099000491,2603,2070,1405,386,98,40,119,3,665
12099000505,2785,2124,1630,336,61,22,52,1,494
12099000437,1496,1390,1233,75,33,13,22,1,157
12099000820,1875,1630,1098,205,274,39,17,1,532
12035000333,466,452,420,11,2,9,6,3,32
12035000330,230,205,181,14,1,1,5,0,24
12083000020,39,28,14,5,1,1,3,1,14
12009000311,3462,3150,2926,90,16,34,58,4,224
12009000324,992,911,813,46,11,9,24,1,98
1209500316A,10926,8746,1930,5368,1490,158,204,17,6816
12086000969,4842,3616,315,2784,441,43,125,7,3301
12086000968,15,11,0,11,1,0,0,0,11
1208600969A,768,612,48,423,148,6,7,0,564
12086000378,2424,2068,52,1992,67,6,11,2,2016
12086000267,2616,1945,12,1143,876,10,23,6,1933
12086003691,0,0,0,0,0,0,0,0,0
12086000014,5870,5163,1127,3584,298,65,133,5,4036
12086000442,3743,3149,72,3062,55,6,4,3,3077
12095000327,4213,3469,2542,509,266,52,119,6,927
12095000335,2825,2334,1938,245,59,41,31,6,396
12086000274,2414,1983,50,1316,661,7,14,1,1933
12086000219,2077,1605,5,562,1077,8,7,2,1600
12086000117,4033,3195,171,858,2145,38,90,3,3024
12086000166,561,447,25,123,294,2,16,2,422
12086000212,5551,4380,283,874,3274,21,47,1,4097
12086000781,1066,844,197,578,26,5,35,1,647
12086000745,5232,4343,708,3327,209,27,121,4,3635
12086000961,3097,2261,64,1222,1024,48,17,3,2197
12086000289,86,72,7,65,1,3,1,0,65
12086000288,56,34,0,20,7,3,9,3,34
12099000353,2636,2079,1315,312,278,15,138,0,764
12099000518,2840,2143,1392,284,267,23,151,7,751
12099000097,405,345,324,10,4,4,8,0,21
12099000193,2495,2153,1984,109,15,2,27,4,169
12099000101,1245,1220,1162,29,2,2,19,0,58
12099000123,2485,2120,1870,148,34,23,42,4,250
12099000312,1210,941,413,447,69,19,13,0,528
12099000311,19,11,2,7,0,0,2,0,9
12099000091,1231,1024,878,81,12,11,26,1,146
12099000024,0,0,0,0,0,0,0,0,0
1209900NP23,0,0,0,0,0,0,0,0,0
12099000092,1024,925,773,100,17,16,26,1,152
12099000088,469,458,417,24,5,4,11,2,41
12099000089,79,75,60,5,7,0,0,0,15
12027000012,2365,1766,1157,457,102,35,16,2,609
12086000354,1864,1608,72,1521,39,3,6,2,1536
12113000005,220,172,157,4,1,10,0,0,15
12113000022,6302,4874,4423,171,27,103,110,6,451
12057000804,5629,4374,2892,720,521,95,184,4,1482
12057000036,2102,1582,1156,174,67,19,157,1,426
12057000532,693,536,397,63,31,4,39,1,139
12086000043,2240,1980,615,1131,129,44,73,3,1365
12086000038,629,509,279,173,22,4,11,1,230
1211100001A,6,3,1,1,0,1,0,0,2
12099000022,2082,1939,1730,100,43,6,59,0,209
12099000354,3527,3166,2629,194,185,11,139,0,537
12099000249,2118,1730,1279,346,49,28,35,2,451
12009000429,2591,2517,2248,109,59,15,66,5,269
12009000433,34,27,23,2,0,0,2,0,4
12086000069,1100,904,194,474,214,15,25,0,710
12131000220,868,673,591,33,13,22,18,3,82
12131000210,608,462,430,9,7,11,3,1,32
12095000232,6875,5478,3179,925,1144,102,212,3,2299
1209500331B,5257,3850,625,2480,744,93,147,16,3225
1209500331A,2976,2384,886,892,470,43,148,3,1498
12095000406,5096,3585,1351,1279,503,62,463,6,2234
12095000437,6010,4209,1524,1506,775,66,455,10,2685
120170208.1,1531,1337,1162,83,50,21,25,1,175
12095000212,4052,2895,594,555,1641,54,132,8,2301
1209500109B,3841,2816,1252,513,677,53,280,4,1564
1209500109Z,0,0,0,0,0,0,0,0,0
1209500131A,4042,2885,1608,490,319,23,338,4,1277
12095000611,5613,4225,742,1140,1856,110,289,33,3483
12111000029,1018,792,518,122,122,19,19,0,274
12105000249,4519,3324,2356,416,231,59,262,3,968
12083000017,2485,1961,1593,175,94,44,29,2,368
12103000137,4472,3655,2775,304,287,94,199,4,880
12103000233,1678,1554,1408,64,19,20,25,2,146
12091000036,3985,3228,2343,284,260,95,249,20,885
12091000078,4486,3714,3027,222,168,73,180,3,687
12095000533,5145,4158,1769,1615,339,64,407,12,2389
12071000006,7179,5031,1410,3136,390,289,37,8,3621
12071000057,4604,4259,3801,286,54,47,59,4,458
12099000063,656,515,430,48,13,3,18,0,85
12023000016,1474,1140,840,48,223,34,3,3,300
12023000008,2261,1766,1431,112,134,60,16,2,335
12091000005,1713,1366,1130,40,118,50,13,1,236
12095000123,5993,4592,2205,963,320,69,871,18,2387
12095000125,4745,3786,2286,400,206,33,778,11,1500
1209500540A,4837,4297,2489,1240,389,110,188,13,1808
1209500540B,30,21,4,11,4,0,1,1,17
12095000436,5168,3956,1301,1877,545,104,252,10,2655
12109000018,2499,2062,1823,84,79,31,22,13,239
12099000280,4026,2930,545,1841,472,116,92,3,2385
12099000357,1530,1122,713,175,109,8,97,0,409
12099000359,2490,1884,1204,325,228,17,112,5,680
12099000027,2699,2135,1779,208,32,35,62,5,356
12057000706,2485,1908,1579,203,34,46,17,3,329
12067000003,1580,1223,1042,142,18,17,4,4,181
12111000037,9583,7135,3167,1789,1860,117,193,26,3968
12111000036,2863,2287,1455,378,338,23,97,3,832
12111000045,3703,2998,1991,470,397,55,77,6,1007
12103000109,5372,4627,3671,416,253,75,171,12,956
12103000106,3113,2698,1981,256,298,47,93,3,717
12103000003,985,808,577,66,113,32,42,2,231
12103000002,2593,2154,917,118,1076,32,33,2,1237
12103000060,1893,1480,1002,222,101,26,103,3,478
12103000061,3037,2730,1988,247,289,43,163,15,742
12131000440,1483,1185,983,74,19,92,17,2,202
12103000135,3157,2522,1560,403,236,57,274,5,962
12103000124,3000,2551,2180,147,72,65,69,3,371
12019070800,3077,2378,2141,91,35,87,23,6,237
12019050300,2222,1639,1261,151,157,32,31,7,378
12029000005,389,359,343,5,4,4,1,0,16
12057000643,1416,1184,476,208,298,13,189,3,708
12057000509,2661,2108,1141,672,131,24,148,12,967
12057000892,2604,2060,1565,319,50,59,60,1,495
12057000587,3237,2616,1939,418,102,54,93,5,677
12073005115,2750,2110,1117,155,665,50,131,9,993
12073005227,353,305,181,22,78,9,15,0,124
12073005101,497,444,344,27,61,6,14,0,100
12073001309,3160,3065,111,118,2854,27,30,0,2954
12073001314,838,739,505,129,82,6,16,1,234
12095000534,3927,3257,1315,1228,477,86,261,14,1942
12095000308,3938,3065,974,1559,441,93,147,11,2091
12065000003,363,289,181,6,100,7,3,0,108
12065000014,235,188,66,5,110,4,3,0,122
12067000002,1284,1033,877,98,50,12,3,6,156
12019060400,564,474,414,26,18,6,8,0,60
12019041003,356,260,215,15,23,2,5,0,45
12019060401,3783,2845,2241,193,245,55,101,17,604
12015000048,2671,2412,2177,91,45,33,34,2,235
12015000052,3324,2725,1909,263,409,60,99,2,816
12015000104,1994,1747,1543,81,49,43,14,3,204
12103000283,2677,2386,2084,150,76,32,47,3,302
12103000350,4276,3272,2783,199,60,40,175,1,489
12023000018,1711,1342,1143,59,58,30,43,4,199
12103000201,3498,3141,2688,208,142,45,56,1,453
12049000012,1982,1506,1081,378,28,17,7,1,425
12047000008,1215,988,821,58,81,18,7,0,167
12047000006,462,369,249,14,94,7,0,0,120
12007000018,834,645,587,7,15,14,10,0,58
12111000020,1533,1429,1194,147,51,29,15,2,235
12111000025,7398,5883,3001,1656,1053,152,94,8,2882
12115000110,804,772,738,18,7,8,1,0,34
12103000213,3592,2861,1925,391,244,64,212,2,936
12103000312,2979,2454,1657,418,265,65,78,1,797
12007000010,1251,960,437,26,459,20,13,0,523
12103000343,7661,6258,5209,529,159,79,238,6,1049
12015000001,887,748,645,45,30,15,10,0,103
12015000033,2708,2299,1768,213,223,54,44,4,531
12071000031,4627,3875,2827,586,228,65,123,5,1048
12049000010,2282,1497,646,648,172,25,15,5,851
12115000042,2758,2306,1675,438,81,22,35,2,631
12115000063,2882,2518,2056,194,167,49,38,8,462
12115000005,2431,2232,2043,59,14,17,65,1,189
12115000104,4724,3901,3179,400,113,75,107,2,722
12115000058,2700,2283,1648,463,65,45,41,0,635
12115000053,3214,2557,1842,504,68,61,63,6,715
12099000331,974,766,70,504,177,13,39,1,696
12099000333,4034,2862,485,1814,537,76,45,5,2377
12099000481,1164,1028,876,85,17,0,26,0,152
12099000479,1811,1530,1119,238,69,18,45,1,411
12063000020,699,550,252,26,250,25,2,2,298
12015000015,3519,2936,2414,195,167,57,67,6,522
12103000158,1603,1274,869,131,61,29,186,4,405
12071000070,5243,4642,4036,266,109,43,172,5,606
12071000020,6727,5877,4462,877,304,60,154,9,1415
120170203.1,3845,3396,2841,268,144,61,82,0,555
12073003405,867,686,617,22,30,8,7,0,69
12073002511,6604,5485,1746,600,3014,108,166,7,3739
12073002380,503,383,156,29,184,17,2,1,227
12071000116A,107,100,96,1,0,0,1,0,4
12071000127,1248,1170,1097,55,5,12,3,3,73
12115000084,4551,4019,3561,167,24,54,164,6,458
12015000034,2827,2351,1856,217,201,36,46,0,495
12099000774,2492,1715,38,115,1569,12,9,4,1677
12099000NP9,0,0,0,0,0,0,0,0,0
12099000854,23,16,0,5,1,3,7,0,16
12099000096,2015,1893,1791,60,11,13,17,0,102
12099000113,1367,1272,1186,53,10,12,4,1,86
12099000396,1921,1878,1533,177,100,12,55,3,345
12099000532,2331,1938,1044,253,588,15,38,0,894
12099000793,3040,2880,2117,381,207,19,148,5,763
12099000794,3333,3096,2343,429,154,29,150,5,753
12099000152,49,43,34,7,1,1,0,0,9
12099000130,8,7,5,1,0,0,2,0,2
12099000140,164,149,134,4,7,7,4,0,15
12099000135,987,899,715,111,40,6,26,3,184
12099000414,255,241,236,1,0,0,4,0,5
12099000307,1577,1243,310,839,93,29,5,1,933
12103000156,6385,5270,4202,422,206,125,305,6,1068
12103000063,2439,1995,1526,178,95,39,150,5,469
12015000126,1479,1159,801,175,119,41,25,3,358
12087000013,3203,2643,1768,604,184,42,82,2,875
12087000010,3400,2701,1625,638,266,69,92,15,1076
12081000084,1926,1214,178,319,710,7,8,0,1036
12081000121,3372,2677,1762,386,438,44,63,8,915
12081000005,258,185,148,22,12,1,2,0,37
12127000191,4844,3912,3110,298,250,64,185,6,802
12033000062,6456,5238,4117,299,377,164,270,18,1121
12033000064,5532,5141,3160,1085,629,74,218,17,1981
12033000191,2164,1735,1451,61,116,31,67,2,284
12033000148,274,221,107,21,67,7,14,4,114
12033000129,1286,958,137,24,781,19,12,2,821
12033000121,927,769,420,40,281,17,17,2,349
12033000134,455,351,37,7,306,6,2,3,314
12033000052,3968,2950,2231,152,288,151,148,13,719
12081000032,535,478,377,44,11,24,15,0,101
12081000201,1022,806,656,106,16,19,11,0,150
12081000035,2774,2691,2475,117,42,32,21,1,216
12081000129,970,838,550,129,122,25,19,0,288
12033000144,1085,860,273,23,535,20,13,4,587
12071000069A,0,0,0,0,0,0,0,0,0
12073005223,288,258,164,12,60,4,18,0,94
12073005224,800,617,300,107,198,12,16,0,317
12073004101,2340,1905,1154,130,455,41,127,4,751
12081000127,1463,1036,459,268,278,22,12,2,577
12073004162,65,49,44,0,4,0,0,0,5
12073004159,997,737,387,24,301,15,6,1,350
12073005265,98,70,10,3,46,10,0,0,60
12073005153,2355,1837,1354,62,351,31,21,1,483
12069000123,3316,2612,1271,656,425,38,195,15,1341
12069000099,11978,9465,5130,2168,1308,165,643,21,4335
12115000055,4392,3788,3097,407,83,88,93,15,691
12115000012,1840,1533,1330,118,30,21,41,3,203
12115000026,1560,1315,1173,52,10,38,23,5,142
12115000046,3245,3054,2890,69,15,16,51,1,164
12115000034,5171,4913,4681,123,37,37,35,5,232
12115000097,7838,6879,6290,247,86,72,121,5,589
12127000209,5723,5038,4401,245,102,79,154,4,637
12069000084,2162,2156,2074,23,14,17,19,0,82
12127000173,579,516,440,35,3,13,21,1,76
12073002252,2001,1610,1139,83,296,79,13,8,471
12073002251,819,659,388,20,229,31,4,0,271
12073002253,901,732,508,26,170,22,1,1,224
12053000047,4979,4928,4787,80,26,15,12,8,141
12033000029,893,689,407,61,130,33,57,13,282
12115000103,2840,2564,2165,158,94,33,106,1,399
12015000124,3692,3159,2394,278,346,52,83,4,765
12033000105,1944,1492,945,158,267,44,69,1,547
12133000012,2355,1809,1354,32,366,46,9,3,455
1201100T021,2386,1823,1032,425,153,27,196,5,791
1201100T030,744,590,349,131,44,5,60,1,241
1201100W017,6813,5109,535,2624,1406,30,631,7,4574
1201100W014,7096,5328,499,3091,1313,31,495,9,4829
12081000103,1605,1510,1366,82,6,16,26,2,144
12081000128,1212,958,546,264,110,31,21,0,412
12081000149,977,781,424,228,92,19,20,0,357
12099000453,2256,2030,1359,253,309,38,45,2,671
12099000451,1911,1732,1198,284,129,18,48,3,534
12081000086,1185,987,836,81,25,18,18,3,151
1201100N023,4934,3807,1683,1183,629,36,297,5,2124
1201100L018,2336,1785,91,125,1562,21,11,6,1694
12059000005,1019,768,722,13,9,16,3,0,46
12081000214,3480,2639,2197,207,91,29,111,1,442
12081000233,15,13,6,0,3,3,0,0,7
12081000207,1065,1005,953,25,18,9,4,1,52
12081000243,2244,1517,1196,177,52,18,65,3,321
12069000088,993,970,915,32,11,7,6,0,55
12127000071,3678,2998,2011,538,268,46,136,1,987
12117000001,4401,3353,1928,367,438,62,520,7,1425
12069000055,1218,936,768,67,66,21,9,2,168
12069000098,3424,3344,2860,209,188,20,72,2,484
12127000072,6833,5437,4051,744,337,114,164,17,1386
12127000216,5274,4582,4001,196,235,69,53,3,581
12069000002,833,716,666,33,0,13,3,0,50
12069000080,944,923,878,31,7,10,1,0,45
12127000152,4762,4544,2925,531,682,54,355,7,1619
12085000101,7016,5559,4760,407,126,54,160,10,799
12069000034,0,0,0,0,0,0,0,0,0
12069000063,1589,1348,964,229,62,31,52,3,384
1201100V028,1522,1200,640,367,128,15,64,1,560
1201100R016,2259,1998,1502,322,90,32,57,4,496
1201100R017,751,660,453,99,44,19,42,1,207
1201100R019,2073,1907,1331,331,149,19,69,1,576
1201100J020,3470,2673,307,687,1588,24,107,9,2366
12133000005,439,347,303,10,22,10,0,1,44
12087000022,1747,1502,1031,380,37,29,18,2,471
12081000009,293,261,218,23,5,5,4,0,43
12081000182,201,194,167,12,3,7,5,0,27
12121000009,2264,1954,1765,113,24,28,6,0,189
12127000139,2969,2616,2127,147,263,48,48,1,489
12127000140,3252,2631,1831,243,426,71,55,2,800
12103000115,3130,2640,1981,285,184,53,127,2,659
12103000357,2545,2318,1978,115,159,37,32,7,340
12103000112,1131,945,757,82,55,12,34,0,188
12103000202,3033,2619,1875,332,201,71,120,7,744
12103000346,2715,2153,1608,244,152,36,127,2,545
1201100U003,3998,3017,1853,806,131,49,214,3,1164
12069000045,1561,1467,1231,73,123,10,23,4,236
1201100Q080,5383,4179,667,1982,1537,97,85,7,3512
1201100X036,3287,2543,403,1397,460,54,281,4,2140
12133000014,390,309,282,9,4,7,3,2,27
12103000284,5263,4584,3939,251,202,73,86,16,645
12033000172,577,510,432,8,34,12,21,0,78
12033000018,1526,1144,654,67,282,39,116,3,490
12121000004,3267,2503,1985,203,241,38,32,1,518
1201100X029,4873,3787,1074,1773,739,44,206,4,2713
1201100Q071,4621,3526,1355,1828,168,36,145,4,2171
1201100Q068,4273,3278,1165,1446,193,40,433,2,2113
1201100Y007,6799,5352,984,2835,1358,82,191,8,4368
1201100R027,3508,2816,671,459,1623,53,47,5,2145
1201100R015,3373,2855,2207,379,115,23,78,5,648
12011000019,1185,1081,910,105,15,8,26,2,171
1201100V001,2189,1644,971,549,48,11,44,0,673
1201100F011,2502,1915,967,370,270,19,130,10,948
1201100M007,1475,1411,371,584,401,6,57,0,1040
12103000028,2286,2146,1526,184,307,50,62,1,620
12103000148,3469,2813,2193,247,108,86,155,3,620
12103000147,5186,4209,2674,660,308,128,465,5,1535
12086000725,2403,1982,332,1573,40,7,48,2,1650
12086004350,3559,2966,85,2846,63,28,20,3,2881
12086004351,1440,1222,78,1122,21,5,10,1,1144
12086000545,8429,7045,369,6338,429,71,93,4,6676
12086000537,1187,923,101,642,213,23,17,4,822
12081000139,285,225,159,14,12,4,28,4,66
12101101025,522,427,265,93,46,13,26,4,162
12086000337,6569,5581,148,5281,223,10,18,3,5433
12086000508,3022,2072,21,533,1568,25,5,1,2051
12086000499,64,53,0,12,41,0,0,0,53
12081000133,373,342,287,30,12,10,8,0,55
12081000124,2687,2515,2099,271,73,40,31,3,416
12081000021,1427,1065,800,195,17,25,17,3,265
12081000203,1615,1301,824,325,113,38,14,0,477
12101000097,3157,2961,2603,179,58,39,57,3,358
12109000021,2647,2225,1885,143,106,42,45,0,340
12069000089,1835,1442,1220,115,29,31,30,2,222
12081000159,4351,3750,3002,419,160,33,106,1,748
12081000054,46,34,17,13,2,0,3,0,17
12101000100,1702,1473,1226,151,41,27,23,6,247
12101000125,2379,2281,882,386,962,19,69,0,1399
12101000025,4846,3985,3087,562,179,76,83,2,898
12101000215,8538,6082,2931,1577,1321,128,273,9,3151
12103000347,3162,2677,2336,134,37,36,105,1,341
12103000277,5054,4455,3689,356,198,64,91,18,766
12103000257,2553,1979,1067,629,197,56,63,3,912
12103000259,1293,1108,828,139,87,16,30,0,280
1201100C014,1759,1572,1175,206,132,18,17,6,397
12011000013,1503,1074,741,216,47,7,57,2,333
12101001060,3452,2582,1270,735,366,71,146,7,1312
12101101104,3,2,0,0,2,0,0,0,2
1201100M026,3593,2813,826,723,1047,15,217,3,1987
1201100U001,1658,1246,633,392,118,12,106,0,613
1201100J012,5928,5384,2709,1437,1138,28,126,3,2675
1201100H011,7048,4949,498,2604,1698,89,203,17,4451
1201100Q067,3859,2853,1148,1288,118,24,197,7,1705
1201100C020,3981,2687,250,1329,1116,52,17,3,2437
1201100C025,3319,2401,346,965,1102,173,11,5,2055
12103000163,2930,2618,1981,232,193,20,164,2,637
1201100W016,10317,7862,981,3967,2094,62,929,7,6881
12011000007,639,511,62,195,120,5,135,2,449
12103000364,3896,3140,2675,162,60,25,199,4,465
12103000052,2769,2299,1728,228,152,39,152,3,571
12103000330,1245,949,628,150,102,26,56,1,321
12109000053,1987,1275,906,77,133,21,156,2,369
12109000087,0,0,0,0,0,0,0,0,0
12109000071,1759,1152,730,124,84,27,189,0,422
12109000079,1365,844,350,69,71,12,337,2,494
12103000014,1801,1405,124,49,1239,8,9,2,1281
12103000015,2114,1654,234,70,1340,17,21,2,1420
12103000161,1533,1238,894,86,53,21,178,2,344
1201100C037,1524,1427,863,263,233,15,20,6,564
1201100C032,1897,1374,210,493,507,17,9,0,1164
1201100H005,5795,4222,352,652,3025,38,223,9,3870
1201100G013,1961,1403,195,290,809,30,87,7,1208
1201100R046,3490,3234,2597,374,79,21,105,0,637
12081000023,629,566,500,24,17,12,14,1,66
1209500544B,30,26,11,6,3,4,2,2,15
1209500431Y,0,0,0,0,0,0,0,0,0
12117000065,5711,4505,2642,1270,327,84,242,12,1863
12117000079,6851,6094,3854,1221,571,80,396,10,2240
12099000695,1331,1164,853,153,102,12,58,6,311
12069820082,444,354,256,71,10,14,8,0,98
12005000013,3891,3229,2610,246,178,81,114,11,619
12117000061,8384,6812,5305,856,264,79,292,12,1507
12117000075,4241,3227,2114,646,278,57,154,8,1113
1201100G007,1027,813,242,306,213,3,53,1,571
1201100T028,6449,5318,2956,1687,383,47,292,14,2362
1201100V033,2182,1744,655,700,336,29,73,9,1089
1201100R045,2679,2212,1174,591,315,48,86,8,1038
1201100R008,1555,1407,1113,191,24,7,53,2,294
12069000096,553,539,523,2,6,7,0,0,16
12099000589,4082,3190,2033,676,208,32,146,4,1157
12099000539,2428,2245,1600,279,326,5,35,1,645
12099000533,650,641,548,55,20,1,14,0,93
12099000622,1646,1294,696,323,94,7,53,1,598
12099000381,2394,2079,1587,232,149,27,54,3,492
12035930000,477,417,298,36,71,0,6,0,119
12035840000,1,0,0,0,0,0,0,0,0
12035850000,594,473,379,33,47,6,8,0,94
1201100C006,6129,4463,234,621,3597,45,37,8,4229
12099000754,1926,1549,1107,317,62,33,28,0,442
12099000752,4683,3515,2021,729,458,33,229,7,1494
12051000008,239,200,55,83,15,51,2,3,145
1201100M003,6076,4405,308,479,3541,36,90,27,4097
12005000035,2518,2073,1832,69,59,63,31,2,241
1201100V015,2147,1814,932,622,226,11,20,2,882
1201100B003,1776,1549,1187,199,62,16,59,3,362
1201100U005,2250,1725,1027,463,103,10,115,4,698
12011000006,566,421,26,206,146,5,40,0,395
1201100J013,3483,2908,604,763,1417,41,146,4,2304
12127000135,0,0,0,0,0,0,0,0,0
12127000196,3364,3130,2888,115,20,34,51,0,242
12127000094,4512,3502,1669,1220,546,73,77,18,1833
1201100C018,2455,2107,1590,294,118,17,37,1,517
1201100Y008,5897,4366,218,1384,2772,44,65,7,4148
12039000017,1339,1051,317,175,529,25,6,0,734
12039000023,411,335,139,29,157,9,7,1,196
12039000014,828,620,54,61,497,12,7,2,566
12101000133,2491,2058,1757,126,57,62,41,4,301
12101000182,1559,1471,1151,98,203,14,7,2,320
12101000005,1863,1524,1202,189,62,39,35,9,322
12117000074,4803,3716,2332,821,320,68,208,14,1384
12117000015,2510,1986,1464,305,119,47,90,1,522
12013000201,1447,1114,1043,31,16,23,1,7,71
12109000037,3086,2567,2343,104,30,20,66,6,224
12021000024,1829,1586,1389,141,5,22,22,1,197
12021000059,359,338,313,18,3,0,0,0,25
12021000106,1342,1240,1163,42,7,13,7,1,77
12021000058,900,838,781,26,5,4,10,2,57
12021000092,2354,1866,1150,600,31,41,41,5,716
12021000091,1995,1717,1195,384,56,19,50,3,522
12009000204,5791,5285,4520,317,182,111,127,6,765
12009000302,4509,3866,3300,235,169,76,70,8,566
12021000047,2453,2348,2230,52,14,8,35,2,118
12021000064,4201,3298,2613,447,75,19,127,0,685
12009000131,1898,1582,1201,149,139,21,73,1,381
12009000121,2583,2204,1873,120,89,49,53,5,331
12097000507,16,8,1,4,1,1,1,1,7
12085000040,6502,5101,4394,348,71,64,198,3,707
12063000017,1899,1473,983,32,406,41,14,3,490
12065000002,434,376,288,8,76,4,0,0,88
12065000004,991,847,605,45,188,8,6,3,242
12057000851,4965,4049,2191,878,716,96,244,19,1858
12057000533,4908,3861,2153,1177,322,59,196,6,1708
12057000034,4748,3531,1224,904,1124,88,267,3,2307
12057000339,2732,2103,496,568,997,62,71,3,1607
12061000001,94,71,57,9,10,0,1,0,14
12057000563,8305,6122,1269,2836,1989,177,198,19,4853
12057000654,2150,1627,564,457,568,32,52,1,1063
12057000653,2782,2328,1632,337,286,44,73,13,696
12001000029,9906,9603,6788,1305,541,57,966,2,2815
12001000025,1831,1596,1200,120,128,24,110,1,396
1205500019L,420,353,304,27,14,6,6,0,49
12085000015,3916,3388,2887,279,94,56,77,5,501
12085000038,804,770,691,33,9,6,24,3,79
12001000057,7486,6842,3346,1406,1332,88,747,20,3496
12086004411,1587,1319,114,1194,20,5,3,0,1205
12086000581,6664,5425,102,5258,280,65,22,6,5323
12086000567,3539,2875,414,2267,85,36,87,2,2461
1201100C027,1064,825,225,128,442,16,9,1,600
12057000412,5092,4346,2282,1142,501,66,373,17,2064
12057000401,5098,4343,2654,1073,348,63,196,4,1689
12027000011,403,274,24,23,224,4,0,0,250
12057000967,3324,2500,422,1183,931,45,22,6,2078
12057000063,3933,2831,1122,906,661,58,172,8,1709
12057000421,4371,3465,1108,1816,356,53,173,1,2357
12057000938,633,460,287,146,14,14,3,0,173
12057000327,6394,4424,461,761,3232,44,47,5,3963
12057000764,3867,3271,2589,513,51,84,39,2,682
12086000237,2610,1959,15,738,1295,11,5,4,1944
12086000236,4846,3318,34,1521,1903,31,13,4,3284
12086007310,2563,2121,226,1830,32,23,45,1,1895
12086007311,231,178,23,148,7,3,0,0,155
12086000730,4517,3737,481,3075,149,37,59,4,3256
12086000957,1653,1230,295,697,192,8,37,3,935
12086007961,143,123,4,116,5,1,3,0,119
12086000762,4901,3891,409,3086,289,35,163,3,3482
12086007960,2900,2873,649,1010,1193,6,25,1,2224
12086000835,0,0,0,0,0,0,0,0,0
12097000153,0,0,0,0,0,0,0,0,0
12123000004,189,164,153,3,3,6,1,0,11
12027000015,2190,1557,565,748,190,28,32,1,992
1201100Q061,6878,5043,1964,2426,258,56,366,5,3079
1201100E012,3682,2762,672,1164,783,35,172,10,2090
12086000411,1742,1443,86,1293,54,8,38,1,1357
12086004111,2599,1991,60,1858,68,16,55,2,1931
12086000576,5081,4233,418,3677,116,35,79,0,3815
12086002511,422,339,9,86,254,1,4,1,330
12086000299,3980,3258,59,3150,76,19,34,1,3199
12086000357,2873,2371,144,2208,48,17,20,0,2227
12086000175,572,468,57,263,156,2,12,0,411
12086000171,254,221,30,129,55,6,8,0,191
12086000179,791,598,268,249,52,11,21,2,330
12086000985,664,595,32,433,149,2,0,0,563
12086000840,2959,2445,574,1491,181,17,167,0,1871
12086000382,3530,3020,94,2900,89,14,14,1,2926
12086000774,5171,4048,165,3696,168,17,84,0,3883
12086000318,6017,5133,192,4880,95,16,31,4,4941
12083000013,639,605,506,55,16,20,10,2,99
12086000140,5217,4022,150,888,3003,39,67,4,3872
12086000544,6386,5722,2388,2449,440,73,286,3,3334
12086000396,3972,3236,142,2940,56,29,93,7,3094
12097000470,2107,1497,275,1031,181,22,44,5,1222
12083000049,500,482,433,14,19,8,3,0,49
12086000932,1574,1122,64,787,277,13,9,1,1058
12086000017,4948,4323,1093,2659,366,55,144,6,3230
12086000016,3211,2741,947,1487,180,16,105,4,1794
12001000043,2550,2075,1659,158,100,43,85,3,416
12031000135,221,163,119,15,13,11,0,0,44
12031000055,1673,1228,644,175,289,33,84,8,584
12031000180,1872,1418,122,66,1209,30,10,1,1296
12031000011,3049,2389,1255,320,667,69,115,7,1134
12086000959,3594,2623,248,1796,523,18,72,3,2375
12086000906,3301,2405,154,1824,480,50,29,6,2251
12086000650,518,388,215,141,15,1,15,0,173
12086000042,3991,3589,1411,1793,247,58,113,3,2178
12031000177,4814,3357,1298,267,1621,71,154,8,2059
12031000144,1914,1437,422,52,937,25,9,3,1015
12086000712,3387,2822,313,2428,51,31,52,1,2509
12099000246,2541,2210,1651,392,98,27,48,4,559
12099000775,1157,738,54,67,614,11,11,1,684
12099000612,3177,2793,2094,426,112,27,74,0,699
12099000611,3667,2793,1694,558,172,26,97,3,1099
12099000416,2515,2442,2204,105,89,10,31,0,238
12099000421,772,763,650,62,39,4,7,0,113
12099000420,2160,1995,1646,144,113,10,43,2,349
12031000179,2679,2206,1648,199,228,60,57,8,558
12031000164,1639,1399,875,103,315,26,66,2,524
12031000285,2617,2302,1844,185,154,44,72,10,458
12031000224,4688,3605,2008,426,878,114,203,11,1597
12086000336,2362,1943,43,1891,55,9,3,2,1900
12086000329,22,16,0,2,15,0,0,0,16
12086000978,1838,1559,237,666,622,16,34,1,1322
12086000296,5155,4091,77,2534,1669,40,29,6,4014
12086000105,2303,1691,794,749,95,13,43,1,897
12086000127,5210,4136,175,1014,2924,26,89,5,3961
12086000773,4532,3839,123,3617,42,9,79,2,3716
12086000321,7352,6287,152,6082,180,26,30,4,6135
12099000462,1790,1501,965,251,166,30,84,6,536
12099000457,3900,3392,2593,436,223,32,103,2,799
12099000484,2784,2298,1226,520,347,29,152,1,1072
12099000650,0,0,0,0,0,0,0,0,0
12099000323,1801,1663,1249,231,135,27,37,3,414
12099000804,1095,950,671,113,135,24,24,0,279
12099000497,3664,3420,2870,265,94,28,98,0,550
12031000130,3689,2840,310,126,2385,13,35,1,2530
12031000099,2036,1550,1301,93,60,17,60,1,249
12031000097,2669,2282,1943,141,81,37,65,0,339
12031000046,1589,1265,663,248,182,38,152,4,602
1209500525B,360,340,240,64,22,2,14,0,100
1209500525Z,0,0,0,0,0,0,0,0,0
12086000158,599,461,187,205,59,4,15,0,274
12086000322,4970,3998,98,3851,132,24,33,5,3900
12086000918,2682,1933,159,1629,173,56,31,4,1774
12086000597,25,14,0,10,7,0,1,0,14
12086000527,680,541,5,523,58,15,10,0,536
12086000528,3149,2524,43,2338,382,65,13,2,2481
12086000598,1101,939,20,863,111,9,2,1,919
12086005910,1588,1192,18,1138,161,33,9,1,1174
12086005911,3477,2883,56,2600,522,45,10,1,2827
12099000427,2687,2424,1880,271,165,26,43,9,544
12099000811,2846,2048,250,366,1434,32,18,5,1798
12031000001,3327,2684,2158,163,179,52,123,3,526
12031000202,2445,1848,1156,159,435,63,24,2,692
12031000117,2039,1522,600,62,853,32,9,4,922
12099000676,2581,2024,1218,451,243,36,65,2,806
12099000679,0,0,0,0,0,0,0,0,0
12099000700,0,0,0,0,0,0,0,0,0
12099000233,1551,1204,418,329,425,21,59,1,786
12099000219,2187,2162,1618,276,212,14,42,3,544
12031000225,4657,3772,2483,369,601,135,193,46,1289
12083000080,3064,2370,1639,345,265,50,53,1,731
12095000113,5280,4258,2791,639,257,53,384,40,1467
12095000422,6384,5184,1292,2944,603,92,330,36,3892
12083000061,1618,1291,1012,172,66,31,19,0,279
12057000965,2901,2149,190,419,1495,31,47,9,1959
12057000574,4036,3390,1933,912,294,74,180,5,1457
12083000097,1067,1044,895,75,52,13,10,1,149
12099000698,0,0,0,0,0,0,0,0,0
12099000483,2657,2119,1201,385,305,28,182,1,918
12099000362,642,436,249,76,46,2,54,0,187
12099000364,3349,2458,1380,576,331,27,144,2,1078
120170406.1,3877,3115,2707,201,82,62,53,3,408
12105000520,1837,1327,558,731,32,39,3,4,769
12099000431,502,484,464,14,2,3,3,0,20
1209900NP21,0,0,0,0,0,0,0,0,0
1209900NP20,0,0,0,0,0,0,0,0,0
12099000541,3452,3012,2206,330,414,14,61,2,806
12099000619,4077,3367,1709,807,263,41,222,6,1658
12099000787,652,585,419,94,30,10,26,0,166
12099000795,1657,1597,1273,210,67,0,47,0,324
12079000002,817,576,99,7,460,8,2,0,477
12099000256,0,0,0,0,0,0,0,0,0
12099000745,2841,2186,1233,504,247,38,144,11,953
12099000723,1350,1202,948,174,34,6,33,0,254
12099000360,2815,2083,1260,356,302,23,140,0,823
12099000355,3333,2728,1929,326,269,16,166,0,799
12095000332,4896,3617,486,2159,805,70,253,15,3131
12031000089,2316,1908,1482,175,148,17,74,3,426
12031000219,960,781,705,22,21,23,8,1,76
12031000065,4232,3110,1332,891,483,55,387,2,1778
12099000228,1093,963,343,211,390,1,33,0,620
12099000861,0,0,0,0,0,0,0,0,0
12099000224,148,122,89,30,2,1,0,0,33
12099000134,12,4,0,0,3,0,0,0,4
1209500504B,618,474,407,33,7,4,20,0,67
12099000327,1181,1138,616,473,30,2,16,1,522
12057000341,7448,5784,1260,1271,3085,104,188,16,4524
12057000811,3960,3116,2110,570,221,65,182,6,1006
12073001505,2872,2368,645,303,1282,36,121,4,1723
12073001503,3792,3155,1094,264,1694,35,91,4,2061
12099000480,2247,1794,1147,362,80,6,70,1,647
12099000615,3668,2801,1298,641,371,18,190,2,1503
12099000617,2576,1996,1009,549,163,44,93,0,987
12057000801,3668,2876,1741,648,341,66,117,9,1135
12057000433,1658,1320,878,174,57,20,194,1,442
12095000208,6546,5262,2368,1267,1226,126,375,7,2894
12057000525,5211,4137,2537,891,402,50,266,8,1600
12057000520,2109,1645,682,642,150,30,168,6,963
12057000671,4936,3986,2271,765,644,71,283,13,1715
12057000121A,4368,3064,2432,325,87,38,174,11,632
12057000807,1438,1063,733,154,78,34,67,1,330
12057000243,6275,4935,1234,2663,863,105,269,5,3701
12057000244,203,174,24,116,45,3,2,0,150
12057000805,2235,1714,1306,173,90,26,93,4,408
12057000952,3239,2566,1826,316,265,72,103,5,740
12057000091,1568,1233,696,193,261,7,62,1,537
12057000522,1805,1427,837,323,112,42,123,1,590
12057000521,3815,3019,1639,931,238,43,175,8,1380
12057000941,2050,1764,1390,174,70,47,79,3,374
12057000825,4193,3442,2061,753,405,63,177,11,1381
12115000023,3011,2546,2175,174,47,49,96,2,371
12115000092,5510,5099,4867,101,24,31,62,2,232
12115000052,750,712,677,13,3,4,6,0,35
12111000068,6052,4753,2182,1025,1346,99,142,10,2571
12111000074,2874,2800,2597,112,54,14,8,3,203
12115000056,4364,3610,2914,463,64,71,90,9,696
12115000021,2349,1973,1571,271,46,29,31,5,402
12115000010,2307,2048,1124,279,276,17,354,3,924
12115000068,1567,1305,1000,226,36,25,19,2,305
12023000007,3273,2684,2181,209,174,74,35,2,503
12115000001,2592,2134,1749,230,46,38,48,0,385
12115000030,1756,1593,1486,50,11,10,21,0,107
12115000002,4455,3578,1740,1338,318,102,97,5,1838
12073003412,900,727,374,80,244,11,43,1,353
12019060001,1140,736,435,83,165,9,46,3,301
1201950602a,67,52,26,17,7,2,0,0,26
12073005220,1797,1452,793,82,334,16,233,1,659
12023000019,2677,1986,1645,139,113,68,18,0,341
12015000051,1446,1342,1185,69,27,14,32,0,157
12015000092,1643,1416,1093,143,108,30,53,1,323
12015000108,3705,3592,3405,87,10,41,21,1,187
12015000047,2746,2285,1468,237,519,27,19,0,817
12071000096A,0,0,0,0,0,0,0,0,0
12033000174,0,0,0,0,0,0,0,0,0
12033000068,1070,893,659,60,98,35,40,4,234
12127000126,4530,4014,3508,197,144,64,93,4,506
1209500131Z,0,0,0,0,0,0,0,0,0
12127000174,111,95,81,6,4,3,0,0,14
12127000172,978,875,811,35,4,12,8,0,64
12033000074,1346,873,206,60,551,36,22,10,667
12033000083,257,215,120,10,66,8,8,3,95
12033000136,1738,1319,408,74,682,15,156,9,911
12033000088,65,50,34,1,9,2,0,0,16
12033000113,1215,922,349,59,450,25,49,2,573
12033000178,953,745,626,47,25,24,18,2,119
12033000266,1571,1244,992,12,130,99,5,1,252
12033000072,1182,1027,881,41,50,27,26,1,146
12081000146,3261,2681,1948,525,118,41,41,2,733
12081000145,1710,1483,975,234,237,15,26,3,508
12033000223,2606,2018,1309,115,455,62,94,6,709
12033000224,977,837,601,40,139,17,32,3,236
12033000228,1584,1353,1050,69,123,45,67,1,303
12033000135,255,198,22,3,169,6,1,3,176
12033000130,1283,1249,609,25,619,1,0,0,640
12081000087,2762,2154,1661,254,117,61,45,4,493
12071000051A,0,0,0,0,0,0,0,0,0
12099000512,135,107,81,10,12,0,1,0,26
12099000856,65,61,49,4,0,1,7,0,12
12099000121,2,2,2,0,0,0,0,0,0
12099000475,2833,2366,1680,355,137,20,113,2,686
12127000105,3703,3367,3023,161,42,50,33,10,344
12033000022,2180,1615,924,104,437,71,109,11,691
12033000056,1882,1663,1462,58,42,48,40,4,201
12081000132,2649,2432,2147,116,79,21,70,3,285
12081000200,1750,1434,1062,191,125,32,20,2,372
12099000563,1758,1735,1392,189,88,9,25,3,343
12033000209,555,486,416,12,40,3,12,0,70
12033000030,2598,2044,1096,102,701,52,99,8,948
12127000198,7118,5400,4365,376,255,81,321,20,1035
12127000073,5995,4838,3771,637,212,107,112,11,1067
1201100F014,3052,2366,926,587,524,18,123,11,1440
12033000170,271,229,195,9,15,5,5,0,34
12127000060,358,293,169,85,20,2,10,1,124
12033000229,1480,1290,838,116,201,46,93,6,452
12033000184,244,227,169,13,27,8,12,0,58
12087000005,2393,2187,1617,352,150,29,35,4,570
12127000171,4113,3429,2765,243,262,85,65,9,664
12127000238,135,121,114,3,1,2,0,0,7
12127000128,11,7,7,0,0,0,0,0,0
12033000014,461,343,191,18,64,3,66,4,152
12081000125,1887,1705,1392,180,69,40,30,6,313
12081000175,2289,1989,1757,95,52,39,32,4,232
12033000100,420,309,202,20,59,23,6,0,107
12033000080,527,432,333,17,64,12,6,1,99
12081000213,1565,1480,1281,88,29,10,64,1,199
12081000065,893,697,393,202,80,13,9,3,304
12081000143,1581,1339,880,233,184,23,18,1,459
12081000066,934,815,635,102,50,17,7,3,180
1201100A003,2406,2387,2048,196,45,8,34,5,339
1201100A007,4014,3409,1667,715,644,32,111,2,1742
12081000116,2983,2006,368,909,706,38,18,2,1638
1201100X027,4653,3415,749,1840,597,39,227,3,2666
1201100X048,1807,1321,269,630,394,40,63,1,1052
12129000010,549,487,456,5,6,13,8,0,31
12037000002,472,433,427,0,1,4,0,0,6
12117000021,5976,4693,3669,514,195,50,246,7,1024
12127000046,1433,1201,984,131,30,36,23,4,217
12101101103,3032,2299,1581,404,138,46,129,10,718
12101101031,5514,3770,2080,1049,363,71,256,12,1690
12101000049,6767,5561,4198,760,389,90,125,11,1363
12101000011,804,662,514,77,19,24,11,0,148
12101000188,2574,2105,1542,296,122,58,74,5,563
12101101023,0,0,0,0,0,0,0,0,0
12033000012,1494,1205,836,63,132,53,122,10,369
12101000077,6747,5329,4432,369,133,95,249,3,897
12127000129,8,5,5,0,0,0,0,0,0
12121000016,2595,1990,1682,148,82,42,16,3,308
12109000019,8929,6463,4973,751,342,149,261,23,1490
12109000075,3099,2121,1588,212,167,50,114,7,533
12109000077,1739,1189,863,155,81,18,67,0,326
12101000124,4731,3770,2708,676,242,118,77,5,1062
12101000144,5,4,3,0,0,1,0,0,1
12101000073,8257,6605,4874,863,543,152,198,13,1731
12033000242,3008,2435,1978,108,144,78,119,7,457
12033000201,847,623,378,42,168,16,24,1,245
12033000159,1771,1372,686,54,497,29,95,4,686
12033000202,2939,2592,2390,75,17,47,37,4,202
12033000265,2278,1758,1558,13,22,151,11,2,200
12033000200,1530,1173,698,78,248,43,82,7,475
12121000014,1672,1322,1040,187,55,31,13,4,282
12101000083,2068,1617,1196,254,87,53,19,2,421
12101000061,3252,2976,2608,189,36,41,65,5,368
12101000217,0,0,0,0,0,0,0,0,0
12103000294,2738,2284,2126,66,18,20,37,1,158
12103000299,1784,1510,1359,73,18,22,23,1,151
12103000185,1909,1589,1431,65,22,13,45,5,158
12103000197,3900,3308,2680,292,193,72,72,7,628
12103000268,1373,1177,928,143,60,23,38,0,249
12039000008,1320,1100,738,57,290,16,9,2,362
1201100Q072,4432,3168,1235,1543,173,25,172,6,1933
12081000224,571,367,113,209,47,0,0,1,254
1201100X006,4440,3463,757,1613,899,29,240,1,2706
1201100S006,2195,1799,949,559,193,26,66,4,850
12103000302,6400,5105,4386,354,116,101,134,7,719
12103000162,1747,1425,996,192,106,27,109,0,429
1201100V012,6119,4942,1445,2144,1262,81,142,6,3497
1201100A014,6345,5071,2073,1184,808,59,232,16,2998
12117000007,7464,5579,4029,470,300,42,708,6,1550
12117000064,2732,2142,1655,317,52,32,105,8,487
12069000113,4581,3657,2680,519,270,77,107,8,977
12039000031,1789,1455,352,161,930,16,2,0,1103
12039000004,336,284,218,11,44,9,1,0,66
12039000038,132,102,63,6,25,7,0,0,39
12039000027,1005,829,438,81,281,24,11,4,391
12101000129,3081,2777,2528,153,41,25,25,0,249
12101000163,3093,2660,2275,195,51,49,64,2,385
12101000123,2081,1805,1592,99,18,53,18,0,213
12039000006,678,525,52,7,468,3,0,1,473
12039000010,1211,1088,557,25,472,22,9,0,531
12039000007,787,579,73,9,490,8,0,2,506
12033000161,1145,809,342,54,362,24,27,7,467
12033000240,1128,935,712,46,126,22,22,2,223
12033000002,939,707,600,22,28,25,27,1,107
12033000143,664,509,282,54,128,22,23,5,227
12099000771,980,896,665,95,104,14,16,1,231
12099000411,2203,1774,1377,179,169,19,15,1,397
12099000878,710,555,186,179,149,3,30,0,369
12099000410,376,292,171,32,70,4,11,1,121
12099000504,3176,2874,2526,190,32,16,78,1,348
1201100X017,3757,3042,805,1534,594,20,138,4,2237
1201100X012,2103,1974,460,973,507,8,43,5,1514
12039000025,1165,914,88,94,724,8,6,0,826
12039000011,165,126,9,7,110,0,0,0,117
12117000070,6674,5363,4556,361,176,137,121,6,807
12117000017,3699,3099,2119,450,349,62,145,17,980
12117000036,8473,7197,4190,1776,871,149,321,11,3007
12117000063,2970,2381,1658,416,141,36,98,2,723
12117000025,3031,2343,1828,327,98,25,74,3,515
12011000010,1289,839,529,141,60,7,87,4,310
1201100V059,0,0,0,0,0,0,0,0,0
1201100D011,739,569,125,195,228,8,14,0,444
1201100T007,4467,3361,1193,1802,143,50,202,5,2168
1201100R005,1234,1202,991,121,21,6,41,0,211
1201100Q020,534,401,303,69,10,4,11,1,98
1201100Q031,2744,2594,2169,249,43,32,52,4,425
1201100R001,3385,3123,2232,525,156,34,116,1,891
1201100D003,2153,1946,1463,293,89,20,54,1,483
12103000203,3739,3037,2064,686,113,83,99,3,973
1201100J017,2837,2244,367,482,1309,19,97,3,1877
1201100E013,3317,2546,1230,656,463,24,159,8,1316
1201100E027,6182,4734,1759,1752,994,50,193,8,2975
1201100R036,1718,1551,1266,163,41,16,37,1,285
12039000002,1290,1011,550,196,230,24,19,1,461
12057000040,2844,2105,720,185,303,22,893,2,1385
12031000010,2582,1903,665,219,883,25,80,4,1238
12031000053,2224,1681,1329,109,121,33,81,4,352
12086000101,3719,2686,1415,1023,148,6,81,0,1271
12086004360,2380,1974,66,1888,24,15,11,1,1908
12086004361,1507,1286,109,1164,26,19,4,0,1177
1201100V014,2347,1868,430,1015,346,30,108,1,1438
12057000871,4616,3650,2247,544,565,95,217,3,1403
12021000052,2005,1956,1911,14,6,3,17,0,45
12057000963,109,81,41,32,1,4,2,1,40
12057000879,4909,3873,2100,861,655,74,238,10,1773
12009000228,1677,1303,947,114,169,25,55,1,356
12009000435,121,107,100,3,1,3,1,0,7
12009000440,88,68,29,5,10,3,20,0,39
12086000802,2585,2103,29,782,1307,10,12,3,2074
12086000746,1669,1388,502,796,67,8,19,3,886
12086000415,7530,6400,218,6117,146,17,31,3,6182
12105000534,1681,1479,1337,79,20,26,11,4,142
12105000219,3640,2735,1612,720,316,85,32,6,1123
12097000155,844,717,441,165,37,32,53,2,276
12007000002,1874,1682,790,114,756,10,9,4,892
12119000125,3518,3506,3359,63,23,20,31,1,147
12031000172,1907,1547,1131,91,243,35,49,11,416
12021000038,3447,2729,1493,1031,160,12,48,2,1236
12097000150,2149,1684,647,805,148,31,72,4,1037
12031000163,460,340,231,20,71,4,13,2,109
12031000133,2767,2001,586,125,1237,34,36,3,1415
12031000024,4132,3137,1923,278,421,52,471,16,1214
12031000141,3519,2628,438,74,2087,30,34,7,2190
12031000259,2815,2254,1183,259,247,34,535,12,1071
12031000193,1861,1494,232,53,1189,24,18,5,1262
12031000022,3590,2805,1752,275,512,55,234,10,1053
12057000501,2653,2077,1171,509,164,28,207,3,906
12057000854,2002,1842,860,297,690,5,11,3,982
12057000113,4002,3482,2373,634,246,54,188,6,1109
12057000833,3443,2803,1343,690,644,42,121,2,1460
12057000410,4550,3521,792,2113,364,48,220,12,2729
12057000414,7545,5953,991,4065,700,80,289,11,4962
12057000562,11556,10544,4447,1701,2642,126,1699,44,6097
1200300004C,2860,2113,1930,31,80,35,31,2,183
12057000129A,3111,2564,2113,265,33,25,100,1,451
12031000147,2100,1296,59,20,1216,4,3,1,1237
12031000023,2048,1739,1341,163,163,25,57,5,398
12031000262,3732,3213,2828,181,59,31,104,0,385
12031000084,4088,3206,1785,726,573,87,79,14,1421
12031000015,3560,2968,1219,501,1129,49,131,11,1749
12031000067,4022,2989,1417,520,721,74,265,8,1572
12021000136,2764,2655,2456,95,24,16,43,2,199
12086000736,6063,4883,135,4608,171,22,44,1,4748
12086000735,4389,3617,357,3120,131,27,74,0,3260
12086009810,3660,3199,208,2170,929,27,42,3,2991
12086009911,2355,2037,32,1987,71,0,7,0,2005
12031000013,3469,2583,946,536,941,63,133,6,1637
12031000191,3606,2714,943,297,1346,54,116,8,1771
12031000173,2087,1606,43,34,1514,12,12,3,1563
12031000199,4753,3474,836,344,2100,48,212,6,2638
12086000201,5259,4273,162,3814,279,35,160,2,4111
12086000350,2343,1959,114,1407,425,10,97,1,1845
12086005342,0,0,0,0,0,0,0,0,0
1208600534A,2888,2627,1195,920,240,25,167,1,1432
12086000036,5465,4958,2249,2207,276,55,168,9,2709
12086000450,3535,2788,295,2265,52,25,148,0,2493
12031000124,1716,1185,185,46,939,20,12,1,1000
12086000339,8390,7146,190,6873,293,14,28,4,6956
12086000756,2804,2191,650,1266,193,15,95,0,1541
12086000559,2559,2181,86,2037,53,18,29,1,2095
12086008431,0,0,0,0,0,0,0,0,0
12086008432,58,44,1,42,1,2,1,0,43
12086000844,13,9,2,7,0,0,0,0,7
12086007420,5386,4081,465,3119,272,37,208,4,3616
12086007421,0,0,0,0,0,0,0,0,0
12086000005,5733,4818,2323,1925,147,28,94,5,2495
12099000133,2697,2165,1592,235,146,38,142,4,573
12099000171,0,0,0,0,0,0,0,0,0
12099000205,1420,1095,226,260,526,7,89,0,869
1209900NP29,23,13,0,0,5,0,6,0,13
12099000212,1297,1188,877,94,181,12,30,0,311
12099000692,1722,1358,668,282,285,11,105,3,690
12085000065,3310,2678,1394,382,828,53,41,5,1284
12085000005,1881,1763,1637,85,12,12,14,0,126
12057000921,2370,2350,2126,106,58,17,31,4,224
12057000112A,2889,2207,1774,253,37,24,117,3,433
12057000529,4217,3201,2214,563,152,45,234,6,987
12099000300,2943,2286,1449,461,288,17,73,10,837
12099000662,3347,3168,2761,157,120,19,94,1,407
12099000078,1956,1513,1376,76,17,16,26,0,137
12099000080,74,58,54,2,0,2,0,0,4
12099000345,3567,2508,585,465,1134,26,303,6,1923
12099000346,605,435,109,121,167,3,40,1,326
12099000344,1008,748,270,363,94,15,27,3,478
1209900NP24,0,0,0,0,0,0,0,0,0
12085000001,3657,3208,2834,171,93,51,29,0,374
12099000342,3667,2708,464,779,1407,39,72,12,2244
12099000790,6212,5197,2100,1000,1959,53,159,9,3097
12086000766,5509,4367,343,3673,264,51,135,4,4024
12086000352,4653,3736,386,3125,165,23,88,3,3350
12086000232,3800,3127,88,2420,732,11,14,0,3039
12086000761,5408,4479,332,3832,218,23,149,3,4147
12086000139,2731,2127,120,540,1481,10,32,2,2007
12086000401,5028,4057,132,3786,122,27,95,1,3925
12086000443,4231,3628,112,3412,115,42,64,10,3516
12105000223,4486,4236,2796,998,264,97,39,4,1440
12086000327,6274,5087,90,4955,164,27,22,10,4997
12086000214,4088,3156,72,455,2641,30,21,4,3084
12099000681,2084,1651,865,368,317,23,82,8,786
12099000825,2709,2180,504,192,1454,8,33,4,1676
12099000450,2308,1811,1474,174,59,9,71,1,337
12057000404,1759,1385,752,418,159,20,62,5,633
12057000808,2597,1942,1369,289,189,40,77,2,573
12086007870,398,322,54,248,16,7,4,0,268
12086007871,18,17,0,15,2,0,0,0,17
12086000748,3804,3130,484,2491,105,51,79,5,2646
12099000715,1180,977,669,180,74,6,41,1,308
12099000517,73,39,17,7,9,5,4,0,22
12099000711,135,116,77,21,9,3,8,0,39
12099000187,1097,720,35,78,598,2,8,0,685
12099000197,272,220,83,29,91,2,17,0,137
12099000163,866,644,298,154,157,16,28,6,346
12113000003,1141,877,829,5,7,25,4,2,48
12031000041,3693,2918,2246,275,139,62,176,11,672
12057000551,2502,1979,1519,319,58,33,39,2,460
12091000065,3749,2833,2397,138,83,86,113,14,436
12103000301,4015,3193,2712,256,68,36,101,5,481
12103000113,1557,1322,995,117,125,35,42,1,327
12103000099,1791,1547,1227,100,161,25,20,5,320
12103000103,1981,1622,1269,140,132,19,62,0,353
12113000037,3294,2554,2232,89,54,77,76,1,322
12125000009,152,117,100,0,17,0,0,0,17
12031000014,4109,3250,1154,366,1578,69,123,12,2096
12035000219,0,0,0,0,0,0,0,0,0
12035000310,3055,2885,2524,112,144,28,74,0,361
12057000141A,1861,1567,1142,246,77,18,91,0,425
12057000119A,4297,2979,2344,382,66,38,136,2,635
12057000524,2516,2040,827,922,187,49,104,9,1213
12057000361,5020,4000,2499,637,467,75,365,18,1501
12057000053,3466,2717,1382,352,361,38,583,7,1335
12057000832,4968,3807,1761,963,819,64,239,8,2046
12057000705,1198,960,863,56,11,17,3,2,97
12086000222,3304,2625,39,356,2291,4,14,4,2586
12009000503,4556,3838,3028,317,188,62,226,6,810
12009000530,1306,1080,884,70,28,31,50,2,196
12113000018,6706,5138,4278,194,277,202,147,18,860
12111000086,3498,3112,2265,407,277,19,96,2,847
12099000649,21,18,10,6,0,0,0,0,8
12099000426,419,372,340,15,7,3,11,0,32
12099000663,2324,1817,1061,359,288,28,78,8,756
12009000107,2929,2459,1930,204,207,59,57,8,529
12086000542,0,0,0,0,0,0,0,0,0
12086006560,595,540,104,369,68,4,14,0,436
12086006550,52,40,6,19,12,1,0,0,34
12086006551,23,20,5,12,6,0,1,0,15
12086006561,673,663,16,585,99,4,2,1,647
12095000338,4309,3415,1699,1332,274,64,113,14,1716
12009000442,62,61,52,2,2,2,1,2,9
12086000306,4068,3424,425,2756,167,19,93,1,2999
12086000407,2234,1940,75,1845,22,6,12,1,1865
12099000635,6,2,1,1,1,0,0,0,1
12099000376,1828,1410,867,261,142,17,106,2,543
12086000319,2660,2221,79,2125,33,5,13,0,2142
12086000314,446,387,33,354,4,3,0,0,354
12009000317,9139,7894,5171,999,1002,112,625,34,2723
12083000088,1066,1047,989,21,23,8,1,1,58
120170102.1,1114,964,853,35,44,17,7,3,111
12057000767,4681,3485,1848,1253,269,86,56,4,1637
12057000454,4574,3697,1022,2134,523,50,90,4,2675
12099000059,318,282,262,4,3,0,6,0,20
12099000153,1562,1303,1071,98,27,12,81,0,232
12099000NP6,0,0,0,0,0,0,0,0,0
120170102.2,237,195,99,9,85,1,1,1,96
12086000950,0,0,0,0,0,0,0,0,0
12086000002,3109,2616,1306,1138,54,7,73,1,1310
12083000057,4361,3463,2382,784,206,88,25,3,1081
12099000006,0,0,0,0,0,0,0,0,0
12099000747,1731,1629,1500,59,35,10,16,1,129
12099000265,4005,3185,1022,1822,269,45,74,1,2163
12009000431,2101,1748,1401,155,90,31,80,1,347
1209500311A,2664,2210,1283,688,120,45,121,5,927
12009000128,10,7,5,0,0,0,2,0,2
12095000117,5904,4917,2255,1862,352,77,345,39,2662
12111000035,3329,2545,1299,646,500,48,58,8,1246
12103000134,3173,2581,1764,393,165,62,192,6,817
12049000008,747,542,46,171,321,13,5,4,496
12091000003,2244,1750,1501,52,84,70,32,0,249
12115000014,3084,2541,1985,335,72,51,62,11,556
12115000109,0,0,0,0,0,0,0,0,0
12095000118,4480,3832,2184,965,209,42,394,15,1648
12099000686,3719,2752,1164,497,843,22,201,2,1588
12019011002,1643,1093,700,123,207,27,43,5,393
12041000003,617,425,234,57,125,3,6,0,191
12041000008,2263,1818,1658,75,13,62,9,1,160
12065000016,207,169,85,4,76,5,2,0,84
12019020801,2281,1869,1299,208,255,31,66,8,570
12019020800,54,41,22,5,2,3,9,1,19
12057000516,3213,2659,1566,768,200,29,127,1,1093
12057000534,4137,3382,1687,1083,493,60,121,6,1695
12057000581,4629,3749,1902,1023,681,90,130,10,1847
12073001304,4,4,0,0,0,3,0,0,4
12019071001,821,797,730,12,45,8,5,0,67
12063000024,1068,855,699,32,103,17,4,0,156
12019050600,1799,1479,1345,43,28,31,17,2,134
12015000078,2115,1832,1463,145,167,19,36,5,369
12015000106,6556,5648,4430,369,612,77,155,8,1218
12015000013,1922,1539,1079,265,140,42,32,5,460
12015000002,962,906,829,33,8,16,9,0,77
12071000065A,0,0,0,0,0,0,0,0,0
12049000009,3144,2323,1509,695,36,55,36,1,814
12103000075,3035,2980,2676,105,77,29,79,1,304
12029000003,333,261,244,3,7,2,3,0,17
12099000222,2830,2021,429,948,599,62,68,3,1592
12099000227,369,277,65,44,163,4,5,0,212
12099000605,1041,803,672,90,19,0,13,0,131
12071000294,0,0,0,0,0,0,0,0,0
12103000209,2422,2152,1887,122,60,40,29,3,265
12029000006,1798,1408,1314,46,20,14,10,1,94
120170300.1,757,646,591,19,4,20,7,1,55
12099000408,1524,1467,1171,168,78,16,26,6,296
12099000784,1686,1575,1244,167,127,15,29,2,331
12099000568,918,904,754,90,29,7,9,7,150
12099000770,4000,3004,358,416,2233,45,35,2,2646
12099000077,808,654,603,38,4,3,6,0,51
12099000090,495,376,187,170,4,27,7,1,189
12099000098,3774,2938,1703,1087,73,86,61,1,1235
12099000117,1662,1587,1473,76,10,5,20,3,114
12103000153,2603,2099,1400,275,124,63,248,9,699
12081000144,5888,3898,777,2518,568,95,28,1,3121
12081000050,883,706,371,259,51,27,7,1,335
12133000017,542,429,239,11,146,30,2,2,190
12127000186,0,0,0,0,0,0,0,0,0
12033000216,775,620,524,41,27,19,9,0,96
12033000264,874,699,597,13,24,51,3,0,102
12081000095,533,402,118,256,18,13,5,0,284
12073005113,0,0,0,0,0,0,0,0,0
12073004153,2400,2057,1714,76,170,22,85,3,343
12073004115,0,0,0,0,0,0,0,0,0
12073004154,212,174,77,4,93,2,1,0,97
12073005212,318,245,170,6,32,3,31,1,75
12073004155,19,19,0,2,13,3,2,0,19
12073004111,17,11,0,3,5,1,3,0,11
12073005228,101,83,40,9,7,6,21,0,43
12133000018,1143,938,845,25,16,22,21,2,93
12133000019,1256,1051,973,24,14,28,9,1,78
12069000014,1740,1428,1159,133,72,33,17,2,269
12041000001,1832,1364,1114,107,97,34,14,5,250
12069000110,1379,1301,1186,53,24,15,25,1,115
12069000086,3450,2901,2523,175,86,42,35,6,378
1213300005B,154,129,122,2,5,2,0,0,7
12133000027,159,114,92,1,17,4,1,0,22
12117000034,10161,8080,3352,2892,1587,137,335,24,4728
12115000086,1653,1626,1548,44,4,14,12,0,78
12073005284,2295,1810,1379,76,245,28,76,2,431
12033000139,382,248,31,12,196,15,3,0,217
12033000031,2485,1918,1139,123,500,56,78,8,779
12081000137,2511,2164,1800,249,64,19,35,0,364
12081000060,1092,876,734,55,26,21,23,6,142
12059000003,1350,1109,1026,22,10,49,7,0,83
12081000211,3119,2841,2587,81,34,12,104,1,254
12069000125,1328,1282,1134,61,65,15,18,0,148
1201100E002,5124,3863,1015,1219,1414,64,180,12,2848
12081000187,989,910,831,37,11,19,15,0,79
12127000144,351,263,94,16,139,9,3,0,169
12081000089,2201,1733,1058,377,231,49,30,2,675
12081000027,751,642,586,25,8,8,12,1,56
12081000249,974,898,834,25,16,18,4,0,64
12081000154,968,907,857,21,9,6,10,0,50
12103000173,1492,1189,1037,74,18,9,46,0,152
12103000227,1818,1700,1561,59,20,15,25,2,139
1201100Z005,2345,1708,198,1178,275,67,64,2,1510
12087000015,2019,1782,1532,142,28,28,22,6,250
12101000203,4201,3468,2402,642,227,60,110,2,1066
12117000042,3892,3358,2015,891,306,64,133,6,1343
1201100N028,2358,1828,916,415,352,14,146,3,912
1201100N016,2452,1899,1020,433,244,16,178,4,879
12103000229,2241,2120,1951,84,18,36,17,6,169
12033000033,1463,1255,755,71,278,23,118,3,500
1201100T026,3456,2597,1522,622,203,27,235,1,1075
1201100J009,2300,2088,729,633,702,14,49,1,1359
12086000711,5799,4910,572,3999,260,41,131,0,4338
12086000047,579,498,380,59,12,1,23,0,118
12086000569,7739,6765,1755,4534,132,38,153,5,5010
12081000059,2017,1657,1466,88,21,44,32,3,191
12103000286,0,0,0,0,0,0,0,0,0
1201100K006,2715,2100,133,167,1800,6,13,3,1967
1201100C022,2194,1906,1412,264,133,28,28,1,494
1201100Q030,3457,3223,2665,352,85,26,44,3,558
1201100M011,1582,1255,376,395,414,13,76,1,879
12103000095,681,631,547,39,21,14,9,1,84
12103000033,2213,1956,1553,140,124,59,77,2,403
12077000002,365,282,194,3,74,12,0,1,88
1201100E029,2695,1942,405,535,894,8,113,10,1537
1201100V003,3178,2756,1434,875,344,49,82,2,1322
12103000324,2708,2169,1549,171,285,51,116,4,620
12103000337,4433,3812,3012,450,163,48,121,11,800
12033000257,270,202,46,4,148,3,1,0,156
12103000220,2437,2304,2082,88,65,22,20,2,222
1209500311B,1037,813,307,331,83,18,91,2,506
1209500312A,3006,2441,1124,849,226,33,231,7,1317
12095000535,6905,5779,2556,1829,719,80,670,21,3223
1209500439Z,0,0,0,0,0,0,0,0,0
12117000032,3394,2652,1627,549,269,71,194,10,1025
1201100X050,2772,2231,291,985,848,38,186,5,1940
1201100X042,3525,2722,502,1451,498,32,334,4,2220
12099000297,1807,1346,315,705,267,15,49,2,1031
1201100X013,3870,3111,852,1536,595,29,161,0,2259
1201100R058,1601,1385,954,221,150,17,26,1,431
1201100P004,1750,1670,1206,276,137,24,30,2,464
1201100T008,3135,2398,985,991,246,40,172,3,1413
1201100V019,2686,2077,268,728,1101,30,28,5,1809
1201100R020,1515,1346,906,284,68,15,38,6,440
1201100V002,6670,6228,4316,1436,225,34,142,3,1912
1201100M020,5976,4641,1126,1842,1465,49,286,8,3515
12011000023,3315,2409,716,660,704,31,316,9,1693
1201100X049,532,426,74,237,96,6,30,1,352
1201100X004,2277,1818,386,1110,269,31,94,5,1432
1201100X005,2303,1847,827,706,265,16,55,1,1020
12099000791,1579,1382,930,302,77,32,49,1,452
12035000181,1109,971,662,95,150,23,48,2,309
1201100Q063,2545,1900,587,1124,100,43,72,2,1313
1201100N020,2717,2096,1177,452,335,46,111,5,919
12099000428,2237,2058,1565,225,182,12,50,2,493
12041000009,1694,1320,1172,65,13,39,12,3,148
1201100R042,1108,935,658,155,85,25,43,3,277
1201100T022,1101,872,460,225,54,10,131,3,412
1201100C016,4900,4162,2923,646,371,43,99,8,1239
1201100R011,1932,1652,1223,248,76,17,44,1,429
1201100C017,1482,1269,989,181,37,19,36,0,280
1201100E025,2503,1826,568,492,653,29,96,3,1258
1201100Q041,6247,4448,2575,797,416,53,448,8,1873
1201100T009,7560,5677,922,3242,1288,50,393,9,4755
12039000001,644,521,176,59,281,3,3,1,345
12091000058,3648,2818,2275,156,116,84,184,7,543
12021000007,3692,3372,2867,302,119,14,49,7,505
12009000224,6772,5323,3774,460,740,139,220,14,1549
12009000439,0,0,0,0,0,0,0,0,0
12009000438,0,0,0,0,0,0,0,0,0
12021000079,2831,2439,2083,196,60,25,53,3,356
12021000037,834,746,594,96,30,8,26,1,152
12021000031,1250,1172,1070,49,6,7,27,0,102
12073005107,568,499,410,33,37,5,10,1,89
12073003401,1863,1563,1195,88,165,21,91,4,368
12057000099,3717,2595,1032,719,695,111,151,9,1563
12057000968,5339,3883,1032,1495,1203,70,199,9,2851
12057000641,4242,3335,1197,584,1051,34,517,13,2138
12057000514,2050,1748,1288,289,106,10,45,4,460
12057000629,5515,4238,2302,725,932,135,245,7,1936
12086000302,2711,2161,273,1853,35,22,13,1,1888
12086000384,4301,3594,82,3476,70,20,24,3,3512
12086000359,4730,3840,71,3745,87,13,24,7,3769
12086000428,2882,2473,164,2266,44,12,35,4,2309
12086000500,2471,2078,135,1913,50,8,22,0,1943
12057000434,7459,5993,3113,1326,611,112,793,13,2880
12086000004,5784,4629,1980,2142,186,42,111,3,2649
12086000432,2880,2417,213,2168,40,12,15,0,2204
12086000128,4823,3664,118,756,2761,40,109,5,3546
12086000317,2458,2074,119,1950,11,2,5,2,1955
12086000538,12352,11148,3467,6129,930,117,420,20,7681
12086000767,4310,3544,250,2944,257,28,121,2,3294
12083000104,975,846,709,73,36,17,7,6,137
12086009840,7852,7223,2477,3593,600,68,390,4,4746
12086009841,997,943,222,579,76,12,49,0,721
12086006581,1409,1407,291,570,615,0,0,0,1116
12086009821,54,47,4,32,11,6,6,2,43
12086000308,1997,1641,256,1336,11,8,41,0,1385
12086000119,3475,2432,923,489,856,23,174,2,1509
12086000983,1487,1349,624,564,45,13,80,4,725
12086006592,23,8,0,4,2,2,1,0,8
12031000156,2856,2257,797,114,1293,19,55,4,1460
12031000077,11143,9606,5078,1045,1680,132,1709,17,4528
12031000227,2295,1781,1056,107,481,24,104,5,725
12086000355,8027,6310,243,5526,669,56,105,4,6067
12086000301,2319,1837,287,1513,35,12,4,0,1550
12086000247,2606,2140,63,1702,489,28,7,0,2077
12086000155,2134,1682,494,721,394,12,70,2,1188
12086000253,2091,1776,33,418,1353,6,4,2,1743
12086000630,2108,1579,691,740,53,13,84,2,888
12083000024,449,369,162,37,156,8,4,2,207
12097000113,7884,6096,1493,3396,536,99,624,11,4603
12031000294,2231,1890,1508,136,104,29,105,8,382
12031000159,1367,965,143,40,776,5,7,2,822
12031000152,1910,1397,50,24,1318,16,10,1,1347
12086000631,1094,836,410,353,12,0,50,2,426
12086000510,2191,1814,41,1735,47,14,34,4,1773
12099000336,2445,1751,460,949,298,111,43,5,1291
12099000869,3544,2552,495,1580,416,102,58,8,2057
12099000330,1965,1527,392,933,180,48,40,0,1135
12099000056,22,18,7,3,8,0,0,0,11
12086000187,356,276,23,51,188,3,10,1,253
12086000020,3345,2941,1013,1661,121,23,73,6,1928
12086000444,4349,3674,90,3521,58,15,25,3,3584
12031000075,4551,3348,1350,794,917,103,274,15,1998
12086000320,6520,5491,135,5314,130,19,21,3,5356
12099000127,1226,1187,1075,48,18,6,33,1,112
12095000211,3373,2556,445,362,1636,33,99,4,2111
12031000165,2053,1662,656,98,842,35,39,4,1006
1209500612A,2627,1948,405,692,563,23,96,5,1543
12099000546,723,655,545,66,24,4,4,0,110
12099000547,461,368,320,26,10,0,12,0,48
12099000799,1791,1747,1645,41,22,1,29,0,102
12099000492,2885,2354,1280,606,196,14,128,3,1074
12099000424,2124,1960,1593,206,73,20,58,7,367
12027000005,536,368,30,48,287,1,2,2,338
12031000254,3355,2839,2378,130,239,34,62,5,461
12041000002,1560,1353,848,141,336,19,13,1,505
12099000618,5697,4339,1444,1163,659,21,209,2,2895
12099000543,1485,1342,950,165,174,10,56,1,392
12099000374,2761,2078,1292,356,269,39,138,4,786
12099000174,1740,1330,545,332,330,29,89,0,785
12099000175,449,359,207,84,63,4,18,1,152
12099000186,0,0,0,0,0,0,0,0,0
12099000198,0,0,0,0,0,0,0,0,0
12099000278,1554,1287,459,715,86,31,22,6,828
12099000325,1212,929,210,631,70,4,28,1,719
12099000864,418,319,52,220,48,7,3,1,267
12099000865,626,436,63,347,26,13,5,0,373
12099000674,1032,697,365,205,58,7,64,3,332
12099000569,2030,1979,1653,200,83,6,37,1,326
12099000772,2936,2225,338,150,1718,17,19,2,1887
12099000395,3353,2902,2002,408,399,13,94,0,900
12095000619,4718,3568,660,549,1997,42,285,7,2908
12099000313,3545,2877,1788,893,130,34,55,5,1089
12099000463,2937,2429,2155,157,36,3,53,3,274
12099000593,2176,2137,1664,296,85,10,58,3,473
12099000595,2421,2386,1900,281,108,14,48,4,486
12099000377,1883,1816,1619,99,57,19,26,4,197
12099000500,2859,2567,1651,422,315,27,108,1,916
12083000083,1886,1591,1305,112,113,32,27,5,286
12099000722,3229,2488,1241,746,400,26,88,2,1247
12099000455,2384,2208,1985,137,29,15,26,2,223
12031000200,3174,2336,744,270,1120,56,188,8,1592
12031000270,7100,5327,1842,894,2246,101,334,23,3485
12031000071,3928,3185,1835,513,493,53,316,14,1350
12099000523,763,760,701,26,27,2,2,0,59
12099000763,177,146,54,16,72,4,7,1,92
12099000067,1444,1369,1241,66,20,10,31,0,128
12099000375,3107,2360,1373,418,375,16,181,4,987
12095000541,4002,3266,1595,940,492,64,262,5,1671
12099000590,2401,1799,1272,216,101,3,132,0,527
12099000591,2024,1604,1104,323,86,19,66,2,500
12099000587,2481,1863,1144,336,120,12,162,4,719
12099000588,2856,2351,1552,405,203,19,120,0,799
12057000863,1332,1179,731,311,119,22,14,0,448
12113000025,5161,3973,3413,196,75,119,134,20,560
12073001315,599,516,110,38,363,8,2,1,406
12099000435,127,111,64,27,21,1,7,0,47
12099000584,1765,1653,1520,51,25,2,37,0,133
12099000575,959,912,846,28,14,2,17,0,66
12099000382,1678,1328,821,215,197,30,65,3,507
12099000530,1113,1113,1056,24,16,3,12,0,57
12099000538,1432,1428,1366,17,10,2,21,0,62
12095000413,5621,3975,1723,1352,452,77,426,18,2252
12073003477,799,637,353,29,227,20,5,0,284
12073003461,2429,1914,1446,81,319,34,33,3,468
12057000802,2891,2219,1433,394,273,60,56,2,786
12115000040,1443,1201,658,304,228,23,11,0,543
12115000069,4979,4058,3266,549,77,61,74,8,792
12073005154,926,706,504,66,86,7,26,6,202
12019011202,1990,1291,711,198,308,40,54,6,580
1209500342Z,0,0,0,0,0,0,0,0,0
12103000108,2471,2041,1740,143,43,39,59,3,301
12115000099,2839,2717,2458,125,55,26,41,1,259
1209500404B,1400,1036,409,348,173,22,105,1,627
1209500404A,3999,2942,1110,1006,472,61,360,5,1832
12095000405,200,172,118,34,7,15,1,0,54
12015000050,1856,1792,1685,33,15,13,26,3,107
12073001213,0,0,0,0,0,0,0,0,0
12023000001,3199,2526,2116,173,145,63,37,6,410
12115000044,3941,3445,2761,377,156,35,100,3,684
12115000015,1332,1056,717,230,59,13,17,0,339
12057000101B,1251,921,448,181,255,25,35,0,473
12057000104,3,2,1,0,0,0,0,0,1
12033000180,1535,1221,1061,44,33,24,50,0,160
12127000194,3250,2716,2370,116,74,57,70,1,346
12071000106A,0,0,0,0,0,0,0,0,0
12033000192,1647,1395,1222,62,29,31,44,1,173
12033000158,491,379,193,20,133,8,15,3,186
12033000078,2119,1737,1278,90,242,78,52,17,459
12033000182,0,0,0,0,0,0,0,0,0
12033000042,651,580,479,35,49,16,5,0,101
12081000189,2492,2072,1706,185,67,22,77,1,366
12033000085,429,406,363,3,12,7,22,0,43
12033000238,423,344,217,44,31,8,39,0,127
12033000054,78,64,52,5,3,2,5,0,12
12033000146,2116,1517,361,97,987,33,49,12,1156
12099000730,2039,1539,751,460,253,9,75,0,788
12033000050,1977,1632,1188,60,258,74,45,4,444
12081000218,3051,2815,2493,92,72,21,94,1,322
12127000155,1924,1741,103,58,1552,34,13,1,1638
12081000119,666,644,584,28,15,8,12,0,60
12033000001,1488,1242,980,80,67,29,68,1,262
12081000152,1055,891,751,72,25,17,20,3,140
12033000205,968,774,534,42,130,18,47,7,240
12033000021,2715,2066,1262,95,431,95,171,16,804
12117000029,5997,4758,2281,1482,768,94,241,13,2477
12117000035,4846,3855,1633,1273,821,62,149,5,2222
12087000004,1650,1440,745,204,437,26,73,1,695
12127000022,2474,2088,1846,97,56,40,14,2,242
12127000147,2819,2623,2435,78,52,24,27,3,188
12033000132,88,69,19,6,46,0,0,1,50
12033000142,971,758,473,43,194,39,10,1,285
12127000239,69,63,52,7,0,2,2,0,11
12033000250,1855,1444,1216,38,87,36,50,5,228
12033000006,3934,3015,2071,215,408,116,224,26,944
12033000126,803,674,335,17,295,13,18,1,339
12081000138,1496,1309,890,188,151,10,59,1,419
12081000174,1215,897,269,461,156,28,9,2,628
12129000011,2133,1728,1339,48,266,55,21,0,389
12109000048,2290,2079,1938,72,14,24,22,1,141
12101000197,2428,1926,1660,141,42,55,23,2,266
12101000152,3866,3170,2651,246,82,59,107,4,519
12069000083,1459,1430,1317,57,25,19,10,0,113
1201100F008,3854,3176,1557,722,591,40,149,2,1619
1201100W025,6187,4705,210,987,3445,39,172,7,4495
12103000187,2142,1732,1507,104,38,23,45,2,225
12039000034,1223,985,252,91,640,9,0,0,733
1201100U002,1941,1534,782,573,77,16,93,4,752
1201100P005,1249,1169,925,132,57,7,34,1,244
1201100E018,1404,1122,658,203,129,14,104,0,464
1201100R061,1627,1347,805,338,133,29,38,6,542
12039000032,546,434,34,33,366,12,0,0,400
12039000041,189,139,10,3,125,1,0,0,129
12033000095,1311,937,513,66,296,28,34,3,424
12033000199,90,73,36,8,20,3,2,5,37
12099000115,709,602,511,49,18,9,17,3,91
12099000573,2311,2294,1842,269,107,16,39,5,452
12099000574,2234,2215,1816,222,115,8,28,4,399
12109000044,1453,1295,885,101,277,17,21,3,410
1201100C001,4306,4017,3336,439,88,38,63,0,681
12011000004,8590,6617,665,3252,2017,55,716,11,5952
1201100W022,18,11,0,8,0,2,3,0,11
1201100M013,3593,2770,616,1007,1053,61,132,11,2154
12099000570,890,864,744,61,30,11,17,4,120
12099000750,1366,1064,748,196,79,7,38,3,316
12099000749,6126,4166,1780,815,766,55,749,13,2386
12099000034,0,0,0,0,0,0,0,0,0
1201100D013,2576,2002,594,293,1071,21,46,2,1408
1201100R012,1887,1757,1499,163,37,11,38,2,258
12103000025,1386,1343,1008,153,102,22,67,0,335
12103000084,1271,1183,1003,38,78,30,17,2,180
1201100Y005,3581,3194,1805,1124,129,27,77,2,1389
1201100Y004,5076,4424,2723,1321,195,23,127,8,1701
1201100C036,1770,1312,153,526,533,24,35,1,1159
1201100N027,620,520,354,69,66,6,14,1,166
1201100N029,3970,3163,1923,739,339,37,151,10,1240
1201100Q043,2841,2100,1348,336,167,8,178,1,752
12031000184,867,656,293,70,247,33,31,0,363
12057000523,5653,4548,2159,1438,412,69,525,10,2389
12043000003,487,349,182,94,64,8,3,0,167
12007000008,2798,2647,1135,307,1192,14,7,3,1512
12043000002,584,509,456,34,2,7,5,0,53
12105000113,3029,2230,1711,376,67,78,28,4,519
12021000030,1669,1428,1240,95,27,10,47,0,188
12021000143,2738,2616,2403,116,19,16,37,0,213
12021000077,3935,3258,1623,1279,248,34,99,6,1635
12031000203,2900,2212,1281,233,542,79,112,7,931
12031000230,1972,1573,1273,89,147,30,19,4,300
12057000109A,3116,2541,1975,299,112,24,104,5,566
12057000353,5853,5813,3292,1049,696,10,478,8,2521
12027000008,1192,1020,492,489,14,26,5,0,528
12031000286,2325,2125,1690,116,195,32,80,8,435
12021000002,2566,2376,2025,216,73,24,34,1,351
12031000146,2061,1649,79,33,1526,10,7,1,1570
12086000805,5832,4781,470,3945,305,50,138,11,4311
12086000937,535,278,0,278,1,1,1,0,278
12086000651,903,784,158,596,13,2,19,1,626
12086000775,4568,3806,263,3274,187,15,144,2,3543
12031000261,2456,1897,1560,120,55,15,139,1,337
12086000291,3921,3232,56,2105,1172,37,9,4,3176
12086000732,3380,2841,94,2699,80,22,28,0,2747
12086000772,5024,4165,160,3924,75,16,57,1,4005
12086000633,4235,3667,548,2922,147,43,93,3,3119
12086000562,10,10,0,7,2,0,1,0,10
12086000668,0,0,0,0,0,0,0,0,0
12086000996,6605,6072,2558,2511,333,42,399,12,3514
12086000ZZZ,0,0,0,0,0,0,0,0,0
12086001611,67,50,3,30,18,4,1,1,47
12099000245,21,17,15,1,1,0,0,0,2
12099000419,1689,1391,891,166,228,19,76,6,500
12099000720,3566,2835,1860,613,202,41,117,3,975
12099000301,2993,2291,1485,490,211,29,62,1,806
12099000789,2698,2135,293,239,1531,10,52,13,1842
12099000037,112,93,76,9,0,3,1,0,17
12099000343,5354,3894,575,899,2315,56,122,9,3319
12086000367,4040,3308,129,3108,84,36,42,1,3179
12086000504,2743,2418,1120,1038,182,27,57,0,1298
12099000039,0,0,0,0,0,0,0,0,0
12099000798,105,94,93,0,0,0,1,0,1
12099000062,2212,1610,1317,123,44,18,78,8,293
12086000821,4605,3636,1353,1795,370,56,136,4,2283
12099000285,2273,1748,471,1038,219,64,32,0,1277
12086000399,1733,1319,68,1187,21,13,47,2,1251
12086000124,7293,6089,2345,3100,274,42,192,7,3744
12099000777,2142,1428,102,117,1210,21,4,1,1326
12113000041,3968,3028,2519,189,113,66,130,5,509
12031000102,3778,3147,2590,154,186,52,142,2,557
12035720000,982,940,859,24,30,15,9,0,81
12035710000,992,923,842,24,29,8,11,0,81
12057000925,1217,1207,1077,54,24,21,21,3,130
12031000245,5371,3993,1898,617,1256,102,166,13,2095
12035000200,297,250,182,20,29,7,13,0,68
12031000092,5562,4618,2821,638,826,114,179,14,1797
12057000373,0,0,0,0,0,0,0,0,0
12057000366,813,611,200,125,166,10,108,0,411
12057000461,2025,1598,396,1003,159,19,62,3,1202
12099000582,749,696,599,53,10,6,17,0,97
12035000191,4808,3899,2612,521,554,104,136,7,1287
12035810000,5739,4305,3140,433,512,96,116,3,1165
12086000889,1691,1282,92,813,379,11,27,3,1190
1209500542B,4461,3311,1380,905,623,36,387,11,1931
1209500542A,2083,1612,750,510,208,36,121,9,862
12086000372,1922,1551,98,1384,71,13,32,1,1453
12086000587,3076,2568,1504,852,87,23,92,7,1064
12086000116,1543,1036,549,223,214,16,42,1,487
12099000366,3982,2838,697,807,1185,65,132,9,2141
12027000002,1578,1196,825,311,25,21,2,0,371
12099000217,2348,2147,1720,208,123,21,81,7,427
12099000269,4675,3615,1317,1079,1035,21,158,0,2298
12099000550,1133,1126,1101,17,6,6,1,2,25
12086000207,6701,5294,647,1619,2884,60,227,18,4647
12099000755,576,528,441,29,33,2,29,0,87
12099000758,1207,697,16,53,642,6,6,0,681
12099000760,2247,1629,155,170,1280,33,31,4,1474
1209900NP34,0,0,0,0,0,0,0,0,0
12099000510,1401,1301,1142,77,10,9,31,3,159
12095000122,5249,4034,1207,1840,424,69,441,18,2827
12103000107,2951,2516,2127,136,111,48,77,4,389
12099000236,1878,1446,312,483,613,22,36,4,1134
12099000264,1731,1288,269,845,165,18,31,7,1019
12099000218,2172,2135,1401,368,298,12,51,5,734
12065000015,761,633,508,20,93,5,5,1,125
12073001507,7473,7365,4913,1053,950,96,375,4,2452
12103000232,1567,1476,1327,67,23,21,26,7,149
12103000231,2020,1937,1733,104,24,25,33,1,204
12007000014,2399,1994,1739,43,144,44,15,2,255
12071000062A,0,0,0,0,0,0,0,0,0
12115000083,3425,3063,2672,211,45,27,87,3,391
12099000168,1656,1250,529,353,123,22,221,6,721
12031000006,5668,4456,2127,538,1507,60,264,14,2329
12099000128,371,326,276,26,3,1,15,3,50
12071000077B,0,0,0,0,0,0,0,0,0
12099000779,5145,3648,750,1465,1394,146,48,4,2898
12099000392,2967,2455,1350,490,469,22,89,4,1105
12099000390,399,307,125,61,65,10,49,0,182
12099000372,1158,1012,656,151,165,3,25,0,356
12099000293,17,14,2,11,0,1,0,0,12
12081000038,1272,924,227,475,215,10,7,0,697
12033000027,803,751,334,187,239,7,10,4,417
12033000040,552,417,268,32,78,20,18,3,149
12127000019,51,37,15,12,0,6,1,0,22
12081000068,134,113,73,22,18,1,0,0,40
12073009000,0,0,0,0,0,0,0,0,0
12081000147,1025,991,893,43,10,24,16,1,98
12087000031,2544,2085,1057,867,110,28,16,1,1028
12115000054,4398,3762,3428,150,45,35,82,2,334
12069000094,1488,1472,1382,34,25,15,17,0,90
12033000131,131,119,59,1,55,4,0,0,60
12133000024,314,240,215,11,6,4,0,0,25
12115000102,743,716,683,17,2,7,2,0,33
12015000040,2473,2373,2217,70,30,22,18,0,156
12033000115,1160,1036,633,49,306,10,27,1,403
12099000216,2723,2297,1153,461,537,13,121,2,1144
12081000036,1184,1160,1112,19,11,14,2,2,48
1201100E026,2006,1498,685,328,322,25,155,0,813
1201100V051,2284,2047,823,885,244,15,113,0,1224
12097000571,184,121,7,96,23,4,4,0,114
12127000024,147,125,100,16,3,5,0,0,25
12117000002,5634,4134,2896,392,284,65,505,10,1238
12127000089,4528,3595,1539,1519,470,109,108,7,2056
1201100R062,1766,1304,54,85,1174,10,8,2,1250
12103000331,3260,2704,2159,295,103,48,101,5,545
12103000056,1727,1405,1095,126,58,45,75,4,310
12051000017,762,591,309,273,2,5,2,1,282
12033000219,1754,1409,972,100,244,42,53,1,437
12103000263,2885,2702,2458,123,23,15,61,2,244
1201100V026,2786,2231,767,1066,359,32,65,5,1464
1201100T006,911,742,500,143,43,8,55,3,242
1201100C004,2124,2036,1708,181,39,13,52,1,328
12101000147,825,744,672,40,16,13,6,0,72
12086000113,1513,1491,502,880,79,7,29,0,989
12101000201,4107,3220,2755,236,93,48,90,15,465
12101000058,5974,4892,3771,610,304,101,98,7,1121
12081000209,3600,2802,2014,373,219,33,153,9,788
12081000234,1807,1733,1567,82,41,21,21,1,166
12081000248,0,0,0,0,0,0,0,0,0
12103000085,1090,1013,854,64,41,41,18,1,159
12103000363,797,714,623,39,32,10,6,0,91
12035000190,1410,1140,738,162,162,25,47,1,402
12101000035,80,71,51,7,7,1,6,0,20
12101104022,227,188,151,23,10,3,3,1,37
12101000034,147,130,102,21,6,1,1,0,28
12101103022,53,48,39,4,4,0,0,0,9
12101105022,85,61,45,7,8,0,0,0,16
12101102022,6,6,6,0,0,0,0,0,0
12103000012,1572,1319,434,72,766,23,28,0,885
12103000022,2309,1703,169,46,1479,27,8,1,1534
12033000017,2437,1892,1187,152,382,72,111,5,705
1201100A013,5401,4384,2372,868,482,42,269,5,2012
1201100M032,2777,2165,323,976,819,17,78,18,1842
12099000146,127,107,92,9,5,0,1,1,15
1201100X031,5350,5096,1168,3172,661,21,149,8,3928
1201100T023,5539,4822,1882,1836,793,74,314,18,2940
1201100K010,1146,1003,171,133,680,5,26,8,832
1201100W015,2005,1505,317,735,341,13,156,3,1188
1201100V035,1318,1154,536,413,165,11,60,0,618
1201100V010,1305,1154,485,447,180,10,48,2,669
1201100N013,1857,1504,642,332,418,31,104,2,862
1201100L019,1035,759,26,71,656,13,18,2,733
12127000226,0,0,0,0,0,0,0,0,0
1201100J005,3730,3059,759,1184,1012,29,132,13,2300
1201100K007,4209,2984,31,71,2860,7,52,0,2953
1201100D012,1121,860,119,132,549,8,34,0,741
12101000074,1610,1286,946,168,115,44,25,4,340
12021000087,1029,946,920,13,3,3,1,1,26
12021000139,1373,932,756,93,17,8,46,1,176
12021000137,850,813,755,19,10,8,21,0,58
12021000006,936,868,802,49,4,0,6,0,66
12021000074,2320,1760,722,835,141,22,52,3,1038
12085000012,2112,1792,1608,92,17,22,37,0,184
12073004157,835,671,426,33,187,9,13,1,245
12073003103,2100,1797,1479,89,141,26,50,1,318
12061000037,0,0,0,0,0,0,0,0,0
1201100T010,4359,3361,2357,695,143,40,142,3,1004
1201100X041,3035,2328,497,1211,510,24,153,11,1831
12057000810,3235,2528,1669,489,246,37,106,1,859
12057000809,354,269,203,33,22,7,6,1,66
12086000449,2448,2011,110,1879,24,10,10,0,1901
12086000011,3903,3154,753,2118,215,32,86,3,2401
12086000897,4405,3269,683,2026,566,39,83,1,2586
12086000452,6045,4576,323,3902,176,45,171,4,4253
12086000892,499,369,11,332,22,6,5,0,358
12086000949,6228,4418,169,3384,972,75,48,7,4249
12086000048,4436,3869,2201,1267,148,23,158,9,1668
12086000740,3515,2895,203,2503,146,15,51,0,2692
12086000305,5207,4375,540,3576,237,24,83,4,3835
12086004131,454,394,20,367,7,0,9,0,374
12086009871,301,265,4,250,17,2,0,0,261
12086000990,0,0,0,0,0,0,0,0,0
12086009870,0,0,0,0,0,0,0,0,0
12086000670,6973,5855,173,5610,161,52,42,3,5682
12086000118,2287,1750,412,482,715,21,132,1,1338
12031000216,88,66,53,8,4,1,1,0,13
12086000517,2721,2375,399,1278,674,20,74,2,1976
12031000206,4885,4067,2052,712,1023,106,247,53,2015
12031000094,2775,2395,1132,384,726,56,130,0,1263
12099000161,1919,1658,1225,248,114,25,51,1,433
12086000755,1475,1124,366,697,39,0,35,0,758
12086000673,647,579,136,216,188,3,46,0,443
12086000635,333,238,114,116,2,2,3,2,124
12097000106,1398,1318,809,378,114,12,21,1,509
12099000493,1413,1239,855,233,41,17,54,3,384
12099000429,1830,1669,1536,71,14,9,27,2,133
12031000118,1898,1468,312,60,1072,16,23,6,1156
12086000818,2924,2066,35,570,1503,28,4,2,2031
12099000459,4295,4131,3750,202,35,11,99,5,381
12099000304,217,184,123,49,5,4,4,0,61
12099000009,54,48,20,22,1,2,4,0,28
12099000276,2897,2663,1521,927,166,32,35,0,1142
12099000380,1511,1486,1385,53,29,2,9,0,101
12099000400,1346,1308,1153,79,45,11,20,3,155
12099000585,552,490,400,58,17,2,9,0,90
12031000105,5553,4337,3026,481,440,92,278,10,1311
12099000405,2399,1846,598,299,891,19,47,2,1248
12099000883,11,11,7,1,0,0,4,0,4
12099000398,5148,4005,1924,1310,534,76,191,3,2081
12099000393,1662,1363,760,277,272,20,36,0,603
12099000038,0,0,0,0,0,0,0,0,0
12031000032,5889,4490,2346,525,735,93,819,23,2144
12031000218,8069,5766,3267,532,1531,155,324,9,2499
12095000425,6353,4941,962,2571,835,69,569,28,3979
12099000705,3638,2707,578,1585,507,45,58,15,2129
12099000703,3688,2662,454,838,1217,36,140,6,2208
12099000334,56,38,18,8,8,1,2,0,20
12099000440,1443,1150,71,93,974,8,27,2,1079
12057000578,2418,1934,1175,472,184,24,111,1,759
12073004461,2967,2260,1675,151,195,36,201,0,585
12073003469,3498,2673,1440,147,977,69,53,3,1233
12057000980,0,0,0,0,0,0,0,0,0
12019060600,148,113,88,4,2,2,1,0,25
12023000014,1534,1232,775,218,212,21,17,5,457
12111000039,1747,1678,1501,96,39,14,10,0,177
1211100039A,1080,877,520,101,207,7,38,0,357
12015000031,1326,1279,1224,24,8,8,5,2,55
12015000112,495,450,412,21,4,4,5,0,38
12127000220,17,12,5,0,0,5,0,0,7
12033000036,2641,2165,1435,101,395,64,163,5,730
12033000179,1956,1423,1268,56,33,34,30,2,155
12033000197,213,164,71,32,43,7,9,2,93
12033000066,3405,2525,1456,165,635,82,179,21,1069
12033000145,983,775,266,23,458,18,6,2,509
12081000104,771,735,700,11,4,11,5,1,35
12033000026,2059,1632,1207,113,166,59,79,3,425
12081000212,784,748,682,36,7,2,17,3,66
12081000142,1163,749,76,499,175,7,7,0,673
12071000048B,0,0,0,0,0,0,0,0,0
12071000027,3021,2881,2692,81,28,13,46,0,189
12071000071,4669,3907,2856,678,258,48,90,6,1051
12099000173,488,429,361,41,17,6,3,0,68
12033000156,388,298,27,20,247,3,4,0,271
12127000162,1297,1226,1115,43,29,23,14,2,111
12127000044,27,16,13,1,2,0,0,1,3
12033000076,382,311,229,30,41,11,5,0,82
1201100C008,1472,1314,973,189,82,6,44,1,341
1201100N007,2355,1858,1054,416,269,25,94,1,804
12033000233,612,483,339,22,78,16,39,0,144
12127000145,28,19,9,7,3,1,0,0,10
12081000166,751,659,564,51,22,3,14,1,95
12081000052,1273,1043,589,240,188,14,8,1,454
12081000002,14,14,14,0,0,0,0,0,0
1201100E009,2148,1678,929,370,254,16,119,8,749
1201100N010,2037,1639,959,403,199,17,67,0,680
1201100X007,3637,2931,755,1718,321,46,164,2,2176
12033000147,426,356,177,53,107,18,10,1,179
12033000082,475,407,261,21,113,8,6,0,146
12033000260,1457,1127,1007,17,30,39,20,3,120
12033000140,97,83,70,1,7,1,3,1,13
12033000243,1788,1445,1160,46,149,42,37,3,285
12101000072,2875,2494,2252,146,20,43,24,3,242
1201100B006,948,821,683,92,15,2,11,0,138
12039000044,1240,894,195,323,371,8,1,0,699
12033000119,432,397,316,17,41,10,10,1,81
12033000106,1446,1137,727,71,256,32,48,2,410
12039000020,675,504,170,93,235,9,1,2,334
12039000028,463,343,170,32,125,7,9,2,173
1201100V031,1763,1374,671,415,248,23,54,0,703
12109000016,398,332,251,35,16,12,16,4,81
12109000080,586,415,301,26,54,16,26,2,114
12099000498,1474,1341,1148,95,36,4,34,2,193
1201100R068,1433,1248,933,217,43,19,30,3,315
1201100W007,3152,2423,201,862,1363,29,68,1,2222
1201100W006,2121,1624,132,633,846,12,55,2,1492
12009000120,1893,1415,263,64,1052,23,4,3,1152
12086000015,1556,1246,455,678,55,8,47,0,791
12097000131,557,461,260,140,33,9,11,2,201
12007000003,563,453,433,10,3,6,2,2,20
12021000110,276,236,179,34,13,6,4,0,57
12031000252,2568,2184,1810,97,96,39,113,0,374
12001000021,3021,2557,2067,202,68,29,171,3,490
12097000250,1343,1023,110,752,148,22,59,3,913
12057000078,3196,2256,1153,357,301,37,411,4,1103
12057000372,1214,1077,564,195,184,22,116,3,513
12057000100,1096,870,329,208,250,11,84,1,541
12086000893,1059,751,79,425,254,6,18,3,672
12086000894,894,540,5,528,12,27,2,0,535
12031000063,1943,1568,1194,182,100,32,48,4,374
12086000165,869,809,141,279,327,5,20,0,668
12086000170,205,195,39,41,100,1,2,0,156
12086000994,1464,1258,94,1128,22,5,23,0,1164
12086000003,4175,3550,2488,873,48,17,92,0,1062
12099000138,0,0,0,0,0,0,0,0,0
12099000586,436,301,231,24,8,4,30,0,70
12099000562,0,0,0,0,0,0,0,0,0
12099000288,2023,1806,1076,487,197,9,55,2,730
12099000026,1639,1287,1095,122,13,23,18,1,192
12099000524,2156,1693,947,318,303,18,100,3,746
12086000141,3996,3120,158,717,2275,37,37,3,2962
12099000693,3870,3123,1484,824,673,73,123,4,1639
12086000464,1703,1471,53,1404,10,2,11,0,1418
12031000007,2807,2131,1183,221,528,29,184,6,948
12057000080,2425,1707,514,537,606,16,78,8,1193
12086008430,214,174,6,138,22,8,10,0,168
12086000963,2196,1713,362,1277,77,32,20,0,1351
12086000023,4891,4220,1673,2197,124,23,119,5,2547
12099000596,1924,1913,1505,237,93,9,31,2,408
12099000831,2372,1799,480,418,842,25,49,0,1319
12099000552,899,888,820,37,14,7,5,0,68
12099000557,2059,2005,1900,56,16,5,15,3,105
12099000540,1013,981,903,30,28,13,15,1,78
12099000415,585,507,465,21,0,2,16,1,42
12099000529,2257,1956,1467,213,194,21,53,2,489
12086000260,1527,1160,14,556,610,10,2,1,1146
12086000275,657,478,5,212,272,2,1,0,473
12091000061,3806,3013,1864,348,419,113,277,17,1149
12103000017,847,761,665,26,55,4,4,0,96
12107000015,723,584,537,20,6,16,3,2,47
12071000100,3962,3923,3780,69,19,29,9,1,143
12019050401,1099,883,813,33,6,9,13,8,70
12099000289,3978,2855,697,1432,664,72,96,11,2158
12099000139,1186,1004,708,230,26,20,15,1,296
12099000118,170,150,127,16,3,1,3,0,23
12057000703,2185,1620,1263,162,107,19,77,2,357
12073004405,2622,1927,1448,90,161,27,180,1,479
12073005261,3284,2737,1994,164,462,76,29,2,743
1209500131B,1272,882,359,268,126,16,83,8,523
12103000029,1647,1418,482,191,692,35,39,0,936
12071000118B,0,0,0,0,0,0,0,0,0
12099000129,2357,1882,1171,352,212,47,102,5,711
12099000NP5,0,0,0,0,0,0,0,0,0
12071000069B,1068,979,877,55,2,8,26,0,102
12071000301,3775,2963,2508,246,58,58,87,0,455
12071000300,960,775,659,70,14,6,24,0,116
12099000086,4,3,2,0,0,0,0,0,1
12033000122,820,583,231,26,289,27,5,0,352
12033000206,669,540,318,50,107,20,41,1,222
12127000131,301,258,204,15,12,12,6,0,54
12127000138,12,12,9,3,0,2,0,0,3
12069000032,430,353,303,30,10,8,3,0,50
12033000164,3111,2491,1266,140,904,70,109,2,1225
12117000027,3733,2923,1440,845,450,36,157,5,1483
12073002401,934,739,225,138,317,19,52,0,514
12043000012,104,94,9,6,79,0,0,0,85
12115000031,1661,1390,1138,142,39,17,46,5,252
12033000008,579,481,374,34,35,18,22,0,107
12081000117,1437,1007,66,323,613,5,2,0,941
12081000163,594,510,410,40,22,5,28,2,100
12081000055,649,625,562,28,12,2,18,0,63
12081000199,1420,1310,1049,118,63,20,50,0,261
12127000006,8,5,5,0,0,0,0,0,0
12103000183,1862,1668,1491,69,24,30,44,3,177
12051000005,2441,1699,30,37,1642,5,4,2,1669
1201100H002,2354,1657,111,304,1194,38,80,6,1546
12033000211,469,394,336,19,9,8,17,1,58
12101000151,2904,2508,2118,216,59,53,52,3,390
12101106069,0,0,0,0,0,0,0,0,0
12101000102,232,192,156,18,7,5,3,1,36
12101000101,972,766,520,142,50,16,36,1,246
12101000079,2278,1948,1533,224,111,38,50,1,415
12101101000,0,0,0,0,0,0,0,0,0
12103000242,1633,1451,1273,77,20,24,54,4,178
12103000261,73,62,60,0,1,1,1,0,2
12081000204,1721,1379,755,334,207,23,44,0,624
1201100V017,1596,1313,328,591,387,18,26,0,985
12101000116,131,110,75,17,7,11,2,0,35
1201100V039,2488,1955,567,992,285,32,123,3,1388
12109000089,88,67,54,3,2,3,5,0,13
1201100V030,2066,1636,947,496,113,12,67,3,689
1201100J014,2365,2216,773,524,854,12,75,2,1443
1201100X039,1938,1497,431,574,256,9,248,4,1066
1201100X037,845,672,265,272,73,7,48,0,407
1201100B005,1242,1145,874,154,41,1,30,1,271
12117000066,3291,2655,1815,554,152,52,121,12,840
12077000001,457,351,123,21,203,9,2,4,228
12099000620,1594,1216,705,268,112,18,45,4,511
12099000621,4320,3339,1659,778,310,35,255,2,1680
12099000401,794,775,719,24,14,2,10,1,56
1201100F009,3969,3195,1256,921,731,30,80,3,1939
1201100L005,3889,2897,105,144,2664,7,16,9,2792
1201100K008,3223,2550,237,234,2076,15,14,2,2313
1201100R006,1649,1386,935,282,106,28,29,9,451
1201100T011,3200,2663,1428,789,255,16,203,17,1235
1201100X025,899,882,254,506,101,5,32,1,628
12127000111,451,408,363,14,10,6,14,0,45
12039000036,473,399,293,28,68,11,2,2,106
12021000028,3566,2968,2566,257,42,25,52,0,402
12021000130,1585,1484,1285,113,27,9,48,0,199
12021000032,2372,1832,1535,176,30,15,52,2,297
12021000141,796,768,713,23,2,5,17,0,55
12021000132,1038,1018,976,27,3,2,4,0,42
12009000430,1091,947,782,61,27,17,58,4,165
12021000039,590,564,530,20,5,5,5,0,34
12073004105,230,168,45,13,104,7,9,0,123
12073004184,916,762,544,45,130,9,30,0,218
12057000940,313,242,140,78,15,2,7,0,102
12001000002,1583,1274,969,68,166,30,26,0,305
12001000017,4063,3131,2027,356,286,50,383,10,1104
12001000003,1007,801,652,49,56,20,19,3,149
12086000206,3798,2867,80,267,2455,12,123,5,2787
12086000196,6520,4770,86,793,3926,36,71,12,4684
12086000763,3465,2871,195,2556,104,20,64,1,2676
12086000532,1021,808,317,257,223,13,9,1,491
12086000200,4330,3461,111,3105,219,36,78,5,3350
12031000149,2109,1504,56,38,1404,13,13,4,1448
12031000289,0,0,0,0,0,0,0,0,0
12031000040,5605,4410,2401,688,677,91,599,28,2009
12031000185,2681,1926,585,171,953,28,188,7,1341
12031000256,4381,3533,1722,587,899,103,254,14,1811
12086000578,4526,3812,349,3289,141,32,82,4,3463
12099000614,1762,1333,824,280,76,10,73,1,509
12099000116,775,632,558,40,6,7,22,1,74
12031000128,3000,2365,1195,336,700,75,72,8,1170
12086000583,2925,2376,1037,1121,159,25,58,1,1339
12097000130,510,395,235,118,23,7,12,3,160
12095000428,6488,4963,449,3738,608,78,242,12,4514
12031000293,2696,2155,1091,300,327,30,438,11,1064
12099000322,1973,1716,1390,218,58,22,26,3,326
12099000496,2498,2090,1102,574,223,45,101,3,988
12099000308,1428,1163,441,639,66,14,14,2,722
12099000250,34,20,0,20,0,1,0,0,20
12099000704,457,345,67,112,133,1,30,0,278
12099000668,1207,846,178,109,429,8,119,1,668
12031000026,4339,3354,1413,621,609,85,656,32,1941
12057000513,1063,902,685,152,34,7,26,0,217
12073002503,1875,1868,1115,356,266,25,111,0,753
12099000561,1551,1442,1334,50,12,8,35,1,108
12099000602,2550,2061,1346,375,102,19,127,4,715
12099000215,2080,1987,1481,248,205,19,36,0,506
12019011203,2124,1453,721,190,391,48,119,11,732
12103000139,2695,2569,2261,159,45,18,70,1,308
12019011301,7694,5194,2014,830,1926,128,410,22,3180
12115000091,1209,1085,1023,22,15,8,11,0,62
12057000132,1427,974,341,235,352,18,52,3,633
1209500330B,1494,1212,620,188,202,23,163,7,592
12033000214,1071,890,722,48,80,17,27,1,168
12033000190,61,33,10,6,11,2,2,0,23
12127000132,274,232,191,17,11,8,3,0,41
12033000049,1151,941,640,54,168,37,34,9,301
1201100V052,3123,2462,575,1424,370,30,162,3,1887
12033000059,735,594,483,23,35,34,17,1,111
12033000101,1641,1270,874,61,219,28,72,6,396
1201100Q010,1987,1891,1683,131,29,10,25,0,208
1201100W003,2021,1550,115,590,848,16,34,5,1435
12121000007,1705,1300,1012,131,88,43,16,6,288
12103000096,2312,2283,2106,102,25,18,31,2,177
12101000075,2762,2465,2106,200,84,46,36,4,359
12103000340,3192,2702,2182,265,129,36,78,5,520
1201100L014,2032,1358,17,42,1288,12,2,0,1341
12033000065,2343,1931,1486,108,151,83,104,5,445
1201100V049,2250,1733,404,1018,257,17,73,3,1329
1201100V054,1771,1391,388,743,216,15,60,2,1003
12103000138,1824,1455,1191,123,68,15,57,20,264
1201100L017,1282,990,29,50,918,9,8,1,961
1201100Q069,3964,2682,629,1426,186,30,387,3,2053
12021000129,1327,1298,1225,46,7,9,6,0,73
12031000136,5055,3777,364,168,3205,28,62,0,3413
12031000018,2497,2039,1580,144,162,49,121,14,459
12021000016,200,161,70,82,1,2,3,0,91
12086000385,5815,4760,271,4307,102,23,91,0,4489
12031000031,2361,1858,1211,182,274,27,164,23,647
12086009820,494,464,190,170,71,1,34,4,274
12057000114,2002,1384,496,378,440,23,51,5,888
1209900NP25,0,0,0,0,0,0,0,0,0
12099000685,119,93,42,18,27,2,6,1,51
12057000661,2376,1808,758,361,632,26,67,2,1050
12057000637,176,124,14,19,95,6,3,2,110
12086000429,2402,1953,372,1534,25,11,24,5,1581
12086000530,834,739,231,385,74,7,48,1,508
12086000540,114,103,5,87,13,3,5,0,98
12057000112B,1318,831,529,130,92,16,70,5,302
12035700000,317,281,258,10,4,6,5,0,23
12035730000,9,8,2,0,3,0,3,0,6
12111000093,27,18,9,2,3,1,5,1,9
12111000033,691,636,526,75,20,1,6,0,110
1211100033A,0,0,0,0,0,0,0,0,0
12031000003,4153,3666,1805,418,1319,75,151,13,1861
12086000324,4425,3714,56,3625,126,10,9,2,3658
12086000181,351,293,161,97,34,4,4,1,132
12099000691,1032,759,302,255,140,12,56,4,457
12103000236,1376,1217,1079,66,11,19,31,0,138
12073003451,86,65,56,1,0,0,7,0,9
12115000085,588,531,508,9,2,4,11,0,23
12065000013,249,196,149,15,25,5,1,0,47
12099000469,2477,2101,1500,305,166,32,102,3,601
12099000397,1328,1243,1023,109,61,11,33,1,220
12099000365,30,27,27,0,0,0,0,0,0
12127000053,227,208,167,25,8,9,0,0,41
12081000070,1866,1230,155,442,630,8,4,1,1075
12069000019,336,311,271,23,7,7,1,0,40
12117000078,6974,5432,3422,1009,448,76,502,2,2010
1213300004D,545,409,388,5,11,5,1,0,21
1213300009C,155,122,76,6,30,8,2,0,46
12069000124,517,513,475,20,5,7,5,2,38
12081000169,64,50,45,5,0,0,0,0,5
12081000188,2329,1890,1658,90,34,22,60,2,232
12033000013,216,175,121,17,8,13,15,2,54
12033000073,512,453,388,11,28,11,10,0,65
12101000109,48,32,7,14,5,16,1,0,25
12103000082,1446,1029,159,80,787,15,6,1,870
12033000208,4182,3408,2614,166,323,114,166,15,794
12033000092,775,579,211,39,210,3,113,5,368
12099000845,6,6,4,0,0,0,1,0,2
1201100Q044,0,0,0,0,0,0,0,0,0
1201100Q042,1795,1324,964,165,81,13,102,4,360
1201100Q040,226,165,110,32,18,7,3,0,55
1201100C012,1965,1920,1636,187,26,7,41,1,284
1201100L002,2196,1751,52,74,1593,15,45,3,1699
12099000279,1945,1418,241,985,184,45,25,6,1177
12099000486,2811,2108,1406,386,118,6,95,0,702
1201100M008,2948,2556,450,1264,794,13,79,4,2106
1201100J022,2330,2258,1614,327,260,13,38,0,644
12039000015,281,212,53,66,93,0,0,0,159
12117000059,2680,2098,1579,290,111,43,84,6,519
12021000044,1065,1013,908,54,14,7,24,0,105
12021000082,769,739,681,29,16,5,6,1,58
12021000027,1944,1816,1450,240,69,6,44,3,366
12021000025,944,815,743,35,7,3,12,0,72
12021000034,1833,1633,1274,187,72,17,71,3,359
12021000081,2706,2181,1688,371,28,27,40,3,493
12021000119,916,785,522,187,42,11,20,0,263
12097000157,1794,1415,726,414,190,42,67,2,689
12097000137,270,223,111,61,22,4,19,0,112
12073002513,2804,2133,782,263,1019,53,60,3,1351
12073001501,1160,955,373,52,500,21,23,2,582
12085000028,2779,2661,2517,93,11,16,12,2,144
12086000622,206,163,51,106,0,3,2,0,112
12057000115B,2532,1803,791,462,415,35,129,4,1012
12057000982,43,23,0,8,13,0,3,0,23
12057000105B,2302,1515,542,254,291,20,437,1,973
12001000022,4086,3166,2113,367,273,52,385,4,1053
1201100C021,2557,2325,1408,460,192,38,183,7,917
12086000151,735,563,203,230,105,8,25,1,360
12086000150,1733,1353,115,443,773,9,51,0,1238
12086000234,1325,1060,15,509,571,13,3,0,1045
12086000785,2518,2051,146,1818,90,5,25,0,1905
12086000896,129,103,35,64,10,0,0,0,68
12099000880,0,0,0,0,0,0,0,0,0
12099000433,145,127,110,10,0,0,2,3,17
12031000277,2873,2302,1289,301,514,46,194,6,1013
12095000407,2890,2288,1197,617,251,45,197,8,1091
12107000030,295,240,199,23,8,1,4,0,41
12099000388,1886,1548,603,347,523,25,75,0,945
1209500101B,3461,2802,1133,542,454,25,488,5,1669
12083000092,1771,1761,1606,80,52,5,13,1,155
120170204.2,1841,1809,1556,72,43,14,113,1,253
12099000709,1870,1427,1006,247,95,16,65,1,421
12031000095,3137,2743,1587,401,528,38,168,4,1156
12099000369,913,647,206,101,201,4,136,1,441
12115000093,1142,959,837,74,9,7,24,1,122
12127000112,466,363,322,16,3,14,12,2,41
12033000220,870,702,471,32,144,28,23,2,231
12033000117,459,369,205,26,122,17,9,0,164
12099000592,2730,2216,1388,423,164,18,173,5,828
12127000136,19,15,12,3,0,0,0,0,3
12033000185,16,8,0,0,0,5,0,0,8
12081000041,663,437,179,205,41,18,8,2,258
12033000244,2792,2282,1815,127,198,60,70,15,467
12033000210,389,322,270,15,16,10,6,0,52
12033000196,4773,4560,3272,412,197,47,479,23,1288
1201100E021,3575,2737,987,923,635,28,139,0,1750
1201100M016,884,839,297,401,123,9,19,0,542
1201100M017,1437,1332,508,534,241,9,31,4,824
12101000087,61,54,33,15,5,1,0,0,21
12039000029,804,697,565,26,69,21,6,0,132
12033000236,1888,1533,1206,61,165,51,42,3,327
12099000112,1188,1124,1056,29,13,5,19,1,68
12099000021,4,4,4,0,0,0,0,0,0
12099000192,1330,1256,1136,46,27,5,25,4,120
1201100M018,1413,1214,323,528,298,10,80,1,891
12099000554,2356,2133,1466,350,206,16,48,5,667
12099000599,2124,2047,1846,132,22,9,27,0,201
12099000597,1461,1453,1169,194,63,2,15,4,284
12057000031,531,405,275,66,36,20,15,0,130
12021000014,1329,1102,557,370,157,11,11,0,545
12031000229,2265,1706,782,174,688,36,30,3,924
12031000042,694,613,322,110,136,8,49,7,291
12031000101,2278,1878,1582,147,55,22,72,5,296
12031000154,1118,830,11,32,792,6,7,0,819
12061000038,4,2,0,0,2,0,0,0,2
12031000257,3729,3041,1338,606,805,65,266,4,1703
12031000153,1328,991,340,38,597,15,14,0,651
12086000391,0,0,0,0,0,0,0,0,0
12057000655,2874,2291,1338,402,409,44,134,3,953
12099000741,3232,2339,1436,388,296,13,188,2,903
12099000044,1821,1634,1521,43,15,11,27,0,113
12099000003,0,0,0,0,0,0,0,0,0
12099000104,1592,1385,1221,98,15,13,38,2,164
12086001071,2247,1910,537,1069,216,3,71,1,1373
12086001070,19,18,0,10,1,2,5,1,18
12099000020,908,755,609,68,31,11,18,0,146
12057000510,2998,2474,1671,516,189,32,67,3,803
12009000236,706,622,536,39,15,10,21,0,86
12009000218,600,581,526,17,7,5,21,0,55
1209900NP17,0,0,0,0,0,0,0,0,0
12099000260,4356,3317,561,1698,1036,41,97,14,2756
12019030800,4223,3151,2212,340,381,55,136,30,939
12019041201,522,401,326,37,13,3,18,0,75
1209500440A,3175,2356,798,1080,236,53,205,0,1558
12099000257,856,640,162,199,236,2,49,0,478
12099000565,804,751,488,102,122,2,20,2,263
12103000126,29,27,18,1,2,3,0,0,9
12033000047,574,486,409,14,18,22,17,0,77
12081000109,835,701,536,104,31,8,19,0,165
12081000160,1973,1468,801,294,257,27,98,1,667
12033000109,1257,980,541,52,323,23,38,0,439
12127000189,0,0,0,0,0,0,0,0,0
12097000306,5174,3982,415,2377,1272,70,105,12,3567
12127000224,59,57,45,10,2,0,0,0,12
1201100V025,1769,1338,1148,124,32,10,9,1,190
12033000003,143,119,70,19,11,7,14,1,49
1201100J021,3541,2850,1106,767,829,15,131,2,1744
12086000816,4939,4040,248,2575,1246,44,65,1,3792
12069000102,662,542,439,55,14,14,14,2,103
12081000215,821,706,613,40,19,8,12,1,93
12103000336,3215,2722,2326,136,49,36,143,9,396
1201100X045,3929,2990,442,1617,750,24,190,2,2548
12081000183,695,517,402,47,54,9,1,1,115
12099000011,375,293,276,11,0,4,1,1,17
12099000079,362,295,277,6,4,1,3,0,18
12099000335,3540,2682,846,705,912,37,191,3,1836
12099000292,312,221,46,88,63,5,22,0,175
1201100Q066,2922,2277,1204,833,66,10,129,3,1073
12099000221,1045,1034,757,150,87,2,26,3,277
12099000220,2011,1986,1292,350,309,10,34,3,694
12021000055,2496,2150,1897,169,25,22,34,1,253
12086000114,3744,3301,2108,970,108,15,66,7,1193
12086000109,6301,4860,2200,2120,190,38,141,2,2660
12086000067,3541,2842,1575,1047,102,13,47,1,1267
1201100V008,1558,1173,27,209,937,8,11,4,1146
12057000115A,3005,2666,1921,390,193,40,129,2,745
12086000040,3548,3137,1392,1440,165,51,90,4,1745
12086001720,220,193,2,46,143,2,0,0,191
12086000173,359,288,14,42,241,2,1,2,274
12086000741,4344,3517,702,2437,239,35,121,1,2815
12086000734,1552,1255,231,982,24,5,17,3,1024
12086000459,1253,1014,33,958,5,1,22,0,981
12086000137,688,522,48,125,343,6,21,0,474
12031000098,2871,2315,1493,285,307,24,107,6,822
12097000570,1578,1087,196,755,118,25,42,3,891
12031000290,5092,3646,2172,435,568,31,429,6,1474
12099000423,902,838,742,51,14,14,15,0,96
1209900NP19,518,481,380,64,14,5,10,0,101
120170208.2,553,474,404,26,16,14,8,0,70
12099000164,651,545,435,48,9,6,39,0,110
12099000055,81,57,45,10,0,2,0,0,12
12095000409,5703,4630,2452,1396,471,81,311,5,2178
12035530000,302,270,265,2,1,2,1,0,5
12099000387,3058,2488,1326,460,557,48,127,0,1162
12031000129,4134,3234,218,151,2851,25,42,2,3016
12031000050,3013,2627,2045,221,159,39,156,3,582
12099000520,1858,1840,1762,34,23,5,8,1,78
12073005214,2008,1748,1125,129,368,21,105,6,623
12023000003,2113,1623,1226,90,226,56,20,3,397
12033000162,931,734,380,88,207,21,28,3,354
12033000154,583,450,17,23,391,9,17,3,433
12033000155,955,770,99,22,621,27,14,3,671
12033000188,118,115,94,5,11,0,5,1,21
12033000239,284,227,158,11,24,22,7,2,69
12099000583,1966,1778,1570,99,21,1,69,0,208
12127000014,9,6,3,1,1,1,0,0,3
1201100H010,1629,1063,61,697,298,24,17,4,1002
12033000252,1655,1166,850,53,163,49,52,1,316
12033000247,0,0,0,0,0,0,0,0,0
12127000231,0,0,0,0,0,0,0,0,0
12033000041,1484,1100,668,59,245,59,76,0,432
12033000198,803,691,455,43,136,11,44,1,236
1201100G005,2162,1653,563,411,608,15,73,5,1090
12033000256,24,11,4,0,3,0,0,0,7
12021000018,1788,1692,1561,90,7,14,13,0,131
12057000093,1840,1091,692,143,46,11,204,2,399
12086000737,4689,3768,151,3480,152,49,69,2,3617
12086005361,1686,1455,236,977,202,33,56,3,1219
12099000555,1651,1621,1365,139,76,6,22,1,256
12099000356,2729,2470,2172,112,98,11,77,1,298
12099000070,2899,2292,1990,159,53,23,54,2,302
12099000757,37,28,1,11,14,4,2,0,27
12099000013,0,0,0,0,0,0,0,0,0
12086000068,17,6,0,3,2,4,0,0,6
12103000048,2161,1964,1722,103,35,20,70,1,242
12086003040,8783,6618,178,6115,497,36,75,2,6440
12086003041,2226,1780,41,1661,128,6,33,1,1739
12095000127,2757,2261,1526,275,94,20,306,0,735
12086005501,87,73,0,73,4,1,0,0,73
12099000093,745,683,632,32,10,2,4,1,51
12027000004,159,120,92,16,4,9,1,0,28
12009000501,681,589,528,20,3,13,14,0,61
12099000232,4877,3939,1730,828,1285,42,77,4,2209
12099000746,771,586,304,143,98,7,39,0,282
12099000743,235,166,81,46,17,3,20,0,85
1209900NP27,0,0,0,0,0,0,0,0,0
12019060200,1948,1517,1061,185,199,45,37,8,456
12103000080,2435,2207,1887,101,127,31,56,2,320
12099000064,2319,1770,1304,246,64,25,115,5,466
12099000119,209,195,183,2,1,4,6,0,12
12081000153,348,319,290,6,10,3,10,0,29
12073003107,1629,1286,700,97,445,25,25,0,586
12033000189,199,170,135,11,2,0,20,0,35
12033000005,0,0,0,0,0,0,0,0,0
12033000232,3443,2890,1704,197,669,54,265,4,1186
12117000077,4103,3240,1968,553,347,34,333,9,1272
12033000009,996,767,575,36,80,20,52,0,192
1201100B001,1340,1141,974,112,14,15,34,0,167
12081000140,2848,2198,1255,540,308,50,50,9,943
12081000006,428,420,411,6,2,0,2,0,9
12086000199,2195,1764,297,690,682,8,75,7,1467
12033000221,1719,1449,1115,96,131,45,60,2,334
1209500435B,1880,1520,538,638,243,40,128,2,982
12099000002,0,0,0,0,0,0,0,0,0
12099000014,581,476,350,66,22,2,39,0,126
1201100X015,1509,1204,489,564,126,3,41,0,715
12127000260,58,52,49,0,0,1,1,0,3
1201100M010,1513,1456,470,730,209,7,53,1,986
12101101001,0,0,0,0,0,0,0,0,0
12021000140,487,473,426,37,2,3,2,1,47
12073003468,114,94,37,11,45,2,4,1,57
12057000148,158,115,54,19,38,0,5,0,61
12057000126,480,411,245,88,57,7,17,1,166
12057000974,1541,1126,337,527,264,13,17,2,789
12086000416,3678,3087,81,2965,49,19,19,0,3006
12086000944,58,51,11,25,17,2,0,0,40
12086000262,2702,2087,17,836,1278,21,8,2,2070
12099000502,3130,2622,1447,588,314,17,172,3,1175
12099000545,2070,2012,1915,50,23,7,12,3,97
12099000526,2805,2402,1650,348,240,28,122,6,752
12099000176,0,0,0,0,0,0,0,0,0
12099000536,1436,1433,1380,24,13,0,13,0,53
12099000604,866,756,689,30,7,1,13,2,67
12099000385,1431,1235,743,163,233,10,70,3,492
12019011500,0,0,0,0,0,0,0,0,0
12033000090,1233,981,518,65,226,40,128,3,463
1209900NP10,0,0,0,0,0,0,0,0,0
12099000564,535,513,328,102,66,0,7,0,185
12033000091,1007,859,498,80,191,35,61,1,361
12081000221,1858,1656,1508,40,42,5,60,0,148
12099000537,934,931,857,48,21,0,3,1,74
12127000061,0,0,0,0,0,0,0,0,0
12127000251,31,28,27,0,0,1,0,0,1
12033000098,926,714,528,39,72,21,47,7,186
12033000150,351,298,143,22,104,6,25,1,155
12039000037,765,611,260,15,332,3,1,0,351
12033000246,4129,3247,2532,129,342,109,137,3,715
12099000295,308,222,74,84,66,4,0,0,148
1201100F003,2054,1744,923,457,210,22,64,1,821
1201100V029,716,576,272,191,78,4,23,2,304
12031000080,4066,3022,912,795,1143,41,174,7,2110
12031000059,1104,892,569,84,129,6,120,6,323
12097000331,2472,1875,472,1057,276,30,72,8,1403
12057000918,1792,1548,645,830,39,21,15,0,903
12086000406,6097,5118,163,4805,160,37,77,3,4955
12086009811,1069,891,57,752,111,3,20,1,834
12086000323,3856,3405,31,3356,85,9,16,4,3374
12099000170,0,0,0,0,0,0,0,0,0
12099000147,23,19,16,0,3,0,0,0,3
12057000803,1269,977,690,151,89,20,42,0,287
12107000034,465,375,335,16,6,13,5,0,40
12099000810,1716,1265,273,316,672,10,8,2,992
12103000013,2260,1759,146,41,1555,13,15,0,1613
12015000076,3693,3124,2502,242,312,42,37,12,622
12033000061,0,0,0,0,0,0,0,0,0
12033000063,0,0,0,0,0,0,0,0,0
12081000044,210,160,7,6,147,1,0,0,153
12073005211,1678,1473,837,107,461,24,44,1,636
12073004109,542,457,330,27,82,4,19,0,127
12073004107,395,362,240,32,61,15,13,2,122
12033000015,0,0,0,0,0,0,0,0,0
12127000187,5,5,5,0,0,0,0,0,0
12127000110,531,449,410,12,12,6,4,1,39
12127000234,1,0,0,0,0,0,0,0,0
1201100C003,1807,1490,914,258,234,23,35,2,576
12086000585,1253,963,93,196,703,7,6,2,870
12099000707,1374,1053,308,413,291,21,39,0,745
12099000824,896,701,142,33,513,2,8,0,559
12021000126,309,274,264,5,4,0,1,0,10
12021000049,2729,2231,1973,165,26,11,49,0,258
12086000174,280,214,11,58,151,1,2,0,203
12086000208,5902,4645,1095,2037,1218,33,183,4,3550
12086000466,3088,2584,59,2473,63,3,28,1,2525
12031000143,2676,2053,757,78,1150,52,50,13,1296
12031000138,2637,2004,958,403,556,42,76,9,1046
12031000115,1671,1367,1162,72,42,22,50,3,205
12086007430,2124,1728,311,1239,105,16,75,1,1417
12086007431,0,0,0,0,0,0,0,0,0
12099000454,2811,2557,1922,283,230,21,69,1,635
12031000239,4775,3758,2248,171,1082,57,164,4,1510
12099000373,2219,1669,1094,271,183,19,80,4,575
12031000100,3247,2675,2040,286,177,47,107,11,635
12099000683,1388,1062,520,187,221,13,127,0,542
12031000231,2660,2038,840,293,740,45,139,17,1198
12099000386,2861,2384,1426,338,436,21,139,8,958
12099000527,1540,1433,1241,96,63,15,30,1,192
12099000566,264,239,162,26,40,4,3,0,77
12099000275,2011,1942,873,821,164,17,36,61,1069
12015000060,1979,1928,1798,63,20,25,16,0,130
12015000129,288,277,276,1,1,0,0,0,1
12033000016,155,144,94,11,18,2,17,0,50
12033000035,800,626,393,24,153,19,38,2,233
12033000071,252,222,160,5,44,4,7,2,62
12081000015,608,483,330,61,54,6,26,1,153
12033000227,1023,859,678,47,68,20,48,1,181
12081000004,10,5,3,0,0,0,2,0,2
12033000204,585,453,248,23,140,4,38,2,205
12081000205,1331,1233,1113,45,22,13,26,1,120
12127000261,0,0,0,0,0,0,0,0,0
12033000187,1513,1315,854,67,264,22,100,3,461
12039000039,703,593,305,20,252,10,0,1,288
12081000001,6,5,2,2,1,0,0,0,3
1201100J006,1061,1034,480,388,151,3,13,1,554
12099000823,2094,1718,530,152,1008,5,34,3,1188
1201100Y003,2911,2524,1563,776,79,8,78,4,961
1201100Y001,2116,1868,1289,460,42,2,38,1,579
12086000006,3093,2696,1773,739,48,11,62,7,923
12021000138,780,766,747,7,4,4,0,0,19
12021000041,1535,1513,1475,14,3,4,9,0,38
12097000471,1563,1140,467,462,161,20,59,1,673
12086000405,3580,3092,93,2963,64,16,16,7,2999
12035150000,356,293,258,18,11,1,5,0,35
12009000321,653,524,313,55,70,1,83,2,211
12099000734,742,717,643,33,26,2,16,0,74
12057000110,2458,1768,655,455,611,43,43,11,1113
12019040600,464,356,280,36,20,7,15,1,76
12019012400,2498,2111,1449,132,246,39,232,12,662
12081000078,668,633,562,23,16,8,19,1,71
12033000235,2196,2021,1517,118,288,24,64,6,504
12069000015,173,169,148,7,8,3,3,0,21
1201100V022,2293,1801,946,635,126,16,71,2,855
12021000033,564,552,525,9,2,1,15,0,27
12057000069,2677,1864,695,396,292,43,458,13,1169
12086000062,1,0,0,0,0,0,0,0,0
12086000967,2280,1736,52,1240,462,17,22,0,1684
12086000106,2595,2116,463,1336,249,17,59,4,1653
12086000992,207,203,0,200,7,1,0,0,203
12086000652,736,571,141,400,18,3,11,0,430
12099000499,1954,1790,1532,136,44,3,42,2,258
12057000051,2141,1685,1030,250,277,41,108,3,655
12057000983,0,0,0,0,0,0,0,0,0
12057000999,20,14,3,1,4,2,5,0,11
12115000009,1674,1490,1202,159,61,19,30,0,288
12073001351,386,297,79,55,157,3,4,0,218
12033000203,0,0,0,0,0,0,0,0,0
12033000010,0,0,0,0,0,0,0,0,0
12099000226,3233,2611,951,609,893,39,157,6,1660
12099000859,117,93,22,22,30,4,18,1,71
12033000186,212,182,117,9,38,4,8,1,65
12127000175,34,26,24,2,0,0,0,0,2
12127000021,7,7,2,5,0,0,0,0,5
12109000005,0,0,0,0,0,0,0,0,0
1201100J007,3461,2918,588,764,1520,35,55,9,2330
1201100C019,1702,1459,1182,193,30,19,41,0,277
12021000036,2013,1598,1349,146,30,13,51,4,249
12031000044,844,672,482,46,50,6,88,0,190
1209900NP26,0,0,0,0,0,0,0,0,0
12099000302,820,770,597,78,66,11,20,2,173
12086000571,769,647,107,501,20,10,14,0,540
12057000121B,0,0,0,0,0,0,0,0,0
12099000378,1257,1234,1152,36,27,3,7,0,82
12127000045,6,3,1,1,0,0,1,0,2
12091000045,457,396,275,54,33,17,15,0,121
12073001353,401,302,89,17,190,4,2,1,213
12033000137,1050,749,79,12,625,1,32,4,670
1201100E005,4804,3746,1152,1329,1005,47,219,3,2594
1201100H007,3912,2887,315,472,2011,19,132,16,2572
12033000225,0,0,0,0,0,0,0,0,0
1201100C005,2940,2213,39,167,2007,16,12,0,2174
1201100C011,2255,2118,1821,173,52,11,51,2,297
1201100M006,1353,1060,335,312,305,10,123,3,725
12103000221,2762,2706,2423,106,25,13,124,2,283
1201100N021,2490,1915,1138,401,186,16,141,3,777
12099000291,1772,1535,827,428,274,11,21,4,708
12099000298,1170,1101,718,215,157,6,23,2,383
12099000094,0,0,0,0,0,0,0,0,0
12021000095,888,873,848,15,5,1,0,0,25
12057000109B,512,468,207,98,101,8,69,0,261
12057000046,284,202,134,30,10,9,14,0,68
12086000624,2328,2108,710,1226,48,15,69,3,1398
12099000572,2567,2529,1944,305,150,13,36,1,585
12099000169,37,16,4,1,10,0,0,0,12
12099000608,3033,2306,1644,412,111,24,60,2,662
12099000548,4547,3275,2501,364,140,23,186,0,774
12081000106,1372,1342,1252,38,12,11,25,0,90
12033000237,1727,1525,1150,100,168,23,61,1,375
12033000168,294,260,187,16,38,3,16,3,73
12081000016,499,390,248,60,49,18,14,0,142
1201100P001,1978,1808,1215,327,162,39,65,3,593
12039000042,402,318,64,19,230,7,2,0,254
12099000274,1698,1668,861,655,114,14,31,0,807
12099000234,753,556,132,198,233,12,8,0,424
12099000231,0,0,0,0,0,0,0,0,0
12086000408,4836,3914,165,3313,176,41,325,2,3749
12086004701,637,517,29,463,24,8,2,1,488
12099000367,1622,1174,760,213,118,9,69,0,414
12099000551,1032,1007,946,28,31,2,6,1,61
12115000090,2137,2014,1908,49,13,8,29,0,106
12127000179,0,0,0,0,0,0,0,0,0
12127000190,2,2,0,0,2,0,0,0,2
12081000177,374,358,324,22,4,0,3,0,34
12081000180,380,371,361,5,2,1,0,0,10
12081000093,413,351,269,32,26,10,10,1,82
12101101016,0,0,0,0,0,0,0,0,0
12101102016,0,0,0,0,0,0,0,0,0
1201100M023,2686,2632,1165,958,393,12,101,7,1467
12081000176,41,40,30,8,0,1,0,0,10
12086000176,1374,1167,147,578,372,6,35,2,1020
12086000387,4998,4082,55,3986,124,15,27,0,4027
12031000104,3210,2655,2193,169,120,32,123,11,462
12099000230,3216,2278,425,780,1071,25,41,5,1853
12099000235,783,627,302,177,126,3,18,5,325
12099000266,250,187,40,113,26,3,9,0,147
1209900NP28,0,0,0,0,0,0,0,0,0
12099000255,1086,1067,264,214,592,3,7,0,803
12099000305,134,109,55,45,5,2,3,1,54
12057000057,2722,2007,851,363,479,26,299,4,1156
12081000115,117,98,18,42,38,0,0,0,80
12127000146,10,8,3,0,5,0,0,0,5
12033000249,1423,1107,846,41,140,40,40,3,261
12117000067,3790,3016,1827,706,304,65,131,9,1189
12021000061,1084,978,875,44,22,3,30,0,103
12007000007,452,342,237,9,87,8,4,0,105
12015000114,816,690,608,37,19,11,11,1,82
12081000040,237,178,97,65,11,2,4,1,81
12033000046,983,820,622,38,87,37,40,0,198
12033000177,63,59,51,0,0,0,8,0,8
12081000230,901,707,593,53,32,5,24,0,114
12033000215,511,400,302,24,34,13,20,0,98
12099000870,29,13,4,4,5,0,2,0,9
1201100V034,3827,3381,1336,1338,602,18,130,15,2045
1201100L003,1947,1625,262,110,1249,6,18,3,1363
12021000083,194,169,135,19,2,3,7,0,34
12021000142,530,508,480,14,4,3,2,0,28
12057000096,563,362,224,36,40,3,56,0,138
12099000082,195,147,128,14,0,0,2,1,19
12099000516,128,87,62,12,5,1,6,0,25
12127000114,36,26,26,0,0,0,0,0,0
12081000223,8,5,0,0,3,2,1,0,5
12127000020,28,12,8,0,3,1,0,0,4
12127000042,0,0,0,0,0,0,0,0,0
12039000030,600,527,454,12,49,4,2,0,73
12071000013A,0,0,0,0,0,0,0,0,0
12099000660,1050,868,579,91,82,16,98,3,289
12099000324,838,656,241,347,59,1,9,2,415
12099000NP8,0,0,0,0,0,0,0,0,0
12099000148,89,73,61,9,2,0,1,0,12
12057000103B,559,385,108,140,108,22,26,1,277
12086002661,0,0,0,0,0,0,0,0,0
12021000090,2469,2039,1551,329,67,15,62,2,488
12086000265,150,122,5,51,75,1,2,1,117
12099000851,0,0,0,0,0,0,0,0,0
12099000018,0,0,0,0,0,0,0,0,0
12099000019,0,0,0,0,0,0,0,0,0
12099000054,489,399,340,30,6,1,20,0,59
12127000003,11,4,2,2,0,0,0,0,2
12103000081,2952,2417,911,180,1297,25,30,4,1506
12101000056,0,0,0,0,0,0,0,0,0
1201100J024,1121,1103,670,234,154,3,23,1,433
12099000805,1261,1238,1115,65,6,5,35,2,123
12099000425,1405,1362,1206,99,20,3,21,3,156
12031000205,864,704,464,40,163,6,26,0,240
12073003104,1267,1006,448,66,392,16,63,1,558
12033000151,517,439,321,26,67,15,14,0,118
12099000032,14,10,6,2,2,2,1,1,4
12127000113,29,11,11,0,0,0,0,0,0
12039000003,360,298,193,9,99,1,0,0,105
12039000026,724,560,13,33,508,5,0,1,547
12031000043,1201,966,334,175,309,15,155,6,632
12031000045,2172,1822,1052,192,367,47,166,2,770
12057000829,4631,3778,1930,889,741,66,180,13,1848
12086000989,21,16,3,13,2,0,0,0,13
12086003001,2824,2260,98,1992,223,18,23,4,2162
12086000850,433,324,126,166,13,3,19,0,198
12033000099,389,314,225,13,45,12,12,0,89
12033000057,55,30,15,9,5,3,2,1,15
12101000053,0,0,0,0,0,0,0,0,0
12021000057,679,611,541,31,18,2,11,0,70
12031000037,4062,3169,1809,323,455,45,566,10,1360
12086000943,636,524,232,272,19,7,6,0,292
12127000253,0,0,0,0,0,0,0,0,0
12127000255,5,2,2,0,0,0,0,0,0
12101101006,0,0,0,0,0,0,0,0,0
12099000559,956,951,765,130,36,3,15,0,186
12099000043,0,0,0,0,0,0,0,0,0
12099000860,104,90,54,22,11,1,3,0,36
12099000075,1932,1501,1326,86,13,19,33,1,175
12009000230,21,21,7,6,3,5,1,0,14
12087000037,0,0,0,0,0,0,0,0,0
1201100E034,579,441,263,73,58,1,52,1,178
12057000814,3140,2398,1894,233,98,62,120,6,504
12099000008,0,0,0,0,0,0,0,0,0
12099000085,95,64,53,6,1,4,3,0,11
12099000131,0,0,0,0,0,0,0,0,0
12127000092,7,4,2,0,1,1,0,0,2
12033000258,904,712,562,29,83,26,11,1,150
12057000089,1316,961,518,163,158,15,122,2,443
12099000001,0,0,0,0,0,0,0,0,0
12099000030,0,0,0,0,0,0,0,0,0
12073005252,437,378,247,32,66,8,24,0,131
12127000227,0,0,0,0,0,0,0,0,0
12127000036,9,9,3,3,3,0,0,0,6
12081000162,1313,1022,696,131,57,24,104,0,326
1201100Y002,4876,4442,2796,1316,172,55,72,4,1646
12021000084,23,23,23,0,0,0,0,0,0
12021000043,363,354,343,6,0,1,0,0,11
12021000054,0,0,0,0,0,0,0,0,0
12021000029,0,0,0,0,0,0,0,0,0
12097000350,996,797,305,336,126,21,26,1,492
12099000725,442,400,189,103,84,13,22,4,211
12099000100,2,2,2,0,0,0,0,0,0
12057000143,826,618,176,206,185,9,54,1,442
12127000222,5,4,4,0,0,0,0,0,0
12127000223,25,21,20,1,0,1,0,0,1
12127000047,9,8,2,3,0,0,1,1,6
12033000195,283,228,169,9,27,8,14,2,59
12031000114,1246,999,823,48,57,13,41,0,176
12099000690,2112,1733,922,387,340,21,80,6,811
12031000047,813,706,490,68,100,6,51,1,216
12035009980,0,0,0,0,0,0,0,0,0
12009000130,0,0,0,0,0,0,0,0,0
12099000081,626,594,569,10,1,1,5,0,25
12127000116,0,0,0,0,0,0,0,0,0
12101000219,0,0,0,0,0,0,0,0,0
12099000733,60,37,12,15,8,1,0,0,25
12033000058,483,407,372,12,10,5,5,2,35
12099000309,242,198,117,69,9,5,1,0,81
12127000066,103,95,64,18,8,9,0,0,31
12127000262,3,3,3,0,0,0,0,0,0
12127000245,35,28,22,2,1,1,0,1,6
12033000007,11,5,4,1,0,0,0,0,1
12127000184,4,3,3,0,0,0,0,0,0
12101103001,0,0,0,0,0,0,0,0,0
12081000007,279,276,267,4,4,2,0,0,9
12057000090,1782,1151,199,371,559,19,35,3,952
12099000358,1450,1048,500,390,106,20,33,3,548
12086004031,1842,1582,78,1465,61,8,11,1,1504
12073003413,0,0,0,0,0,0,0,0,0
12127000065,0,0,0,0,0,0,0,0,0
12101000050,0,0,0,0,0,0,0,0,0
12033000259,144,107,79,4,3,11,0,1,28
12099000513,6,2,1,0,1,0,0,0,1
12115000107,0,0,0,0,0,0,0,0,0
12127000041,23,18,13,5,0,0,0,0,5
12033000176,185,143,112,18,5,6,3,1,31
12069000097,562,555,516,10,20,0,2,1,39
12021000048,741,703,619,49,11,9,18,1,84
12127000268,1,1,0,0,1,0,0,0,1
12127000258,11,8,8,0,0,0,0,0,0
12033000163,726,582,350,52,172,6,14,1,232
12086000976,951,634,17,355,294,4,3,2,617
12015000097,608,568,495,33,1,7,29,0,73
12099000068,325,269,234,25,4,7,0,0,35
12099000073,3,0,0,0,0,0,0,0,0
12021000125,807,804,782,12,6,2,2,0,22
12127000057,0,0,0,0,0,0,0,0,0
12127000004,24,10,8,0,1,1,2,0,2
12099000576,1011,855,719,47,23,4,52,2,136
12099000025,0,0,0,0,0,0,0,0,0
12127000064,9,7,2,4,1,0,0,0,5
12081000012,67,59,45,5,4,0,2,0,14
12127000202,0,0,0,0,0,0,0,0,0
12021000080,1226,1174,1091,49,9,3,15,0,83
12099000124,54,42,37,2,3,0,0,0,5
12057000102,282,201,52,74,69,8,6,0,149
12127000185,4,3,3,0,0,0,0,0,0
12033000183,632,563,406,24,76,3,52,0,157
12033000011,1113,799,484,37,165,23,82,3,315
12101000142,0,0,0,0,0,0,0,0,0
12057000906,459,457,432,15,4,4,1,0,25
12033000084,0,0,0,0,0,0,0,0,0
1201100C029,894,872,833,18,10,0,7,0,39
12127000033,0,0,0,0,0,0,0,0,0
12101000108,0,0,0,0,0,0,0,0,0
1201100M021,1561,1458,532,587,294,12,74,3,926
12127000031,20,14,0,8,2,1,3,0,14
12127000240,23,18,13,2,1,4,1,0,5
12101000223,76,70,68,2,0,0,0,0,2
12057000561,354,347,265,36,39,0,7,2,82
12081000181,60,60,55,5,0,0,0,0,5
12033000212,19,17,8,3,4,1,0,1,9
12033000019,111,96,89,3,0,3,1,0,7
12033000213,0,0,0,0,0,0,0,0,0
12081000184,123,102,86,12,3,3,0,0,16
12097000212,644,547,152,318,67,16,8,0,395
12087000036,0,0,0,0,0,0,0,0,0
12073002355,199,166,130,9,15,7,4,0,36
12057000954,1515,1213,419,409,393,33,38,7,794
12033000037,1084,873,584,36,133,37,70,8,289
12081000161,498,486,424,29,10,8,16,1,62
12127000267,12,12,12,0,0,0,0,0,0
12009000524,33,29,26,2,0,0,3,1,3
12031000093,3294,2693,1460,328,508,43,357,5,1233
12099000694,526,389,129,165,75,3,26,3,260
12099000007,0,0,0,0,0,0,0,0,0
12099000765,0,0,0,0,0,0,0,0,0
12127000055,0,0,0,0,0,0,0,0,0
12127000225,5,5,2,0,0,0,0,0,3
12033000222,455,342,249,26,50,7,16,0,93
12101000051,0,0,0,0,0,0,0,0,0
12021000063,15,7,0,0,0,0,0,0,7
12091000077,196,190,176,5,2,2,4,0,14
12099000149,74,49,34,3,6,1,3,0,15
12127000263,2,2,2,0,0,0,0,0,0
1201100J016,1474,1196,263,530,345,12,59,5,933
12127000115,6,6,4,0,0,2,0,0,2
12099000580,548,535,489,26,11,1,7,0,46
12099000045,0,0,0,0,0,0,0,0,0
12033000020,136,110,73,8,22,5,4,0,37
12086000790,194,148,11,137,0,8,0,0,137
12099000296,32,28,9,13,8,0,0,0,19
12099000225,0,0,0,0,0,0,0,0,0
12127000067,0,0,0,0,0,0,0,0,0
12033000048,188,154,133,2,10,3,3,1,21
12127000264,32,25,25,0,0,0,0,0,0
12127000271,0,0,0,0,0,0,0,0,0
12073005165,214,182,85,11,86,1,1,0,97
12081000151,0,0,0,0,0,0,0,0,0
12127000164,111,98,81,15,1,0,0,0,17
12127000254,6,6,6,0,0,0,0,0,0
12101000222,94,71,49,9,7,2,1,1,22
12099000016,7,7,7,0,0,0,0,0,0
12127000265,2,2,2,0,0,0,0,0,0
12086000169,1248,1054,199,445,329,5,46,0,855
12086000768,948,780,144,525,63,4,54,0,636
12127000103,0,0,0,0,0,0,0,0,0
12101000084,26,15,0,2,9,2,1,0,15
12021000133,789,682,614,37,10,9,15,1,68
12127000054,1,1,0,0,0,0,0,0,1
12101102033,56,54,48,2,0,4,0,0,6
12127000166,0,0,0,0,0,0,0,0,0
12099000673,41,39,31,3,3,0,0,0,8
12033000079,0,0,0,0,0,0,0,0,0
12127000007,0,0,0,0,0,0,0,0,0
12099000165,0,0,0,0,0,0,0,0,0
12099000012,0,0,0,0,0,0,0,0,0
12101000076,0,0,0,0,0,0,0,0,0
12127000201,0,0,0,0,0,0,0,0,0
12127000266,0,0,0,0,0,0,0,0,0
12101000032,11,7,0,2,3,2,2,1,7
12099000210,331,245,84,38,99,1,27,3,161
12099000035,0,0,0,0,0,0,0,0,0
12101000052,0,0,0,0,0,0,0,0,0
12009000319,3,3,3,0,0,0,0,0,0
12127000243,0,0,0,0,0,0,0,0,0
12033000004,0,0,0,0,0,0,0,0,0
12101000055,0,0,0,0,0,0,0,0,0
12033000038,793,650,436,35,120,11,46,6,214
12127000069,0,0,0,0,0,0,0,0,0
12099000023,36,32,18,4,8,0,2,0,14
12086000108,4827,4109,850,2634,563,65,101,3,3259
12099000394,0,0,0,0,0,0,0,0,0
12011000025,316,286,229,30,9,0,6,0,57
12099000653,0,0,0,0,0,0,0,0,0
12086004030,805,699,14,675,27,5,1,2,685
12099000680,12,10,8,1,1,0,0,0,2
12101000143,0,0,0,0,0,0,0,0,0
12086000460,59,51,0,50,0,1,0,0,51
12099000200,18,18,12,5,0,0,1,0,6
12127000242,0,0,0,0,0,0,0,0,0
12101000054,0,0,0,0,0,0,0,0,0
12099000206,621,504,204,112,186,6,10,0,300
12127000259,14,14,14,0,0,0,0,0,0
12086000648,93,72,38,18,0,2,16,0,34
12127000250,7,7,7,0,0,0,0,0,0
12127000252,13,13,13,0,0,0,0,0,0
12127000062,0,0,0,0,0,0,0,0,0
12099000141,124,101,93,6,0,0,1,0,8
12127000213,21,18,15,3,0,0,0,0,3
12099000143,14,10,8,2,0,0,0,0,2
12033000039,640,533,274,43,172,11,47,2,259
12033000023,0,0,0,0,0,0,0,0,0
12033000217,0,0,0,0,0,0,0,0,0
12033000060,116,93,81,5,2,1,8,0,12
12127000229,0,0,0,0,0,0,0,0,0
12033000067,0,0,0,0,0,0,0,0,0
12127000048,0,0,0,0,0,0,0,0,0
12099000631,77,61,10,51,0,3,0,0,51
12103000254,9,9,5,2,0,0,2,0,4
12127000133,0,0,0,0,0,0,0,0,0
12029000002,4,4,4,0,0,0,0,0,0
12086000059,0,0,0,0,0,0,0,0,0
12039000048,11,5,4,1,0,0,0,0,1
12127000030,0,0,0,0,0,0,0,0,0
12099000126,14,14,12,1,2,2,0,0,2
12099000144,150,126,110,4,4,2,4,0,16
12009000133,0,0,0,0,0,0,0,0,0
12033000028,0,0,0,0,0,0,0,0,0
12099000661,161,130,94,17,7,3,6,0,36
12127000246,0,0,0,0,0,0,0,0,0
12101000046,0,0,0,0,0,0,0,0,0
12101000094,0,0,0,0,0,0,0,0,0
12033000230,0,0,0,0,0,0,0,0,0
12127000215,5,5,4,1,1,0,0,0,1
12127000063,104,83,67,14,0,0,1,0,16
12069000049,12,11,9,1,0,0,1,0,2
12101000044,0,0,0,0,0,0,0,0,0
12127000035,140,103,81,4,8,2,8,0,22
12127000165,0,0,0,0,0,0,0,0,0
12101000038,0,0,0,0,0,0,0,0,0
12099000010,0,0,0,0,0,0,0,0,0
12057000920,16,4,0,1,1,0,1,0,4
12101000047,0,0,0,0,0,0,0,0,0
12099000438,3,1,0,1,0,0,1,0,1
1201100C038,224,210,178,17,5,3,2,1,32
12033000194,0,0,0,0,0,0,0,0,0
12101000045,0,0,0,0,0,0,0,0,0
12099000029,0,0,0,0,0,0,0,0,0
12101000064,78,52,35,11,2,0,4,0,17
12127000029,0,0,0,0,0,0,0,0,0
12127000027,0,0,0,0,0,0,0,0,0
12127000025,17,15,8,2,2,0,3,0,7
12127000270,9,7,6,0,0,0,0,0,1
12099000201,44,37,33,0,1,1,3,0,4
12039000046,11,11,6,1,5,0,0,0,5
12127000214,11,11,10,1,0,0,0,0,1
12033000089,0,0,0,0,0,0,0,0,0
12127000228,0,0,0,0,0,0,0,0,0
12127000141,0,0,0,0,0,0,0,0,0
12099000167,23,18,11,5,0,0,2,0,7
12099000299,38,35,23,3,2,0,7,1,12
