GEOID,TOTAL_POP,TOTAL_VAP,WHITE_VAP,HISPANIC_VAP,BLACK_VAP,NATIVE_VAP,ASIAN_VAP,PACIFIC_VAP,MINORITY_VAP
26039039006,2114,1650,1571,18,8,24,11,1,79
26039039004,342,282,266,5,0,8,2,0,16
26047047017,1492,1261,1102,30,18,110,4,2,159
26047047013,1295,1049,958,4,2,65,7,2,91
26143143004,2414,2076,1933,35,15,58,8,0,143
26143143008,1252,1130,1077,15,2,18,1,1,53
26143143005,2796,2416,2293,25,14,47,9,5,123
26143143013,2463,2052,1912,33,24,57,11,3,140
26143143014,1934,1622,1535,22,5,28,12,2,87
26137137014,2857,2374,2236,22,14,55,14,2,138
26137137004,1300,1034,983,7,4,24,2,0,51
26137137012,2725,2121,1979,27,11,67,15,0,142
26039039007,1268,1067,1010,16,11,19,5,2,57
26039039005,1918,1566,1466,19,6,39,17,1,100
26039039003,1867,1454,1298,59,16,56,16,3,156
26053053002,1135,933,878,11,5,26,7,1,55
26053053008,455,414,393,0,5,13,0,0,21
26137137001,3153,2407,2279,28,9,53,15,2,128
26137137008,1917,1441,1317,30,24,52,10,1,124
26137137003,1350,1141,1097,13,2,24,4,0,44
26137137005,1708,1387,1299,13,13,42,3,0,88
26001001001,966,879,830,12,8,14,4,0,49
26001ZZZZZZ,0,0,0,0,0,0,0,0,0
26005005023,2113,1738,1581,89,9,20,22,0,157
26005005024,2838,2316,2057,162,25,31,37,1,259
26005005010,2454,1839,1691,55,27,43,16,1,148
26005005009,3334,2383,2218,74,25,46,15,3,165
26005005008,2134,1572,1470,42,18,26,9,2,102
26005005017,3937,2872,2650,101,16,57,29,2,222
26005005029,3312,2448,2143,210,16,32,15,1,305
26047047022,711,614,543,6,11,43,5,1,71
26047047004,568,472,415,2,3,52,1,0,57
26047047008,954,771,707,6,3,42,4,1,64
26047047001,3061,2386,2173,46,21,115,19,2,213
26031031003,3133,2639,2401,11,16,173,19,1,238
26031031012,2160,1776,1624,7,5,120,8,0,152
26001001008,1076,952,918,8,3,17,3,1,34
26005005016,2462,1836,1685,37,32,53,13,1,151
26005005007,2060,1588,1001,517,27,49,8,0,587
26005005045,4435,3256,2930,123,45,98,31,1,326
26011011015,1701,1394,1286,23,6,67,6,4,108
26039039002,1161,952,886,15,2,36,4,2,66
26073073019,5959,5629,4066,278,863,112,295,3,1563
26073073017,3788,3007,2328,127,187,152,236,4,679
26081081204,2488,1954,1792,59,30,45,5,0,162
26081081205,4023,2943,2739,85,17,42,24,1,204
26081081051,3612,2589,2270,119,63,93,45,6,319
26081081192,3127,2367,2196,52,41,33,31,0,171
26081081191,3460,2600,2386,87,37,44,26,1,214
26081081052,2704,1874,1740,38,13,37,27,2,134
26081081208,2946,2202,1943,170,29,32,13,2,259
26081081206,4154,3216,2901,167,42,58,18,1,315
26081081199,3158,2538,2295,84,40,44,44,3,243
26081081045,3090,2259,2020,52,37,16,112,4,239
26081081006,1236,891,782,19,19,8,54,0,109
26081081238,1791,1423,1030,212,127,46,35,1,393
26081081119,2859,2632,2181,173,164,36,75,1,451
26081000002,1728,1366,1263,21,15,33,3,0,103
26081081209,2437,1916,1805,36,11,39,9,2,111
26081081023,4801,3353,2122,486,541,122,121,8,1231
26081081026,1669,1228,1004,59,37,25,87,2,224
26081081230,1885,1404,907,238,162,42,54,0,497
26081081012,2510,1853,1694,58,34,44,18,2,159
26081081011,2391,1709,1564,58,18,31,18,3,145
26081081009,1640,1255,1154,41,4,26,13,0,101
26081081123,1867,1475,1070,57,284,14,41,3,405
26081081187,2239,1676,1552,55,21,26,11,0,124
26081081186,2656,2087,1895,64,22,60,15,1,192
26081081081,3232,2405,1334,605,373,105,38,4,1071
26081081071,2114,1778,1150,282,249,73,59,4,628
26081081082,3655,2818,1629,655,430,82,56,1,1189
26081081074,2211,1783,1244,299,177,30,35,0,539
26081081020,3289,2433,2234,85,21,52,28,0,199
26107107003,2337,2002,1647,85,134,70,52,5,355
26107107005,2096,1601,1410,42,62,51,12,0,191
26107107001,2241,1689,1582,24,17,31,11,0,107
26107107016,2744,2105,1947,54,19,50,14,1,158
26107107006,3917,3139,2800,87,116,59,59,3,339
26107107004,3294,2886,2268,128,283,61,126,0,618
26095095002,1135,923,850,3,1,61,1,2,73
26095095001,169,140,126,0,1,12,1,1,14
26081081010,1939,1522,1427,32,1,20,21,0,95
26081081013,3571,2475,2308,48,20,40,47,0,167
26081081203,3602,2480,2302,58,21,29,45,2,178
26081081064,5210,3847,2086,478,815,81,414,13,1761
26081081233,2741,1881,635,1026,193,79,19,2,1246
26081081091,1432,908,167,492,230,71,19,0,741
26081081107,4232,3703,2699,297,475,71,153,10,1004
26043043011,2820,2204,2115,21,8,37,5,1,89
26043043009,2365,1933,1843,21,11,37,18,3,90
26043043010,2774,2218,2053,46,18,46,31,2,165
26081081017,3477,2558,2002,257,168,68,44,9,556
26081081014,1427,1171,1022,90,17,24,18,2,149
26081081223,2896,2148,1160,608,244,80,115,11,988
26081081225,3489,2670,1285,822,400,57,128,1,1385
26081081207,2295,1751,1534,132,15,33,13,0,217
26043043013,1066,906,871,5,1,15,3,0,35
26043043002,1678,1298,1242,5,5,29,8,0,56
26043043006,2544,1998,1862,51,21,44,22,0,136
26029029011,1515,1279,1180,21,1,44,8,2,99
26029029019,1939,1547,1441,25,8,47,11,9,106
26029029012,1854,1581,1451,14,12,79,11,2,130
26029029003,1425,1156,1082,14,5,35,11,1,74
26081081182,2083,1563,1408,56,23,42,10,0,155
26081081184,3133,2379,2244,25,27,26,30,3,135
26089089004,3152,2575,2381,53,22,60,11,2,194
26089089005,1763,1441,1300,73,3,33,15,0,141
26081081216,2819,2271,1873,121,105,61,105,0,398
26081081215,3276,2673,2175,178,201,53,50,1,498
26001001005,773,617,580,3,9,14,3,0,37
26065065025,3475,3219,2478,189,130,44,375,5,741
26065065027,2149,2068,1360,75,375,14,241,1,708
26065065038,2561,2154,1295,262,449,75,92,3,859
26065065070,2465,2031,1221,189,457,71,104,2,810
26065065066,2869,2382,1136,281,835,55,112,3,1246
26065065039,2509,2000,1282,239,375,76,62,7,718
26065065048,1543,1289,1032,110,87,39,34,5,257
26065065045,2715,2159,1536,284,258,66,19,0,623
26065065094,2889,2117,1235,75,106,29,676,0,882
26065065014,2670,2082,1803,86,101,46,37,1,279
26065065008,3703,2926,2192,146,389,85,100,5,734
26065065009,3306,2555,2044,125,212,60,119,5,511
26029029001,1288,1054,991,4,4,21,9,0,63
26029029014,1657,1337,1259,26,11,34,0,1,78
26029029016,700,595,560,4,4,20,0,1,35
26011011006,2050,1644,1544,31,14,40,9,1,100
26011011004,896,768,731,6,2,18,5,0,37
26011011001,554,421,411,0,3,7,0,0,10
26011011005,1001,808,760,13,5,22,4,0,48
26011011008,750,623,570,11,6,31,4,0,53
26069069009,1572,1268,1136,59,16,35,16,1,132
26029029018,259,231,217,1,0,13,0,0,14
26029ZZZZZZ,0,0,0,0,0,0,0,0,0
26029029017,266,233,223,3,4,2,2,1,10
26065065078,2023,1625,1023,250,286,45,36,1,602
26065065018,2564,2150,1841,86,74,28,117,1,309
26065065005,1749,1378,1242,59,13,28,19,4,136
26065065085,1809,1408,1331,23,3,27,17,2,77
26065065075,1702,1366,955,115,222,35,38,1,411
26065065064,1682,1385,990,94,231,35,34,2,395
26065065067,1895,1400,529,133,673,64,43,1,871
26075075053,2142,1585,1475,35,10,53,11,2,110
26075075062,2618,2054,1939,29,19,42,5,0,115
26075075048,1643,1310,1228,21,20,27,6,0,82
26065065036,2234,1836,1239,232,223,66,88,6,597
26065065043,2366,2034,1462,128,196,38,200,2,572
26065065011,2860,2318,1763,89,227,30,187,0,555
26065065012,2509,1802,1421,115,187,36,40,2,381
26065065015,2737,2031,1748,83,71,59,64,3,283
26065065024,3787,3351,2820,156,127,35,217,8,531
26065065089,2021,1471,1260,62,58,22,70,1,211
26065065044,2859,2223,1240,268,572,80,78,3,983
26065065059,2685,2146,1197,283,592,63,57,3,949
26029029020,1858,1486,1386,6,3,61,15,2,100
26029029002,3816,3044,2820,38,23,103,28,11,224
26075075014,2115,1649,1544,41,10,41,3,1,105
26075075047,1949,1480,1361,44,17,36,9,1,119
26075075041,2288,1842,1729,28,15,45,14,0,113
26075075033,3673,2955,2732,61,36,87,11,1,223
26075075035,3445,2647,2368,52,98,74,35,1,279
26075075034,3900,3012,2753,69,51,96,14,2,259
26075075036,2829,2280,2095,52,27,57,18,0,185
26065065072,2148,1739,1235,145,268,22,70,5,504
26065065071,2553,1942,1008,353,499,76,55,3,934
26065065001,965,776,704,35,11,8,11,0,72
26065065051,2121,1619,688,192,534,52,195,2,931
26065065117,2802,2153,1979,51,23,49,28,2,174
26065065113,1710,1341,1236,40,12,31,17,1,105
26065065115,3819,2960,2682,91,48,56,45,0,278
26065065068,1701,1320,843,114,320,39,37,4,477
26011011003,945,779,704,14,7,31,6,4,75
26011011017,907,786,761,5,6,11,1,0,25
26163163196,918,673,16,4,644,3,1,3,657
26163163520,1242,1159,319,25,780,12,36,1,840
26163163521,1199,851,18,10,827,13,1,1,833
26163163460,2367,2217,732,75,1317,31,91,0,1485
26163163461,1331,1153,48,19,1085,2,7,1,1105
26163005125,426,395,36,4,352,0,6,0,359
26163163519,1285,1182,94,6,1073,6,11,0,1088
26163163518,964,820,19,4,788,15,9,0,801
26163163085,2852,1868,1628,68,65,5,67,2,240
26163163083,1560,1477,1258,18,187,4,4,2,219
26065065031,2703,2388,1455,122,253,20,529,11,933
26065065080,1551,1214,840,121,210,27,29,1,374
26075075061,3534,2704,2202,132,262,82,22,3,502
26075075046,2801,2121,1971,54,31,38,10,1,150
26027027021,1096,852,789,11,19,25,4,1,63
26027027022,2576,2115,1880,81,54,73,6,1,235
26027027020,3051,2444,2110,180,29,91,12,1,334
26027027017,2119,1690,1433,76,113,59,12,1,257
26027027002,1953,1441,873,102,375,83,9,1,568
26027027003,1857,1382,1103,80,111,78,6,4,279
26027027004,1911,1369,1013,55,182,97,11,2,356
26075075016,2600,2030,1863,32,19,73,7,1,167
26075075019,2769,2035,1557,136,235,100,32,1,478
26075075029,1781,1446,995,52,353,22,13,2,451
26075075028,1586,1282,839,48,326,43,26,0,443
26075075011,2403,1848,1726,31,25,37,16,2,122
26075075045,1883,1463,1374,24,13,32,4,1,89
26075075006,2666,2169,2024,26,23,40,27,2,145
26065065034,3183,2307,1158,577,424,93,65,1,1149
26031031020,297,242,213,3,2,14,4,0,29
26031031018,1195,943,865,15,5,43,7,1,78
26031031008,557,466,430,6,1,25,4,0,36
26031031021,373,302,285,4,1,4,0,0,17
26031031009,977,807,762,8,4,23,2,0,45
26031031019,3080,2562,2387,31,4,96,19,0,175
26163163555,167,145,73,8,61,3,1,0,72
26163163517,303,247,25,10,202,10,4,0,222
26163163554,1625,1484,836,54,530,19,49,1,648
26163163928,2787,2254,1392,93,556,83,115,6,862
26163163933,2665,2204,1552,75,505,47,40,0,652
26163163666,2504,1975,1692,83,92,64,25,0,283
26007007011,1123,908,859,4,5,25,2,1,49
26007007006,1704,1428,1374,8,1,31,1,0,54
26007007015,2078,1616,1559,11,6,23,6,0,57
26007007010,1781,1467,1421,7,8,18,8,0,46
26007ZZZZZZ,0,0,0,0,0,0,0,0,0
26007007014,1640,1352,1289,12,3,30,2,2,63
26027027001,1993,1600,1213,15,294,51,9,2,387
26027027016,1755,1417,1218,28,103,26,37,1,199
26027027009,3787,2997,2154,121,470,150,62,0,843
26027027018,2179,1773,1651,40,15,44,6,4,122
26027027019,1571,1321,1256,19,24,11,3,0,65
26027027013,1602,1278,1176,21,31,26,13,0,102
26007007007,1740,1448,1368,17,10,26,14,4,80
26007007002,1798,1566,1464,20,23,26,19,7,102
26007007005,1851,1493,1388,27,6,41,12,3,105
26007007001,3485,2756,2540,55,25,88,20,10,216
26007007009,1562,1257,1160,32,16,25,9,1,97
26081081142,1427,1128,886,53,154,17,28,1,242
26081081103,2755,2141,1272,127,611,60,92,6,869
26081081022,4220,3172,2845,81,34,38,172,2,327
26081081149,2213,1865,1710,45,31,14,60,0,155
26081081120,3293,2334,820,220,833,40,449,5,1514
26081081067,3581,2614,2349,90,51,42,73,2,265
26081081061,3016,2155,1908,85,51,38,60,4,247
26027027014,3572,2637,2405,59,37,75,35,3,232
26027027012,3128,2465,2245,65,46,56,50,2,220
26075075054,3184,2361,1807,91,353,42,36,0,554
26075075005,3233,2458,1984,103,261,75,39,3,474
26065065033,3167,2430,1562,415,302,133,45,7,868
26081081034,2670,2011,1792,70,78,25,39,9,219
26081081030,3515,2902,2425,173,225,22,49,4,477
26081081007,1370,1036,943,30,19,11,26,0,93
26063063027,627,484,466,7,1,1,1,0,18
26063063002,1642,1300,1256,18,5,12,8,1,44
26097097013,2306,1913,1305,24,16,559,18,1,608
26097097010,1029,886,603,15,10,247,6,0,283
26027027010,2401,1871,1733,36,19,54,10,1,138
26163163032,3247,2604,1699,93,498,52,256,5,905
26163163060,3287,2651,1022,75,430,59,1067,1,1629
26163163093,1382,1177,973,63,74,26,44,0,204
26163163137,1868,1403,1065,89,193,39,24,0,338
26163163876,2665,2136,1784,159,77,78,21,2,352
26163163153,1818,1391,136,35,1200,34,9,0,1255
26163163183,868,665,112,9,537,12,5,0,553
26163163296,2122,1503,17,20,1467,22,10,1,1486
26163163297,1190,850,17,2,828,21,4,1,833
26163163841,3602,2784,1511,111,1054,64,57,1,1273
26163163752,2680,2177,1896,75,66,10,114,4,281
26163163899,2980,2407,1722,136,409,72,57,1,685
26163163134,2425,1798,1645,28,56,17,39,1,153
26163163125,2039,1579,1378,63,63,18,42,0,201
26163163605,803,593,17,1,570,7,2,0,576
26049049170,2896,2171,1894,50,106,48,60,2,277
26049049110,1881,1026,206,18,778,17,1,0,820
26049049109,2332,1717,666,61,943,30,24,0,1051
26049049099,1868,1367,107,24,1222,30,5,0,1260
26049049143,2012,1479,1152,42,233,47,5,5,327
26049049023,1507,1160,1038,36,17,47,5,0,122
26049049139,2119,1715,1543,44,31,48,21,1,172
26049049142,2025,1605,1484,35,24,39,15,0,121
26049049098,2043,1608,81,16,1498,24,1,0,1527
26049049097,1551,1212,644,79,454,35,10,1,568
26049049024,2525,2014,1790,80,50,71,8,0,224
26049049212,2788,2261,2061,64,31,60,27,0,200
26049049094,2428,2062,773,87,1120,54,61,7,1289
26049049095,1462,1157,769,77,236,57,25,2,388
26049049153,1929,1568,1187,66,259,34,26,5,381
26049000017,3006,2288,1820,76,258,53,61,5,468
26049049191,1507,1130,184,24,908,21,2,0,946
26049049064,1515,1104,51,8,1034,20,6,4,1053
26049049001,2863,2323,2167,37,16,55,21,1,156
26049049003,816,649,591,15,7,22,10,0,58
26049049007,2022,1516,1394,31,23,30,6,1,122
26049049091,1787,1268,561,38,634,28,13,0,707
26097097008,583,502,382,18,18,85,2,0,120
26097097001,100,96,88,0,3,4,0,0,8
26097097003,1917,1607,1306,20,8,252,4,0,301
26069069012,2084,1784,1713,9,14,44,3,0,71
26001001003,1087,968,910,9,1,35,2,2,58
26019019010,763,629,592,10,0,16,1,0,37
26019019002,2734,2288,2086,51,32,94,20,5,202
26019019009,2386,1882,1743,33,14,53,14,0,139
26107107011,1627,1243,1151,33,9,39,8,0,92
26163163516,404,338,8,2,325,6,0,0,330
26163163624,1478,1121,20,10,1090,18,7,0,1101
26163163860,1924,1451,753,45,495,35,94,5,698
26163163858,2076,1590,643,82,804,30,34,3,947
26163163889,3377,2732,2057,194,308,103,46,6,675
26163163887,2924,2267,1831,148,188,72,28,2,436
26163163877,3509,2899,2006,233,448,66,135,2,893
26163163523,1588,1523,670,66,607,29,158,9,853
26163163524,1487,1436,811,78,432,19,99,1,625
26163163531,781,721,285,17,386,9,27,1,436
26163163532,616,549,324,32,162,9,27,3,225
26163163522,1191,1013,490,119,355,22,43,1,523
26163163112,1807,1429,1263,81,29,17,35,1,166
26163163114,2041,1623,1362,107,83,33,36,2,261
26163163542,3642,2285,411,1594,281,120,15,2,1874
26163163336,843,651,49,1,561,6,33,0,602
26163163334,2853,1954,210,6,61,6,1677,2,1744
26163163553,1122,900,299,401,174,39,19,1,601
26163163551,1967,1576,375,648,551,82,5,4,1201
26163163557,655,529,48,20,456,8,0,2,481
26163163548,40,24,5,1,16,1,0,1,19
26163163558,565,422,34,66,321,12,8,0,388
26163163225,1104,841,93,7,726,19,5,1,748
26163163026,3559,2772,1690,227,537,73,233,4,1082
26163163075,2409,1605,1488,18,33,4,53,0,117
26163163656,1840,1291,1098,65,72,43,16,1,193
26163163246,603,461,25,4,422,6,3,0,436
26163163556,2176,1598,121,60,1398,24,5,1,1477
26049049022,1311,1008,869,25,85,10,8,0,139
26049049077,1936,1513,164,59,1283,43,4,2,1349
26049049066,449,336,28,5,301,12,3,0,308
26049049078,259,182,118,14,41,7,0,1,64
26049049165,1473,1268,1107,25,69,23,31,1,161
26049049164,2897,2107,1512,65,254,42,231,1,595
26049049163,2830,2126,1653,43,187,30,206,0,473
26049049159,2563,2012,1474,91,331,30,79,0,538
26049049161,3268,2511,1815,104,350,45,182,4,696
26049049182,1930,1523,1303,52,105,34,14,2,220
26049049205,1792,1344,1094,39,150,42,16,1,250
26049049017,3494,2743,2259,117,242,79,21,1,484
26049049010,2863,2324,2039,78,97,78,20,0,285
26049049008,2493,2097,1701,57,266,53,10,4,396
26063063010,1081,888,839,18,5,8,1,0,49
26019019013,579,497,458,6,3,21,0,1,39
26075075063,2931,2345,2177,51,19,55,19,0,168
26081081224,1967,1475,771,393,226,40,64,0,704
26081081055,1816,1341,1237,26,29,9,35,2,104
26081081109,2440,2073,1640,127,218,38,55,0,433
26081081248,1653,1352,1099,98,77,15,65,1,253
26081081249,1590,1239,876,136,85,25,115,1,363
26081081092,2297,1877,1674,98,37,29,31,2,203
26081081090,2363,1849,1665,78,24,34,27,12,184
26063063006,1674,1442,1386,24,6,19,0,0,56
26063063005,652,587,553,11,5,16,0,1,34
26163163235,1712,1462,496,43,862,15,57,2,966
26163163299,1197,883,26,4,842,14,2,0,857
26163163611,1324,1001,39,27,933,14,2,0,962
26019019004,677,569,524,12,9,16,5,0,45
26019019011,694,661,635,6,2,8,4,0,26
26163163020,3488,2705,1768,156,327,54,403,0,937
26163163854,3173,2574,2155,101,219,35,51,4,419
26163163687,2006,1492,1340,29,35,23,54,4,152
26163163572,1403,1058,47,133,877,39,6,4,1011
26163163574,1404,1119,38,79,993,26,2,3,1081
26163163316,1377,947,61,20,855,14,16,0,886
26163163494,924,695,15,5,673,5,3,0,680
26163163525,1576,1326,416,20,863,6,18,1,910
26163163868,3110,2127,951,86,1000,50,37,6,1176
26163163285,1404,1056,6,7,1044,15,0,0,1050
26163163722,2887,2157,435,54,1618,68,23,4,1722
26163163540,1376,1010,27,228,750,17,7,1,983
26163163417,1418,1036,20,9,1002,17,9,3,1016
26163163580,2312,2238,1065,45,421,33,683,6,1173
26163163529,1339,1195,277,36,820,23,53,1,918
26163163477,1043,985,546,35,252,12,140,1,439
26163163528,3611,3510,1802,68,1090,44,503,8,1708
26163163253,1537,1222,15,16,1190,27,4,1,1207
26163163583,1091,823,4,14,807,8,9,0,819
26163163582,1572,1084,14,4,1049,15,3,0,1070
26163163603,1407,991,37,13,930,8,1,1,954
26163163668,2727,2191,1920,81,75,66,26,1,271
26007007017,1967,1552,1484,7,4,35,7,1,68
26007007003,1631,1339,1257,15,12,28,11,0,82
26007007004,1432,1177,1112,25,4,17,12,0,65
26143143009,2401,2066,1943,40,11,40,7,1,123
26099099093,2651,2168,1625,65,357,55,58,2,543
26099099094,2960,2620,2103,67,352,43,52,2,517
26099099167,3368,2540,1709,67,641,70,36,1,831
26099099318,3842,3138,2483,53,402,66,135,1,655
26099099251,2011,1569,1207,26,142,24,164,6,362
26099099103,1558,1291,1224,20,13,30,1,1,67
26099099160,2598,2077,1915,67,21,37,19,6,162
26099000017,2791,2210,1552,56,518,47,40,2,658
26099099012,2280,1921,1752,36,39,31,43,0,169
26099099144,769,624,572,15,22,9,5,0,52
26099099273,4067,3512,2924,59,145,22,345,2,588
26099099180,3285,2731,2297,84,217,63,60,0,434
26099099181,2971,2515,2112,47,239,37,57,2,403
26163163803,3811,2634,1284,88,82,19,1160,1,1350
26163163749,2390,2113,1833,50,97,33,100,3,280
26163163750,1768,1454,1300,43,13,20,57,1,154
26163163347,507,367,7,8,357,8,0,0,360
26163163355,454,341,1,0,336,1,1,0,340
26163163353,1343,1018,9,12,990,22,3,0,1009
26163163351,1128,818,14,7,788,11,0,0,804
26163163284,1389,1085,15,6,1053,7,0,0,1070
26163163306,584,408,24,3,379,7,2,2,384
26163163562,2553,1797,280,1372,139,109,12,2,1517
26163163560,4373,2888,472,2194,200,150,6,1,2416
26163163569,1599,1071,190,784,93,53,11,3,881
26163163563,4034,2808,457,2141,219,133,21,2,2351
26163163567,4365,2892,462,2254,183,156,15,1,2430
26163163578,2864,1940,444,1350,100,101,8,1,1496
26163163017,2532,2068,1514,54,434,40,26,0,554
26163163016,1476,1155,864,43,179,50,27,1,291
26163163923,3314,2709,1704,80,772,53,76,0,1005
26163163924,2437,1926,1162,38,658,45,28,2,764
26163163922,3164,2553,1712,77,646,71,54,3,841
26163163897,2593,2086,1710,152,122,58,18,4,376
26163163113,2184,1778,1431,110,102,28,94,3,347
26163163005,2566,2049,1724,180,66,40,23,2,325
26163163009,1437,1131,910,127,41,44,20,2,221
26163163909,3185,2726,2372,128,108,70,32,3,354
26163ZZZZZZ,8,7,5,0,0,0,2,2,2
26163163851,3790,3093,2755,154,58,95,20,4,338
26163163028,1992,1507,1302,67,52,42,30,1,205
26163163980,1917,1568,1329,101,79,35,19,0,239
26163163667,2270,1830,1585,65,78,40,41,0,245
26163163847,1734,1239,604,237,364,28,5,5,635
26163163025,2697,1950,1491,102,190,56,90,4,459
26163163915,2708,2261,1898,130,149,54,37,2,363
26163163671,2324,1889,1682,74,21,32,70,1,207
26163163672,3116,2622,2443,45,17,47,52,1,179
26163163648,3021,2224,1140,397,608,100,19,2,1084
26163163845,3050,2458,819,69,1533,33,15,1,1639
26163163105,1392,1058,913,51,21,17,38,2,145
26163163104,1347,1004,881,55,25,11,25,2,123
26155155029,2422,1968,1847,41,9,49,9,1,121
26155155006,3046,2445,2232,68,23,78,19,3,213
26155155005,2076,1693,1570,50,13,41,12,2,123
26155155014,2639,2134,1976,58,30,52,15,4,158
26155155004,2332,1912,1801,36,9,30,23,3,111
26155155028,2740,2187,2054,40,12,45,6,6,133
26155155031,2296,1889,1790,22,3,46,12,2,99
26155155007,1891,1508,1365,44,10,50,7,3,143
26155155027,1688,1338,1251,21,10,35,1,1,87
26155155010,2054,1606,1544,22,2,27,8,2,62
26155155003,3280,2606,2463,49,6,58,12,2,143
26155155033,3687,2977,2739,59,36,66,16,3,238
26155155015,2179,1736,1574,68,21,40,17,3,162
26163163068,3056,2027,1539,72,84,23,287,0,488
26163163064,3441,2312,839,114,187,36,1130,2,1473
26163163039,1940,1285,619,73,109,13,477,0,666
26163163063,2536,2133,1449,60,330,23,269,3,684
26089089009,2048,1818,1675,63,5,58,12,3,143
26005005022,2760,2061,1894,59,23,53,7,4,167
26075075031,2057,1500,1126,69,229,42,43,0,374
26075075030,1604,1284,1066,54,117,22,18,0,218
26065065083,1927,1450,1317,58,18,24,17,0,133
26065065084,2305,1841,1708,55,15,48,5,3,133
26065065118,2439,1895,1740,50,31,30,27,1,155
26075075021,1229,847,603,41,184,14,5,1,244
26075075002,3792,2953,2581,91,120,60,84,1,372
26075075001,9373,8697,5191,283,3017,169,46,4,3506
26075075003,4397,3503,3038,99,233,68,54,2,465
26075075027,1301,830,385,57,345,37,11,3,445
26075075018,2619,1759,506,85,1120,78,6,4,1253
26075075023,2091,1519,1209,80,168,47,13,0,310
26075075022,2396,1760,1370,146,178,30,25,2,390
26075075058,2440,1834,1634,32,64,25,67,2,200
26019019012,343,287,275,0,0,8,0,0,12
26097097007,193,163,120,1,0,40,1,0,43
26097ZZZZZZ,0,0,0,0,0,0,0,0,0
26097097014,973,766,461,8,5,290,3,1,305
26097097009,611,512,450,2,4,57,2,0,62
26097097005,528,447,377,6,0,56,2,1,70
26097097006,117,110,85,0,0,25,0,0,25
26005005036,3788,2961,2672,86,65,76,25,0,289
26005005015,3686,2818,2602,72,22,81,25,0,216
26163163162,635,433,14,4,412,6,1,0,419
26163163159,648,489,44,8,431,24,3,0,445
26163163036,2641,1956,1560,62,174,31,107,1,396
26163163054,2378,1898,1561,51,71,31,163,0,337
26163163619,1284,976,11,8,944,12,3,1,965
26163163602,1602,1198,17,16,1154,24,12,9,1181
26163163213,748,557,7,1,543,12,1,3,550
26163163608,1304,954,13,9,930,10,2,0,941
26163163289,1176,892,2,6,884,7,2,0,890
26163163863,2491,1846,376,41,1403,20,13,1,1470
26163163808,2088,1613,1497,45,10,16,34,1,116
26163163807,2821,2231,1980,79,37,33,82,1,251
26163163769,1873,1498,1368,49,43,14,22,0,130
26163163862,1864,1396,771,40,513,40,11,2,625
26163163010,2116,1681,1445,149,23,43,23,2,236
26163163981,2846,2469,2117,152,83,81,36,6,352
26163163913,3454,2722,2433,125,54,63,24,1,289
26163163129,3150,2320,1944,29,221,2,121,1,376
26163163130,3090,2233,1804,37,234,10,128,0,429
26163163258,1304,988,16,12,952,18,6,0,972
26163163248,690,547,14,1,522,2,2,1,533
26163163771,1445,1204,1064,52,39,9,39,1,140
26163163950,2088,1647,1417,38,106,29,48,0,230
26163163097,1244,978,817,79,44,18,21,1,161
26163163988,2953,2458,2217,135,28,57,10,2,241
26163163870,2433,1939,1606,163,61,77,21,4,333
26163163871,2889,2300,1927,195,69,84,21,7,373
26163163973,2478,1952,1526,137,145,34,87,1,426
26035035002,3176,2380,2172,45,33,76,23,1,208
26035035007,3360,2557,2443,40,8,45,7,1,114
26049049166,2103,1682,1227,84,275,50,38,4,455
26049049156,2794,2106,1628,74,295,63,53,1,478
26049049184,2787,2134,1597,72,387,49,16,2,537
26049049185,1284,1009,578,44,341,19,11,0,431
26049049209,954,768,718,21,6,19,2,0,50
26049049146,2590,2103,1740,86,182,75,5,0,363
26049049177,1540,1218,1146,27,8,18,0,0,72
26049049147,1577,1224,1096,49,33,26,8,0,128
26049049213,2610,2078,1865,61,71,50,10,3,213
26049049116,3277,2545,1619,85,708,98,23,1,926
26049049113,3014,2578,1988,116,346,68,29,1,590
26049049121,1252,1024,644,33,296,34,15,0,380
26049049120,1301,1082,726,48,234,25,43,0,356
26049049042,2445,2013,1789,80,59,57,28,1,224
26049049092,742,494,225,49,184,10,29,0,269
26049049081,331,275,142,4,114,3,9,1,133
26049049082,157,134,85,4,34,4,4,0,49
26049049074,1248,916,661,74,149,31,8,7,255
26049049068,1791,1231,549,94,550,38,10,6,682
26049049151,2580,2085,1846,76,86,52,5,1,239
26049049122,1953,1452,1270,36,83,43,5,0,182
26049049175,1301,994,918,15,28,12,4,0,76
26049049009,2483,1940,1723,84,51,70,12,1,217
26049049186,2398,1795,1045,117,564,65,8,1,750
26049049101,2408,1750,1117,81,482,42,18,0,633
26049049199,1563,1276,1129,27,46,29,32,0,147
26049049200,1305,1025,947,13,13,27,11,1,78
26049049198,2075,1445,1196,52,110,30,48,0,249
26163163867,1789,1422,1188,48,110,53,13,1,234
26163163693,3085,2540,2291,39,122,20,52,1,249
26163163685,1142,939,748,33,106,19,28,0,191
26163163670,2789,2204,1981,79,29,35,60,0,223
26163163669,2551,1960,1792,69,18,31,45,0,168
26163163593,2145,1526,421,59,1012,23,25,3,1105
26163163777,2183,1845,1652,57,61,28,37,3,193
26097097012,907,788,736,6,3,31,2,1,52
26005005042,2530,1993,1853,31,30,49,15,0,140
26005005006,2211,1705,1519,55,47,49,16,1,186
26163163445,923,763,104,25,622,17,11,2,659
26163163447,1189,962,36,10,909,21,9,0,926
26163163390,1703,1239,143,5,1082,12,7,0,1096
26163163564,596,434,109,172,138,12,9,3,325
26163163293,1458,1020,9,5,1004,11,3,2,1011
26163163832,2379,1852,850,65,884,37,32,0,1002
26163163835,2278,1893,781,44,1009,22,33,2,1112
26163163139,2501,1935,1357,144,309,53,68,0,578
26163163140,2582,2014,1500,188,255,57,28,0,514
26163163733,3495,2598,1498,729,250,114,40,2,1100
26163163790,2431,1806,970,401,322,69,46,2,836
26163163856,1935,1542,1417,45,11,37,17,1,125
26163163088,2729,1754,1565,34,65,11,56,0,189
26163163078,2776,1839,1719,31,22,7,41,0,120
26163163006,2010,1632,1393,127,34,52,17,2,239
26163163007,1701,1377,1153,139,28,34,15,1,224
26163163079,2752,1760,1578,28,25,5,109,0,182
26163163967,1668,1304,1142,38,65,22,27,0,162
26163163331,1525,1137,38,24,1067,21,3,0,1099
26163163309,1306,1041,60,5,977,10,0,3,981
26065065086,2370,1847,1688,60,32,41,15,0,159
26065065111,3606,2819,2570,83,51,63,14,5,249
26075075020,2156,1526,1042,104,306,56,12,2,484
26075075060,3775,2938,2686,82,64,62,43,3,252
26163163633,1705,1284,56,26,1205,9,3,2,1228
26163163635,1762,1363,65,21,1277,11,7,0,1298
26163163916,2468,1992,1481,115,317,62,38,6,511
26163163734,3386,2556,1701,551,167,123,21,8,855
26081081110,3116,2484,2094,122,171,59,46,1,390
26081081181,3126,2688,1607,180,567,41,294,2,1081
26081081177,1159,982,756,48,99,18,57,0,226
26081081065,3127,2403,1345,205,628,52,196,1,1058
26081081093,4266,2716,378,1603,711,155,18,6,2338
26081081084,5623,3550,402,2584,549,173,37,2,3148
26081081083,3041,2338,1798,283,154,80,45,1,540
26081081190,1663,1337,1252,37,3,17,17,1,85
26081081189,2429,1889,1753,43,22,27,16,0,136
26081081075,2683,2312,2032,113,95,26,42,1,280
26013013006,375,325,307,4,7,8,4,3,18
26013013007,3551,2826,2312,24,15,460,23,5,514
26013013004,320,235,211,5,1,19,3,2,24
26075075007,1858,1554,1460,32,13,31,14,0,94
26163163177,1793,1257,9,11,1237,25,4,0,1248
26163163301,1502,1051,7,8,1031,18,1,0,1044
26163163941,2088,1798,1271,57,315,32,117,0,527
26163163965,2633,2245,1626,78,357,55,126,5,619
26163163969,2748,2202,1050,80,726,32,310,0,1152
26163163878,3699,2976,2159,294,309,107,113,2,817
26163163792,2793,2331,2154,36,23,18,76,5,177
26163163102,2352,1737,1547,85,36,18,45,2,190
26163163103,1601,1217,1097,44,34,17,18,1,120
26163163744,1483,1186,865,52,146,24,87,1,321
26163163703,2614,1930,528,28,1323,23,18,3,1402
26163163756,2626,2186,1639,89,272,43,124,1,547
26163163401,1667,1264,140,16,1105,24,3,0,1124
26163163388,2159,1500,116,14,1360,15,10,0,1384
26163163491,848,725,96,18,600,8,6,0,629
26163163493,610,521,85,11,420,10,5,1,436
26163163618,662,486,14,11,462,4,2,0,472
26163163638,2006,1557,70,33,1448,27,9,1,1487
26163163637,767,534,2,19,512,1,2,0,532
26107107009,1962,1527,1428,22,29,24,20,0,99
26107107012,702,562,520,13,6,19,4,0,42
26107107010,1785,1317,1220,27,22,43,6,0,97
26035035008,1108,896,851,14,5,14,5,0,45
26035035009,1785,1476,1383,13,5,43,8,0,93
26035035014,1805,1509,1393,40,15,48,5,1,116
26163163781,1822,1464,1341,32,28,23,32,0,123
26163163873,2350,1995,1492,167,217,68,32,0,503
26065065041,2928,2148,1088,351,585,90,43,12,1060
26065065065,1583,1178,742,133,233,66,13,2,436
26065065104,4742,3596,1885,122,217,40,1315,2,1711
26069069011,1266,1068,1020,8,2,24,1,0,48
26063063016,657,600,578,2,0,13,2,0,22
26065065061,3261,2494,1020,328,886,77,237,6,1474
26065065007,2910,2214,1721,120,227,44,102,4,493
26065065056,3021,2127,953,203,820,64,127,3,1174
26065065109,1869,1489,1369,31,9,47,9,1,120
26065065114,1199,946,869,19,3,30,3,1,77
26065065069,2910,2174,1157,328,582,70,72,2,1017
26065065026,3051,2439,1868,120,300,51,107,2,571
26065065106,2005,1624,1168,101,125,57,170,0,456
26075075038,1300,1050,967,22,6,38,7,5,83
26075075049,1155,905,861,11,8,17,7,0,44
26075075059,2067,1725,1323,45,277,40,35,4,402
26075075008,2869,2332,2208,45,15,30,24,4,124
26065065076,1276,1103,781,86,140,39,66,3,322
26065065077,1655,1424,1063,74,186,18,87,4,361
26049049072,1294,1007,663,128,168,48,3,2,344
26049049067,856,655,405,109,121,16,6,2,250
26049049071,1232,952,614,122,176,48,7,1,338
26049049137,1964,1547,1420,20,10,57,14,2,127
26049049115,2517,1995,1325,49,459,29,120,0,670
26049049118,411,288,99,17,164,2,7,0,189
26049049201,2419,1933,1648,65,98,65,16,3,285
26049049202,3412,2696,2453,92,30,92,4,3,243
26049049069,1696,925,258,23,646,10,5,3,667
26099099027,867,735,639,15,38,24,12,1,96
26099099039,967,819,732,11,25,24,9,0,87
26099099151,2164,1762,1518,43,123,37,16,1,244
26099099204,2183,1797,1660,32,38,20,30,0,137
26099099280,5114,3821,1810,114,1317,72,512,12,2011
26099099028,3059,2350,1764,89,362,60,55,2,586
26099099159,3277,2584,2279,122,59,62,14,22,305
26099099170,4175,3360,2535,83,533,125,76,6,825
26099099164,4103,3290,2171,65,911,79,42,5,1119
26099099168,4327,3366,2619,70,482,96,63,3,747
26099099001,3386,2720,2559,48,20,44,16,1,161
26099099217,4058,3048,2647,120,81,31,157,2,401
26099099208,1359,1036,941,28,9,5,47,0,95
26099099336,2533,2048,1872,66,23,22,44,2,176
26099099115,2329,1591,1439,32,46,27,40,0,152
26099099142,2514,1782,1532,53,79,25,81,2,250
26099099122,4990,3381,3057,57,93,38,116,5,324
26053053003,267,233,222,2,1,5,2,2,11
26053053001,1805,1489,1395,25,21,32,6,0,94
26163163859,1558,1080,185,47,801,26,24,1,895
26071071004,1647,1432,1367,14,4,22,6,0,65
26071071014,489,432,418,4,0,6,2,0,14
26071071006,269,229,217,3,2,7,0,1,12
26049049150,2970,2385,2149,72,74,47,18,0,236
26049049014,3063,2333,1649,123,453,88,22,0,684
26049049019,1936,1550,1332,56,98,31,20,0,218
26049049195,1488,1213,1122,21,19,30,5,0,91
26049049215,2618,2106,1890,61,72,53,8,0,216
26049049102,2002,1460,890,93,410,37,18,0,570
26049049103,676,508,301,42,148,17,6,0,207
26049049020,2447,1947,1747,35,89,41,14,3,200
26049049206,1293,1015,865,32,65,30,11,0,150
26049049173,1743,1283,1132,50,27,37,6,1,151
26049049058,1019,774,37,9,728,11,1,0,737
26049049059,1189,890,84,17,781,17,5,1,806
26049049204,1266,991,912,24,26,18,19,0,79
26049049133,3037,2392,2110,60,102,48,53,1,282
26049049039,2051,1620,1505,34,24,32,24,2,115
26049049040,3718,2975,2730,76,54,49,55,0,245
26049049210,1641,1362,1212,44,45,50,9,2,150
26049049207,1546,1297,1171,24,49,35,14,0,126
26011ZZZZZZ,0,0,0,0,0,0,0,0,0
26011011002,864,681,641,10,5,24,5,0,40
26011011011,986,871,835,12,0,20,1,1,36
26011011012,1432,1136,1038,20,7,49,9,1,98
26011011007,950,747,700,8,2,27,5,0,47
26065065010,4609,3359,2583,200,282,91,187,6,776
26065065063,1729,1449,1075,106,202,42,39,3,374
26065065110,2043,1548,1405,53,16,53,11,1,143
26163163927,960,812,735,12,12,4,44,0,77
26163163450,1457,1103,69,19,1004,15,8,2,1034
26163163441,654,528,15,5,500,4,5,1,513
26163163546,686,531,13,108,408,10,3,1,518
26163163470,2644,2277,332,58,1800,27,98,6,1945
26163163449,149,132,59,1,69,1,4,0,73
26163163475,1952,1302,14,17,1272,7,2,1,1288
26163163511,1365,1006,20,11,970,8,8,0,986
26163163536,1446,1098,29,24,1039,14,2,1,1069
26163163645,711,575,24,10,544,10,0,0,551
26163163027,3267,2502,1836,208,222,44,169,1,666
26163163590,1669,1101,146,96,846,15,3,2,955
26163163287,1503,1104,15,17,1063,17,7,0,1089
26163163800,3363,2829,2060,84,185,24,447,0,769
26013013003,416,351,305,8,6,29,4,1,46
26143143006,1864,1536,1426,32,8,42,12,2,110
26143143012,1682,1455,1353,14,3,59,1,2,102
26143143001,236,206,198,3,2,0,1,0,8
26163163224,797,602,92,16,490,9,4,1,510
26163163071,2904,1853,1673,35,81,3,44,2,180
26163163782,1819,1480,1280,51,75,34,39,0,200
26163163142,2171,1720,1364,105,155,45,46,0,356
26163163143,3108,2377,1853,177,207,57,49,3,524
26163163141,2453,1935,1528,147,163,61,24,1,407
26163163120,2507,1876,1637,48,84,29,69,3,239
26163163726,2857,2101,700,68,1271,61,12,0,1401
26163163741,2687,2022,1487,334,99,71,23,3,535
26163163842,2717,2036,601,50,1310,41,43,3,1435
26163163948,1898,1563,562,33,779,18,163,3,1001
26163163795,2557,1962,1422,64,52,15,391,0,540
26163163797,2367,1845,1511,30,33,14,244,0,334
26163163824,708,527,324,26,140,22,15,0,203
26049049108,1103,854,584,38,201,29,2,0,270
26049049083,330,253,109,9,113,11,2,1,144
26049049084,107,82,39,2,36,4,0,0,43
26065065050,1993,1627,1159,210,194,74,26,0,468
26065065087,2908,2124,1904,86,53,25,30,4,220
26065065088,3005,2458,2061,99,170,56,56,5,397
26017017021,2994,2482,2310,71,24,54,7,2,172
26037037014,1636,1387,1236,68,22,35,14,2,151
26037037021,1827,1423,1337,39,4,24,3,0,86
26037037028,2581,2077,1906,60,26,53,26,4,171
26037037007,2919,2203,2035,77,12,39,17,0,168
26037037022,2143,1673,1549,66,6,33,8,2,124
26037037018,2303,1789,1635,79,7,31,12,2,154
26037037006,1138,852,776,49,1,14,3,0,76
26163163736,3341,2550,1652,605,207,85,32,3,898
26163163454,834,639,57,10,573,12,9,0,582
26163163275,712,595,9,15,574,8,2,0,586
26163163090,2862,1756,1557,17,42,8,38,0,199
26163163576,517,402,51,48,304,4,9,2,351
26163163346,834,647,66,21,555,5,6,2,581
26163163100,3116,2762,1720,122,458,34,420,1,1042
26163163101,1632,1208,1065,45,31,11,55,1,143
26163163257,1824,1425,17,10,1392,20,6,0,1408
26163163170,1663,1299,17,9,1254,17,5,1,1282
26163163211,563,404,83,21,296,15,10,0,321
26163163203,1013,719,39,23,646,13,2,0,680
26099099186,1631,1427,1206,41,140,11,17,2,221
26099ZZZZZZ,0,0,0,0,0,0,0,0,0
26099099101,2489,2111,1835,89,111,40,21,3,276
26099099235,4255,3490,2514,86,528,32,319,2,976
26099099233,3915,3262,2331,68,594,46,211,0,931
26099099067,3863,3310,2397,117,601,56,133,5,913
26099099002,1932,1558,1485,12,10,29,8,0,73
26049049149,1994,1623,1502,43,18,30,8,1,121
26049049088,1149,855,89,20,745,6,5,0,766
26049049076,1206,921,107,17,766,28,1,0,814
26049049107,2451,1802,1205,105,423,61,16,1,597
26049049047,2741,2037,1838,45,39,62,35,1,199
26049049046,2420,1922,1796,29,20,24,33,0,126
26049049169,2842,2144,1764,80,172,47,55,0,380
26049049154,1977,1560,1240,53,171,27,72,1,320
26049049152,1558,1197,1020,42,42,33,46,2,177
26049049100,1879,1400,956,49,317,35,31,1,444
26049049031,1780,1400,1279,47,23,44,10,0,121
26163163594,1935,1374,158,35,1162,13,8,3,1216
26163163754,2700,2159,1782,83,94,26,148,0,377
26163163755,2573,2011,1522,78,238,43,124,5,489
26163163798,3093,2392,2132,82,21,15,122,0,260
26163163478,1196,1117,640,117,273,11,67,0,477
26163163533,1890,1841,1025,105,550,27,124,3,816
26163163473,1404,989,209,37,700,11,42,2,780
26163163715,3343,2579,2240,118,111,69,18,1,339
26163163716,3488,2466,1993,131,197,96,39,0,473
26163163003,2161,1726,1304,273,60,56,40,3,422
26163163817,2501,1958,1628,91,80,39,93,1,330
26163163849,1265,921,26,64,829,17,1,0,895
26163163730,2168,1583,409,56,1084,48,15,4,1174
26163163035,1958,1395,672,56,197,20,451,3,723
26163163065,2474,1784,1042,30,102,22,588,1,742
26163163462,1177,1055,177,26,839,20,15,6,878
26163163646,799,646,7,13,628,8,1,1,639
26073073012,2096,1611,1445,37,18,97,7,0,166
26073073013,2069,1585,1462,55,25,35,0,0,123
26033033004,1327,995,780,16,7,158,3,0,215
26033033005,671,613,513,7,0,80,1,0,100
26033033014,4665,3755,2860,96,55,662,51,11,895
26049049126,1377,1103,991,38,31,23,12,1,112
26049049127,1320,1062,927,30,74,19,11,0,135
26049049129,1825,1361,1235,34,30,27,23,0,126
26049049065,912,658,24,21,616,12,3,1,634
26049049062,1104,879,32,11,837,18,3,0,847
26049049038,2826,2083,1866,71,39,61,26,1,217
26049049051,666,543,39,22,471,24,0,1,504
26049049050,1353,1058,31,10,1000,28,3,0,1027
26049049141,1040,833,781,20,1,20,4,2,52
26071071015,87,78,78,0,0,0,0,0,0
26163163640,1423,1026,6,25,998,14,0,4,1020
26163163148,1170,912,5,4,893,11,3,0,907
26163163987,2316,1895,1683,97,37,48,17,1,212
26163163738,4287,3354,2359,509,357,124,30,4,995
26163163869,2385,1870,1555,139,79,50,37,2,315
26163163432,754,575,17,4,553,4,3,0,558
26163163676,1412,1102,1050,13,6,7,21,0,52
26163163678,2274,1787,1644,34,36,12,58,1,143
26163163411,942,662,39,9,616,13,3,0,623
26163163413,2237,1555,31,16,1500,19,4,0,1524
26163163444,1076,752,37,13,695,9,13,4,715
26163163410,1407,980,61,5,910,4,2,2,919
26163163701,2779,1899,405,24,1439,28,10,0,1494
26163163328,1112,773,62,8,698,8,5,0,711
26163163709,1130,918,51,14,850,9,4,0,867
26163163710,2053,1522,60,22,1440,17,6,0,1462
26163163415,1703,1232,32,8,1186,16,3,1,1200
26163163456,926,760,39,2,708,20,5,2,721
26163163506,723,542,68,22,456,4,2,0,474
26163163198,971,749,5,7,731,16,4,0,744
26163163250,1246,1023,14,4,996,2,4,0,1009
26163163251,1174,941,20,6,913,3,5,1,921
26163163587,1822,1231,131,126,967,25,0,0,1100
26163163589,2768,1840,604,386,798,33,24,2,1236
26049049060,1201,925,62,17,832,17,5,1,863
26049049032,2261,2094,1874,46,91,43,30,0,220
26093093041,2558,2079,1940,30,15,48,26,1,139
26093093045,3230,2655,2531,30,10,46,34,0,124
26093093043,2612,2175,2044,30,8,28,41,0,131
26093093016,1972,1584,1492,35,2,40,13,1,92
26111111011,1060,846,756,50,0,22,6,0,90
26093093014,3246,2589,2414,51,0,50,24,8,175
26093093017,2201,1767,1653,29,8,52,14,2,114
26093093072,1724,1347,1264,30,4,20,11,2,83
26093093069,3237,2520,2327,64,16,45,49,3,193
26093093015,3608,2667,2530,39,1,53,10,0,137
26163163391,1003,796,179,17,586,10,13,0,617
26163163176,1662,1199,19,13,1159,17,4,1,1180
26163163468,1550,1411,528,30,799,28,40,0,883
26163163318,1384,956,30,19,898,7,10,0,926
26163163265,1203,903,11,10,882,12,1,1,892
26163163057,1975,1582,847,34,185,22,481,0,735
26089089006,1126,991,949,8,7,14,4,0,42
26089089012,2883,2361,1787,141,31,386,24,7,574
26063063003,404,329,304,17,1,10,1,0,25
26093093023,2534,2084,1947,43,8,50,25,0,137
26093093027,1875,1533,1412,33,22,33,26,0,121
26093093022,1311,1049,998,18,1,16,6,0,51
26093093051,2824,2252,2106,46,3,38,29,4,146
26093093079,2721,2154,1984,55,9,60,29,2,170
26111111010,1049,817,779,10,3,9,2,0,38
26111111029,1781,1381,1225,48,49,27,18,3,156
26111111024,887,742,695,14,5,22,1,0,47
26111111022,1491,1226,1097,33,28,32,22,0,129
26111111007,1601,1232,1120,25,5,30,19,2,112
26111111030,2335,1808,1612,40,56,46,32,2,196
26111111018,1541,1113,1003,28,15,17,38,0,110
26111111038,1914,1411,1164,59,30,29,106,5,247
26155155016,2359,1765,1586,82,26,52,21,3,179
26033033012,4833,3945,2903,84,71,824,48,7,1042
26123123013,2390,1840,1684,71,17,36,18,4,156
26123123009,2008,1519,1417,52,10,24,4,0,102
26123123022,741,613,488,17,70,30,3,3,125
26093093063,2190,1672,1571,22,4,56,14,0,101
26111111005,1138,916,885,10,7,11,5,0,31
26111111028,1852,1511,1376,43,35,33,15,1,135
26111111044,1826,1476,1334,53,26,28,26,1,142
26111111027,1509,1150,1036,36,22,15,26,1,114
26111111040,1716,1333,1229,29,14,28,22,3,104
26093093077,3053,2382,2209,53,29,54,29,3,173
26093093073,1650,1396,1301,28,10,44,9,2,95
26049049002,3412,2697,2473,65,24,77,14,3,224
26049049044,3041,2408,2220,47,14,74,19,1,188
26049049197,1848,1552,1265,26,165,31,40,0,287
26049049196,909,723,636,25,29,17,6,0,87
26049049174,1451,1154,1021,21,54,44,3,1,133
26163163652,2819,2215,1862,131,101,99,21,4,353
26163163654,1938,1404,1235,68,38,43,12,0,169
26123123005,2224,1706,1533,89,9,59,11,1,173
26123123001,2764,2042,1749,206,6,63,8,3,293
26099000011,1805,1363,1278,24,5,18,25,0,85
26099099334,2370,1992,1894,24,20,20,19,3,98
26099099254,2766,2134,1673,48,78,47,271,2,461
26099099265,3680,2853,2146,218,262,80,126,2,707
26099099202,3289,2599,2356,64,41,29,72,5,243
26099099211,3421,2804,2357,121,123,42,150,3,447
26099099203,1503,1227,1097,50,21,35,14,1,130
26099099255,3796,3037,2744,84,80,42,68,2,293
26099099153,1487,1288,1151,43,29,35,10,2,137
26099000015,2826,2233,2001,44,112,23,36,3,232
26099099050,2427,1830,1445,45,258,35,33,5,385
26099099319,4034,2972,1379,97,905,76,491,2,1593
26099099140,2338,1676,1426,48,89,22,70,0,250
26099099136,2373,1833,1511,56,101,36,108,0,322
26099099130,2090,1805,1522,41,164,15,43,0,283
26099099141,2735,1836,1486,37,143,23,131,0,350
26099099117,3102,2279,1866,72,145,54,125,3,413
26099099018,1981,1481,1331,31,47,18,38,2,150
26099099326,1592,1171,711,53,319,27,65,5,460
26013013002,2192,1862,768,20,596,475,7,0,1094
26111111053,2040,1633,1541,28,10,37,10,2,92
26071071011,1052,898,864,7,1,23,0,1,34
26071071016,1200,1008,954,11,6,24,7,0,54
26163163743,3360,2742,2091,134,327,70,105,1,651
26163163958,2285,1779,1500,66,102,55,34,0,279
26163163966,2757,2195,1810,113,181,40,47,1,385
26163163830,2066,1657,1096,69,414,41,19,2,561
26163163888,2533,2077,1331,100,531,40,70,0,746
26123123028,254,200,179,4,0,14,1,0,21
26123123014,2112,1600,1460,53,15,34,13,2,140
26123123026,2518,1918,1733,110,9,22,13,4,185
26123123030,1133,886,801,16,19,33,5,0,85
26123123021,1292,1059,963,24,15,35,7,2,96
26123123010,2008,1547,1377,88,21,47,8,4,170
26123123011,2603,2005,1863,63,7,36,12,0,142
26063063019,698,563,548,8,1,4,2,2,15
26063063029,437,339,333,3,0,1,1,0,6
26063063024,705,591,579,2,1,6,1,0,12
26063063018,401,325,317,4,1,2,0,0,8
26063063025,1155,917,880,13,2,19,4,1,37
26063063011,152,138,132,4,0,2,0,0,6
26063063026,2678,2129,2010,56,10,28,9,0,119
26063063015,352,311,290,15,2,8,0,0,21
26063063023,1384,1232,1141,72,11,18,3,0,91
26063063014,739,615,596,4,3,7,0,0,19
26063063028,999,794,771,7,4,2,4,2,23
26063063022,15,15,11,1,3,1,1,1,4
26063ZZZZZZ,0,0,0,0,0,0,0,0,0
26063063013,1604,1282,1197,16,5,28,28,1,85
26155155017,3526,2656,2401,103,36,75,15,3,255
26155155020,3242,2596,2409,69,17,55,23,2,187
26155155011,1424,1013,931,32,13,20,11,0,82
26155155012,1522,1214,1135,21,14,13,8,1,79
26155000001,7,6,0,2,2,0,0,0,6
26155155024,2045,1549,1431,32,13,47,10,2,118
26155155023,2091,1597,1472,29,8,48,4,2,125
26155155021,1523,1250,1170,36,5,16,12,0,80
26013ZZZZZZ,0,0,0,0,0,0,0,0,0
26013013001,492,437,413,1,0,22,2,0,24
26013013005,550,443,334,5,1,106,0,0,109
26163163037,2770,2130,1563,40,109,19,389,0,567
26035035013,2435,2060,1885,51,22,70,8,2,175
26035035006,1807,1508,1428,20,7,35,6,2,80
26035035001,676,501,491,2,1,6,1,0,10
26035035010,2150,1700,1557,34,36,47,8,0,143
26035035004,1125,963,904,17,7,24,4,3,59
26035035015,459,377,352,7,5,13,1,0,25
26035035011,893,707,667,5,3,18,3,0,40
26139139076,1231,1012,890,79,4,8,24,1,122
26139139077,2501,2032,1752,175,26,26,52,3,280
26139139075,2765,2240,2027,106,18,30,46,1,213
26139139001,3496,2444,2249,102,14,31,30,2,195
26139139007,2223,1585,1465,46,20,22,21,5,120
26139139006,1676,1235,1149,48,13,18,9,0,86
26139139087,2547,1996,1653,184,24,44,77,0,343
26139139090,2043,1487,1292,121,10,29,27,0,195
26101ZZZZZZ,0,0,0,0,0,0,0,0,0
26101101007,2824,2345,2090,72,35,115,17,1,255
26101101001,657,541,521,7,3,7,4,0,20
26101101009,4022,3560,2703,88,518,220,19,1,857
26101101016,834,720,646,11,7,48,2,0,74
26163163233,1402,1144,221,25,875,18,14,0,923
26163163151,1591,1217,153,39,986,32,26,0,1064
26163163155,469,360,49,7,308,5,1,0,311
26163163886,3970,3056,2334,215,350,118,40,1,722
26163163665,2747,2253,1843,120,157,72,43,1,410
26163163096,2109,1657,1290,123,149,45,42,0,367
26163163829,3713,2949,1845,109,906,66,25,1,1104
26163163826,2014,1641,1043,52,481,51,25,0,598
26163163407,1670,1125,36,15,1053,21,14,2,1089
26163163408,1311,856,32,12,819,8,0,0,824
26163163256,1808,1405,24,10,1363,17,3,2,1381
26163163762,1782,1429,1306,36,20,29,28,0,123
26017017012,3733,2993,2591,211,74,62,23,2,402
26087087008,2712,2039,1870,53,11,56,8,2,169
26139139085,2565,1906,1779,54,2,39,3,3,127
26139139065,3443,2448,1166,761,70,39,447,0,1282
26159159021,1968,1522,1216,224,20,64,1,2,306
26159159011,2930,2347,2134,94,50,62,5,1,213
26077077031,2317,1858,1556,60,129,37,66,0,302
26123123015,2486,1931,1723,125,19,39,5,4,208
26123123018,3298,2430,2067,258,7,56,16,3,363
26005005021,2457,1833,1425,242,97,30,45,5,408
26005005005,2796,2319,1960,173,67,82,21,0,359
26005005044,2176,1647,1531,27,12,44,14,0,116
26159159029,1723,1358,1067,73,168,41,13,1,291
26159159031,2638,1987,1473,185,202,84,39,3,514
26159159012,2546,1954,1605,224,52,83,4,7,349
26077077009,2386,1928,1667,73,69,76,20,0,261
26077077007,2577,2000,1792,36,71,55,26,2,208
26077077006,2364,1857,1727,51,20,25,8,2,130
26077077087,3679,2754,2075,133,196,59,294,3,679
26077077089,2379,1893,1576,44,61,32,177,1,317
26069069007,2213,1891,1755,45,17,40,17,1,136
26069069001,424,381,367,3,1,0,3,0,14
26123123003,463,374,327,14,5,10,5,0,47
26093093031,2716,2111,1916,90,28,47,22,0,195
26093093061,2403,1931,1760,57,29,45,23,2,171
26111111015,1684,1339,1242,21,4,37,6,0,97
26111111052,1270,955,873,34,0,24,9,0,82
26093093020,2247,1879,1745,33,17,31,32,1,134
26093093021,1637,1267,1208,11,4,17,6,2,59
26093093080,3286,2371,2174,55,20,66,25,3,197
26093093081,3333,2713,2551,60,20,58,11,1,162
26093093074,2282,1899,1767,46,12,45,12,2,132
26093093050,3231,2431,2288,53,13,42,13,1,143
26093093049,2951,2250,2016,74,12,98,20,4,234
26093093052,3570,2560,2309,84,31,43,58,3,251
26005005001,3665,2753,2424,111,91,85,26,7,329
26055055009,2375,1998,1884,39,13,35,12,0,114
26055055023,3630,2816,2644,54,12,54,27,1,172
26055055022,3124,2504,2334,57,14,40,11,1,170
26041041021,468,412,367,6,1,39,1,0,45
26077077034,3562,2437,1118,528,738,119,26,6,1319
26077077005,1904,1455,1360,30,13,30,8,0,95
26033033017,1276,997,697,13,7,272,8,2,300
26087087003,3148,2483,2309,56,14,74,18,0,174
26017017019,1576,1281,1145,63,20,26,17,0,136
26017017018,1803,1378,1260,54,20,32,11,1,118
26087087031,3153,2491,2293,55,23,74,12,2,198
26087087034,3571,2692,2523,74,10,57,3,6,169
26087087026,3091,2512,2336,62,17,51,13,3,176
26069069005,2663,2223,2071,45,16,50,35,0,152
26019019003,484,427,411,5,0,5,2,0,16
26035035018,3635,2914,2704,44,12,90,18,4,210
26035035016,1548,1072,1022,28,0,15,2,0,50
26033033001,1567,1222,599,8,8,604,7,3,623
26033033015,2966,2377,1760,19,15,546,21,3,617
26033033006,973,857,775,4,2,63,0,1,82
26033033016,653,560,381,5,1,163,1,0,179
26033033013,3839,2953,1968,33,33,887,22,9,985
26033033010,632,527,465,7,5,52,2,3,62
26033033019,474,447,412,1,1,28,1,0,35
26033ZZZZZZ,0,0,0,0,0,0,0,0,0
26033033002,2000,1574,1334,16,2,210,5,2,240
26033033009,2791,2455,1548,45,714,127,10,0,907
26037037026,2188,1675,1548,44,21,38,7,0,127
26037037025,1481,1111,986,64,12,41,3,1,125
26037037034,2444,1786,1707,37,9,21,2,1,79
26057057014,558,437,405,21,1,5,0,1,32
26057057020,813,652,610,27,0,10,0,0,42
26057057007,870,685,641,20,9,13,0,1,44
26057057010,2832,2286,2056,133,8,43,19,2,230
26057057006,1293,1012,959,30,3,10,4,0,53
26033033003,187,140,122,4,3,14,2,2,18
26135135006,1158,1014,955,10,3,29,12,1,59
26123123025,547,425,401,5,6,8,5,0,24
26123123019,238,200,178,7,1,3,0,0,22
26085085003,383,321,309,5,2,7,0,0,12
26085085008,655,530,487,7,7,24,2,0,43
26085085015,755,614,324,9,254,22,4,1,290
26085085001,1153,874,818,7,13,26,1,2,56
26085085007,810,707,663,16,8,17,2,2,44
26105105009,329,287,274,6,0,4,1,0,13
26085085013,258,229,206,10,7,8,3,2,23
26085085002,422,355,310,4,23,12,6,0,45
26085085009,398,369,348,7,4,5,1,0,21
26085085012,373,342,320,6,3,8,2,0,22
26105105022,1044,848,798,11,8,20,2,0,50
26135135001,1016,889,827,12,6,29,8,5,62
26135135002,1588,1283,1194,23,5,35,5,2,89
26135135005,1150,864,829,11,3,14,8,1,35
26135135007,1037,878,817,22,3,23,9,4,61
26159159028,1106,904,629,48,186,24,12,0,275
26159159032,1334,1079,841,106,77,31,12,1,238
26077077046,1558,1377,905,83,304,41,55,1,472
26077077074,2828,2280,1886,97,142,40,83,10,394
26077077078,1675,1452,1036,88,146,25,131,1,416
26077077036,2450,1886,1324,118,356,52,45,3,562
26079079011,1250,987,916,19,8,25,4,3,71
26079079008,2626,2066,1915,33,15,62,23,1,151
26079079003,1475,1193,1109,16,4,38,8,0,84
26161161100,2277,1792,1591,50,72,47,42,2,201
26161161071,2115,1651,1497,41,32,20,50,1,154
26161161127,2259,2046,1485,89,286,26,138,4,561
26161161136,3771,2911,1358,206,1244,73,79,1,1553
26161161035,2324,1911,1580,103,72,32,114,2,331
26161161049,1301,1045,832,40,62,3,86,3,213
26161161109,2429,1994,1647,68,109,43,119,6,347
26161161108,2715,2019,1479,98,170,42,243,6,540
26161161101,2792,2198,1347,101,147,17,572,3,851
26161161046,2084,1761,1394,83,138,29,118,0,367
26161161054,2091,1626,1287,78,45,16,187,5,339
26161161010,2521,2007,1088,78,475,38,324,5,919
26161161068,1311,1126,1060,16,12,14,17,0,66
26161161059,1617,1338,1248,28,5,26,17,0,90
26161161094,2120,1670,1481,52,33,40,39,0,189
26161161043,2851,2484,1977,150,105,38,199,1,507
26161161098,2490,2020,1833,61,24,20,69,2,187
26161161119,2432,1839,1691,46,11,31,37,0,148
26161161117,2056,1608,1461,26,21,44,36,0,147
26101101012,1567,1342,1242,27,14,44,9,2,100
26101101010,1342,1055,972,32,9,45,1,1,83
26101101011,398,313,281,10,3,10,2,0,32
26139139046,2308,1880,1363,295,113,42,81,1,517
26139139003,3982,2898,2634,126,37,53,29,2,264
26139139002,4028,2857,2482,217,63,57,18,4,375
26161161092,2912,2070,1642,89,84,40,217,6,428
26161161088,1435,1059,908,27,25,13,74,2,151
26161161081,2671,2234,1522,104,232,54,305,2,712
26161161086,5239,4399,2774,168,977,96,403,2,1625
26161161146,2470,1922,1202,103,509,51,69,1,720
26161161150,3927,2940,1742,150,819,69,153,3,1198
26161161026,3669,2736,1234,171,801,38,507,3,1502
26161161077,3865,2926,2586,109,95,83,40,1,340
26161161120,4237,3766,2348,412,990,70,44,2,1418
26161161103,1931,1566,1403,41,33,34,44,3,163
26161161107,2063,1531,996,80,65,14,369,2,535
26161161072,2540,1975,1756,42,24,32,105,2,219
26161161073,1762,1304,858,178,100,40,111,7,446
26161161017,2045,1669,1174,65,60,7,358,4,495
26161161055,2689,2218,1370,74,95,19,650,2,848
26161161016,1851,1397,1115,55,40,14,162,3,282
26161161019,3084,2721,1686,88,91,24,792,6,1035
26161161011,1613,1242,499,30,68,16,620,0,743
26161161021,3539,2900,1552,100,134,38,1059,5,1348
26161161020,2588,2154,1294,84,68,21,666,9,860
26161161091,2995,2263,1761,77,67,17,322,5,502
26161161089,2911,2460,1638,101,168,25,497,5,822
26161161097,2912,2335,2046,78,62,49,94,1,289
26161161138,1989,1588,1005,102,399,65,26,0,583
26161161129,2792,2548,1473,144,655,41,233,16,1075
26161161058,2588,2027,1710,66,134,77,20,0,317
26161161056,2615,2038,1633,53,233,30,48,6,405
26073073002,2877,2177,1504,111,19,566,13,4,673
26033033018,332,303,254,3,4,40,1,0,49
26121121003,3192,2495,2278,53,37,67,17,0,217
26121121026,2142,1536,603,113,779,57,5,1,933
26121121029,2696,1941,667,222,977,77,12,6,1274
26121121030,3106,2419,1329,203,820,60,16,2,1090
26093093057,3795,3074,2654,162,92,80,41,24,420
26093093065,3392,2565,2359,63,4,48,58,1,206
26057057008,2484,1957,1844,66,11,19,8,0,113
26005005040,3443,2824,2574,127,18,45,33,1,250
26005005039,873,760,708,28,8,3,7,1,52
26005005011,1370,1230,1162,29,11,15,10,0,68
26005005025,1002,806,743,36,7,8,6,2,63
26005005032,4120,3146,2858,89,42,72,50,2,288
26005005033,2745,2143,2015,43,24,25,17,1,128
26147147009,1931,1560,1507,13,9,16,3,0,53
26151151007,889,709,657,26,1,14,2,0,52
26151151024,2713,2192,1996,64,59,34,12,1,196
26151151003,745,560,518,23,1,21,1,0,42
26151151026,1343,1073,1009,12,2,29,2,0,64
26147147051,2992,2276,1887,111,148,89,31,4,389
26147147059,2438,1967,1796,56,40,40,11,1,171
26147147061,2720,2164,1945,68,90,37,20,1,219
26147147052,2754,2195,1826,92,155,98,24,7,369
26147147017,2120,1682,1572,38,24,30,5,2,110
26147147034,2405,1919,1828,26,13,32,4,0,91
26147147008,2059,1596,1457,44,20,41,6,1,139
26111111006,1254,1012,946,19,15,29,5,2,66
26111111036,1450,1132,918,35,35,22,110,0,214
26111111037,2104,1573,1380,46,44,25,47,0,193
26055055025,2665,1980,1847,43,16,48,9,2,133
26055055034,2892,2389,2132,77,47,87,29,2,257
26055055030,2265,1941,1817,41,16,30,14,2,124
26055055029,2686,2272,2087,68,21,47,31,2,185
26055055018,1212,948,896,6,3,23,4,0,52
26055055020,4296,3457,3084,147,45,99,42,17,373
26085085014,2384,2166,881,978,296,65,26,2,1285
26085085004,469,415,399,5,2,5,0,0,16
26111111014,809,635,608,4,2,12,5,1,27
26093093044,2594,2145,1962,52,22,46,9,1,183
26093093040,3580,2744,2559,57,13,47,39,1,185
26093093032,2049,1577,1464,37,6,31,23,2,113
26093093047,1695,1370,1263,34,7,41,10,0,107
26093093025,1818,1425,1352,30,5,13,14,0,73
26111111039,2339,1650,1323,60,48,32,170,5,327
26111111045,2223,1690,1567,45,12,46,11,0,123
26111111026,1691,1341,1142,59,83,34,16,4,199
26093093026,1993,1634,1493,41,14,31,46,1,141
26093093028,998,769,700,16,9,26,11,0,69
26093093018,2460,1956,1796,43,27,43,36,5,160
26093093046,1798,1502,1409,26,3,35,9,2,93
26063063031,1960,1533,1456,42,8,21,2,0,77
26093093068,3093,2432,2257,58,18,51,28,1,175
26111111001,1262,982,925,10,11,35,1,0,57
26111111013,1319,1113,1042,21,8,20,6,1,71
26093093005,2018,1593,1456,49,11,21,34,1,137
26093093011,2398,1807,1684,31,12,22,33,4,123
26147147025,2703,2062,1872,67,39,42,28,2,190
26147147055,3502,2786,2210,162,307,85,32,1,576
26147147067,3640,2939,2770,31,12,59,48,2,169
26147147068,3445,2686,2507,50,27,55,11,0,179
26147147042,2923,2286,2102,52,37,36,25,1,184
26057057005,1773,1498,1242,63,162,24,1,0,256
26151151025,2301,1954,1836,43,16,33,10,1,118
26151151018,1200,899,842,24,3,25,3,0,57
26145145038,2025,1518,198,356,974,52,5,0,1320
26145145067,1395,1139,1053,42,6,21,6,5,86
26145145068,1788,1399,1275,45,14,38,3,2,124
26145145048,3431,2671,1646,347,614,46,27,3,1025
26145145045,3710,2798,1497,452,776,60,41,2,1301
26145145044,3214,2384,1398,340,578,62,21,1,986
26145145051,2826,2132,1345,259,479,42,16,3,787
26057057016,2348,1849,1682,84,17,41,20,1,167
26057057002,2849,2183,1858,213,50,58,7,3,325
26057057017,7010,6122,3935,391,1671,97,26,5,2187
26057057011,516,417,396,14,1,3,0,0,21
26061061006,1878,1417,1338,6,5,33,18,3,79
26055055011,1526,1219,1114,24,5,60,3,0,105
26159159007,2811,2156,1934,79,36,48,27,2,222
26159159003,2502,1921,1623,175,49,70,9,1,298
26077077041,3749,2612,1661,128,722,64,56,0,951
26077077032,2483,1662,628,378,609,99,20,8,1034
26077077084,3574,3010,2529,108,145,58,141,2,481
26077077039,2689,2035,1629,104,207,45,42,0,406
26159159010,1939,1479,1146,190,57,66,12,2,333
26077077035,2604,1999,1514,143,265,59,31,3,485
26077077050,1988,1557,1215,68,204,43,32,1,342
26151151028,1263,985,953,12,2,16,3,1,32
26151151023,1110,830,774,27,1,16,2,0,56
26151151012,1013,718,664,25,3,14,3,1,54
26147147065,1945,1535,1432,31,22,16,9,0,103
26147147066,1795,1418,1305,27,10,38,21,0,113
26147147054,3015,2318,1793,120,306,80,9,1,525
26121121035,2279,1877,1578,67,155,53,24,0,299
26121121036,2111,1737,1444,116,92,59,24,1,293
26121121034,2627,2125,1598,76,375,51,16,1,527
26121121005,2333,1687,1457,74,32,74,19,0,230
26121121006,1614,1226,1066,56,45,41,7,1,160
26121121007,2938,2314,2070,84,38,71,17,4,244
26121121004,2542,1979,1800,63,9,55,21,0,179
26121121012,2828,2245,2030,69,28,64,12,2,215
26159159006,2521,1868,1657,79,38,50,30,3,211
26159159016,3416,2630,2026,294,176,110,20,2,604
26077077103,2138,1729,1442,66,118,38,55,3,287
26077077105,3323,2399,1963,81,70,28,247,3,436
26077077003,2476,1951,1788,31,29,67,14,0,163
26077077069,2307,1775,1690,29,9,28,15,3,85
26077077004,1955,1495,1396,7,12,37,23,0,99
26077077024,4873,4360,3134,224,623,76,302,2,1226
26077077099,4296,3083,2762,80,86,78,53,3,321
26077077029,3432,2550,1670,136,651,69,32,4,880
26077077057,3033,2289,1286,119,780,85,48,2,1003
26077077048,2087,1538,1154,109,200,53,26,1,384
26129129001,1543,1269,1197,22,4,29,5,0,72
26129129010,1439,1182,1089,24,8,46,0,0,93
26133133017,991,754,723,3,1,14,0,0,31
26133133007,1148,838,803,7,4,13,7,0,35
26147147020,3406,2748,2604,37,10,56,8,1,144
26147147021,3704,3148,2988,49,26,36,33,1,160
26147147010,1968,1551,1467,26,10,14,15,0,84
26147147060,2342,1875,1669,70,66,42,11,1,206
26147147041,2219,1818,1708,34,10,38,10,1,110
26147147057,3096,2184,1392,176,501,89,30,1,792
26147147013,1893,1712,1639,10,7,34,5,1,73
26147147014,933,882,858,0,0,17,0,2,24
26147147015,2549,2127,2009,26,16,47,9,0,118
26147147031,2624,2107,1904,59,66,52,5,0,203
26147147007,2208,1734,1576,57,23,34,20,1,158
26147147024,2963,2525,2346,36,68,19,39,0,179
26147147032,2343,1905,1797,37,8,28,10,2,108
26147147012,3071,2520,2362,27,9,77,12,0,158
26147147064,1724,1376,1282,29,11,25,16,0,94
26147147006,1869,1508,1420,22,12,27,10,0,88
26147147049,2289,1882,1664,83,57,40,30,3,218
26147147001,2126,1734,1618,30,2,45,7,0,116
26147147002,2070,1688,1566,28,15,39,8,0,122
26147147048,2440,2023,1813,46,96,27,37,2,210
26147147040,1860,1515,1411,25,18,37,7,0,104
26147147045,2733,2136,1984,67,10,37,23,6,152
26147147043,2127,1745,1637,37,21,45,8,2,108
26147147011,1541,1234,1169,19,8,10,13,1,65
26151151017,3485,2876,2729,86,7,32,11,2,147
26147147063,3199,2566,2408,35,13,47,28,0,158
26147147036,3362,2758,2544,75,52,52,24,0,214
26147147035,2596,2002,1857,61,30,36,5,0,145
26147147037,3651,2854,2614,66,45,64,24,2,240
26147147018,2376,1855,1757,25,10,35,12,0,98
26123123029,1479,1163,886,52,144,47,14,6,277
26123123012,1978,1536,1369,51,38,53,7,2,167
26117117020,1908,1482,1405,19,5,33,8,2,77
26117117007,1141,885,831,19,3,27,8,2,54
26117117019,2716,2058,1846,98,32,53,23,3,212
26077077026,2663,2037,1155,190,571,48,75,2,882
26077077054,2943,2266,1796,79,314,32,35,0,470
26025025032,3517,2757,1980,74,611,70,24,0,777
26025025034,1957,1476,1395,18,8,37,2,2,81
26025025017,2436,1763,1096,169,423,57,17,2,667
26025025041,2964,2414,1967,91,176,90,78,0,447
26025025002,1101,741,285,58,369,34,2,0,456
26025025057,1809,1314,1176,34,61,33,5,0,138
26147147053,3360,2469,1932,155,228,117,37,1,537
26151151019,1578,1219,1120,58,2,34,6,0,99
26151151011,961,681,627,32,2,15,2,0,54
26147147062,3292,2425,1823,103,394,85,16,0,602
26025025030,2361,1923,1671,91,70,52,19,2,252
26025025031,3320,2637,2272,86,175,69,32,5,365
26025025009,2139,1684,1218,53,313,48,47,3,466
26025025010,3479,2681,1942,97,534,64,51,2,739
26025025008,2444,1883,1709,43,18,85,6,2,174
26025025051,3167,2519,2303,80,34,59,31,0,216
26025025056,4282,3377,2843,121,282,93,35,0,534
26025025054,3093,2433,2214,64,64,54,23,1,219
26025025019,3146,2371,1640,150,482,89,34,2,731
26077077102,2427,1801,1649,25,31,23,66,1,152
26077077066,4101,3244,2271,264,402,50,234,4,973
26077077058,1678,1264,1115,19,65,9,41,0,149
26077077043,1490,1252,905,86,182,55,37,1,347
26077077068,1926,1469,1141,35,213,39,17,3,328
26077077095,2614,2068,1882,45,33,55,24,3,186
26077000020,1993,1588,1323,66,104,44,40,1,265
26077077037,2379,1850,1324,138,323,52,28,1,526
26077077055,2408,1834,1108,168,477,69,14,6,726
26077077030,2524,1671,489,137,989,50,19,4,1182
26115115019,3072,2568,2300,91,48,88,18,4,268
26115115020,1454,1207,1110,35,6,39,3,1,97
26115115018,2878,2030,1794,75,41,80,19,0,236
26115115003,2221,1757,1618,31,10,53,6,1,139
26163163855,1321,1071,923,46,43,34,11,3,148
26115115055,1410,1169,1019,64,37,38,17,1,150
26115115034,2498,2000,1853,47,20,57,5,0,147
26115115049,1747,1244,788,64,358,35,2,0,456
26115115063,2405,1940,1783,37,49,36,7,4,157
26115115014,2910,2233,2099,51,5,36,17,2,134
26115115016,2408,1894,1765,34,12,45,22,1,129
26115115023,2708,2199,2014,45,44,46,27,3,185
26115115024,3365,2440,2286,45,16,57,12,1,154
26115115044,1586,1264,1168,29,18,32,9,0,96
26115115045,2199,1669,1473,68,70,39,5,1,196
26115115017,2730,2136,1881,87,56,70,35,0,255
26115115025,2496,1998,1847,47,16,63,8,0,151
26115115022,2072,1565,1438,42,23,34,20,1,127
26115115026,1803,1426,1241,78,30,64,4,0,185
26115115046,3562,2724,2349,112,166,71,21,1,375
26115115047,3374,2616,1966,166,318,117,25,0,650
26115115058,1993,1642,1472,54,46,34,20,2,170
26115115051,3428,2831,2534,83,102,67,27,1,297
26115115053,2073,1772,1549,86,79,27,29,0,223
26115115060,2701,2198,2063,35,22,56,1,0,135
26115115050,3455,2662,2293,130,99,72,49,3,369
26063063030,1210,1005,968,15,5,8,9,0,37
26063063017,727,569,542,5,4,13,6,0,27
26151151030,1656,1358,1277,30,5,23,9,1,81
26147147047,4234,3209,2826,281,6,58,18,4,383
26147147023,2515,1981,1879,38,13,33,12,1,102
26147147004,1897,1492,1422,31,5,29,2,0,70
26151151005,1161,924,864,21,2,16,3,0,60
26147147056,2993,2243,1822,108,216,68,29,2,421
26091091035,3035,2465,2324,40,13,45,12,1,141
26115115010,2212,1795,1655,53,17,34,22,0,140
26157157001,1379,1089,1008,33,4,18,5,1,81
26157ZZZZZZ,0,0,0,0,0,0,0,0,0
26157157032,604,514,459,30,3,12,6,1,55
26121121050,2074,1589,1471,40,34,16,17,2,118
26121121049,2019,1615,1392,71,59,45,33,3,223
26121121025,2385,1847,775,170,827,47,36,4,1072
26121121024,2296,1895,1063,116,677,38,6,3,832
26121121009,4228,3111,2759,135,48,116,21,0,352
26157157031,1590,1283,1179,36,7,26,9,0,104
26157157030,2091,1668,1556,24,9,55,1,1,112
26157157023,2276,1820,1716,27,15,43,7,0,104
26157157007,1229,900,846,22,2,21,3,0,54
26157157003,1410,1140,1060,17,7,42,5,0,80
26121121031,6104,5366,2316,306,2654,94,23,3,3050
26121121027,2430,1804,893,183,656,65,15,1,911
26121121048,2709,1937,429,66,1386,69,20,0,1508
26121121045,2428,1787,252,74,1424,44,15,5,1535
26121121052,2270,1866,1581,108,119,25,28,3,285
26121121046,2378,1522,123,28,1363,15,5,2,1399
26149149018,3468,2604,2430,74,21,43,28,0,174
26125125078,2966,2373,2140,49,38,43,67,1,233
26125125476,3113,2417,2049,67,102,48,138,6,368
26125125482,2998,2309,1931,69,143,26,118,1,378
26125125478,2768,2257,1790,57,194,40,174,2,467
26099099323,3460,2485,1271,79,955,70,110,4,1214
26099099322,3627,2502,1178,71,1107,61,101,0,1324
26099099300,38,29,20,2,6,0,0,0,9
26045045049,2812,2299,1988,95,92,59,57,0,311
26045045038,1765,1342,1257,25,6,29,10,0,85
26045045045,1748,1335,1251,22,12,23,8,0,84
26045045046,2050,1586,1482,42,14,25,6,5,104
26125125376,2655,2389,791,211,1282,26,99,15,1598
26125125441,3846,2893,1867,80,122,36,778,0,1026
26125125440,2437,1861,1264,54,76,16,434,0,597
26125125446,4015,3310,1827,149,284,28,1022,3,1483
26021021014,2411,1806,1438,176,88,56,45,7,368
26021021047,4670,3993,1437,495,1275,75,656,38,2556
26021021046,1888,1436,853,196,211,44,105,18,583
26021021008,2556,2034,429,71,1456,35,26,2,1605
26021021041,1909,1508,1266,86,94,44,12,0,242
26021021026,1821,1482,1289,57,54,48,16,2,193
26021021003,3548,2495,1259,139,1049,38,7,0,1236
26021021049,2451,1939,1615,65,77,35,116,6,324
26021021050,2690,2013,1680,81,45,44,142,3,333
26079079007,984,782,728,14,3,29,1,1,54
26079079004,2497,1987,1837,30,15,63,8,4,150
26079079001,668,586,574,4,2,1,3,0,12
26145145022,2313,1895,1775,70,13,8,17,0,120
26145145006,2142,1682,1578,52,18,33,6,1,104
26145145021,2435,1886,1722,93,10,34,10,0,164
26145145025,1896,1467,1392,40,10,12,5,1,75
26145145024,2360,1981,1846,53,29,21,22,2,135
26125125279,3910,3220,1055,298,1779,49,52,3,2165
26125125281,3729,2675,1065,898,558,110,89,6,1610
26125125270,2877,2224,2032,57,30,41,23,3,192
26125125423,3585,2888,1736,67,76,30,981,1,1152
26125125428,3000,2354,1746,41,81,25,445,0,608
26125125444,3995,3547,2420,144,263,36,683,1,1127
26125125443,3231,2682,2142,78,123,25,299,0,540
26125125445,3901,3101,1931,194,224,51,679,4,1170
26125125166,3594,2985,2586,146,70,59,94,1,399
26125125168,2260,1921,1709,107,35,36,22,4,212
26125125167,1554,1335,1164,44,38,26,51,3,171
26125125162,3305,2484,2091,105,136,36,91,4,393
26113113016,1124,794,753,26,7,7,1,0,41
26113113011,637,485,456,16,0,5,9,0,29
26135135003,431,378,345,13,1,13,10,1,33
26125125300,1374,1043,821,41,35,9,123,0,222
26125125299,2600,1972,1602,49,28,10,253,0,370
26125125164,3403,2384,2122,81,59,41,69,0,262
26125125115,3682,2877,2103,84,389,38,271,1,774
26125125293,2836,2145,228,180,1724,31,19,0,1917
26125125292,3414,2290,238,273,1769,35,9,0,2052
26125125294,2722,1955,269,273,1419,43,24,0,1686
26125125054,2251,1834,1422,52,69,5,252,2,412
26125125458,3546,2872,2452,162,90,65,78,2,420
26125125463,1820,1606,1365,75,104,32,41,0,241
26125125457,3135,2649,2295,141,88,45,52,1,354
26055055036,2688,2134,1989,38,16,64,25,2,145
26055055002,1456,1248,1165,16,18,32,8,0,83
26145145074,2111,1697,1533,86,33,24,22,1,164
26145145083,2449,1812,1657,64,28,29,16,0,155
26145145080,2895,2041,1882,62,17,41,23,1,159
26145145049,3788,2725,1369,397,907,68,27,0,1356
26145145076,1354,1092,1040,16,3,19,9,0,52
26145145073,1627,1270,1125,36,20,13,74,0,145
26145145075,2125,1746,1624,54,20,24,21,0,122
26153153002,563,478,427,0,1,47,0,1,51
26153153003,469,386,345,2,0,34,1,0,41
26125125375,1890,1340,585,4,690,7,21,0,755
26125125371,2072,1739,355,19,1313,22,31,1,1384
26125125343,2959,2409,2126,85,69,40,79,1,283
26125125274,3064,2283,190,159,1896,60,19,1,2093
26125125275,2581,1986,446,330,1181,39,32,1,1540
26125125436,2975,2325,1168,29,60,7,1054,0,1157
26125125188,2828,2388,2037,80,105,53,92,0,351
26125125278,2087,1634,599,236,706,43,53,6,1035
26125125277,2333,1892,1069,221,509,67,46,3,823
26125125419,1716,1497,1332,42,63,34,18,1,165
26117117015,2600,1890,1667,126,23,48,10,4,223
26117117029,1348,1008,924,47,15,13,5,1,84
26045045051,1873,1565,1322,75,68,58,36,1,243
26009009004,1150,964,911,6,4,28,2,0,53
26003003006,1986,1647,1481,23,5,122,5,0,166
26003003007,2865,2464,1651,23,581,176,11,5,813
26153153012,808,674,597,4,0,70,0,1,77
26153153004,1305,1112,994,7,3,103,4,1,118
26125125192,4319,3784,2148,153,709,67,715,4,1636
26125125356,2681,2417,2000,68,161,33,118,4,417
26125125210,2209,1848,1207,46,233,20,323,2,641
26125000013,3332,2486,1605,168,431,38,214,9,881
26125000010,1867,1853,1792,5,7,5,46,0,61
26125125152,1010,765,695,8,25,9,12,1,70
26125125487,2585,1890,1505,32,115,11,185,6,385
26125125477,1195,1048,860,36,105,15,32,0,188
26125125040,2061,1758,1304,50,179,21,202,1,454
26125125061,2569,2091,1798,21,80,8,176,1,293
26125125062,1891,1519,1267,38,42,6,158,1,252
26125125128,2034,1795,1459,77,157,52,45,0,336
26125125432,3837,2923,2093,59,149,39,561,6,830
26121121021,2417,1869,1688,82,8,47,18,3,181
26121121011,2965,2377,2211,76,27,28,9,0,166
26023023009,3196,2509,2089,239,76,61,59,1,420
26023023011,2751,2012,1700,146,49,74,30,1,312
26023023017,458,330,302,14,2,8,0,0,28
26023023012,4842,4114,3016,141,845,72,27,1,1098
26023023008,3368,2271,1971,180,34,36,44,3,300
26023023007,1181,648,632,7,0,8,1,0,16
26125125009,3027,2588,1752,165,269,67,343,3,836
26125125173,3447,2523,2039,84,72,48,257,3,484
26125125177,2995,2303,2070,57,28,26,86,0,233
26125125175,3587,2672,2252,123,68,43,145,2,420
26125125418,1105,885,832,22,5,12,10,0,53
26125125002,2276,1840,1714,28,26,41,22,0,126
26125125290,3647,2538,727,769,943,64,88,7,1811
26125125291,2628,1956,661,538,648,33,106,7,1295
26125125289,3152,2295,358,450,1451,55,22,0,1937
26125125280,1774,1283,359,413,476,37,44,1,924
26125125155,1366,1015,945,20,12,12,21,0,70
26125125153,1149,854,805,11,10,5,16,0,49
26125125345,2382,1953,1747,67,31,29,65,2,206
26125125346,2080,1830,1563,83,73,17,87,3,267
26125125337,2786,2402,2107,100,53,32,105,1,295
26125125395,1855,1527,664,57,736,44,56,2,863
26125125335,2123,1733,1566,56,20,45,15,1,167
26125125485,2874,2360,1482,46,534,14,257,3,878
26125125222,2757,1951,960,41,75,10,847,0,991
26125125223,3461,2380,1248,135,231,58,707,0,1132
26125125171,2045,1715,616,30,1039,40,23,2,1099
26125125172,2043,1723,466,28,1203,21,23,1,1257
26125125363,2406,1918,895,155,849,32,73,3,1023
26125125364,2153,1790,510,39,1146,26,91,1,1280
26125125336,2478,2201,1887,75,77,21,130,1,314
26125125272,2627,2105,1906,59,53,29,53,0,199
26125125341,3271,2819,2440,73,113,31,144,2,379
26125125296,3182,2701,2337,126,74,21,145,2,364
26127127001,1425,1186,1088,72,4,13,4,1,98
26127127009,1156,826,746,37,1,24,7,0,80
26127127010,2053,1574,1121,380,14,60,7,1,453
26127127011,2028,1551,1225,259,12,44,16,1,326
26127127005,999,754,593,125,5,35,4,2,161
26127127006,1271,995,886,46,7,50,7,1,109
26125125467,3741,2994,2187,310,358,53,65,2,807
26125125465,3624,3110,2568,243,130,74,68,0,542
26125125282,3253,2423,672,548,1003,53,189,2,1751
26125125373,1691,1370,204,22,1105,27,30,5,1166
26125125405,1719,1324,1093,32,100,7,89,0,231
26125125039,2141,1620,1365,42,88,10,109,0,255
26125125407,1124,939,746,28,100,8,46,0,193
26125125020,2307,1800,1632,38,55,5,50,0,168
26125125349,2003,1587,1396,41,63,22,61,1,191
26125125125,2136,1877,1613,64,96,26,71,1,264
26125125129,1272,1155,957,56,76,19,42,3,198
26125125111,6676,5557,1362,171,1034,43,2929,10,4195
26125125006,2867,2266,1466,168,310,37,278,0,800
26125125004,4025,3777,2693,192,622,52,216,8,1084
26151151027,1524,1160,1064,53,4,32,6,0,96
26015015003,3417,2705,2484,60,17,91,14,2,221
26015015017,1755,1370,1251,42,13,43,5,5,119
26015015018,2381,1816,1682,64,9,22,10,1,134
26015015009,1803,1443,1306,52,16,34,18,0,137
26015015012,3734,2703,2537,65,14,38,9,3,166
26015015002,1947,1486,1399,35,9,27,7,2,87
26161161140,2506,2033,1269,149,508,48,47,5,764
26161161116,3308,2638,2418,34,50,50,54,1,220
26161161061,2252,1954,1798,53,32,32,29,1,156
26161161074,2674,2204,1958,49,89,59,27,2,246
26161161110,1827,1483,1358,33,16,27,17,0,125
26161161090,4069,3247,1799,493,478,79,420,5,1448
26125125161,2857,2242,1994,104,40,39,35,1,248
26125125370,2144,1734,765,59,835,37,59,0,969
26125125490,2848,2241,1691,40,189,15,288,1,550
26125125484,3180,2438,1985,44,194,28,157,1,453
26125125491,2673,2124,1669,29,190,12,217,0,455
26157157009,2741,2179,2031,74,7,30,16,0,148
26157157002,1987,1631,1514,34,14,31,8,0,117
26157157015,1549,1216,1099,60,6,21,3,1,117
26157157006,1952,1517,1331,77,27,43,18,3,186
26157157005,2376,1854,1666,89,25,35,21,0,188
26157157021,1476,1125,1047,23,2,38,3,0,78
26157157026,1995,1605,1530,19,9,23,6,1,75
26157157022,1485,1166,1090,21,3,29,3,5,76
26147147070,1903,1454,1375,26,8,21,11,1,79
26147147069,3180,2506,2334,33,56,49,10,0,172
26151151022,558,419,410,7,1,1,0,0,9
26147147050,2542,2064,1847,60,76,31,30,2,217
26125125403,2546,1882,1582,50,165,6,75,0,300
26151151031,1799,1468,1389,39,11,19,4,1,79
26147147027,3586,2792,2576,64,57,45,39,3,216
26161161145,3705,2863,1591,97,1031,55,75,2,1272
26125125042,2544,1933,1665,45,54,21,146,0,268
26125125041,2208,1702,1482,35,80,13,93,3,220
26125125121,3553,2969,1845,125,785,60,109,3,1124
26125125120,3709,3009,2014,238,544,49,212,4,995
26125125032,2867,2192,1613,73,204,28,257,3,579
26125125434,2710,2037,1325,35,50,20,589,0,712
26125125433,2987,2277,1479,59,78,24,633,1,798
26125125379,2166,1764,50,21,1667,20,22,0,1714
26125125383,2847,2420,92,22,2267,27,35,4,2328
26125125303,2953,2309,1610,83,143,18,444,6,699
26125125304,3770,2967,2203,133,210,36,359,2,764
26125125314,1680,1274,1176,24,17,5,38,0,98
26015015008,1822,1341,1227,43,20,34,10,2,114
26015037120,1892,1535,1441,30,10,22,12,0,94
26015015022,1994,1578,1483,41,13,25,14,0,95
26015015013,2841,2306,2171,39,9,39,6,1,135
26015015020,1997,1535,1433,24,13,27,14,0,102
26015015021,4295,3006,2700,131,50,65,39,5,306
26015015006,3329,2559,2384,55,20,64,6,0,175
26125125021,2309,1757,1563,50,35,19,75,1,194
26125125089,1304,1039,836,52,91,28,40,0,203
26125125399,1266,1026,891,31,55,12,29,2,135
26125125190,2929,2399,2003,73,135,59,126,1,396
26145145027,1792,1493,1389,59,0,24,8,2,104
26145145070,2416,1985,1848,60,9,48,2,0,137
26145145013,1384,1064,892,71,65,26,2,0,172
26145145079,1458,1161,1040,45,16,24,27,0,121
26125125249,2238,1874,1499,31,123,19,185,1,375
26015015014,1599,1176,1126,10,2,24,10,1,50
26015015007,1997,1487,1345,56,9,53,19,0,142
26067067004,2138,1661,1560,45,11,31,8,1,101
26067067012,8219,7840,4243,524,2957,108,23,4,3597
26067067016,3971,2947,2709,115,20,64,25,0,238
26067067014,1935,1440,1256,112,28,24,18,1,184
26067067025,2664,2068,1910,96,16,34,9,2,158
26067067008,2399,1832,1704,69,11,30,7,1,128
26067067022,1954,1477,1318,101,12,21,9,1,159
26149149003,2122,1684,1569,63,7,21,12,0,115
26149149004,1915,1351,1194,86,25,33,11,1,157
26149149010,3729,2873,2492,79,192,55,45,4,381
26149149024,3464,2505,2010,138,221,103,52,5,495
26149149006,1469,1127,952,114,4,21,16,1,175
26149149022,2620,1879,1387,396,34,41,11,0,492
26149149020,2736,2001,1204,544,79,66,12,2,797
26149149019,3134,2243,1740,314,42,36,75,2,503
26131131010,2253,2006,1883,21,15,56,14,1,123
26149149023,2039,1529,1236,168,26,39,13,2,293
26149149021,2689,1912,1164,606,45,51,25,0,748
26041041003,300,273,265,1,1,6,0,0,8
26041041014,297,267,224,3,1,27,3,0,43
26041ZZZZZZ,0,0,0,0,0,0,0,0,0
26041041017,2545,1981,1820,29,11,88,9,1,161
26041041006,746,618,574,7,1,27,1,0,44
26041041018,2712,2158,2021,25,10,77,13,0,137
26041041010,1812,1400,1270,14,22,66,15,2,130
26041041016,772,658,578,8,5,62,4,1,80
26041041008,3304,2670,2437,45,4,134,32,7,233
26041041004,1023,845,790,4,4,39,2,0,55
26041041015,2019,1676,1590,16,1,46,4,0,86
26041041007,3104,2463,2180,60,14,153,33,3,283
26067067023,1964,1516,1387,70,13,28,8,0,129
26149149002,3325,2490,2399,20,7,41,13,1,91
26149149009,1161,862,829,8,2,17,4,1,33
26067067011,1640,1311,1211,50,16,27,9,5,100
26067067013,1636,1121,971,83,24,37,10,1,150
26067067029,2011,1468,1369,34,14,29,7,0,99
26067067030,1936,1422,1331,33,13,28,8,2,91
26145145014,1384,1014,85,52,866,27,4,1,929
26145145020,928,756,721,16,3,15,2,0,35
26145145003,1525,1212,1083,67,20,27,4,0,129
26145145002,2481,1993,1846,51,22,63,9,0,147
26145145056,2858,2330,1802,143,288,34,56,2,528
26145145055,3075,2564,2023,189,230,46,82,2,541
26145145084,1534,1257,1085,96,42,25,4,0,172
26145145015,1433,1020,86,83,840,25,3,0,934
26145145035,2650,1899,72,118,1718,17,9,0,1827
26145145029,4911,3472,2874,188,252,33,84,1,598
26145145078,1372,1192,1090,43,24,9,19,0,102
26131131006,203,178,166,3,0,4,3,0,12
26131131005,628,531,517,3,1,6,1,0,14
26041041009,4230,3360,3080,43,28,166,27,1,280
26041041020,1645,1369,1273,14,2,86,1,0,96
26125125012,2086,1926,1087,59,257,19,495,2,839
26125125011,2854,2474,1350,152,452,65,445,3,1124
26125125108,2810,2279,1797,69,241,43,122,0,482
26125125103,3346,2683,2022,60,295,21,273,3,661
26125125104,4050,3141,1963,65,548,38,514,1,1178
26125125323,3322,2565,1902,101,98,32,413,7,663
26125125320,1870,1486,1092,57,67,27,230,1,394
26125125324,2063,1732,1286,69,65,15,280,4,446
26125125361,1193,898,86,16,792,10,5,0,812
26109109009,1109,948,902,5,4,20,5,1,46
26109109008,501,444,430,2,2,6,3,0,14
26041041001,700,566,514,5,5,38,2,1,52
26041041023,3101,2483,2359,10,5,77,9,2,124
26145145053,1859,1517,1257,96,113,25,19,0,260
26139139063,4062,2943,2356,218,65,39,256,3,587
26021021031,2867,2090,1791,78,48,35,118,0,299
26021021061,3036,2364,2050,121,57,97,22,3,314
26021021060,1669,1263,1042,86,37,62,16,0,221
26121121067,1383,1115,1035,37,3,29,2,0,80
26121121023,1627,1233,1132,48,11,29,8,4,101
26021021016,2096,1675,1536,32,28,21,47,0,139
26021021043,3038,2438,2142,99,89,70,16,3,296
26021021042,4361,3330,2746,153,268,114,31,5,584
26045045011,3266,2656,2105,159,161,50,160,6,551
26045045026,2171,1700,1564,61,8,25,19,3,136
26045045027,1836,1455,1338,64,6,19,16,0,117
26045045028,1624,1276,1147,52,12,41,4,2,129
26045045037,3227,2529,2323,77,33,63,20,2,206
26045045047,1947,1511,1399,47,11,35,13,3,112
26045045025,1458,1158,931,82,77,29,26,2,227
26045045040,3003,2163,618,210,1170,66,153,0,1545
26045045042,2610,2049,1874,74,23,35,18,2,175
26045045036,1102,879,808,33,21,13,10,1,71
26045045033,2509,1966,1744,109,48,50,13,1,222
26045045009,1769,1358,1304,17,9,11,11,4,54
26045045050,2455,2019,1811,63,53,39,46,1,208
26145145040,1936,1461,150,161,1155,36,2,1,1311
26145145050,3726,2811,1824,390,520,90,21,0,987
26125125380,1707,1330,270,40,998,20,26,1,1060
26125125201,3326,2617,2270,86,24,36,189,2,347
26125125071,2045,1711,1511,45,32,29,63,1,200
26125125072,1916,1658,1469,47,38,40,45,1,189
26125125073,2532,2103,1861,69,48,34,81,7,242
26125125069,2940,2529,2277,62,72,37,68,7,252
26045045006,1858,1418,1292,67,17,35,9,0,126
26045045043,1376,1071,959,35,24,30,13,0,112
26045045005,3027,2300,2029,130,41,41,45,3,271
26045045003,1467,1180,1082,34,12,43,6,3,98
26045045032,2209,1799,1624,66,39,43,17,0,175
26045045019,2110,1877,1434,110,246,48,41,0,443
26045045020,1513,1305,928,87,166,25,87,0,377
26125125122,2680,2300,2019,73,118,20,58,5,281
26125125208,2717,2166,1286,69,198,33,576,6,880
26125125209,3248,2507,1366,94,279,16,736,6,1141
26125125288,3086,2094,218,188,1670,28,29,1,1876
26125125286,2987,2290,886,411,894,41,93,8,1404
26125125468,4104,3155,2189,316,474,126,87,5,966
26139139059,2779,2110,1825,118,25,24,106,3,285
26139139055,2324,1769,1187,379,89,61,73,3,582
26139139047,2863,2768,2319,215,110,27,113,2,449
26139139044,1527,1179,949,145,22,22,31,2,230
26139139100,1781,1341,1246,57,13,13,7,0,95
26139139101,1409,1082,999,32,14,11,6,1,83
26139139011,2264,1665,1499,81,34,32,9,4,166
26139139086,2739,2213,2055,66,19,20,39,0,158
26101101005,980,801,724,16,2,37,2,0,77
26145145019,3416,2678,1956,314,318,82,19,1,722
26145145018,2334,1842,1299,249,243,45,9,0,543
26145145036,1530,1230,271,135,786,17,21,0,959
26145145037,2319,1823,269,292,1281,33,10,5,1554
26145145039,2099,1272,155,168,947,31,3,0,1117
26145145069,1975,1590,1102,193,237,46,7,6,488
26145145023,2626,2182,2022,49,23,38,33,0,160
26139139074,2659,1863,1664,132,14,22,23,0,199
26139139073,2268,1621,1197,260,62,50,54,0,424
26113113010,829,652,590,13,10,20,6,1,62
26113113015,1489,1116,1062,24,6,16,10,1,54
26079079006,991,784,727,17,4,26,6,1,57
26079079005,1551,1271,1201,11,5,40,9,3,70
26055055013,3389,2735,2530,58,18,52,50,2,205
26099099150,3854,2991,1610,82,1206,56,17,5,1381
26099099033,2141,1726,1186,37,422,24,41,0,540
26099099166,1737,1350,980,22,293,24,23,0,370
26099099098,2824,2287,1814,47,324,37,45,1,473
26099099102,1844,1502,1392,24,34,19,19,3,110
26099099096,2806,2308,1942,40,233,38,37,1,366
26099099165,3138,2509,1463,54,774,64,120,2,1046
26125125267,3305,2567,2315,116,21,67,28,0,252
26125125036,3605,2574,2392,56,11,15,81,0,182
26125125165,3566,2697,2157,269,126,77,61,0,540
26125125231,3232,2503,1994,61,105,24,308,0,509
26125125276,2754,2178,498,251,1352,51,60,2,1680
26127127017,964,753,643,91,4,20,6,1,110
26045045035,1617,1289,1168,58,18,27,11,0,121
26109109005,2113,1543,1117,17,5,401,14,2,426
26109109014,1994,1692,1627,25,7,7,16,7,65
26109109013,2249,1792,1672,28,32,40,7,0,120
26109109015,1375,1161,1115,9,8,12,11,1,46
26105105003,1321,1029,961,18,9,29,10,1,68
26105105020,686,518,447,31,8,18,2,0,71
26105105001,2534,2068,1823,83,37,68,30,3,245
26139139097,3439,2726,2487,72,65,44,37,1,239
26139139099,2266,1681,1557,31,12,20,19,1,124
26139139098,3097,2396,2213,40,25,58,25,1,183
26139000004,2084,1379,1268,48,3,24,28,0,111
26139139106,2911,2118,1703,202,49,30,136,2,415
26139139023,3029,2229,2024,83,27,31,41,0,205
26067067027,3730,2840,2652,73,25,50,22,5,188
26067067009,2953,2233,2152,28,4,30,10,3,81
26145145047,2867,2168,1284,301,525,54,8,0,884
26145145061,3382,2739,1727,276,587,58,99,9,1012
26105105002,1405,1081,1016,27,8,17,9,1,65
26105105006,925,779,717,14,1,36,2,0,62
26129129004,788,673,626,16,0,17,1,1,47
26129129006,1251,1105,1042,28,2,24,3,1,63
26129129002,717,573,547,6,1,13,3,0,26
26133133008,1246,904,869,5,3,10,5,0,35
26051051009,1511,1150,1064,19,26,32,6,0,86
26121121001,2416,1847,1613,37,54,96,16,0,234
26121121065,2904,2294,2084,73,42,45,23,0,210
26121121066,1773,1390,1245,43,19,48,10,0,145
26121121022,1555,1247,1128,46,11,35,5,3,119
26121121028,2669,2014,644,161,1151,57,13,3,1370
26105105005,842,690,642,13,4,19,1,0,48
26121121061,2962,2190,1992,97,9,54,15,2,198
26121121047,2402,1746,477,106,1104,80,10,1,1269
26121121059,2901,2267,1951,99,90,74,37,1,316
26121121053,2475,1988,1718,77,75,55,34,1,270
26055055005,2035,1505,1320,52,27,56,35,8,185
26127127015,1652,1468,1406,26,2,18,5,1,62
26127127018,1224,972,829,88,9,36,12,2,143
26121121032,3241,2233,899,270,994,75,17,2,1334
26045045001,3200,2431,2263,64,22,62,8,4,168
26045045048,2293,1781,1643,57,20,44,9,5,138
26023023015,1427,1227,1164,22,3,18,14,0,63
26023023022,2942,2231,2021,40,30,96,12,6,210
26023023002,1323,1036,948,47,4,28,2,3,88
26023023001,2033,1459,1397,18,9,14,10,2,62
26145145001,2046,1596,1407,85,44,42,5,0,189
26145145071,1635,1315,1201,38,14,40,1,0,114
26145145072,2430,1934,1776,61,12,50,15,0,158
26145145059,2317,1934,1554,103,172,18,79,7,380
26145145064,3898,3095,2272,180,356,40,234,2,823
26145145033,1997,1567,1451,48,7,46,3,3,116
26117117022,3394,2645,2485,57,10,59,12,3,160
26117117009,2100,1523,1410,47,12,21,13,1,113
26091091016,1503,1174,1079,37,5,35,9,2,95
26091091009,720,568,499,32,9,20,4,0,69
26149149025,4509,3359,2703,162,386,76,34,1,656
26149149005,3311,2653,2464,61,51,46,26,0,189
26121121043,2407,1924,1511,115,189,82,17,6,413
26121121042,2827,2254,1997,108,29,96,10,6,257
26091091027,2270,1679,1524,68,21,44,9,0,155
26151151009,1522,1182,1101,38,6,23,3,0,81
26113113012,631,514,488,2,5,11,1,0,26
26127127004,681,530,389,103,3,26,2,0,141
26127127012,911,645,547,63,3,31,0,0,98
26127127003,446,332,269,46,3,9,2,0,63
26105105010,1192,993,915,33,10,19,5,0,78
26105105016,179,149,133,5,2,4,5,0,16
26129129009,596,483,463,8,0,6,1,1,20
26129129011,2534,2026,1846,28,17,83,2,0,180
26133133003,1705,1262,1152,32,24,39,5,2,110
26133133004,1382,1114,1044,20,11,32,3,1,70
26051051005,390,341,323,4,0,7,0,0,18
26051051012,126,97,88,3,0,5,1,1,9
26133133014,2374,1756,1601,23,38,55,13,1,155
26133133015,1773,1378,1289,14,14,37,6,3,89
26091091030,2974,2364,2099,129,27,84,16,2,265
26091091032,2552,1917,1759,75,19,36,10,2,158
26091091040,2295,1844,1623,88,27,66,16,1,221
26055055006,2086,1578,1375,55,21,81,36,1,203
26055055012,3169,2424,2172,87,21,86,24,4,252
26109109010,2137,1752,1562,70,34,48,27,4,190
26109109011,2002,1612,1498,26,19,37,16,0,114
26109109017,1090,894,862,9,1,17,3,1,32
26109109012,2095,1711,1584,42,20,46,7,0,127
26109109016,992,810,764,14,5,17,5,2,46
26109109018,1599,1315,1270,12,3,21,5,0,45
26105105012,1336,1127,1032,38,10,28,11,2,95
26109109007,924,816,784,4,3,15,2,0,32
26139139042,3632,2537,2197,151,66,68,36,1,340
26139139043,2230,1736,1587,58,12,35,36,2,149
26139139070,3342,2287,2108,58,31,41,45,1,179
26139139017,2995,2011,1808,92,28,32,37,0,203
26139139018,3012,2190,2022,98,19,25,26,2,168
26101101006,2318,1982,1831,41,8,57,15,0,151
26001001007,1307,1100,1027,13,8,28,8,4,73
26001001010,850,716,691,7,2,9,1,1,25
26001001004,1270,1095,1063,4,3,8,2,0,32
26021021033,1562,1303,1175,36,33,25,38,0,128
26021021053,2494,2164,1748,90,121,53,150,0,416
26127127008,3002,2266,1858,261,24,107,17,0,408
26021021025,1422,1182,1034,41,45,36,21,0,148
26021021035,2455,2069,1845,93,49,38,16,3,224
26021021034,1708,1450,1296,79,16,27,15,3,154
26021021004,2240,1588,535,225,784,40,10,1,1053
26025025028,3990,3048,2054,157,625,87,143,0,994
26025025042,3245,2537,2288,84,52,54,45,0,249
26139139053,3229,2576,1597,686,163,83,85,5,979
26023023021,1959,1540,1410,29,17,55,4,3,130
26149149017,2397,1920,1767,50,37,33,16,1,153
26067067003,1590,1217,1134,31,21,23,4,3,83
26023023004,2307,1617,1254,286,16,45,15,0,363
26099099049,1410,1205,1090,21,52,7,28,0,115
26099099043,1600,1352,1242,27,38,34,5,1,110
26125125066,3461,2731,2491,75,27,60,40,1,240
26125125064,2818,2251,2054,66,17,55,35,0,197
26125125284,3878,2878,1298,544,886,99,111,8,1580
26125125285,3619,2642,962,1026,548,94,88,3,1680
26125125264,3482,2436,1697,236,174,39,249,2,739
26125125257,2367,1831,1462,76,98,41,147,1,369
26125125459,3569,2898,2523,157,82,81,43,1,375
26125125455,3486,2864,2548,110,59,65,55,0,316
26125125145,1810,1418,1325,30,8,28,9,1,93
26125125143,1673,1323,1250,19,13,25,11,1,73
26125125140,2751,2237,2093,31,14,63,22,1,144
26099099157,1669,1329,1249,34,4,18,13,0,80
26139139034,3422,2979,2738,77,52,47,53,0,241
26139139040,1656,1300,1135,39,21,27,61,1,165
26139139035,3344,2573,2338,68,33,68,34,3,235
26139139048,2057,1653,1136,389,60,47,36,2,517
26139139020,2820,2245,2083,71,38,31,12,4,162
26139139088,2540,1975,1835,46,7,43,19,3,140
26139139089,1799,1389,1262,43,7,27,24,0,127
26117117018,1702,1280,1160,59,13,24,1,2,120
26117117026,2376,1781,1660,30,21,40,17,4,121
26117117011,1568,1268,1197,32,10,16,5,1,71
26117117012,1373,1018,967,20,7,12,1,1,51
26117117028,2538,2001,1877,36,7,36,14,0,124
26143143003,2879,2482,2355,24,8,63,13,0,127
26117117030,2279,1771,1669,21,10,44,6,1,102
26117117010,2147,1647,1509,55,8,43,23,1,138
26121121039,2053,1589,1297,72,136,51,15,0,292
26121121056,1675,1323,1220,39,25,19,17,1,103
26117117025,3055,2216,2039,36,15,78,13,0,177
26117117014,1331,1044,994,22,10,12,1,0,50
26117117013,1802,1422,1294,55,9,27,10,0,128
26149149016,3685,2784,2606,38,42,47,27,2,178
26127127013,2329,1839,1673,84,18,47,9,0,166
26127127007,1660,1392,1262,83,6,34,6,0,130
26105105011,1214,959,886,24,7,27,10,1,73
26105105008,2357,1890,1786,32,6,34,7,2,104
26105105024,995,826,741,64,7,12,1,2,85
26125125451,928,744,696,10,7,10,8,0,48
26125125077,2968,2284,2072,61,36,32,48,4,212
26125125079,2539,1914,1735,37,37,26,57,3,179
26125125502,1661,1334,1203,45,47,14,8,0,131
26125125359,1409,1238,1028,49,45,17,79,1,210
26099099271,1999,1628,1380,67,90,31,43,0,248
26125125500,3072,2326,2071,85,55,36,73,3,255
26077077090,2500,1735,1268,50,270,44,96,0,467
26077077101,2909,2073,1829,49,74,39,60,6,244
26077077027,2430,1736,341,105,1262,55,14,1,1395
26053053006,777,621,578,10,6,19,4,0,43
26053053005,2097,1791,1620,36,24,66,29,2,171
26053053010,301,260,256,1,0,3,0,0,4
26053053009,1702,1429,1376,6,4,34,6,0,53
26103103033,1045,836,794,17,4,17,3,1,42
26103103030,806,657,616,8,3,23,5,0,41
26103103001,250,200,182,3,2,10,2,0,18
26103103023,327,292,280,0,0,4,2,0,12
26103103012,1568,1238,1169,12,2,39,3,0,69
26103103004,1900,1494,1419,9,1,43,8,0,75
26103103024,2569,1959,1827,11,19,62,20,0,132
26125125350,2064,1808,1350,57,242,35,126,1,458
26125125057,2825,2226,1544,59,275,29,308,2,682
26125125283,1484,1047,390,336,291,50,15,2,657
26105105007,1354,1146,1063,28,9,19,8,0,83
26091091003,3020,2227,1509,499,119,69,25,0,718
26091091005,3275,2591,2037,338,125,74,31,1,554
26091091007,3261,2583,2245,192,38,38,40,6,338
26091091008,3153,2463,2159,162,49,52,20,1,304
26091091026,1115,857,779,46,5,33,2,0,78
26091091033,1535,1197,1088,32,14,36,20,1,109
26015015015,3398,2760,2539,102,14,64,9,5,221
26015015024,1986,1649,1544,18,8,34,15,1,105
26015015011,3154,2550,2377,56,16,77,9,1,173
26061061020,970,732,713,3,1,10,5,1,19
26077077076,1914,1495,1353,52,27,25,27,0,142
26077077020,2162,1884,1323,106,310,54,95,2,561
26077077047,946,707,526,80,73,40,6,0,181
26015015016,3334,2762,2501,130,26,46,34,4,261
26015015005,2368,1857,1706,48,11,48,14,2,151
26159159013,2510,1885,871,528,426,53,13,7,1014
26159159027,2568,2080,1895,89,9,52,11,1,185
26077077016,3373,2659,2300,103,118,85,32,1,359
26077077014,1394,1104,985,31,15,37,14,1,119
26077077096,2218,1840,1709,43,15,20,24,0,131
26077077093,2132,1655,1496,41,17,46,31,2,159
26077077104,3691,2485,1846,91,121,41,370,6,639
26103103029,994,859,818,6,4,23,1,0,41
26103103009,413,335,322,2,0,9,1,0,13
26103103005,150,135,131,1,0,0,3,0,4
26103103027,458,415,385,4,3,13,2,2,30
26061061007,118,108,104,0,0,1,0,0,4
26127127016,3145,2210,1406,695,29,72,10,2,804
26025025035,1903,1542,1463,26,20,23,6,0,79
26025025013,2115,1440,649,252,485,59,25,3,791
26025025014,2185,1581,458,92,992,50,11,0,1123
26025025053,2781,2210,2018,43,43,48,35,0,192
26025025049,3408,2669,2425,81,41,84,17,0,244
26025025048,2205,1746,1634,48,24,36,5,2,112
26025025046,1977,1596,1498,31,16,26,10,1,98
26025025005,1421,1118,734,64,300,15,8,1,384
26025025001,1327,896,343,41,495,12,1,0,553
26023023005,1288,934,849,46,3,25,0,0,85
26077077059,3162,2375,2069,62,119,60,54,1,306
26077077067,1240,936,791,35,63,35,11,0,145
26077077008,2967,2299,1804,106,209,121,45,3,495
26061061017,6649,6210,5096,223,179,112,541,1,1114
26061061023,2298,1801,1693,17,18,34,24,4,108
26125125258,3347,2498,1869,115,108,31,344,2,629
26099099169,4537,3447,2597,82,628,80,50,0,850
26099099031,2481,2061,1184,40,754,40,52,0,877
26125125447,5285,3999,1501,145,252,18,2067,2,2498
26125125213,3169,2816,1587,152,641,50,376,2,1229
26125125212,2630,2044,1513,73,196,41,207,2,531
26125125479,2843,2211,1661,55,218,17,233,5,550
26125125473,3820,3173,2539,186,327,44,53,4,634
26139139069,2706,2018,1902,41,26,23,24,1,116
26101101004,1063,839,776,25,3,26,3,0,63
26139139004,4324,3339,2840,222,126,79,68,1,499
26139139005,10752,10315,8236,584,919,151,368,7,2079
26139139015,5952,4812,4187,217,226,52,112,22,625
26139139016,3473,2603,2351,104,29,33,57,5,252
26021021057,3207,2546,2225,92,70,44,95,0,321
26021021054,2937,2441,1472,73,771,62,41,1,969
26021021058,1995,1651,1365,103,115,47,14,0,286
26021021048,2177,1706,1426,147,65,46,8,0,280
26059059020,1732,1408,1347,12,12,27,4,1,61
26043043007,2750,2179,2025,26,12,72,30,0,154
26159159019,2515,1771,1140,487,39,120,9,2,631
26053053011,1456,1213,924,5,2,261,4,3,289
26059059022,2389,1926,1789,49,15,38,14,2,137
26125125301,3121,2801,2379,75,149,40,144,1,422
26125125250,2546,1939,1722,55,49,48,41,1,217
26125125251,2894,2384,2138,115,43,34,37,0,246
26125125252,2279,1815,1665,50,29,37,31,0,150
26125125074,3519,2712,2329,83,61,61,143,4,383
26125125170,287,252,231,4,0,6,10,0,21
26125125007,2474,2142,1384,193,344,37,163,1,758
26125125421,3422,2617,1803,89,201,18,472,7,814
26125125309,1581,1367,1159,57,30,12,108,0,208
26125125332,3120,2452,1871,88,117,39,297,2,581
26125125311,2962,2274,1796,85,66,17,291,1,478
26125125424,1743,1437,1180,24,32,10,177,0,257
26125125427,2582,2003,1119,56,94,9,723,0,884
26055055026,2287,1746,1609,36,8,61,10,1,137
26021021059,2324,1906,1726,66,27,55,14,0,180
26021021024,1412,1099,1043,11,7,25,6,0,56
26021021062,1832,1495,1385,32,12,42,14,1,110
26021021039,3014,2278,1922,82,171,61,20,1,356
26021021038,3119,2407,1800,158,319,84,38,5,607
26021021022,2807,2251,2041,83,39,57,7,2,210
26015015001,1992,1555,1464,19,9,34,13,0,91
26099099097,2048,1760,1649,21,16,24,30,3,111
26125125269,2369,1804,1612,73,24,53,40,1,192
26059059004,2552,1992,1860,29,10,53,9,4,132
26059059012,3016,2394,2226,34,16,79,24,1,168
26059059010,2101,1567,1427,46,13,45,19,2,140
26103103026,3232,2436,2268,24,10,90,11,1,168
26103103017,2318,2065,1875,39,32,65,30,2,190
26103103006,3075,2496,2270,34,18,113,33,2,226
26043043016,51,48,47,0,0,1,0,0,1
26103103028,276,251,229,2,0,5,2,0,22
26165165018,509,427,385,5,1,25,0,0,42
26165165003,3346,2520,2322,43,23,75,29,1,198
26165165013,3413,2656,2477,38,15,69,31,0,179
26059059011,2001,1544,1459,18,9,31,10,1,85
26059059007,2041,1712,1537,34,25,35,56,3,175
26059059006,1113,881,816,26,4,19,3,1,65
26059059013,2176,1678,1559,30,16,41,12,0,119
26059059002,1602,1268,1192,26,10,22,3,1,76
26059059026,1618,1232,1123,34,10,52,4,0,109
26021021030,3426,2770,2354,75,111,47,164,0,416
26021021045,2668,2095,1661,157,134,42,76,10,434
26021021040,2581,2014,1736,99,55,54,40,0,278
26055055008,3839,2922,2701,38,24,72,51,7,221
26055055004,2914,2160,1966,52,20,70,34,11,194
26103103031,2411,1868,1737,16,15,78,7,1,131
26103103007,957,806,743,14,5,36,1,0,63
26103103008,2054,1399,1216,42,31,91,14,0,183
26103103036,1709,1282,1140,17,21,63,11,1,142
26021021037,3082,2395,1891,130,274,73,38,0,504
26021021021,1465,1133,992,54,30,36,3,0,141
26059059021,1845,1401,1313,15,8,46,2,0,88
26059059015,1024,802,761,17,1,11,3,0,41
26059059014,1399,1056,983,25,5,23,13,0,73
26059059018,808,641,615,14,3,8,0,0,26
26115115064,2156,1647,1523,46,16,37,13,2,124
26115115061,3202,2514,2317,42,50,53,17,2,197
26115115027,1703,1385,1302,23,14,34,8,2,83
26115115028,2224,1750,1516,36,141,28,3,3,234
26115115002,2803,2316,2091,78,50,62,15,0,225
26115000003,0,0,0,0,0,0,0,0,0
26021021006,1875,1402,901,36,428,27,5,1,501
26021021012,2420,1613,197,76,1335,23,3,1,1416
26021021002,2835,2221,2034,87,16,45,13,2,187
26021021019,3436,2720,2497,34,50,72,20,2,223
26021021017,2424,1906,1493,97,193,74,17,2,413
26021021015,2611,2127,1961,29,35,54,24,0,166
26021021009,1543,1056,107,40,895,24,6,2,949
26021021011,3320,2325,136,110,2075,30,5,2,2189
26153153011,115,95,85,0,0,10,0,0,10
26009009010,1780,1501,1412,21,15,33,6,0,89
26009009007,1675,1454,1377,26,4,19,3,0,77
26009009015,1212,1058,1004,31,0,13,7,1,54
26009009008,937,836,814,6,4,7,2,2,22
26009009001,1588,1280,1203,19,4,35,6,3,77
26125125110,3525,2896,1839,87,533,26,425,7,1057
26061061014,1440,1203,1076,33,29,23,27,2,127
26061061025,375,273,259,4,3,1,2,2,14
26061061015,500,330,320,1,0,3,1,2,10
26013013008,262,236,216,8,6,7,2,2,20
26099099258,2154,1697,1472,29,84,23,81,0,225
26099099267,2949,2314,1793,76,204,29,192,3,521
26165165015,936,684,639,10,7,22,7,0,45
26165165011,633,479,449,7,6,10,0,1,30
26165165006,1855,1379,1281,22,6,29,11,0,98
26165165008,2468,1943,1851,27,15,29,13,0,92
26165165005,4047,3172,2915,100,40,57,33,2,257
26165165020,1739,1318,1178,27,10,46,6,1,140
26103103021,2878,2382,2123,24,21,156,31,0,259
26103103014,2867,2285,2067,39,32,101,30,2,218
26103103022,1262,1012,923,14,7,37,17,1,89
26103103016,2879,2582,2237,130,22,123,48,2,345
26165165007,2421,1910,1801,28,21,27,17,4,109
26125125462,3262,2715,2396,123,60,60,51,1,319
26125125319,1920,1613,994,75,139,15,368,0,619
26125125176,2417,1757,1572,44,26,43,73,1,185
26125125174,786,612,531,26,4,3,32,0,81
26125125178,5067,3395,2704,76,92,47,440,5,691
26125125181,3380,2108,1808,58,46,24,138,6,300
26125125409,2853,2219,1992,63,28,40,65,1,227
26009009011,3638,2774,2560,38,15,103,14,2,214
26003003010,1231,980,908,5,0,47,2,1,72
26099099176,2209,1814,1339,40,338,38,38,5,475
26125125318,2641,2100,1556,114,101,26,284,1,544
26125125193,2094,1680,1538,45,12,41,28,2,142
26125125199,2585,1999,1841,32,24,45,18,1,158
26009009002,2159,1820,1713,15,5,55,11,2,107
26073073016,2422,2056,1719,87,78,99,79,1,337
26165165004,2978,2210,2013,47,28,77,23,1,197
26073073005,1288,1006,912,45,15,28,4,3,94
26139139029,2557,2110,1972,50,29,28,34,1,138
26139139028,3328,2471,2341,44,11,16,51,1,130
26139139031,845,648,577,20,8,5,36,2,71
26139139030,2959,2365,2050,136,79,29,58,1,315
26139139022,5115,3217,2947,102,31,30,88,3,270
26139139027,3045,2243,2068,60,28,46,30,1,175
26009009003,512,403,368,8,0,22,1,0,35
26009009014,1028,819,780,4,3,19,1,0,39
26083083003,238,213,207,0,0,3,0,0,6
26095095003,2471,1968,1703,19,9,209,4,2,265
26095ZZZZZZ,0,0,0,0,0,0,0,0,0
26095095004,1564,1234,1043,11,4,174,2,3,191
26031031010,810,712,663,11,6,19,7,0,49
26031031007,452,347,298,4,3,36,0,0,49
26031031006,3927,3136,2681,60,43,299,35,8,455
26031031011,298,237,218,2,2,15,1,0,19
26031031022,822,649,597,2,3,34,0,0,52
26031ZZZZZZ,0,0,0,0,0,0,0,0,0
26061061013,1381,1141,1035,16,10,44,23,2,106
26159159023,3074,2469,2171,132,56,55,26,4,298
26159159022,3289,2524,1935,405,52,137,7,1,589
26077077010,1705,1227,1101,25,34,18,35,0,126
26077077012,1473,1226,1050,43,80,19,30,1,176
26077077017,3010,2302,2188,33,28,24,15,2,114
26077077002,2323,1832,1709,29,26,33,14,0,123
26159159024,2325,1831,1591,100,53,55,20,3,240
26079079002,393,358,339,4,3,9,0,1,19
26061061009,204,191,183,2,1,3,0,1,8
26161161105,1605,1295,1161,24,26,16,44,1,134
26161161104,1890,1494,1150,24,35,6,263,8,344
26061061026,1988,1505,1427,17,4,32,9,3,78
26061061003,1754,1283,1192,11,10,34,17,3,91
26061061002,2028,1596,1513,17,2,43,7,0,83
26061061018,487,400,382,0,1,14,0,0,18
26161161115,3198,2492,1872,86,144,45,336,5,620
26161161053,1276,1004,830,38,54,20,50,1,174
26161161008,1810,1451,1133,48,102,28,136,6,318
26161161009,3509,3156,1182,103,190,11,1655,2,1974
26009009012,673,524,481,3,5,18,7,0,43
26059059025,1322,914,857,16,9,30,1,1,57
26087087006,1414,1105,1054,29,2,13,0,0,51
26017017026,1917,1537,1387,47,42,24,21,0,150
26017017025,2148,1758,1621,64,30,31,18,0,137
26017017042,1410,1162,1053,47,20,24,8,0,109
26017017020,3672,3085,2787,118,61,42,71,2,298
26087087009,3052,2364,2195,49,11,49,16,0,169
26087087016,2702,2180,2049,34,3,42,20,0,131
26087087017,1845,1515,1387,34,15,33,21,1,128
26017017006,2984,2519,2318,82,22,68,17,1,201
26017017016,3631,2836,2461,180,84,71,18,1,375
26017017010,3682,2826,2247,274,194,70,26,1,579
26087087002,3877,3024,2815,88,11,62,16,3,209
26087087037,1500,1136,1068,19,2,33,4,0,68
26087087015,1735,1402,1300,40,13,34,0,1,102
26163163677,2408,1836,1703,40,30,15,38,1,133
26163163066,2461,1768,859,76,172,16,650,1,909
26163163565,2369,1630,188,1285,141,79,9,2,1442
26163163421,1145,789,33,9,748,6,2,1,756
26163163381,0,0,0,0,0,0,0,0,0
26163163385,1300,929,19,3,905,5,3,0,910
26163163435,1605,1229,20,15,1198,7,1,0,1209
26163163442,1527,1106,21,13,1073,13,6,0,1085
26163163708,1016,804,44,7,739,24,6,1,760
26163163448,2011,1243,886,2,257,6,90,0,357
26163163340,690,524,35,1,476,11,10,0,489
26163163471,905,698,119,21,538,16,15,1,579
26163163616,2962,1814,1152,245,345,27,51,2,662
26163163286,945,688,12,4,661,7,2,3,676
26099099022,2162,1752,1551,62,78,25,24,1,201
26099099290,3336,2731,1834,53,403,39,392,0,897
26099099298,2738,2215,1749,34,241,21,159,0,466
26099099188,1136,895,823,21,18,11,14,0,72
26099099139,2264,1779,1475,102,155,16,34,1,304
26099099199,2136,1752,1581,34,50,46,25,3,171
26099099137,1886,1393,1189,42,73,21,45,1,204
26059059001,2327,1868,1734,33,23,47,19,0,134
26099099036,2631,1966,1198,55,607,52,60,0,768
26099099042,1753,1465,1202,27,82,34,133,0,263
26099099051,2432,1988,1543,26,350,27,40,2,445
26099099256,2896,2341,2071,44,46,43,118,1,270
26099099184,2167,1748,1490,58,115,39,29,1,258
26099099084,924,758,272,19,449,18,4,0,486
26099099178,3027,2721,2434,41,158,21,61,2,287
26163163865,1880,1457,1028,72,274,63,20,1,429
26163163837,2158,1687,459,41,1141,33,17,0,1228
26163163737,3461,2594,1654,607,233,129,23,6,940
26163163649,3047,2192,585,406,1146,70,12,0,1607
26163163885,2098,1740,1547,38,79,50,11,1,193
26163163811,2638,2201,1930,84,53,25,91,2,271
26163163547,960,733,31,112,583,16,7,1,702
26163163549,108,82,6,17,61,3,0,0,76
26163163212,1525,1011,86,33,877,21,9,0,925
26163163179,1031,740,28,9,697,21,3,0,712
26163163208,863,650,86,12,548,11,1,0,564
26163163178,2195,1560,296,36,1211,30,9,0,1264
26163163307,1713,1261,65,12,1174,11,2,0,1196
26163163185,2009,1505,45,18,1439,35,6,1,1460
26163163062,1965,1685,663,46,579,22,382,1,1022
26163163732,3242,2293,1146,770,299,79,22,2,1147
26163163904,2014,1568,753,101,551,30,129,9,815
26163163694,2909,1789,749,9,710,25,285,2,1040
26037037009,2092,1559,1433,49,30,23,13,0,126
26037037011,2660,1886,1703,51,45,34,44,4,183
26037037012,1972,1448,1264,76,21,23,33,2,184
26037037010,2684,2031,1855,50,39,27,38,2,176
26037004042,4,3,0,2,0,3,0,0,3
26037037015,2295,1733,1508,102,52,30,26,3,225
26037037029,2851,2184,1992,97,35,33,17,1,192
26037037013,2522,1891,1644,86,79,28,47,2,247
26037037019,2776,2184,2003,87,27,40,17,4,181
26037000002,0,0,0,0,0,0,0,0,0
26037037030,2266,1727,1558,73,19,44,16,2,169
26123123008,1562,1236,1136,28,2,41,9,2,100
26123000002,1799,1472,1350,39,7,59,12,0,122
26123123007,2492,1947,1768,111,13,32,12,0,179
26037037032,2474,1927,1757,50,31,47,28,1,170
26037037027,2020,1541,1451,36,12,28,3,0,90
26017017041,2299,1821,1682,47,5,70,3,0,139
26087087007,1904,1480,1364,49,12,36,8,0,116
26087000001,3,2,0,2,0,0,0,0,2
26141141015,964,832,808,4,9,8,4,0,24
26141141008,292,242,235,0,1,6,1,1,7
26141141003,686,590,569,6,2,8,1,0,21
26141141007,280,238,218,6,3,9,1,2,20
26141141013,1698,1520,1473,13,7,14,5,4,47
26141141006,666,589,575,5,5,4,0,0,14
26141141016,2850,2366,2239,21,13,58,23,3,127
26141141010,544,496,473,2,2,15,4,0,23
26141141002,371,349,335,4,3,4,2,0,14
26141141014,372,295,294,0,0,1,0,0,1
26141141011,890,689,641,4,7,22,1,2,48
26113113008,221,188,167,11,1,5,0,0,21
26141141001,940,774,724,6,6,26,3,4,50
26141141009,452,370,356,2,0,4,0,0,14
26145145008,1139,908,630,82,173,13,12,0,278
26145145010,2241,1849,1613,112,38,58,18,1,236
26145145017,1658,1262,334,105,832,8,7,1,928
26145145012,1443,1203,1013,74,88,11,6,0,190
26119119003,1697,1429,1341,23,5,30,9,2,88
26119119009,535,444,417,5,5,15,3,2,27
26119119001,2453,2082,1952,24,8,64,5,1,130
26121121038,2649,1978,1520,94,284,53,14,1,458
26121121041,3231,2552,2151,105,148,94,42,1,401
26025025047,1682,1396,1295,22,17,46,11,2,101
26025025058,2489,1916,1505,102,189,78,68,3,411
26115115040,2034,1673,1512,72,11,48,12,4,161
26115115029,1788,1389,1204,59,36,73,9,1,185
26115115033,3650,2691,2317,109,145,83,18,2,374
26115115031,1720,1383,1262,32,18,47,10,0,121
26115115036,2011,1595,1431,49,19,69,17,3,164
26115115035,4158,3489,2885,347,124,68,42,4,604
26115115048,1835,1237,980,53,139,44,13,1,257
26021021032,1760,1396,1221,58,46,18,33,0,175
26051051015,2427,1972,1872,19,6,42,10,0,100
26051051011,1122,810,770,9,3,11,4,0,40
26115115062,3173,2532,2349,58,20,74,18,2,183
26115115059,1174,907,837,31,6,22,2,1,70
26115115001,2836,2244,2047,63,24,55,18,0,197
26115115042,2984,2343,1978,50,186,73,14,1,365
26115115009,2996,2313,2171,45,12,35,34,2,142
26115115012,1426,1154,1092,27,5,12,10,2,62
26115115015,1927,1514,1411,37,14,12,30,1,103
26115115007,2687,2104,1949,61,22,43,17,0,155
26067067021,1191,951,894,24,2,21,0,0,57
26067067018,1242,972,895,34,3,24,10,1,77
26149149026,3762,2904,2636,121,38,76,15,3,268
26149149014,2581,2074,1971,37,21,14,9,0,103
26067067019,1292,954,913,25,2,12,0,0,41
26119119002,662,573,531,10,4,20,3,0,42
26119119006,636,536,512,0,2,12,0,0,24
26119119004,2009,1682,1566,22,5,56,5,1,116
26021021020,2778,2501,2321,32,45,42,28,0,180
26025025045,1055,834,780,14,7,27,7,1,54
26025025044,2896,2103,2004,34,15,46,1,1,99
26025025038,1298,1017,977,11,7,16,1,1,40
26021021051,2925,2490,2154,89,81,40,76,6,336
26021021052,2494,1987,1743,74,55,39,68,1,244
26025025015,3174,2407,1225,345,734,83,42,11,1182
26025025043,1585,1304,1246,19,7,14,8,0,58
26021021005,1105,927,529,40,325,25,12,2,398
26067067031,1861,1421,1302,53,9,32,5,5,119
26103103019,3776,3400,2872,222,73,160,59,3,528
26103103020,2842,2479,2260,67,36,57,49,0,219
26165165019,348,305,286,3,3,5,4,0,19
26149149001,2639,1926,1787,66,14,48,8,3,139
26099099269,2711,2105,1821,52,114,53,73,3,284
26099099120,2423,1976,1747,39,80,25,65,0,229
26125125123,2038,1752,1427,55,156,40,77,4,325
26125125124,2231,1956,1556,94,144,48,79,3,400
26125125126,2304,2048,1707,67,134,50,71,1,341
26125125430,2408,1856,1395,48,45,25,323,0,461
26125125271,3931,2722,2419,93,39,59,91,1,303
26125125470,3368,2741,2423,139,73,49,32,0,318
26099099158,2125,1747,1647,29,6,36,16,0,100
26125125408,3753,3096,2806,78,56,52,80,0,290
26125125226,3045,2246,1980,113,40,64,43,0,266
26125125019,2084,1712,1566,39,37,30,33,0,146
26125125015,2203,1799,1544,46,113,28,48,2,255
26125125154,1358,1006,952,11,13,12,12,1,54
26125125238,1880,1382,437,20,884,21,16,1,945
26125125239,1893,1496,183,13,1266,15,25,0,1313
26125125241,1845,1408,94,18,1288,21,14,0,1314
26099099299,3092,2155,1044,63,937,66,52,4,1111
26125125351,3095,2634,2242,66,189,35,78,1,392
26125125352,2173,1774,1575,49,80,15,43,0,199
26125125348,2464,2016,1762,79,52,25,72,0,254
26105105015,1320,1007,891,39,20,28,13,4,116
26105105013,1350,1059,902,77,11,47,10,0,157
26105105017,743,574,532,10,5,14,4,0,42
26125125315,2578,1861,1450,74,62,16,258,1,411
26125125317,2027,1675,1451,47,64,20,80,0,224
26125125081,3099,2404,2143,65,69,39,67,0,261
26039039009,598,497,461,8,2,17,2,1,36
26107107021,1396,1094,983,18,32,52,9,0,111
26107107019,2030,1771,1661,30,23,22,19,2,110
26107107018,2396,2018,1843,18,60,65,10,0,175
26107107002,1715,1264,1188,19,13,30,5,1,76
26039039008,567,512,497,3,1,8,2,0,15
26015015010,3013,2363,2223,33,21,43,18,1,140
26137137007,1714,1386,1308,9,4,35,13,2,78
26029029009,2239,1715,1562,31,14,71,1,3,153
26137137011,935,719,671,9,7,25,1,0,48
26137137013,2652,2076,1951,25,14,62,20,4,125
26137137009,1434,1158,1073,18,13,31,12,0,85
26137137006,632,492,466,5,3,5,0,0,26
26107107008,1227,1027,966,10,4,38,3,0,61
26015015019,3039,2216,2028,74,25,60,12,0,188
26143143007,1119,1020,967,21,6,20,2,3,53
26029029006,1042,898,835,10,11,36,0,1,63
26029029005,571,514,491,1,4,5,2,1,23
26029029008,1763,1433,1305,29,8,61,15,1,128
26039039001,1515,1277,1198,23,7,39,7,0,79
26039039010,1638,1396,1343,11,1,18,6,2,53
26107107020,1314,1060,949,31,44,41,7,1,111
26029029010,767,623,576,6,4,12,6,2,47
26107107013,3219,2534,2324,43,32,77,30,2,210
26047047010,3200,2485,2198,24,30,184,7,4,287
26073073001,1857,1444,1334,40,16,36,7,0,110
26073073023,3127,2391,2181,52,17,99,16,0,210
26047047007,240,221,186,1,0,28,0,0,35
26001001011,362,343,327,2,0,7,1,0,16
26053053007,2214,1820,1721,26,21,42,11,2,99
26005005018,1635,1221,1025,129,41,22,11,0,196
26047ZZZZZZ,0,0,0,0,0,0,0,0,0
26047047011,2657,2141,1958,37,15,103,13,5,183
26081081239,3310,2474,1001,776,555,54,148,1,1473
26081081024,2793,2094,1918,58,26,30,46,14,176
26081081021,3594,2599,2331,72,50,23,82,1,268
26081081151,2746,2053,1772,58,78,16,119,1,281
26081081211,2364,1635,1342,233,13,25,5,0,293
26081081210,2657,1960,1767,122,14,39,10,0,193
26081081139,2692,1799,323,437,1044,40,6,3,1476
26081081132,2526,1812,492,421,864,76,36,2,1320
26081081130,1136,976,764,62,115,26,20,0,212
26081081137,1871,1346,928,41,331,19,28,0,418
26081081027,3373,2487,2169,130,28,38,116,1,318
26047047016,1694,1450,1310,26,16,69,13,4,140
26047047020,2816,2242,2069,36,11,77,31,1,173
26043043015,809,677,650,6,0,15,4,0,27
26043043005,687,544,528,4,1,10,1,1,16
26043043001,471,367,345,2,0,13,4,0,22
26043043008,2202,1727,1601,38,10,44,19,0,126
26073073010,1445,1094,1034,14,3,20,1,0,60
26073073004,1744,1301,1189,62,8,40,3,3,112
26081081179,3530,2615,2052,85,127,33,313,1,563
26081081041,1810,1380,1194,14,26,11,121,3,186
26081081155,1690,1174,1021,46,25,14,56,6,153
26081081150,2653,1929,1608,58,42,17,188,1,321
26081081069,2352,1792,1149,61,323,20,224,0,643
26081081068,3507,2638,2216,113,130,51,120,1,422
26081081129,3095,2516,1558,251,657,62,36,2,958
26081081046,1964,1558,1296,38,69,36,122,2,262
26081081047,1599,1429,1221,46,52,7,102,0,208
26081081196,4087,3083,2818,98,40,43,63,1,265
26081081202,2544,1921,1765,62,20,41,32,4,156
26031031017,592,533,511,7,1,12,3,0,22
26031031016,1236,1028,945,11,4,58,5,0,83
26031031004,710,625,574,4,7,37,0,0,51
26005005043,2221,1724,1552,62,20,45,13,3,172
26005005034,3158,2338,2117,67,44,62,14,0,221
26005005031,2436,1816,1646,81,17,43,7,0,170
26005005003,3246,2581,2356,85,39,49,18,0,225
26031031013,1193,939,860,8,12,38,1,0,79
26073073028,1355,1028,947,22,6,51,5,0,81
26043043012,1555,1271,1212,14,0,38,5,0,59
26043043003,1451,1158,1106,11,0,19,8,0,52
26043043004,2724,2268,2158,19,10,49,15,1,110
26005005014,2574,2124,1774,260,25,32,9,1,350
26031031014,491,437,383,11,9,29,5,1,54
26081081062,2460,1794,1208,76,170,26,315,1,586
26081081131,2364,1733,548,185,946,43,43,4,1185
26081081197,3418,2782,2487,99,116,30,37,1,295
26081081112,2250,1889,1601,95,80,34,73,3,288
26081081214,2290,1947,1402,153,141,41,206,1,545
26081081098,2821,1998,1153,226,557,60,32,4,845
26081081164,3582,2592,1291,519,481,66,271,3,1301
26073073015,3119,2581,2083,150,150,174,25,9,498
26073073018,1098,882,759,24,19,62,17,1,123
26073073025,6011,5023,3776,304,414,315,184,8,1247
26005005013,2778,2147,1898,132,30,31,53,2,249
26005005019,1758,1323,755,434,80,28,46,1,568
26073073007,2011,1595,1442,25,10,79,29,0,153
26081081102,1772,1558,1340,77,66,21,35,2,218
26081081004,1295,985,915,19,9,6,35,0,70
26081081099,1993,1633,1443,71,61,23,27,2,190
26081081143,1762,1298,766,122,350,29,41,0,532
26089089003,1103,945,903,12,1,29,0,0,42
26081081156,2129,1643,1351,111,87,41,58,3,292
26081081160,3028,2321,1991,151,73,47,61,1,330
26081081158,2974,2346,1994,127,122,44,63,9,352
26081081159,2666,2044,1765,95,77,56,52,1,279
26081081157,3174,2554,2064,241,124,51,69,1,490
26099099011,1220,1002,781,28,129,20,36,0,221
26099099083,3031,2448,1277,39,1061,70,17,0,1171
26099099082,2671,2035,956,45,980,43,8,0,1079
26099099044,1441,1228,1087,25,77,18,17,2,141
26099099065,2935,2421,2157,31,122,29,65,2,264
26099099241,1938,1508,1242,46,84,22,111,0,266
26099099242,2886,2296,1938,27,87,21,207,1,358
26099099026,1887,1596,1388,36,104,17,41,0,208
26107107015,1594,1301,1228,10,9,37,3,0,73
26065065006,1966,1533,1435,39,5,38,5,0,98
26099099104,4464,3782,2652,132,898,70,22,2,1130
26099099193,2865,2385,2129,40,131,35,33,4,256
26099099328,2514,2106,1408,47,471,34,144,3,698
26099099302,1164,896,637,11,107,19,106,0,259
26099099301,3462,2741,1546,52,912,44,188,4,1195
26099099086,1641,1319,1120,36,78,46,28,4,199
26099099231,3321,2642,2000,26,190,37,387,2,642
26099099315,3512,2944,2107,46,611,26,141,0,837
26099099324,2276,1641,898,32,571,47,82,2,743
26099099321,2891,2066,963,63,835,63,135,7,1103
26081081097,2616,2105,1541,149,306,66,52,6,564
26081081086,3557,2728,1867,496,249,105,27,2,861
26081081188,2013,1495,1392,30,12,23,14,2,103
26081081146,1653,1302,897,85,246,13,49,0,405
26081081124,2813,2268,1710,110,380,25,44,2,558
26081081178,4378,3570,1661,405,1123,74,364,1,1909
26081081162,2233,1789,1661,33,19,36,13,1,128
26081081153,1310,1012,887,45,20,23,32,0,125
26075075024,2038,1576,1249,77,191,34,9,3,327
26075075017,2491,1791,913,103,675,83,26,9,878
26065065052,3199,2569,1428,235,763,65,88,1,1141
26099099073,2778,2196,1069,39,979,54,49,4,1127
26099099127,4895,3483,2783,73,181,32,339,2,700
26099099128,2033,1728,1580,18,47,14,58,0,148
26031031015,857,715,658,14,3,32,7,0,57
26017017045,1923,1515,1378,38,23,43,8,2,137
26163163724,2522,1780,179,41,1546,26,17,1,1601
26163163123,2069,1556,1143,78,257,28,52,3,413
26163163001,1922,1541,952,224,244,38,72,1,589
26163163492,673,521,41,17,463,4,5,0,480
26163163836,2787,2239,1008,65,1098,40,25,3,1231
26163163047,2499,1926,1310,77,165,41,325,0,616
26163163056,2877,2130,1199,60,122,17,712,3,931
26163163031,2523,2107,1528,82,245,35,213,4,579
26163163052,2581,1994,1556,62,133,28,191,0,438
26163163030,2885,2151,1434,87,217,47,358,1,717
26163163094,2379,1864,1495,147,137,25,54,0,369
26099099291,4109,3394,2576,69,242,53,448,4,818
26099099275,3499,2912,1994,68,331,22,483,0,918
26099099119,2411,1903,1680,48,60,12,96,1,223
26099099304,3771,3083,1990,42,780,47,235,5,1093
26163163919,3290,2813,1351,115,1124,38,186,0,1462
26163163550,1884,1293,144,644,497,43,17,0,1149
26099099333,2551,1991,1898,20,7,19,26,0,93
26081081078,3280,2977,1890,258,674,56,98,10,1087
26081081212,2481,1824,1694,32,14,39,25,0,130
26081081003,1303,901,804,22,12,9,34,0,97
26081081008,1797,1338,1231,30,14,15,40,0,107
26017017014,3531,2812,2434,170,92,72,28,1,378
26017017013,3720,2787,2245,297,157,86,17,0,542
26017017034,2362,1904,1762,66,23,20,26,0,142
26087087029,2493,2039,1872,65,9,49,17,1,167
26017017031,1352,1065,1001,23,6,17,4,0,64
26017017037,2307,1834,1742,40,14,23,4,1,92
26017017011,3816,2941,2318,330,164,100,11,4,623
26099099283,2428,1858,1072,63,252,57,401,2,786
26099099207,2097,1729,1591,45,31,20,39,0,138
26099099330,3702,2967,2521,231,107,38,50,2,446
26099099227,3603,3010,2430,71,307,28,146,0,580
26099099063,1741,1401,1227,21,96,11,49,2,174
26099099069,3238,2629,2071,94,331,26,79,2,558
26099099247,2651,2098,1762,34,87,2,201,0,336
26099099075,2743,2098,1253,51,706,48,23,2,845
26099099294,2913,2400,1589,46,556,26,164,4,811
26099099282,3409,2610,1541,56,356,50,612,1,1069
26099099224,3402,2674,2431,55,47,42,75,4,243
26163163961,2225,1818,1387,83,212,49,71,2,431
26163163099,1196,947,806,58,45,20,12,1,141
26163163393,1410,1011,55,16,935,17,9,1,956
26163163437,1311,1110,100,5,1005,3,6,1,1010
26163163440,1001,776,71,19,685,7,5,2,705
26163163386,1380,957,36,20,902,7,2,0,921
26163163664,3688,3059,2568,98,239,82,61,0,491
26163163857,1798,1424,797,71,499,42,26,2,627
26163163875,2363,2048,1612,153,153,70,75,1,436
26163163044,2902,2356,1589,59,251,33,405,0,767
26163163772,2274,1804,1389,77,201,27,108,3,415
26017017038,1302,1027,956,34,6,6,15,0,71
26087087027,2399,1903,1752,41,15,74,16,1,151
26087087013,1701,1384,1297,26,6,31,7,0,87
26087087021,2213,1763,1628,67,10,32,14,0,135
26017017004,2850,2171,1963,97,44,46,8,0,208
26017017030,1888,1523,1421,33,6,32,10,0,102
26087087012,1491,1188,1071,36,21,26,11,1,117
26163163018,3618,2822,2184,156,251,49,150,2,638
26163163029,1911,1499,1136,86,160,27,90,0,363
26163163021,1829,1583,1338,52,99,30,60,0,245
26163163455,805,634,31,10,597,10,0,1,603
26163163399,807,613,11,8,591,1,1,1,602
26163163319,1653,1206,30,24,1102,15,48,3,1176
26163163339,1179,771,270,7,397,7,79,0,501
26163163372,1134,874,117,8,749,4,1,0,757
26163163323,1009,731,29,6,697,9,1,0,702
26087087004,2253,1818,1652,81,8,49,8,5,166
26017017015,3654,2777,2409,164,80,84,34,0,368
26017017008,3510,2760,2306,201,145,66,36,3,454
26017017024,1068,859,756,45,25,14,11,0,103
26017017028,2057,1594,1438,46,43,50,12,0,156
26071071009,1469,1120,1038,14,2,34,13,1,82
26027027008,2590,2061,1824,30,112,60,23,0,237
26047047023,1768,1539,1426,24,6,62,8,3,113
26163163326,2100,1420,84,16,1318,13,10,3,1336
26163163216,1521,1197,55,17,1124,20,3,2,1142
26163163595,1996,1407,37,24,1341,25,8,3,1370
26163163674,2518,2044,1800,46,106,20,67,0,244
26163163675,3160,2399,2231,43,58,24,38,2,168
26163163457,635,533,33,4,491,13,0,1,500
26163163552,1080,803,179,310,294,32,14,4,624
26163163566,2737,1890,344,1408,126,136,16,4,1546
26163163570,3730,2583,432,1825,319,107,20,3,2151
26163163571,3805,2454,1052,1156,193,69,52,6,1402
26163163702,1895,1394,343,19,1013,19,11,1,1051
26163163327,2279,1571,104,20,1452,8,4,3,1467
26163163338,2365,1609,514,17,678,19,405,3,1095
26163163577,706,505,96,325,70,27,1,2,409
26163163199,1288,937,16,4,912,11,3,0,921
26163163274,1749,1221,6,6,1206,7,14,5,1215
26163163365,1414,1014,33,9,966,10,7,0,981
26163163680,2372,1818,1607,48,96,13,46,1,211
26163163002,2370,1875,1437,269,99,51,37,1,438
26163163642,1323,1006,57,21,920,14,9,3,949
26163163813,2163,1772,1551,69,64,18,57,0,221
26163163843,2951,2268,348,51,1820,28,23,8,1920
26163163575,1626,1249,25,113,1122,23,9,5,1224
26163163815,2272,1805,1629,48,19,33,70,0,176
26163163814,2464,1963,1801,43,31,23,49,1,162
26163163192,1776,1357,39,4,1296,17,8,1,1318
26163163205,1055,816,21,6,776,10,2,0,795
26069069003,1614,1345,1271,20,11,23,13,0,74
26099099006,2141,1733,1643,22,11,35,9,2,90
26099099222,3226,2655,2341,58,61,34,128,2,314
26099099038,3135,2463,1847,117,341,70,76,4,616
26017017009,3372,2761,2308,202,132,86,32,1,453
26163163514,681,499,13,19,468,1,0,0,486
26163163545,574,438,15,25,397,3,0,0,423
26163163956,1852,1450,884,67,398,48,63,4,566
26071071001,925,795,754,4,2,11,6,0,41
26163163690,2800,2223,1837,71,227,30,49,1,386
26163163706,3031,2332,795,44,1433,37,39,2,1537
26163163426,972,696,11,7,671,15,0,0,685
26163163436,105,76,1,0,74,0,0,0,75
26163163427,999,728,23,10,699,9,6,0,705
26163163406,502,415,7,1,407,0,0,2,408
26163163277,1963,1612,38,14,1555,5,6,0,1574
26163163106,2286,1728,1536,69,39,25,41,1,192
26163163080,2564,1752,1547,34,61,9,72,4,205
26163163718,3221,2518,2128,119,132,97,28,2,390
26163163717,2492,2044,1778,80,76,40,39,0,266
26163163719,1385,1076,882,46,75,35,26,3,194
26163163086,3780,2735,1932,92,174,25,483,0,803
26163163818,2954,2261,1823,74,72,23,255,2,438
26163163613,1215,935,7,22,909,7,2,0,928
26163163395,1389,957,53,12,891,9,1,2,904
26163163920,3132,2558,1640,120,645,97,65,8,918
26069069013,632,489,458,5,4,14,3,0,31
26163163880,1916,1448,1041,54,280,72,6,4,407
26163163932,3013,2391,1790,112,386,84,32,5,601
26163163931,3176,2481,1273,70,929,69,115,1,1208
26163163720,2233,1434,58,19,1331,26,20,8,1376
26163163568,1019,634,83,486,56,17,1,2,551
26163163322,1133,853,44,11,793,6,13,0,809
26163163045,2529,1748,1132,107,422,64,37,7,616
26163163061,2291,1787,867,55,286,41,533,2,920
26163163283,992,708,6,7,691,11,2,0,702
26163163165,2042,1476,23,20,1438,19,6,1,1453
26099099105,4093,2852,1996,169,546,95,29,2,856
26099099210,1999,1601,1477,37,15,19,35,0,124
26099099243,3878,3035,2318,27,215,17,442,4,717
26099099197,1402,1166,1052,28,42,17,15,2,114
26099099053,3758,2566,1453,114,935,71,19,1,1113
26099099029,710,557,401,16,119,9,12,1,156
26099099183,2948,2441,1454,67,815,34,70,1,987
26099099249,3866,3045,2380,84,319,23,234,1,665
26099099239,1487,1214,1017,28,85,11,75,0,197
26099099240,3337,2746,2272,50,194,28,195,0,474
26099099161,1592,1270,1186,26,3,35,7,0,84
26099099162,1952,1541,1402,40,19,48,7,0,139
26099099226,2781,2428,2192,71,66,45,45,0,236
26099099014,1946,1665,1510,43,36,44,26,3,155
26027027015,3332,2643,2479,52,14,58,21,2,164
26089089002,1243,1022,967,29,2,9,7,1,55
26089089010,2126,1779,1639,78,10,34,12,0,140
26005005046,3573,2733,2499,79,11,88,27,4,234
26037037004,3389,2495,2050,117,108,68,128,3,445
26037037008,2411,1795,1708,41,3,19,15,1,87
26037037031,3463,2715,2539,57,17,53,15,0,176
26037037017,2491,1976,1595,202,70,52,43,2,381
26037037003,1744,1313,1201,33,21,30,10,0,112
26037037001,1817,1392,1233,60,27,42,19,1,159
26163163810,1570,1408,1234,42,36,24,66,0,174
26163163809,2486,2010,1856,61,18,28,32,0,154
26163163791,2560,1865,1161,323,254,37,87,2,704
26163163098,1197,958,788,69,49,21,34,1,170
26163163793,1585,1186,1088,28,6,7,50,0,98
26163163714,3015,2389,2125,75,91,60,15,1,264
26163163846,1612,1122,463,175,463,25,8,5,659
26163163651,2075,1539,62,90,1379,19,9,3,1477
26163163488,890,743,185,18,517,10,17,0,558
26163163489,1391,1111,150,20,924,20,14,2,961
26163163486,2251,1941,510,57,1263,26,114,3,1431
26163163490,1176,996,190,31,735,31,29,5,806
26163163614,1595,1182,35,24,1127,10,2,0,1147
26163163839,1747,1360,814,36,470,33,19,1,546
26163163917,3765,2942,1658,97,1006,67,135,0,1284
26163163930,2918,2246,1322,114,698,83,32,2,924
26163163487,895,591,57,8,517,8,1,0,534
26163163485,1935,1629,193,34,1304,24,86,2,1436
26163163290,971,767,29,4,726,18,3,0,738
26163163174,1673,1306,25,12,1260,20,5,0,1281
26027027011,2841,2203,1972,76,23,79,30,4,231
26075075051,4939,4136,3778,168,84,72,33,4,358
26075075052,3591,2697,2451,78,49,51,34,2,246
26065065081,3791,2868,2645,61,16,76,32,3,223
26065065002,1031,812,726,45,8,27,9,1,86
26081081044,2106,1504,1372,39,14,13,51,0,132
26081081043,1335,1021,922,25,14,12,39,1,99
26081081072,2601,1942,1272,201,418,46,36,3,670
26099099054,2251,1812,1605,25,131,27,24,1,207
26099099182,2882,2348,1973,64,194,44,42,1,375
26099099335,2826,2217,2081,31,10,19,62,0,136
26099099216,3196,2469,2291,38,28,18,78,1,178
26099099218,2346,2029,1767,49,111,40,61,3,262
26099099005,2436,1901,1649,118,45,57,14,0,252
26099099004,2884,2253,2141,35,12,32,18,0,112
26099099058,3887,2966,2222,81,517,63,82,3,744
26099099040,1735,1430,1083,37,236,43,23,1,347
26099099305,2862,2319,1939,30,193,42,96,0,380
26099099148,1901,1530,1147,78,211,51,26,0,383
26099099212,1409,1131,1070,17,7,9,15,0,61
26099099100,2049,1701,1076,45,541,24,16,1,625
26099099263,2530,2086,1687,21,42,11,323,2,399
26099099025,1860,1376,1215,35,57,27,36,0,161
26099000016,1839,1503,1337,34,60,33,25,0,166
26099099024,2786,2132,1841,48,153,43,47,1,291
26099099077,3107,2219,912,39,1158,38,58,5,1307
26099099078,2568,1850,431,43,1343,29,6,1,1419
26099099068,980,825,740,13,48,6,16,0,85
26163163371,691,575,77,7,489,3,5,0,498
26163163964,2540,2040,1483,83,370,63,35,0,557
26163163963,2014,1619,1270,91,168,65,18,2,349
26163163187,1022,821,79,7,727,7,0,0,742
26163163222,727,602,42,6,548,4,4,0,560
26163163261,1326,1047,43,17,990,10,1,0,1004
26163163721,1121,818,70,29,721,15,8,0,748
26163163281,1654,1146,15,5,1119,22,7,1,1131
26163163753,1810,1510,1360,45,27,24,61,0,150
26069069008,810,687,641,11,7,23,1,0,46
26007007013,1559,1263,1192,3,4,36,7,0,71
26087087010,2513,1995,1876,37,4,48,9,0,119
26087087019,1370,1074,783,228,14,34,14,2,291
26087087025,1869,1485,1350,36,18,49,14,1,135
26087087024,3403,2880,2023,85,659,88,9,3,857
26163163374,778,554,14,3,534,3,0,0,540
26163163526,2653,1991,100,31,1806,22,32,2,1891
26163163527,5,5,0,0,5,0,0,0,5
26163163530,1940,1583,598,58,800,15,92,2,985
26099099095,2406,1987,1799,54,38,41,33,3,188
26099099277,1786,1454,1270,39,54,19,49,5,184
26099099041,2305,1973,1531,30,326,25,48,2,442
26099099059,4032,3545,2223,132,939,64,207,0,1322
26099099070,2088,1724,1483,57,91,23,63,6,241
26099099270,1834,1434,1219,21,85,24,68,5,215
26099099278,2378,1997,1535,42,181,23,192,1,462
26099099020,2713,2131,1762,69,207,49,28,1,369
26099000018,1745,1412,1300,21,28,30,18,3,112
26035035019,460,382,361,7,5,6,2,0,21
26019019008,2329,1885,1735,36,17,62,11,0,150
26123123004,2436,1967,1783,61,32,67,7,0,184
26047047021,2146,1661,1514,19,12,90,5,2,147
26093093054,3120,2287,2129,61,18,28,26,0,158
26093093070,4114,2976,2763,79,14,49,39,6,213
26093093071,2455,1828,1694,49,4,45,18,1,134
26093093075,2413,1891,1745,34,21,51,27,0,146
26093093058,3218,2594,2337,86,25,77,33,14,257
26155155008,1616,1280,1176,19,8,35,8,2,104
26155155002,3119,2519,2351,44,21,62,27,1,168
26155155026,1268,1040,964,17,7,24,14,2,76
26099099118,2723,2029,1674,53,168,23,104,0,355
26099099123,3675,2623,2205,54,147,56,141,5,418
26099099081,2247,1641,769,44,787,41,9,4,872
26099099080,1945,1511,467,44,959,32,13,3,1044
26099099232,4885,3914,2876,85,423,36,484,2,1038
26099099309,1817,1455,1054,27,170,21,161,2,401
26099099146,1673,1358,1114,38,160,28,12,1,244
26099099056,2609,2097,1646,58,309,38,35,3,451
26099099030,2287,1573,261,31,1136,27,122,0,1312
26071071007,1538,1223,1149,24,8,31,5,0,74
26097097002,502,430,325,8,2,94,1,0,105
26005005030,2723,2052,1885,85,14,37,16,0,167
26071071003,1598,1274,1208,21,1,23,6,1,66
26155155001,2116,1691,1583,41,3,41,2,9,108
26155155013,1218,984,945,13,6,8,8,3,39
26071071002,805,652,604,0,7,29,4,0,48
26005005020,1855,1396,1060,229,32,26,44,1,336
26063063009,708,562,546,1,2,8,2,2,16
26063063021,491,391,376,7,5,5,1,0,15
26111111009,1726,1395,1307,35,10,21,12,0,88
26111111004,1731,1367,1256,37,5,49,7,0,111
26093093053,3565,2828,2616,60,31,70,29,5,212
26093093048,2420,1780,1598,56,31,47,24,12,182
26093093064,2937,2234,2085,44,12,43,21,3,149
26093093038,2374,1858,1563,39,182,39,28,2,295
26163163074,2360,1515,1402,21,27,3,47,0,113
26163163024,2462,1900,1617,91,73,61,36,0,283
26163163023,2843,2307,1761,134,272,59,63,0,546
26163163210,2596,1885,130,27,1722,24,11,1,1755
26163163004,1845,1427,1105,179,74,39,17,2,322
26123123020,835,690,621,13,23,30,1,0,69
26123123016,536,436,420,5,3,6,1,1,16
26063063008,1768,1447,1355,40,5,21,16,0,92
26063063001,3006,2383,2218,66,22,30,39,0,165
26063063012,869,664,632,18,2,6,2,0,32
26033033008,6139,5097,2518,111,1749,685,27,6,2579
26123123006,1220,1000,932,18,3,33,9,1,68
26111111051,1609,1251,1164,21,4,37,5,0,87
26123123023,328,266,244,12,1,11,0,0,22
26123123024,2471,1827,1607,124,23,47,16,4,220
26141ZZZZZZ,0,0,0,0,0,0,0,0,0
26041041022,1775,1404,1300,7,10,73,7,1,104
26079079013,1566,1231,1148,22,10,33,4,0,83
26041041011,2216,1781,1643,13,8,77,27,1,138
26101101002,1831,1420,1284,54,11,51,11,1,136
26139139049,2836,2058,1139,716,109,70,53,2,919
26139139107,3382,2556,2081,289,32,31,124,1,475
26139139108,3631,2482,2122,195,27,42,86,7,360
26131131001,438,413,390,2,1,18,0,0,23
26121121008,2563,1911,1650,124,43,72,8,6,261
26077077091,2369,1802,1709,22,21,41,3,5,93
26077077106,3203,2267,2059,68,45,29,52,4,208
26159159008,1958,1514,1258,165,35,58,4,3,256
26159159009,2016,1439,942,328,114,39,7,4,497
26141141004,350,311,300,2,0,9,1,0,11
26141141012,808,654,638,3,1,5,1,0,16
26145145082,3133,2733,1796,119,774,28,12,3,937
26145145007,1842,1474,1385,31,3,28,5,0,89
26145145046,3666,2648,1302,371,868,95,40,6,1346
26145145042,2167,1475,105,108,1265,12,4,0,1370
26145145041,2281,1690,183,206,1302,28,6,0,1507
26145145054,1680,1350,1062,117,99,33,34,1,288
26145145057,3151,2574,1871,207,364,43,79,3,703
26113113004,1394,1071,1009,27,8,28,2,0,62
26113113009,2825,2232,2125,40,6,30,20,3,107
26113113017,452,355,338,5,2,7,3,1,17
26025025060,1520,1249,1184,16,9,23,9,1,65
26025025021,1846,1406,1086,84,100,38,81,4,320
26041041019,694,588,557,1,1,17,6,0,31
26077077060,1866,1454,1165,54,150,24,67,2,289
26159159033,2506,1924,1727,76,28,53,2,1,197
26131131011,226,182,166,2,2,5,6,1,16
26131131012,645,562,536,1,1,12,6,1,26
26139139033,2213,1776,1681,17,13,28,20,0,95
26139139041,2674,2162,1993,56,10,27,44,2,169
26139139032,2032,1737,1562,71,33,38,22,3,175
26161161123,2755,1730,490,111,1072,54,41,6,1240
26161161135,2154,1808,889,116,692,62,66,2,919
26061061027,1445,957,905,13,10,24,3,3,52
26061061016,1725,1315,1116,24,18,20,124,3,199
26061061022,153,109,102,5,0,0,2,0,7
26061061001,2540,1846,1763,9,11,31,14,4,83
26025025012,2526,1896,1427,120,106,66,151,4,469
26025025039,2634,2067,1803,67,120,58,16,3,264
26025025050,3414,2743,2466,124,46,51,30,1,277
26025025007,1094,860,809,22,14,10,5,0,51
26133133002,479,389,372,3,2,10,1,0,17
26133133011,775,631,602,6,2,13,0,0,29
26133133018,967,716,669,18,4,16,9,1,47
26025025036,1181,890,856,5,1,21,2,0,34
26079079009,2401,1898,1777,23,10,54,17,2,121
26149149007,1153,895,831,25,12,22,5,1,64
26113113002,574,445,411,13,0,11,2,1,34
26055055033,2675,2234,2006,76,51,50,35,9,228
26055055032,2348,1967,1786,45,34,59,24,2,181
26055055015,3900,3197,2708,170,72,141,69,2,489
26055055014,3079,2727,2489,78,12,100,38,1,238
26101101008,3435,2662,2341,93,46,154,26,3,321
26125125382,1979,1725,126,25,1560,28,20,1,1599
26125125381,1921,1570,133,15,1418,20,14,0,1437
26125125334,2402,1928,1752,49,22,61,14,1,176
26125000023,2176,1585,909,38,63,16,549,0,676
26125125221,2008,1495,886,56,106,25,422,2,609
26125125358,2168,1870,1626,58,53,21,95,4,244
26125125411,2197,1694,1533,45,16,36,46,3,161
26125125132,2473,1930,1728,67,46,49,33,0,202
26125125119,3530,3085,1880,57,622,34,435,0,1205
26125125127,2213,1994,1672,71,133,59,51,1,322
26125125135,2708,2298,1858,57,237,73,62,3,440
26125125182,2338,1947,1622,78,143,47,60,2,325
26125125049,1625,1418,983,44,207,23,157,0,435
26125125053,2717,2231,1402,83,401,18,326,1,829
26077077082,2891,2180,1664,86,145,45,217,5,516
26159159030,1200,1112,979,28,72,18,13,0,133
26125125245,1853,1588,465,25,1031,25,54,1,1123
26125125244,1946,1579,322,30,1202,35,18,0,1257
26125125203,3328,2633,1683,63,221,21,634,0,950
26077077094,3359,2470,2043,63,202,59,64,2,427
26077077092,3221,2399,2167,73,49,49,41,4,232
26135135004,1839,1425,1364,16,2,30,4,0,61
26057057018,2132,1704,1593,57,13,29,3,0,111
26121121002,2793,2070,1851,133,17,38,6,2,219
26121121013,3285,2587,2372,68,33,51,21,2,215
26079079012,1245,953,875,16,3,38,8,1,78
26021021056,1747,1347,1161,42,48,13,67,6,186
26021021013,2457,1952,1554,124,141,40,86,0,398
26121121051,2560,1945,1545,181,112,91,15,0,400
26059059003,1176,971,921,15,0,23,5,1,50
26091091014,1248,975,891,24,6,31,8,1,84
26091091015,2517,1920,1733,59,19,49,21,1,187
26091091019,3063,2470,2267,83,10,69,16,0,203
26091091020,2415,1732,1574,80,21,45,15,0,158
26091091038,2040,1662,1521,60,19,40,15,0,141
26091091017,1662,1316,1166,85,6,49,0,2,150
26133133009,1462,1154,1094,8,5,33,1,0,60
26133133006,1941,1454,1358,33,11,29,5,1,96
26051051013,1974,1432,1356,22,10,19,5,0,76
26161161062,1439,1110,974,44,17,29,42,2,136
26161161064,1227,878,782,32,22,15,25,3,96
26161161096,1793,1396,1231,53,13,23,69,1,165
26161161034,2688,2421,1810,143,175,26,271,1,611
26051051003,829,680,641,6,4,21,0,0,39
26051051004,2318,2021,1912,33,5,48,7,0,109
26091091043,3608,2897,2665,76,30,99,4,0,232
26119119008,519,427,413,5,0,4,2,1,14
26057057001,3474,1960,1571,225,92,23,32,11,389
26057057019,1863,1502,1390,55,8,24,5,0,112
26057057013,1064,813,724,65,1,12,2,0,89
26161161060,3215,2448,2261,59,14,20,64,1,187
26161161141,2899,2380,1565,108,571,66,72,7,815
26057057012,1112,850,756,69,2,18,3,2,94
26057057009,427,357,316,35,0,3,1,0,41
26057057003,3171,2330,1989,221,20,70,18,2,341
26161161130,2366,2237,1568,158,255,33,207,15,669
26161161079,2455,1986,1812,44,15,34,54,1,174
26161161139,2684,1963,959,96,794,70,45,7,1004
26051051002,1863,1408,1332,28,6,31,2,1,76
26051051001,1145,858,803,18,7,21,2,0,55
26055055027,3044,2556,2377,98,7,25,23,4,179
26055055028,2973,2418,2292,29,4,20,40,0,126
26145145028,1618,1250,1170,41,6,19,1,0,80
26145145062,2344,1989,1510,131,148,17,171,6,479
26145145065,1296,969,691,41,97,17,123,0,278
26145145005,1874,1512,1431,42,8,16,7,0,81
26145145034,1958,1542,1477,37,5,10,0,1,65
26145145077,1884,1520,1325,116,47,23,15,0,195
26161161031,1994,1646,1167,71,60,33,306,1,479
26161161024,1654,1290,1126,47,33,12,75,2,164
26121121064,2541,2017,1883,45,17,38,7,1,134
26161161002,2338,2218,1512,152,118,11,433,2,706
26161161004,981,900,648,54,56,11,139,3,252
26161161001,2555,2404,1553,136,154,18,547,3,851
26161161042,2078,1998,1270,117,95,21,493,4,728
26161161099,3546,2730,2389,76,89,43,121,11,341
26125125134,2855,2356,1789,97,307,77,72,0,567
26125125400,1046,824,736,27,35,8,11,0,88
26125125450,1205,877,619,32,38,5,187,0,258
26125125086,3107,2399,2113,63,54,34,112,0,286
26125125076,3083,2662,2087,85,136,23,313,0,575
26023023006,1417,999,957,12,2,21,3,0,42
26161161112,3151,2487,1299,113,876,31,172,7,1188
26125125439,3162,2404,1304,37,61,4,990,0,1100
26125125159,2578,1936,1747,70,35,26,30,0,189
26161161067,1359,1129,1061,18,9,18,14,1,68
26051051007,2086,1777,1716,19,7,23,4,1,61
26051051018,2459,2072,1975,38,5,32,5,0,97
26051051016,1022,937,900,13,5,15,4,0,37
26051051008,916,782,748,7,3,10,4,0,34
26091091012,1841,1585,1491,28,9,36,12,1,94
26129129008,572,469,448,6,0,8,4,0,21
26133133010,1565,1230,1137,17,8,50,4,0,93
26133133012,733,604,565,8,4,25,0,0,39
26091091024,1920,1551,1362,95,30,43,15,1,189
26091091002,3319,2403,1577,600,160,90,10,2,826
26091091039,1974,1599,1455,75,13,23,18,0,144
26115115038,2458,1963,1844,39,11,31,13,1,119
26067067024,1012,760,724,20,6,9,3,0,36
26067067026,2268,1809,1712,40,5,28,8,1,97
26067067001,2659,2012,1769,122,27,47,14,2,243
26067067002,1689,1284,1165,76,9,31,3,2,119
26125125248,1969,1542,1002,50,398,36,59,0,540
26125125085,1708,1373,1225,41,19,41,36,0,148
26125125075,2836,2363,2108,59,57,43,65,2,255
26125125507,3328,2633,2401,56,45,69,24,4,232
26125125456,3231,2651,2276,150,96,87,47,2,375
26125125460,3690,2896,2333,215,166,101,69,1,563
26161161085,1863,1403,671,56,54,10,601,3,732
26161161027,2144,1718,1157,124,264,56,126,3,561
26161161039,3059,2716,1613,195,303,47,532,7,1103
26161161084,3366,2743,1277,350,552,39,549,3,1466
26161161005,1772,1556,1097,101,107,29,212,0,459
26161161149,3836,2750,1654,171,758,62,122,2,1096
26117117017,2272,1820,1659,56,19,41,25,5,161
26161161078,3467,2792,2535,83,43,62,36,0,257
26161161080,2663,2153,1904,67,51,63,43,1,249
26161161087,2854,2405,1565,110,172,10,540,8,840
26161161036,2125,1862,1334,112,107,34,260,2,528
26125125331,4360,3456,1511,164,261,33,1468,0,1945
26125125329,1379,1056,632,72,63,27,258,0,424
26125125206,2886,2214,1140,93,249,30,686,0,1074
26125125047,2894,2205,1715,37,102,13,308,1,490
26125125130,2282,1993,1652,109,112,32,89,1,341
26125125422,2928,2301,1696,53,155,35,351,1,605
26125125461,3624,3093,2615,187,136,66,79,2,478
26125125464,3652,3101,2403,167,363,52,87,3,698
26125125326,2744,2161,1715,69,56,42,262,0,446
26055055003,1959,1480,1327,46,13,71,15,0,153
26091091029,2024,1590,1385,114,22,61,9,1,205
26091091028,913,724,692,15,1,14,3,0,32
26091091010,3204,2474,2285,117,14,46,10,1,189
26091091018,1661,1296,1184,51,11,33,6,0,112
26091091022,1330,1076,1014,15,7,24,8,0,62
26091091034,1286,1027,964,24,8,26,5,1,63
26149149015,1444,1163,1061,29,14,38,1,2,102
26127127014,858,654,584,42,4,18,4,0,70
26117117024,1870,1450,1344,39,9,39,4,1,106
26125125144,2456,2007,1882,43,8,31,23,1,125
26125125266,3291,2368,2076,103,63,78,23,8,292
26125125384,2609,2133,492,52,1509,35,50,1,1641
26125125388,2162,1823,211,25,1496,13,86,0,1612
26125125365,2713,2226,732,48,1319,34,100,5,1494
26125125366,1552,1219,636,27,466,29,75,6,583
26125000019,2746,2075,1264,76,69,12,629,0,811
26125125321,2620,2092,1712,56,69,24,214,1,380
26159159026,2994,2361,2183,64,28,45,4,2,178
26091091004,3195,2524,2088,244,100,47,52,3,436
26115115056,3264,2486,2094,85,167,63,44,0,392
26109109004,451,342,312,4,1,23,0,0,30
26109109006,341,296,286,1,1,5,2,0,10
26061061012,1680,1479,1313,41,35,33,44,5,166
26103103025,2058,1597,1494,23,11,50,17,1,103
26103103018,2316,2023,1809,54,33,83,30,2,214
26061061008,116,105,99,0,0,2,3,0,6
26157157011,1462,1118,1055,27,7,19,2,1,63
26157157012,2070,1663,1557,51,9,27,8,2,106
26157157018,2470,1990,1802,49,23,59,8,0,188
26125125253,2769,2142,1958,69,24,38,55,3,184
26125125254,2954,2168,1844,104,73,37,87,1,324
26083083001,1428,1158,1125,8,2,16,2,1,33
26059059016,1367,1103,1020,41,0,39,0,0,83
26165165014,183,162,154,1,1,6,1,1,8
26083083002,217,205,189,1,8,6,4,0,16
26083083004,72,70,69,0,0,1,0,0,1
26157157008,1920,1516,1382,27,34,42,10,2,134
26157157016,3167,2480,2317,60,11,57,6,0,163
26157157028,3873,3034,2822,51,16,87,4,1,212
26157157014,1060,850,797,26,2,16,2,1,53
26117117023,3363,2639,2436,54,20,58,20,3,203
26025025018,2580,1970,1455,81,370,55,29,0,515
26023023014,1770,1405,1328,24,4,19,14,0,77
26117117006,2619,2009,1881,50,8,41,11,3,128
26117117005,2898,2191,2036,80,18,41,7,0,155
26117117001,2135,1729,1606,36,9,50,3,0,123
26117117008,2239,1769,1676,40,8,29,7,0,93
26003003005,532,433,402,1,3,25,0,0,31
26003003002,411,368,355,2,1,6,3,1,13
26153153005,654,579,523,6,0,51,1,0,56
26059059024,1341,998,956,26,2,6,3,1,42
26059059017,1538,1169,1095,15,10,27,3,1,74
26003003001,1020,880,806,11,4,58,4,1,74
26009009013,2355,1945,1789,49,2,70,7,3,156
26103103011,3336,2648,2468,36,23,97,5,3,180
26117117002,6352,5983,3549,503,1866,24,36,2,2434
26117117004,1120,881,809,45,6,14,1,0,72
26117117016,2206,1672,1532,69,15,30,7,5,140
26165165012,1698,1252,1158,17,10,37,6,0,94
26103103010,2804,2184,2059,29,17,68,3,0,125
26103103032,810,649,596,11,0,31,5,0,53
26103103015,3631,3257,2623,41,437,116,36,2,634
26165165016,1258,901,843,18,7,26,2,0,58
26009009016,364,287,281,0,0,3,0,0,6
26083083005,91,82,76,1,0,0,0,0,6
26009009006,2521,2164,2061,30,1,44,16,8,103
26003003004,392,318,297,3,1,13,1,1,21
26165165017,2233,1799,1698,29,18,30,15,0,101
26165165021,1161,881,798,16,9,26,6,1,83
26103103003,2868,2282,2086,13,6,135,17,1,196
26103103002,3031,2438,2218,23,13,133,20,1,220
26119119007,380,360,347,4,3,4,1,1,13
26119119005,262,232,230,0,0,1,0,0,2
26139139056,3104,2160,817,1083,81,92,140,11,1343
26139139066,2570,1868,1553,133,32,29,105,6,315
26139139064,2904,2207,1273,505,108,39,306,6,934
26139139060,3551,2727,1278,811,72,78,528,4,1449
26139139072,4048,2653,2415,116,26,18,56,3,238
26001001009,653,565,544,4,2,5,2,0,21
26047047019,560,475,447,5,0,18,5,0,28
26005005027,4489,3155,2901,91,45,66,29,4,254
26005005028,2512,1697,1537,57,24,36,40,1,160
26005005026,3805,2786,1843,651,156,151,8,5,943
26081081201,2225,1636,1542,26,14,15,21,1,94
26011011016,519,441,404,12,1,12,4,0,37
26081081015,1918,1518,1182,148,102,74,30,7,336
26081081005,2550,1840,1679,28,35,25,55,0,161
26081081016,2857,2237,1980,132,48,49,24,5,257
26081081032,1811,1292,1171,29,14,33,31,0,121
26081081033,3476,2464,2227,46,53,39,84,2,237
26081081163,1576,1263,1181,22,11,10,20,0,82
26081081128,2794,2316,1729,102,372,32,77,0,587
26081081085,5881,3730,549,2700,507,234,38,7,3181
26081081029,1622,1139,1041,31,22,21,15,0,98
26081081077,1505,1254,1106,57,21,32,37,1,148
26081081200,2365,1762,1644,42,8,19,40,0,118
26001001012,354,314,292,3,0,12,1,0,22
26001001002,1032,908,880,4,4,16,2,0,28
26137137002,2714,2168,1981,43,20,88,18,1,187
26081081073,2467,1830,1067,321,392,45,40,9,763
26081081070,3999,3258,2190,516,398,105,69,4,1068
26081081094,1702,1467,1009,212,170,46,22,5,458
26081081060,1912,1321,1229,21,13,16,23,1,92
26081081183,2059,1593,1432,61,34,36,12,0,161
26081081222,2741,2286,1956,120,103,26,53,0,330
26081081218,2544,2043,1853,79,43,19,26,5,190
26047047012,1294,1012,856,9,18,108,10,2,156
26047047005,748,666,607,4,8,41,2,1,59
26081081154,2424,1742,1414,55,35,20,209,2,328
26081081115,3981,3222,2061,166,827,55,124,3,1161
26029029015,1405,1122,1060,6,2,35,12,3,62
26011011009,1166,1004,946,11,1,30,5,0,58
26069069016,1834,1514,1380,29,25,39,25,0,134
26069069015,1733,1404,1331,11,6,32,13,1,73
26065065037,2014,1684,1138,207,226,47,70,10,546
26075075044,2668,2050,1813,60,88,49,23,0,237
26075075039,2351,1795,1676,43,13,47,7,0,119
26065065020,3547,3128,1915,230,372,29,568,3,1213
26163163684,1748,1304,1142,38,57,22,41,0,162
26163163898,3468,2542,1407,168,855,76,36,2,1135
26065065032,2401,1869,1731,48,8,50,7,3,138
26065065013,2406,1912,1545,104,150,42,50,6,367
26075075055,2956,2493,2174,67,110,38,95,3,319
26075075056,2521,2149,1885,43,129,29,51,2,264
26065065035,1796,1401,1075,87,148,25,63,2,326
26065065019,2735,2164,1437,122,306,45,240,6,727
26065065073,2351,1789,1174,224,316,66,42,1,615
26073073027,1300,1008,960,10,7,26,4,0,48
26073000001,78,55,53,1,0,1,0,0,2
26163163785,1811,1426,1166,54,127,51,28,0,260
26163163945,2256,1777,1261,81,347,49,43,3,516
26027027006,3198,2551,2262,64,132,60,16,0,289
26047047006,525,449,391,6,1,49,2,2,58
26007007008,2335,1912,1824,15,11,16,30,0,88
26081081057,2049,1372,1261,29,29,9,41,0,111
26081081122,6103,5682,4450,259,389,40,510,7,1232
26081081101,2119,1836,1356,165,214,45,69,6,480
26081081140,2064,1552,795,135,573,39,35,0,757
26081081221,2673,1910,1661,89,46,39,71,0,249
26011011010,281,224,210,2,4,5,0,0,14
26007007012,971,804,758,10,4,15,4,1,46
26075075004,4562,3494,2762,115,363,71,144,1,732
26081081066,2523,1849,1500,50,126,22,145,6,349
26063063020,1419,1101,1020,52,6,3,4,0,81
26073073021,2225,1741,1573,45,6,96,17,0,168
26027027005,3077,2403,2198,63,68,42,9,1,205
26027001001,0,0,0,0,0,0,0,0,0
26163163728,3077,2263,318,53,1871,52,12,0,1945
26163163610,1405,1030,45,41,945,18,4,1,985
26163163294,962,718,3,6,709,9,3,0,715
26163163959,2086,1702,1441,55,108,46,31,0,261
26163163789,2327,1506,987,260,167,56,48,0,519
26163163787,2962,2101,1352,289,348,32,60,2,749
26049049080,1174,1011,495,51,431,12,24,3,516
26049049035,1877,1500,1334,38,47,46,14,0,166
26069069010,2557,2038,1836,74,53,39,31,4,202
26019019007,791,673,625,17,10,14,5,0,48
26019019006,1252,1103,1049,16,3,18,3,1,54
26047047003,3481,2854,2582,38,29,145,32,8,272
26047047015,1382,1110,1014,29,11,39,7,3,96
26163163866,2037,1598,603,68,883,39,17,2,995
26163163713,1511,1268,87,8,1146,22,8,1,1181
26163163711,1377,1072,96,30,947,42,9,2,976
26163163513,1127,868,49,18,804,4,4,2,819
26163163452,556,434,10,0,421,6,1,0,424
26163163970,2372,2058,806,85,952,56,179,4,1252
26163163937,2598,2213,1303,61,714,58,84,1,910
26163163317,1445,997,53,14,913,19,7,0,944
26163163559,517,401,13,43,349,4,2,1,388
26163163348,922,682,14,8,651,18,6,0,668
26163163788,2571,1769,1197,362,114,49,47,1,572
26163163091,1732,1511,725,36,325,8,411,2,786
26163163982,2152,1747,1520,103,57,61,9,2,227
26049049041,974,762,697,15,13,15,16,1,65
26049049148,3384,2510,2130,92,135,108,20,3,380
26049049079,1421,1169,406,60,641,42,22,0,763
26049049073,2339,1760,1238,174,296,48,14,1,522
26049049089,1998,1453,144,32,1260,18,9,1,1309
26049049119,3472,2543,1264,90,1091,96,22,0,1279
26049049123,1097,889,759,34,78,18,4,1,130
26049049018,1725,1382,1198,49,61,40,16,1,184
26049049144,1678,1317,585,48,638,49,9,0,732
26075075012,1105,879,800,21,12,21,6,2,79
26075075009,2755,2097,1958,43,18,57,9,3,139
26081081167,2391,1804,973,371,173,81,232,2,831
26081081056,1864,1300,1205,39,11,10,29,2,95
26081081058,1776,1197,1104,26,17,7,37,1,93
26081081088,3295,2452,1471,529,344,106,45,7,981
26081081089,2706,2270,2009,105,50,42,53,8,261
26081081121,991,806,465,38,267,6,24,0,341
26019019001,3873,3019,2842,60,11,63,11,0,177
26163163404,1954,1532,310,31,1181,28,14,2,1222
26163163705,2855,2110,963,44,1047,25,34,1,1147
26163163538,834,627,9,60,550,11,13,3,618
26163163484,447,336,39,0,287,2,7,0,297
26099099121,2355,1852,1664,29,42,22,58,0,188
26099099129,1894,1678,1591,17,25,18,21,2,87
26163163111,1612,1190,1095,38,10,11,25,0,95
26163163544,42,30,4,0,24,1,1,1,26
26163163679,1682,1301,1186,26,27,6,40,2,115
26163163757,2832,2357,2073,56,101,43,68,4,284
26163163126,2226,1771,1340,86,303,30,29,4,431
26163163660,1675,1337,1130,36,96,40,18,9,207
26163163241,1469,1107,17,14,1065,7,5,4,1090
26163163238,1133,936,40,21,876,10,3,0,896
26163163903,2735,2302,1540,166,438,59,90,5,762
26155155019,2629,1890,1733,79,18,47,4,0,157
26155155032,1977,1652,1550,29,6,39,2,2,102
26065065098,2028,1704,1341,59,91,21,174,0,363
26065065107,2012,1627,1342,51,72,18,141,0,285
26065065091,1821,1488,1219,80,80,26,84,2,269
26065065057,3034,2155,918,323,762,61,141,3,1237
26065065058,3201,2292,1028,341,833,70,83,5,1264
26065065053,2914,2198,1463,200,418,69,51,3,735
26075075025,1767,1313,1007,60,189,36,22,0,306
26075075015,2073,1698,1611,27,6,33,5,0,87
26097097011,430,367,317,4,5,35,3,0,50
26019019005,1065,918,880,9,1,8,11,0,38
26163163173,1274,950,20,14,912,8,4,0,930
26163163172,889,610,13,11,578,10,2,0,597
26163163819,2607,2088,1758,55,61,13,185,0,330
26163163735,3622,2813,1847,639,246,82,15,6,966
26049049104,2232,1621,1100,76,373,76,16,1,521
26163163761,2140,1672,1520,31,34,26,56,0,152
26163163363,1141,819,40,12,761,14,4,1,779
26163163356,1873,1359,37,9,1302,10,1,0,1322
26005005038,2538,1886,1746,49,7,43,8,1,140
26005005037,2618,1869,1716,50,6,46,17,0,153
26163163683,886,736,606,13,88,3,15,1,130
26163163907,3731,2695,1321,192,1007,57,116,1,1374
26163163124,2179,1684,1262,94,231,29,73,1,422
26163163985,3105,2470,2115,179,59,87,25,1,355
26075075013,1547,1253,1197,15,3,20,5,1,56
26163163598,2368,1730,43,20,1678,15,1,1,1687
26163163938,2628,2176,1607,86,369,29,76,1,569
26163163957,2004,1626,892,56,534,27,102,0,734
26163163770,2028,1671,1406,49,112,41,61,3,265
26163163663,2857,2345,1932,77,207,68,42,2,413
26081081079,2255,1848,1483,145,151,48,30,5,365
26081081228,2420,1803,1137,383,186,65,58,3,666
26035035017,459,394,380,5,2,5,0,0,14
26035035005,1038,878,827,10,8,26,3,2,51
26035035012,2207,1798,1690,29,4,41,11,0,108
26065065003,914,739,659,27,21,17,8,0,80
26065065049,4252,3668,1906,377,753,82,565,5,1762
26065065022,2061,1632,1256,90,149,26,109,0,376
26163163186,1731,1248,29,13,1206,11,0,0,1219
26163163272,853,666,15,2,641,11,5,0,651
26163163304,1443,1055,39,20,991,18,2,2,1016
26163163806,1696,1457,1276,41,30,27,74,2,181
26163163245,1387,1036,20,11,1002,16,3,1,1016
26163163621,928,698,9,8,679,4,0,0,689
26163163639,766,546,16,13,518,6,5,1,530
26069069018,720,622,597,6,2,15,2,0,25
26163163051,2078,1622,1259,67,76,34,203,0,363
26163163661,1760,1443,1206,51,82,57,26,2,237
26163163960,3505,2631,892,156,1505,83,32,2,1739
26163163905,1948,1604,990,128,346,51,85,5,614
26075075057,2443,2002,1801,44,62,28,53,2,201
26065065108,2997,2254,2066,82,38,43,20,2,188
26075075032,1934,1519,1236,54,151,36,44,0,283
26075075043,1510,1324,1268,6,16,25,6,0,56
26065065090,2213,1830,1418,105,113,43,153,3,412
26049049114,2762,2168,735,50,1280,42,72,1,1433
26049049106,2839,2070,1305,128,553,77,20,4,765
26049049180,1516,1180,880,54,185,41,8,2,300
26049049187,1553,1179,170,29,976,18,9,0,1009
26049049181,1796,1460,1309,38,70,39,4,1,151
26049049055,507,382,31,15,340,12,1,1,351
26049049057,804,614,18,11,580,8,2,0,596
26099099106,2004,1384,1051,74,193,50,19,0,333
26099099332,3574,2735,2236,343,57,58,49,1,499
26099099214,3549,2656,2364,78,74,40,81,1,292
26099099289,3857,3073,1979,97,483,76,416,2,1094
26099099088,2865,2304,1901,40,263,52,45,0,403
26099099017,2417,1854,1641,68,75,52,28,1,213
26049049105,2582,1980,648,62,1233,42,10,2,1332
26049049203,3160,2257,2042,67,45,60,16,1,215
26049049085,774,604,60,23,513,8,8,2,544
26065065099,3088,2751,1868,174,165,32,494,2,883
26065065100,1602,1374,1017,62,103,19,167,0,357
26065065060,3516,2450,807,282,1116,73,218,2,1643
26075075040,2149,1747,1614,51,24,44,7,0,133
26065065101,1858,1419,889,33,74,12,395,3,530
26065065097,1942,1519,1219,50,82,23,125,0,300
26163163188,1506,1182,106,10,1059,13,3,0,1076
26163163405,648,449,13,6,432,4,2,0,436
26163163881,1451,1178,987,56,84,47,9,1,191
26163163269,1713,1284,13,16,1261,8,4,2,1271
26163163332,1049,740,117,19,387,2,224,1,623
26163163467,1528,1264,622,47,565,20,17,2,642
26163163358,2194,1683,54,17,1602,21,2,1,1629
26163163368,1046,749,27,16,708,5,5,1,722
26163163366,1269,930,28,1,896,14,0,0,902
26143143002,294,251,246,1,0,3,1,0,5
26163163731,4419,3339,1513,858,876,102,29,5,1826
26163163043,2935,2283,1569,81,280,31,305,2,714
26163163747,3135,2646,2128,60,211,37,189,3,518
26163163630,1218,945,10,12,922,6,2,1,935
26163163259,858,663,7,11,642,15,1,0,656
26163163249,1988,1517,24,15,1475,29,1,1,1493
26163163308,944,705,53,21,634,13,6,1,652
26049049125,2097,1668,1372,51,191,41,6,1,296
26049049124,2371,1867,1456,100,207,63,34,1,411
26049049075,256,182,121,25,25,5,2,0,61
26049049086,441,334,237,33,53,5,2,0,97
26037037033,3089,2300,1994,101,59,55,60,3,306
26163163059,2324,1769,839,45,559,28,305,2,930
26163163746,1739,1416,1221,30,61,15,81,1,195
26163163360,870,654,122,13,511,7,5,0,532
26163163848,1437,1066,549,241,263,31,1,0,517
26163163914,1890,1517,1393,49,14,34,10,2,124
26163163910,2497,1993,1821,65,20,44,30,1,172
26163163925,2515,1966,1573,82,228,53,28,3,393
26163163739,4216,3316,2418,523,252,95,26,7,898
26099099331,3013,2331,2155,44,33,29,49,0,176
26099099225,2703,2200,1872,54,75,32,154,3,328
26073073014,2427,1933,1577,127,59,149,27,3,356
26049049049,1588,1263,43,17,1183,20,4,0,1220
26049049006,2449,1938,1811,33,8,37,14,0,127
26049049053,1071,813,30,24,759,11,2,0,783
26049049052,1717,1307,19,24,1261,14,2,0,1288
26049049145,1796,1547,1326,45,101,50,11,0,221
26049049193,1786,1432,1253,36,81,34,15,7,179
26049049192,2733,2269,1724,72,374,52,42,1,545
26049049111,1954,1636,792,22,716,16,74,0,844
26049049179,1857,1424,1070,56,225,61,12,4,354
26163163058,2127,1734,921,53,412,17,349,0,813
26163163951,2449,1973,1143,85,497,45,176,2,830
26163163581,2896,1923,69,99,1739,24,14,2,1854
26163163745,2484,2186,1675,55,315,27,108,0,511
26163163073,3700,2553,2324,35,63,12,61,2,229
26163163627,874,690,5,12,670,16,1,1,685
26163163629,898,677,9,8,642,19,4,0,668
26163163625,1691,1296,7,10,1270,6,2,0,1289
26163163601,3380,2149,638,428,1061,54,17,7,1511
26163163053,2142,1740,1196,37,171,28,296,1,544
26163163607,1102,826,17,6,803,6,1,0,809
26049049138,1351,1135,1055,26,7,22,4,0,80
26049049136,1132,948,886,8,4,29,9,0,62
26049049093,1606,1146,471,50,594,32,8,0,675
26049049021,2195,1784,1504,49,147,59,14,1,280
26049049216,1756,1413,1335,21,17,25,5,2,78
26049049171,1504,1214,1141,23,10,17,17,0,73
26163163816,2182,1775,1569,40,55,22,76,0,206
26163163926,1610,1302,1176,26,20,10,76,1,126
26163163647,989,746,66,17,644,18,16,1,680
26163163600,803,588,47,9,529,14,1,1,541
26163163696,4027,2828,1144,19,169,29,1476,3,1684
26163163796,2807,2179,1659,52,78,12,374,0,520
26049049131,2509,1871,1641,58,82,41,22,5,230
26049049134,2362,1855,1656,53,77,25,24,5,199
26049049027,1606,1340,1169,45,67,45,10,3,171
26049049025,1215,909,816,22,22,24,14,3,93
26093093037,1292,1067,968,36,10,41,11,1,99
26093093034,2535,2027,1881,32,14,43,24,0,146
26111111003,1065,843,801,15,2,15,3,1,42
26163163048,2435,1842,1185,69,115,36,436,7,657
26163163942,2466,1817,918,97,697,72,28,6,899
26163163181,991,773,106,18,643,20,4,0,667
26089089008,1647,1330,1242,28,14,18,14,0,88
26093093042,3192,2514,2333,51,18,61,35,3,181
26049049190,1372,931,84,39,813,21,1,0,847
26049049016,1213,964,859,31,24,25,13,0,105
26163163986,2118,1699,1481,91,41,62,11,1,218
26099099131,2253,1582,1384,27,61,19,66,0,198
26099099143,1711,1420,1294,37,36,17,33,1,126
26099099190,3359,2814,2585,58,56,45,55,2,229
26099099320,2496,1915,1160,57,319,37,315,4,755
26099099173,3534,2747,2166,88,342,84,57,6,581
26099099205,2472,1844,1382,31,85,16,320,2,462
26099099230,2258,1850,1625,33,70,31,87,0,225
26099099114,2282,1851,1674,36,55,19,56,0,177
26099099112,1994,1731,1566,25,79,20,37,3,165
26111111021,2490,2026,1888,36,10,47,14,1,138
26111111034,2272,1652,1444,25,43,29,95,2,208
26111111016,2059,1566,1422,35,15,26,56,1,144
26111111033,2062,1606,1359,51,41,35,112,5,247
26163163658,2568,2093,1819,67,124,43,29,1,274
26163163723,2042,1492,245,47,1169,25,17,2,1247
26163163989,1790,1471,1298,62,47,48,11,3,173
26033033011,1289,964,840,16,2,103,1,0,124
26123123027,2105,1675,1567,32,8,33,8,2,108
26063063007,454,344,324,7,0,7,2,0,20
26155155009,652,509,484,16,1,1,0,0,25
26155155025,2096,1637,1480,21,21,45,15,3,157
26163163279,1266,987,36,21,908,11,3,0,951
26163163263,946,724,4,6,710,6,3,0,720
26163163655,1928,1447,1143,55,157,54,20,0,304
26163163644,1065,784,14,19,745,7,3,1,770
26163163822,1947,1469,669,45,709,38,18,1,800
26139139058,3540,2896,1906,456,130,58,363,3,990
26159159015,3575,2760,2268,251,94,143,19,4,492
26159159001,3187,2432,2220,63,35,60,33,6,212
26077077083,2595,2071,1907,44,43,28,40,0,164
26077077088,2263,1752,1580,59,34,22,51,1,172
26077077045,2025,1709,1454,42,141,13,48,1,255
26069069014,431,352,335,3,2,5,4,0,17
26093093001,2335,2005,1809,60,27,30,36,6,196
26093093006,1974,1619,1499,24,3,35,30,0,120
26093093008,1616,1295,1227,18,8,28,9,1,68
26077077025,2588,2160,1541,114,384,34,76,6,619
26077077021,6013,5874,3971,551,825,21,311,13,1903
26077077070,1589,1261,1135,40,20,40,10,2,126
26077077071,2505,1799,1440,106,106,93,26,3,359
26077077107,1341,1022,946,34,11,18,8,0,76
26087087035,2813,2231,2083,24,13,69,28,3,148
26087087036,2899,2357,2187,62,10,59,34,2,170
26087087005,2453,1954,1821,47,3,44,11,2,133
26017017039,1399,1146,1102,10,5,22,1,0,44
26087087020,2333,1749,1095,577,17,58,16,5,654
26069069004,726,581,544,16,2,20,1,0,37
26069069017,414,319,310,0,1,3,3,0,9
26085085011,1603,1285,982,26,208,52,7,4,303
26085085010,757,554,512,8,9,20,2,1,42
26161161148,3581,2655,1324,122,904,51,239,4,1331
26161161118,2052,1605,1480,36,9,19,45,0,125
26161161076,2639,2108,1953,48,18,51,18,0,155
26161161063,1834,1334,1195,52,5,9,59,0,139
26161161045,2428,1934,1651,66,60,22,123,3,283
26139139019,3199,2294,2085,80,27,46,35,2,209
26139139045,2509,1947,1139,470,127,35,181,0,808
26139139050,2625,1894,1013,686,109,68,59,1,881
26139139071,2240,1612,1521,39,11,7,21,0,91
26101101014,870,725,681,15,4,12,1,0,44
26161161133,4232,3571,1531,385,1263,90,330,11,2040
26161161132,1938,1722,1273,96,219,53,66,6,449
26161161025,1985,1677,1236,75,82,17,247,3,441
26161161065,2844,2048,1867,48,32,42,47,0,181
26161161122,2094,1543,1379,48,24,22,69,0,164
26161161069,2028,1580,1431,33,16,45,42,1,149
26161161070,2002,1427,1269,57,25,20,51,1,158
26139139012,3261,2417,2194,66,37,59,33,4,223
26093093060,2976,2263,2017,111,23,52,33,2,246
26111111041,1657,1280,1181,41,14,16,16,2,99
26093093004,1391,1168,1113,16,10,13,18,2,55
26093093056,3053,2493,2315,47,18,46,57,0,178
26147147039,1117,917,851,38,6,12,3,0,66
26055055001,3000,2395,2228,56,20,42,17,0,167
26085085005,940,834,798,8,4,22,1,0,36
26093093055,2199,1709,1573,51,13,30,28,0,136
26093093036,2400,1932,1798,36,13,15,44,0,134
26151151020,1855,1428,1320,40,14,39,7,1,108
26057057021,2612,2073,1905,102,16,32,2,1,168
26151151008,784,633,590,25,1,8,4,1,43
26151ZZZZZZ,0,0,0,0,0,0,0,0,0
26145145011,2779,2166,707,161,1275,39,22,0,1459
26145145063,3153,2625,1926,191,348,33,130,7,699
26093093066,1953,1585,1464,42,8,30,19,1,121
26093093019,1609,1208,1075,47,24,37,15,1,133
26093093076,1545,1290,1201,27,10,23,19,1,89
26057057004,1665,1312,1202,56,14,27,2,0,110
26061061030,678,599,588,3,7,3,1,0,11
26077077061,2381,1885,1308,81,366,62,82,0,577
26077077085,2009,1521,1290,50,64,26,86,0,231
26077077049,3499,2792,2041,124,462,63,107,2,751
26077077022,2713,2368,1733,152,342,63,75,4,635
26077077051,1602,1278,1020,48,173,25,11,1,258
26151151014,958,744,688,13,1,15,7,0,56
26121121044,1779,1403,1194,81,59,49,3,1,209
26121121054,2857,2149,1775,107,155,35,62,7,374
26151151002,619,492,478,2,2,9,0,0,14
26147147030,1490,1156,1107,20,6,11,1,0,49
26151151021,1686,1303,1199,33,6,37,5,0,104
26151151029,416,312,295,3,0,8,3,0,17
26025025003,1403,1043,587,61,367,30,7,0,456
26025025016,2948,2180,842,127,1145,53,15,0,1338
26077077063,2552,2266,1586,76,485,44,88,1,680
26115ZZZZZZ,0,0,0,0,0,0,0,0,0
26115115043,1382,1103,989,30,22,49,2,0,114
26115115039,2325,1826,1711,40,7,43,5,0,115
26151151006,2322,1790,1499,205,16,57,2,0,291
26147147003,3115,2513,2369,60,3,40,19,1,144
26157157025,1443,1103,1058,22,3,9,3,3,45
26121121014,3708,2818,2469,119,85,112,26,0,349
26121121015,3644,2844,2585,78,62,59,46,0,259
26121121037,1226,1148,1076,16,22,20,7,2,72
26121121033,3006,2261,1637,215,287,104,15,4,624
26121121055,2430,1890,1694,41,36,24,77,1,196
26121121062,1924,1515,1236,57,147,31,47,0,279
26125125397,1898,1556,388,24,1097,24,37,1,1168
26125125148,3109,2424,2161,86,44,101,20,1,263
26125125147,2875,2237,2039,64,46,59,19,1,198
26021021055,2055,1662,1432,34,40,19,108,4,230
26021021007,3023,2191,1057,177,896,50,13,1,1134
26145145043,2793,2013,1057,336,564,45,11,2,956
26145145016,1805,1270,333,127,796,27,5,0,937
26145145031,2676,2077,1956,45,25,35,5,3,121
26145145081,2129,1592,1475,45,12,32,6,1,117
26145145052,1940,1572,1296,87,132,21,31,0,276
26125125158,2636,1963,1808,53,28,28,30,1,155
26125125136,2549,2118,1640,90,249,58,68,3,478
26125000006,2305,1844,1377,89,306,39,33,1,467
26125125333,1663,1361,1252,33,10,32,23,0,109
26125125198,2143,1783,1643,26,18,43,17,1,140
26125125438,2272,1706,1201,66,64,26,348,2,505
26153153006,480,365,318,8,0,37,4,1,47
26153153007,1635,1324,1111,19,9,167,15,1,213
26125125378,2229,1543,389,17,1108,11,24,0,1154
26125125242,2030,1615,83,18,1502,16,18,0,1532
26125125260,1730,1370,1214,43,27,52,39,1,156
26125125261,2567,2006,1831,59,53,22,18,1,175
26125125510,3034,2337,2159,37,34,43,35,0,178
26125125091,1782,1478,1166,47,125,36,86,0,312
26121121019,2918,2367,2128,41,43,57,28,3,239
26023023020,2772,2105,1995,43,16,23,13,1,110
26023023003,1431,1032,914,60,14,28,6,2,118
26125125151,1505,1112,1034,21,17,7,24,0,78
26125125354,3364,2811,2514,69,61,31,100,2,297
26125125243,2253,1694,666,30,949,38,23,2,1028
26125125044,2691,2061,1627,34,173,19,197,1,434
26125125185,2477,1982,1586,62,157,49,109,0,396
26125125018,2239,1773,1612,43,47,25,41,0,161
26125125013,2294,1816,1667,41,29,14,42,0,149
26125125362,1861,1542,283,20,1203,11,43,2,1259
26125125265,3492,2693,2436,85,56,55,57,1,257
26121121057,2631,2087,1926,48,57,30,21,4,161
26121121060,2743,2165,1956,74,39,33,41,1,209
26125125225,2470,1822,1635,41,27,22,61,2,187
26125125014,2102,1658,1495,46,31,34,42,0,163
26125125237,1325,1034,325,27,645,15,23,0,709
26125125372,2270,1905,221,16,1569,30,76,1,1684
26125125090,1779,1558,1245,32,186,18,67,0,313
26151151016,764,580,555,11,3,10,1,0,25
26147147029,1829,1446,1375,24,6,22,8,4,71
26125125065,3059,2410,2203,55,13,59,48,2,207
26151151010,724,593,553,23,3,7,3,0,40
26125125406,1431,1123,881,24,81,5,118,1,242
26125125448,3149,2422,1979,103,80,30,213,2,443
26125125031,2003,1577,1322,49,40,9,138,5,255
26121121016,3938,3218,2895,116,60,81,49,1,323
26125125234,1966,1456,1214,41,139,17,34,0,242
26125125233,1814,1528,537,42,888,18,54,0,991
26125125016,2293,1803,1614,48,61,34,47,3,189
26125125179,807,492,325,25,8,12,119,0,167
26125125180,783,536,456,21,7,4,38,0,80
26125125410,2945,2229,1999,64,35,41,68,0,230
26145145026,1998,1597,1508,38,12,27,5,0,89
26125125084,3515,2821,2149,156,173,42,280,6,672
26125125452,2634,2170,1708,93,222,13,117,1,462
26125125496,3317,2790,1873,57,530,12,306,0,917
26125125083,2109,1703,1513,53,28,40,49,2,190
26067067032,1124,851,798,29,3,15,3,0,53
26131131004,582,526,480,8,1,29,9,2,46
26125125096,3329,2755,1813,51,709,20,155,0,942
26067067005,1684,1347,1262,37,8,19,3,1,85
26125125398,1119,867,762,31,17,14,32,1,105
26109109001,242,222,204,2,1,11,3,0,18
26041041005,555,447,437,2,0,7,0,0,10
26041041013,540,430,410,2,0,9,2,1,20
26045045010,1818,1493,1177,69,163,19,59,1,316
26045045022,1862,1375,1097,48,63,31,125,1,278
26045045021,2395,1791,1500,50,122,15,87,3,291
26125125393,1720,1458,331,14,1091,18,22,1,1127
26125125025,2554,2108,1878,42,55,12,109,6,230
26125125486,3037,2686,1872,40,524,18,196,2,814
26125125080,2742,2153,1967,44,24,52,25,2,186
26125125322,2020,1653,1284,35,50,24,239,0,369
26139139010,2564,1735,1560,70,24,45,11,3,175
26139139036,3300,2603,2294,95,59,61,60,1,309
26055055016,3053,2354,2157,55,23,44,36,2,197
26055055017,2910,2363,2100,88,41,68,33,3,263
26145145060,3027,2443,1771,190,368,46,59,19,672
26139139061,4240,3011,1607,924,180,77,270,21,1404
26125125449,679,591,528,17,13,7,17,0,63
26125125029,2267,1797,1403,32,89,13,243,1,394
26139139039,2136,1715,1636,31,8,13,11,1,79
26133133001,1410,1077,1018,13,6,25,8,0,59
26129129016,2342,1886,1756,34,17,39,16,2,130
26129129017,2567,2054,1934,36,13,43,13,0,120
26129129012,1163,892,850,1,4,19,3,0,42
26105105021,670,498,418,28,10,20,7,0,80
26023023018,2161,1850,1742,39,9,36,9,0,108
26091091023,4918,4216,2485,423,1189,98,29,1,1731
26121121010,4337,3186,2699,200,99,147,23,2,487
26091091021,1499,1227,1124,57,15,38,4,1,103
26051051010,1558,1221,1126,25,8,37,15,3,95
26129129013,827,671,621,18,2,16,3,0,50
26133133016,1406,1065,1022,7,1,18,1,0,43
26139139051,2222,1752,1512,152,28,22,30,2,240
26101101003,704,593,571,9,3,7,2,0,22
26127127002,855,675,611,37,12,20,6,2,64
26021021036,2773,2041,1416,144,384,77,28,1,625
26149149008,1587,1249,1168,26,7,19,11,2,81
26125125513,2807,2131,1890,58,46,22,100,0,241
26125125466,3887,3095,2563,251,131,60,64,10,532
26139139057,3019,2405,1722,446,76,65,121,2,683
26045045023,1991,1666,1098,93,318,36,123,2,568
26045045018,1573,1247,824,79,265,29,64,1,423
26117117027,2646,2071,1933,44,19,37,2,1,138
26105105025,1406,1106,1029,34,0,24,4,1,77
26125125307,3129,2269,1699,63,85,36,373,2,570
26125125302,1242,922,780,27,27,13,76,0,142
26125125316,2892,2127,1751,58,45,21,236,0,376
26099099172,2083,1733,1371,31,207,68,40,0,362
26125125169,2764,2249,1821,150,136,43,86,0,428
26077077015,1598,1276,1171,20,35,29,10,0,105
26025025027,2394,1873,1558,55,104,31,115,1,315
26025025022,2274,1716,1332,83,79,34,175,5,384
26023023016,1173,936,868,7,16,25,6,0,68
26061061024,750,585,550,8,3,14,3,0,35
26125125474,3698,3047,2352,374,195,70,61,3,695
26139139102,1133,787,710,47,5,11,12,0,77
26099099274,2885,2405,2021,16,23,16,325,1,384
26125125163,2173,1700,1512,30,56,22,70,2,188
26125125313,1685,1307,1170,48,29,12,47,3,137
26125125501,2664,2157,1968,60,17,65,25,0,189
26125125063,2658,2120,1942,56,22,44,20,0,178
26125125412,1990,1608,1465,32,14,32,40,1,143
26059059005,2070,1467,1400,16,1,34,3,1,67
26021021001,2682,2144,1880,136,25,61,19,1,264
26021021044,2528,2008,1770,53,90,53,33,2,238
26115115006,2293,1766,1651,49,19,37,3,0,115
26115115057,3301,2607,2358,57,81,49,28,0,249
26125125236,1813,1360,740,24,549,12,19,7,620
26125125514,6667,5785,3057,296,1835,115,510,9,2728
26165165001,900,688,632,14,4,20,8,0,56
26125125200,1792,1503,1369,41,16,23,20,0,134
26125125413,2690,2037,1801,95,59,38,35,1,236
26125125503,1352,1060,950,27,28,27,21,1,110
26139139105,1824,1552,1470,41,9,12,20,0,82
26139139025,3308,2531,2243,118,61,45,48,2,288
26139139024,2768,2093,1937,56,26,36,29,0,156
26139139079,1881,1525,1405,62,6,25,27,0,120
26009009005,952,761,717,10,3,14,1,0,44
26139139092,1938,1410,1285,36,17,32,23,1,125
26139139091,2611,2178,1993,64,44,47,27,0,185
26077077065,1581,1240,940,39,201,15,41,0,300
26059059009,1979,1488,1380,24,21,39,15,1,108
26061061005,1864,1405,1332,15,7,36,4,1,73
26017017043,1814,1513,1418,55,10,16,0,1,95
26017017046,698,540,503,21,3,10,1,0,37
26017017044,2437,1922,1829,24,7,22,17,0,93
26163163310,1311,952,41,11,891,20,1,3,911
26099099311,5049,3756,1994,80,1453,106,112,5,1762
26099099257,2698,2139,1907,47,100,12,55,3,232
26099099248,2714,2228,1773,70,159,39,153,2,455
26099099171,3724,2999,2281,59,498,80,68,2,718
26099099110,2396,1837,1649,48,52,34,47,2,188
26163163892,4000,3126,2490,240,201,112,65,4,636
26163163976,1982,1630,1291,103,153,51,39,6,339
26163163320,558,412,20,13,383,1,3,0,392
26163163184,1186,794,114,32,635,31,7,3,680
26163163911,2520,2054,1856,75,20,60,26,2,198
26037037024,2520,1985,1833,53,11,40,29,2,152
26037037023,597,452,424,18,0,5,1,0,28
26017017023,1124,881,838,10,1,20,4,1,43
26141141005,819,670,621,10,4,23,9,1,49
26145145030,894,734,690,30,6,8,4,0,44
26025025059,2803,2074,1311,119,295,70,286,7,763
26115115052,3102,2443,2110,97,137,50,42,2,333
26133133013,943,764,714,13,7,17,4,2,50
26113113014,1201,919,880,11,8,17,4,0,39
26023023019,1336,1002,917,35,11,18,14,0,85
26025025025,2079,1637,1349,40,59,29,145,6,288
26021021010,1837,1190,107,49,1021,17,0,0,1083
26067067020,979,752,700,22,10,9,6,1,52
26103103013,1824,1408,1331,10,4,33,13,2,77
26153153009,1045,832,679,2,4,136,5,2,153
26125125246,1403,1166,735,48,333,17,47,0,431
26125125026,3013,2208,1864,71,84,11,154,1,344
26125125414,2764,2146,1947,74,46,43,19,0,199
26105105018,1650,1301,1212,39,7,29,6,2,89
26107107017,1064,809,758,18,8,17,6,0,51
26001001006,437,364,348,4,6,3,1,0,16
26015015023,3336,2476,2255,81,29,58,18,2,221
26029029007,735,640,612,7,4,6,5,0,28
26053053004,2171,1804,1700,23,21,36,6,4,104
26081081018,1254,1011,930,46,7,18,7,3,81
26073073008,1246,952,887,22,6,25,9,0,65
26073073009,1199,871,717,44,14,90,3,0,154
26005005002,1557,1202,1044,58,54,29,12,2,158
26031031002,1092,893,807,6,5,60,2,0,86
26081081174,3994,3062,2006,157,444,40,441,1,1056
26081081116,2113,1800,1526,72,123,24,35,0,274
26081081198,3378,2673,2344,102,114,37,67,2,329
26081081108,1182,1055,803,76,121,24,30,2,252
26081081100,3044,2338,1754,229,284,64,22,4,584
26073073026,3566,2941,2459,147,192,82,49,1,482
26081081035,2760,1970,1824,48,21,21,26,1,146
26081081234,2191,1638,758,619,206,57,47,3,880
26089089011,1562,1254,1185,17,8,21,12,0,69
26099099021,2608,2243,2047,53,32,47,41,1,196
26099099076,2687,2033,1197,40,721,57,20,1,836
26099099175,1536,1212,958,33,130,48,23,0,254
26099099307,2894,2425,2004,44,202,50,126,3,421
26099099308,1879,1544,1363,25,70,27,54,4,181
26099099306,3500,2787,2203,63,341,30,144,0,584
26099099287,3333,2717,1875,54,177,34,575,1,842
26099099246,2993,2378,1859,31,113,7,360,5,519
26099099089,2806,2198,1785,55,212,54,76,4,413
26099099192,3201,2572,2313,56,86,53,40,2,259
26099099126,2406,1877,1633,41,80,14,101,0,244
26099099303,1844,1482,1117,45,196,26,102,0,365
26081081243,3663,2866,1923,562,271,35,81,7,943
26065065046,2620,1963,1143,302,427,60,41,6,820
26099099008,1504,1316,813,27,368,28,71,1,503
26099099133,2092,1496,1336,56,41,5,44,2,160
26017017022,1693,1343,1256,25,4,39,1,0,87
26017017003,2189,1785,1646,56,18,44,15,0,139
26017017001,2068,1631,1530,35,16,32,5,0,101
26017017029,2531,2077,1939,41,8,48,19,0,138
26163163119,2758,2000,1323,81,521,17,55,1,677
26163163894,2231,1785,1446,149,106,54,19,2,339
26163163895,2695,2181,1770,156,158,83,29,6,411
26163163352,1179,884,25,10,849,13,1,1,859
26163163350,893,646,9,3,634,8,0,0,637
26163163260,1916,1496,26,8,1460,14,0,1,1470
26163163955,3194,2661,1502,74,558,64,459,0,1159
26163163954,2045,1727,1097,56,429,23,116,1,630
26163163805,2765,2394,2149,47,70,48,66,0,245
26163163780,2248,1859,1655,62,26,41,55,1,204
26163163046,2496,1950,1369,63,125,27,339,1,581
26163163662,2791,2247,1956,87,112,67,32,3,291
26163163497,1025,770,31,7,722,12,6,1,739
26163163361,1218,888,27,14,838,15,2,1,861
26099099314,4316,3479,2701,54,398,63,255,6,778
26163163443,868,685,158,12,501,9,10,0,527
26163163402,1003,773,129,16,608,12,6,2,644
26163163541,2804,1871,132,1279,499,80,7,4,1739
26163163422,1322,975,26,10,939,15,0,1,949
26163163382,1241,895,13,13,857,20,15,1,882
26163163267,827,649,17,6,628,2,1,0,632
26081081135,3388,2252,375,444,1407,61,28,5,1877
26081081175,2719,1985,1016,113,374,21,479,0,969
26081081180,2355,1741,604,115,843,33,169,6,1137
26017017017,2723,2177,2058,42,4,36,12,0,119
26081081236,1810,1401,961,255,124,47,29,0,440
26099099177,3353,2740,1711,60,820,63,71,4,1029
26099099250,3172,2467,2133,50,125,28,121,4,334
26099099260,2017,1581,1275,35,159,20,71,1,306
26163163906,2511,2033,1515,142,211,72,72,2,518
26163163940,2396,1946,1141,71,617,54,63,5,805
26163163936,1841,1473,1200,70,114,50,49,3,273
26163163465,1004,843,106,19,711,8,8,0,737
26017017027,2517,2221,2026,75,57,55,12,2,195
26047047009,1274,1132,1033,16,7,57,10,2,99
26163163597,1491,1037,25,10,997,3,0,1,1012
26163163302,546,409,3,6,402,2,2,1,406
26163163585,837,589,32,31,516,13,1,2,557
26163163584,1427,995,55,53,871,26,10,2,940
26163163364,1282,922,19,14,882,16,6,1,903
26163163354,1027,643,2,3,635,12,2,0,641
26163163337,2459,1620,346,12,528,14,734,0,1274
26163163534,697,533,2,15,512,6,4,2,531
26163163335,2181,1495,435,9,235,16,793,0,1060
26099099145,1562,1232,483,33,676,26,13,2,749
26099099185,2736,2193,2008,47,65,37,23,1,185
26163163472,459,394,38,14,264,8,67,1,356
26163163691,2202,1717,1317,57,278,30,42,0,400
26163163599,1144,856,14,16,815,18,7,1,842
26163163592,2114,1414,118,55,1244,22,7,2,1296
26163163884,1730,1249,861,52,279,47,13,5,388
26163163766,2544,2142,1957,45,68,34,40,0,185
26099099023,3696,2635,2016,143,327,99,41,0,619
26099099244,3005,2471,1838,33,226,14,348,0,633
26099099237,4392,3592,2770,75,221,39,459,6,822
26099099236,2874,2280,1897,34,130,20,184,4,383
26163163150,942,749,94,14,619,16,7,0,655
26163163689,2850,2255,1937,56,141,29,79,3,318
26163163688,3154,2511,2221,52,99,27,88,2,290
26163163483,1838,1549,245,39,1233,35,18,1,1304
26163163167,1165,926,26,19,873,7,7,1,900
26163163168,1947,1519,98,16,1386,16,12,1,1421
26163163657,3497,2777,2417,103,103,63,58,1,360
26163163760,1388,1106,1035,30,14,15,10,0,71
26163163117,2268,1775,1474,94,88,36,60,2,301
26163163882,1606,1227,914,34,218,46,10,0,313
26163163758,2220,1782,1570,45,71,33,47,1,212
26163163952,1872,1494,1164,41,179,47,61,0,330
26163163379,715,485,28,9,443,1,3,0,457
26163163398,189,147,3,2,143,1,0,0,144
26163163397,981,761,24,10,727,11,3,1,737
26163163160,1764,1354,26,15,1313,17,1,0,1328
26099099296,1507,1227,725,20,254,6,218,1,502
26099099295,2694,2179,1287,56,312,20,498,0,892
26099099034,1414,1137,894,32,143,35,32,4,243
26099099055,2289,1886,1394,27,376,37,41,4,492
26163163202,1602,1270,73,10,1184,10,2,0,1197
26005005035,3133,2243,2087,88,19,28,20,1,156
26069069002,2016,1635,1500,33,18,37,15,3,135
26037037020,2504,2040,1307,81,234,27,400,1,733
26037037005,1076,930,781,18,42,13,64,2,149
26037037016,3626,3258,1899,179,537,73,571,1,1359
26163163055,2483,1854,1229,62,135,25,386,2,625
26163163344,424,342,14,0,328,2,0,0,328
26075075010,2561,2041,1904,42,26,44,12,2,137
26099099155,2836,2291,2042,48,93,67,24,0,249
26099099209,2449,1926,1454,79,182,35,172,1,472
26099099099,2254,1890,1723,40,46,41,18,1,167
26099099268,4540,3930,3125,90,395,42,256,1,805
26099099215,3022,2445,2202,55,52,50,69,1,243
26099099312,3180,2441,1716,67,480,71,87,0,725
26099099032,1170,923,737,28,124,24,4,1,186
26099099238,2509,2020,1555,31,98,15,331,0,465
26099099262,2386,1729,1354,83,156,50,76,2,375
26099099221,2975,2460,1599,131,438,47,235,3,861
26163163500,1253,1025,107,14,893,19,5,4,918
26163163481,924,772,180,21,555,20,12,1,592
26163163132,2216,1579,1355,68,87,20,49,1,224
26163163804,2897,2268,1739,86,65,27,327,4,529
26163163943,2486,1874,1186,90,545,54,18,3,688
26163163864,2737,2135,350,46,1681,27,46,1,1785
26163163362,1181,908,30,22,861,12,1,1,878
26163163163,1116,890,37,6,850,13,0,1,853
26017017007,2365,1953,1806,57,24,32,28,0,147
26087087001,3084,2402,2149,124,8,51,28,0,253
26087087023,1671,1304,1176,40,20,21,30,0,128
26087087022,1732,1277,1124,57,26,45,11,2,153
26163163727,2806,2150,774,47,1206,14,115,1,1376
26099099074,2994,2228,1308,45,732,52,77,3,920
26099099317,2441,2001,1560,67,266,41,54,0,441
26099099293,2424,2017,1314,31,325,18,320,0,703
26099099187,3119,2575,2217,67,189,35,44,1,358
26099099288,1784,1411,1152,8,91,16,145,0,259
26093093003,1965,1570,1463,30,12,28,35,0,107
26093093013,3136,2381,2187,52,27,39,37,3,194
26111111050,1775,1445,1324,20,1,49,12,0,121
26099000019,2191,1696,1450,37,106,42,39,1,246
26099099003,1863,1471,1213,135,63,33,12,0,258
26071071012,236,215,204,4,0,1,2,0,11
26063063004,739,571,551,8,1,6,3,0,20
26093093059,2514,1957,1821,47,6,42,22,1,136
26163163934,1966,1550,1259,58,137,49,39,0,291
26033033007,171,145,127,0,4,13,0,0,18
26111111032,2463,2016,1733,74,65,45,72,20,283
26131131007,270,237,221,2,0,8,0,0,16
26121121018,2126,1679,1518,38,33,33,18,1,161
26061061010,1037,713,673,15,0,7,5,2,40
26025025040,2884,2186,1954,63,76,59,32,1,232
26025025004,1131,911,594,97,147,20,39,0,317
26139139009,2096,1620,1493,77,12,21,14,0,127
26139139014,2952,2486,2294,56,25,31,50,1,192
26145145066,3195,2675,2184,110,137,39,190,2,491
26161161040,1798,1316,1089,53,56,16,105,2,227
26161161041,2054,1892,1161,89,178,31,427,4,731
26161161137,2799,2124,1239,126,634,103,38,2,885
26161161114,3867,2880,1506,306,878,95,137,4,1374
26061061011,470,347,329,3,2,9,3,0,18
26061061021,430,318,306,0,4,3,4,0,12
26025025006,1317,1206,932,135,40,8,59,1,274
26079079010,292,231,210,1,1,14,1,0,21
26113113013,508,392,361,9,5,11,2,0,31
26131131009,90,79,70,4,1,4,1,0,9
26131131002,49,44,43,0,0,1,0,0,1
26125125156,3420,2576,2340,75,41,55,38,0,236
26125125232,1977,1479,1250,33,35,13,140,0,229
26125125263,1680,1295,1113,47,38,20,69,0,182
26125125235,2122,1555,1183,34,227,10,64,1,372
26125125437,2086,1564,1132,37,21,8,364,1,432
26159159025,1482,1202,1067,53,18,37,15,1,135
26125125017,1979,1566,1394,50,43,25,40,2,172
26077077100,1592,1199,1094,37,25,23,14,1,105
26129129005,350,310,291,5,1,9,0,0,19
26161161151,3105,2316,1421,103,649,71,67,0,895
26161161142,2000,1653,856,44,664,46,47,1,797
26161161075,1994,1635,1520,46,13,23,13,1,115
26161161128,1286,1088,871,72,81,27,43,5,217
26161161044,1299,1138,884,40,130,24,62,8,254
26129129007,902,735,699,12,3,16,2,0,36
26051051006,1360,1098,1035,24,7,18,3,1,63
26125125367,1748,1425,330,7,1053,10,35,0,1095
26125125387,2007,1681,404,16,1227,6,32,0,1277
26125125386,1744,1532,320,8,1078,11,113,1,1212
26125125139,3473,2767,2579,75,25,39,29,2,188
26125125338,1892,1608,1431,62,46,17,49,2,177
26121121040,2650,1970,1750,64,67,51,11,0,220
26023023013,656,507,478,12,2,9,1,0,29
26125125347,2330,1948,1666,75,118,31,47,1,282
26161161023,2757,2568,1755,142,67,7,571,5,813
26161161111,1981,1621,1249,33,62,28,244,3,372
26051051014,1279,1100,1031,19,5,27,5,0,69
26129129014,1241,1051,988,18,3,20,9,1,63
26091091001,2999,2310,1583,505,152,85,15,1,727
26091091031,2381,1788,1591,106,19,35,20,0,197
26091091041,2371,1826,1648,87,24,47,16,0,178
26091091037,1155,903,829,36,1,20,5,1,74
26091091036,1824,1441,1334,59,5,33,2,1,107
26067067010,1418,1095,1034,31,8,16,4,0,61
26067067028,0,0,0,0,0,0,0,0,0
26121121020,2582,2012,1784,65,59,43,10,1,228
26113113006,174,151,141,3,0,4,2,0,10
26125125138,2822,2384,1815,92,316,87,78,1,569
26125125137,1744,1499,1212,38,181,43,30,0,287
26125125058,1730,1295,1014,39,61,16,152,0,281
26091091042,2042,1601,1463,46,18,40,21,1,138
26161161022,4364,4223,3040,264,413,27,457,7,1183
26125125494,1806,1430,1043,24,176,11,162,0,387
26125125492,2234,1793,1435,24,196,14,113,3,358
26125125305,1736,1364,1040,49,64,20,191,0,324
26055055035,468,379,365,6,0,7,1,0,14
26161161051,2825,2239,1718,103,186,54,165,4,521
26115115041,2605,2120,1992,26,7,54,11,0,128
26045045004,2839,2183,2022,79,13,34,24,2,161
26045045016,1901,1556,918,197,319,61,92,2,638
26125125505,3562,2932,2585,107,63,83,50,0,347
26125125327,2373,1958,1453,99,112,55,223,1,505
26125125325,2096,1483,987,46,20,21,413,2,496
26125125087,2903,2136,1766,153,74,82,45,2,370
26125125297,1765,1446,1277,55,28,22,49,0,169
26159159017,851,602,535,25,6,20,4,2,67
26055055021,3202,2500,2297,56,10,66,22,2,203
26061061004,621,500,472,11,1,11,1,2,28
26157157024,1970,1556,1469,25,3,35,5,0,87
26157157027,2727,1963,1709,105,83,46,6,0,254
26125125255,2221,1710,1496,68,36,29,62,1,214
26125125160,2879,2330,2117,61,49,34,61,3,213
26125125497,3799,2958,2090,46,569,23,227,1,868
26059059019,1094,781,722,13,10,18,4,3,59
26025025037,1508,1190,1110,21,15,31,2,0,80
26157157013,1325,1024,973,25,7,7,2,1,51
26139139104,1423,1008,874,92,16,6,14,0,134
26139139068,1981,1475,1353,41,39,16,18,2,122
26081081227,3030,2367,1594,428,226,70,74,2,773
26081081226,2858,2195,1524,404,160,55,80,3,671
26081081219,2677,2075,1826,86,63,48,35,2,249
26081081053,3297,2511,2321,62,25,52,27,5,190
26081081166,2246,1658,1077,154,275,50,114,1,581
26081081134,2805,2100,812,259,934,39,99,4,1288
26081081050,1919,1323,1210,29,13,21,41,1,113
26081081039,1933,1500,1370,37,17,22,29,0,130
26081081231,3611,2623,1321,826,391,111,52,3,1302
26081081213,2297,1695,1574,34,13,35,26,0,121
26081081217,3288,2460,2184,115,66,38,52,5,276
26081081025,3621,2471,2253,84,26,40,50,3,218
26065065092,2547,2178,1866,104,95,28,86,4,312
26163163377,1937,1648,282,44,1298,17,23,2,1366
26163163861,1914,1554,868,66,516,59,15,2,686
26163163515,34,32,7,0,23,2,0,0,25
26163163505,37,30,2,0,28,4,0,0,28
26163163507,82,61,1,1,59,0,1,0,60
26163163357,811,608,10,5,593,7,4,0,598
26081081087,2002,1365,312,374,670,59,16,0,1053
26081081161,2112,1677,1465,91,53,11,42,1,212
26081081173,3360,2547,1591,139,409,29,393,4,956
26081081172,3247,2391,1205,185,586,26,395,5,1186
26081081165,4058,3006,1859,239,498,53,370,2,1147
26081081104,2420,1986,1792,64,85,32,24,4,194
26163163939,2227,1726,1120,92,416,88,29,2,606
26163163295,1443,1058,8,10,1030,15,2,0,1050
26163163116,1488,1153,981,57,57,25,21,0,172
26163163135,2189,1608,1471,45,46,18,26,0,137
26049049029,2838,2100,1879,66,62,66,13,0,221
26049049208,1977,1577,1323,50,132,55,8,0,254
26049049172,2638,2047,1887,53,30,48,24,0,160
26049049140,1480,1149,1035,39,15,51,5,1,114
26049049130,2104,1640,1481,60,56,40,6,0,159
26107107014,1054,797,757,23,5,17,1,1,40
26163163891,2054,1615,915,79,500,38,71,0,700
26163163759,1975,1577,1423,52,11,30,47,0,154
26163163110,1541,1198,1027,58,76,4,30,1,171
26163163543,4515,2762,1456,1072,120,47,72,10,1306
26163163321,606,436,11,7,383,2,30,0,425
26163163229,1175,979,232,25,699,14,10,3,747
26049049030,2268,1760,1606,47,10,41,33,0,154
26049049214,3529,2864,2551,102,101,97,5,0,313
26081081080,2233,1869,1695,68,40,33,24,1,174
26163163636,665,500,3,10,485,13,2,0,497
26163163508,1068,884,73,13,788,13,4,1,811
26099099206,2742,2284,1859,87,154,62,112,0,425
26099099109,2420,1807,1572,28,70,21,82,3,235
26163163883,859,690,598,7,47,29,4,0,92
26163163458,1515,1448,475,38,848,9,81,3,973
26163163423,1692,1175,23,11,1133,2,4,1,1152
26163163622,967,723,5,1,714,8,0,0,718
26163163220,1925,1417,10,13,1387,13,6,1,1407
26163163659,3293,2598,2133,95,223,72,60,4,465
26163163768,2423,1919,1733,61,57,23,38,1,186
26163163896,1877,1493,1191,101,109,58,29,1,302
26065065042,1052,828,612,93,92,34,9,2,216
26019ZZZZZZ,0,0,0,0,0,0,0,0,0
26163163214,1212,934,17,15,900,9,6,4,917
26163163219,1243,926,12,7,909,4,3,0,914
26163163271,1115,959,5,3,944,7,2,1,954
26163163019,3071,2312,1506,119,471,53,151,0,806
26049049135,737,586,502,31,18,20,5,2,84
26049049054,1557,1143,30,8,1094,21,2,0,1113
26049049155,2627,2117,1549,64,373,56,74,2,568
26163163466,2852,2754,374,21,2296,34,44,2,2380
26163163476,731,615,122,16,469,4,0,0,493
26163163169,2066,1509,25,13,1442,35,9,1,1484
26163163653,2000,1519,1254,71,114,47,19,3,265
26163163077,4109,2785,2605,35,33,5,64,0,180
26163163844,2687,2162,1092,66,968,30,16,1,1070
26163163918,3156,2295,741,58,1360,40,94,0,1554
26163163268,1617,1266,17,18,1237,13,3,1,1249
26163163081,2468,1601,1496,16,22,6,32,2,105
26163163801,2807,2332,1718,142,160,41,269,6,614
26163163820,2115,1686,1481,32,24,13,117,1,205
26163163166,273,192,0,9,184,3,0,0,192
26163163161,545,381,14,8,356,7,2,0,367
26163163156,976,721,22,6,692,3,1,0,699
26163163228,947,767,128,10,620,15,6,0,639
26035035003,730,613,581,4,4,22,0,0,32
26163163138,1906,1423,900,76,346,33,43,9,523
26163163087,4335,2936,2429,57,285,16,116,1,507
26075075037,1759,1434,1344,22,17,31,5,3,90
26075075042,1290,1066,983,10,19,31,8,0,83
26075075050,1129,843,768,16,14,22,10,0,75
26049049048,2782,2376,2210,42,29,40,35,4,166
26049049043,3052,2401,2234,51,32,56,11,3,167
26049049132,2056,1603,1478,19,35,44,11,0,125
26049049012,2013,1633,1424,69,77,36,13,1,209
26049049157,2047,1511,1197,60,160,61,23,1,314
26099099228,2251,1994,1857,16,29,5,67,0,137
26099099079,2601,1998,400,9,1541,27,28,1,1598
26049049117,2430,1900,299,46,1528,30,16,1,1601
26049049063,433,349,6,1,341,4,0,0,343
26049049061,127,102,0,1,99,4,0,1,102
26049049034,2908,2383,1930,80,273,59,20,3,453
26065065023,1525,1335,1020,63,119,25,95,0,315
26163163305,1023,770,25,6,736,6,3,0,745
26163163367,990,726,41,10,666,4,5,2,685
26163163474,492,427,38,11,374,11,6,0,389
26163163164,1173,912,5,7,892,11,0,2,907
26163163145,2638,2044,1615,125,194,69,33,5,429
26163163109,1878,1356,1232,51,14,18,30,0,124
26163163852,3012,2484,2184,102,104,49,20,4,300
26049049033,2908,2277,1761,99,284,64,50,10,516
26049049162,1531,1168,659,48,433,20,8,0,509
26049049045,2807,2143,1984,48,16,45,26,6,159
26163163424,333,259,4,1,251,4,0,0,255
26163163480,1665,1315,266,18,1007,31,12,1,1049
26163163451,799,631,12,12,605,18,5,0,619
26163163315,1612,1076,37,12,1030,1,3,0,1039
26163163821,2093,1604,908,60,574,38,27,2,696
26163163535,724,540,12,56,464,9,3,1,528
26049049004,2395,1830,1685,45,20,25,37,1,145
26049049189,2480,1814,633,77,1036,75,7,1,1181
26049049188,1401,977,119,37,802,18,5,0,858
26163163040,2482,1863,1506,52,77,22,190,2,357
26163163740,2476,1866,1304,372,124,49,12,2,562
26163163144,2843,2203,1696,189,162,95,54,2,507
26163163218,788,590,23,5,561,4,0,0,567
26163163799,2811,2519,2165,53,68,18,192,0,354
26163163247,1600,1200,21,11,1164,13,4,6,1179
26163163707,1890,1489,101,45,1313,28,32,3,1388
26163163209,1506,1151,83,5,1053,6,6,0,1068
26163163223,950,785,45,8,722,11,6,0,740
26093093009,1341,1066,978,24,8,20,19,1,88
26093093007,2021,1546,1434,34,14,22,24,1,112
26111111019,2179,1693,1580,18,13,48,7,0,113
26099099253,2698,2148,1819,15,17,8,282,1,329
26099099189,3119,2645,2367,58,112,39,49,0,278
26101101013,1338,1164,1109,18,4,23,2,0,55
26163163278,1743,1298,52,11,1216,6,8,0,1246
26163163838,2221,1775,827,49,849,25,42,2,948
26163163751,1659,1344,1212,33,39,10,49,0,132
26163163118,2121,1616,1179,64,271,19,69,1,437
26163163984,3043,2403,2095,164,49,45,17,6,308
26163163252,861,674,3,1,648,3,5,1,671
26163163748,2966,2488,2080,41,98,22,229,2,408
26163163979,2343,1779,1429,127,149,40,22,1,350
26077077073,2323,1811,1396,98,222,63,36,4,415
26093093035,2179,1697,1526,52,32,23,57,0,171
26093093039,1274,1031,958,11,13,25,7,1,73
26087087011,2286,1875,1770,23,6,47,5,0,105
26089089007,757,699,680,7,4,2,1,0,19
26089089001,2554,2115,1946,55,13,68,9,0,169
26089ZZZZZZ,0,0,0,0,0,0,0,0,0
26085085006,736,598,558,16,3,23,0,0,40
26159159020,3021,2254,1652,437,37,119,14,3,602
26161161125,1893,1608,907,109,513,53,56,4,701
26161161047,1836,1477,1207,49,86,47,77,2,270
26161161131,1840,1615,1145,81,249,48,71,5,470
26161161113,2599,1628,392,56,1139,38,25,2,1236
26139139080,4488,3340,2381,662,54,57,182,2,959
26111111020,1806,1404,1294,27,2,43,5,1,110
26055055007,2062,1783,1649,29,22,42,26,3,134
26055055031,2525,2132,1903,67,23,99,28,8,229
26111111043,1348,1028,910,36,15,22,31,1,118
26111111031,1801,1390,1181,46,34,26,81,0,209
26145145009,2502,1912,1088,299,473,61,17,2,824
26055055024,1786,1321,1240,14,9,29,17,0,81
26077077013,2325,2013,1404,88,352,47,124,3,609
26077077038,3556,2811,1877,164,627,85,87,2,934
26159159018,1370,1096,879,153,13,34,9,3,217
26077000006,2631,2419,1658,122,310,29,296,1,761
26077077033,2274,1609,734,291,504,82,16,4,875
26077077097,1829,1500,1418,34,9,32,6,1,82
26147147026,1990,1721,1585,46,32,28,23,0,136
26077077072,2251,1828,1399,65,216,59,103,3,429
26077077019,2049,1523,1325,48,73,40,13,1,198
26077077028,2520,1690,145,81,1444,40,8,0,1545
26147147016,3403,2718,2528,68,28,49,14,0,190
26147147044,2214,1637,1536,29,11,20,23,0,101
26157157004,1398,1104,1027,20,6,37,2,1,77
26125125204,2981,2240,1223,62,273,34,644,2,1017
26045045002,2766,2213,2025,77,19,49,22,2,188
26045045044,3055,2231,1910,122,53,88,36,0,321
26125125028,2023,1625,1400,70,51,15,83,2,225
26021021028,2972,2389,2147,65,53,36,68,4,242
26125125146,2006,1541,1423,40,19,19,11,4,118
26125125097,2937,2315,1890,39,233,8,126,0,425
26125125374,2085,1559,457,21,1059,4,12,1,1102
26125125442,3914,2937,1747,60,112,41,975,0,1190
26125125092,1873,1560,1070,47,233,21,182,0,490
26125125508,2587,2050,1861,42,32,45,41,1,189
26125125114,3623,2934,1749,85,845,31,218,2,1185
26125125191,2598,2160,1683,38,113,40,271,0,477
26125125342,2306,2079,1630,75,186,18,170,1,449
26125125240,1718,1382,97,16,1261,17,5,0,1285
26125125024,2513,1769,1538,54,53,4,96,4,231
26125125495,2395,1988,1225,22,445,3,277,0,763
26125125195,2220,1784,1622,30,27,43,51,1,162
26125125355,2595,2097,1834,77,52,39,78,4,263
26125125050,2276,1788,1310,32,93,10,317,2,478
26161161029,2058,1704,1360,87,116,41,94,4,344
26157157017,735,569,538,15,2,6,0,0,31
26125125426,2195,1681,997,29,37,23,589,1,684
26125125023,2411,1747,1598,39,22,18,60,0,149
26125125344,3259,2784,2410,86,95,33,136,1,374
26125125480,2628,2222,1434,19,333,9,434,2,788
26125125416,2326,1736,1586,40,29,36,36,0,150
26125125512,3728,2847,2555,63,51,26,106,4,292
26125125483,2264,1766,1161,47,384,20,129,9,605
26021021023,2244,1820,1582,58,46,79,21,0,238
26021021027,3316,2669,2435,68,46,61,33,2,234
26045045039,1967,1436,517,218,664,41,40,0,919
26045045014,2424,1932,1184,169,466,55,88,4,748
26125125116,2614,2138,1207,42,406,15,462,2,931
26125125339,1933,1691,1486,52,32,17,86,2,205
26045045008,2099,1667,1529,60,29,36,4,0,138
26045045007,2315,1822,1596,100,63,53,8,2,226
26045045030,1894,1414,1282,58,20,39,11,0,132
26045045041,1517,1282,1018,30,199,28,15,4,264
26139139067,2942,2116,1870,113,35,65,25,7,246
26139139095,3131,2322,2193,42,9,29,37,1,129
26139139094,2507,2038,1928,30,16,19,22,3,110
26055055019,2407,1961,1828,31,10,49,26,4,133
26057057015,895,682,635,37,1,8,1,0,47
26139139013,1311,1022,960,20,4,21,7,1,62
26113113005,907,677,622,41,1,9,1,0,55
26109109002,614,482,459,13,0,10,3,2,23
26151151013,883,754,711,24,0,16,2,0,43
26045045029,1685,1273,1150,51,21,30,10,0,123
26045045013,2511,2074,1651,120,183,43,74,4,423
26105105019,1227,945,822,67,7,41,2,2,123
26105105023,1127,879,812,16,10,27,2,0,67
26105105004,580,453,416,21,3,9,4,0,37
26145145085,62,54,47,1,2,2,1,1,7
26121121017,2586,1946,1756,73,8,70,10,1,190
26045045012,2260,1899,1243,89,333,28,207,4,656
26023023010,3071,2243,2016,123,33,36,43,3,227
26117117003,1516,1158,1082,24,4,27,7,1,76
26133133005,591,435,424,1,2,1,2,0,11
26067067006,2384,1702,1578,50,15,25,9,1,124
26025025023,1985,1554,1233,34,111,22,144,2,321
26143143011,1863,1591,1485,23,9,41,7,0,106
26125125504,2605,2167,1936,62,52,44,50,0,231
26125125082,3680,2664,2356,70,79,30,100,1,308
26125125035,3038,2441,1910,44,201,17,245,1,531
26103103034,110,101,96,0,0,0,3,0,5
26077077023,3452,3159,2108,182,538,82,239,1,1051
26077077081,2799,2177,1947,79,48,42,66,1,230
26101101015,849,693,658,5,8,14,3,0,35
26125125117,2309,1783,1207,61,231,23,247,1,576
26059059023,2199,1789,1661,48,8,46,19,1,128
26165165002,650,527,500,8,3,11,4,0,27
26109ZZZZZZ,3,2,2,0,0,0,0,0,0
26115115030,1502,1222,1111,34,9,46,10,0,111
26115115005,2242,1797,1675,59,11,21,26,2,122
26115115054,2350,1722,1464,80,90,44,8,0,258
26099099285,4209,3445,2006,45,728,45,588,0,1439
26153153008,713,585,497,6,2,70,6,3,88
26153153010,260,221,205,0,0,16,0,0,16
26125125214,2814,1920,510,84,82,14,1221,5,1410
26125125215,2276,1708,822,50,28,16,781,0,886
26125125394,2585,2104,157,14,1896,16,40,2,1947
26009009009,887,724,684,8,1,20,4,0,40
26003003009,371,326,301,3,1,13,5,1,25
26083ZZZZZZ,0,0,0,0,0,0,0,0,0
26061061029,1215,930,893,12,1,13,7,0,37
26061061028,145,124,112,5,0,4,0,0,12
26161161134,2164,1760,1127,112,391,19,101,4,633
26087087018,3115,2414,2113,210,7,62,7,2,301
26087087032,2529,1993,1847,41,8,55,35,1,146
26017017005,2003,1699,1583,47,22,25,23,0,116
26017017036,1478,1285,1189,51,12,10,16,0,96
26163163312,2101,1556,36,5,1500,25,5,1,1520
26163163311,851,627,15,8,601,13,4,1,612
26163163537,864,633,19,34,575,15,1,0,614
26163163615,2287,1495,571,86,815,26,27,1,924
26099099297,3123,2500,1972,66,230,52,157,5,528
26099099071,3470,2946,2162,58,501,50,164,4,784
26099099035,1214,997,917,15,36,6,7,1,80
26099099200,2292,1914,1689,44,95,52,20,0,225
26099099124,2561,1979,1404,102,399,63,24,3,575
26099099090,877,669,534,11,87,8,6,0,135
26163163827,3404,2628,1116,96,1324,77,39,3,1512
26163163650,1162,898,482,196,197,25,10,0,416
26163163823,2659,2103,1291,70,627,57,32,1,812
26163163699,2953,1791,1291,19,228,8,231,4,500
26163163764,2003,1682,1551,41,25,24,21,0,131
26163163765,2255,1949,1772,46,36,40,45,0,177
26037037002,3125,2459,2055,128,98,60,99,8,404
26017017040,1204,915,852,27,15,19,2,0,63
26017017033,1327,1100,1005,38,16,25,2,0,95
26067067015,1578,1112,1001,64,19,19,8,6,111
26025025026,2335,1852,1337,45,84,30,354,0,515
26025025029,2270,1765,1346,92,82,30,191,3,419
26067067017,1730,1347,1230,49,10,39,5,3,117
26125125003,1681,1296,1164,50,9,35,24,0,132
26125125228,2009,1535,1354,57,28,21,69,0,181
26125125216,2666,1991,1290,56,57,14,567,1,701
26125125022,2301,1851,1589,46,89,16,95,1,262
26125125369,1662,1376,251,21,1060,27,45,2,1125
26125125401,1575,1166,1078,16,31,13,17,0,88
26073073011,1314,1043,985,18,5,27,2,0,58
26081081240,1957,1480,848,408,156,40,64,3,632
26081081136,3734,2524,515,282,1695,52,18,0,2009
26073073024,2122,1649,1468,32,48,60,38,4,181
26081081106,3018,2471,2159,112,101,43,37,5,312
26007007016,250,201,190,2,2,3,1,0,11
26073073022,1406,1019,941,20,16,39,3,1,78
26081081063,3036,2300,1857,133,187,55,65,4,443
26081081114,2562,2218,1810,100,220,10,71,3,408
26073073006,801,609,567,9,4,25,1,0,42
26073073003,1569,1240,1093,33,11,91,11,2,147
26081081252,3214,2332,1957,126,97,23,124,2,375
26081081251,2142,1611,1312,112,51,25,103,1,299
26081081036,2577,1939,1791,59,23,21,23,0,148
26081081105,2340,2006,1124,158,661,44,42,1,882
26081081095,2236,1787,1162,157,383,25,55,1,625
26099099264,3602,2884,2332,48,55,13,427,1,552
26099099019,1918,1502,1337,30,56,34,18,1,165
26081081147,2057,1522,1272,40,33,19,153,0,250
26081081176,2698,2200,1390,149,481,61,155,1,810
26081081111,2402,1936,1736,86,64,26,18,2,200
26081081232,2989,2044,850,943,211,85,37,4,1194
26031031001,937,814,755,6,0,46,3,1,59
26163163038,3029,2409,1641,78,270,44,357,0,768
26099099281,2488,1975,1286,41,402,54,192,5,689
26099099284,1940,1537,854,23,210,15,424,0,683
26163163409,1759,1178,79,14,1081,16,1,0,1099
26163163292,1475,1043,27,6,1000,5,4,1,1016
26017017002,1654,1370,1277,43,5,22,14,1,93
26099099196,2120,1716,1582,20,52,35,20,4,134
26081081193,2619,2133,1826,98,105,41,51,0,307
26081081040,2352,1720,1617,27,18,26,16,0,103
26099099046,1106,965,737,16,186,10,10,0,228
26099099060,2895,2445,2131,44,177,28,59,4,314
26163163276,1015,767,36,5,724,6,1,0,731
26163163420,1212,810,12,1,784,6,0,2,798
26163163303,1385,1032,23,14,1004,10,4,1,1009
26087087030,2342,1877,1729,54,25,39,12,2,148
26163163463,1097,978,301,32,600,11,26,0,677
26163163504,571,437,28,6,398,6,0,1,409
26087087014,2043,1653,1549,30,19,36,10,0,104
26017017032,146,113,101,1,2,5,0,0,12
26017001004,14,9,4,1,0,2,0,0,5
26163163069,1742,1283,783,42,66,16,368,0,500
26163163325,1690,1132,51,17,1043,8,20,1,1081
26163163692,2396,1856,1637,29,125,6,50,1,219
26163163324,2001,1408,54,24,1330,16,11,1,1354
26163163070,2146,1613,935,83,366,43,199,1,678
26163163050,1899,1686,1083,41,314,16,227,1,603
26163163341,473,376,13,2,362,0,3,0,363
26163163171,1302,1012,28,7,964,10,8,1,984
26163163975,1198,944,750,66,65,27,25,0,194
26163163418,312,229,12,5,204,5,1,2,217
26163163394,657,440,20,13,408,2,0,0,420
26163163013,2013,1534,1347,110,27,33,17,0,187
26163163015,1426,1189,907,116,109,25,30,2,282
26099099245,2307,1843,1527,16,40,7,239,2,316
26099099010,1167,939,615,26,199,21,79,0,324
26163163935,1737,1460,1029,62,289,28,38,0,431
26163163879,1841,1641,1097,76,320,20,130,0,544
26163163429,1059,723,29,2,684,10,6,1,694
26163163775,2229,1911,1602,54,116,33,105,0,309
26163163446,1832,1474,73,23,1358,21,11,0,1401
26163163586,2010,1365,222,56,1041,19,30,2,1143
26163163825,2323,1757,1049,50,586,46,28,0,708
26163163729,2415,1718,343,38,1292,42,10,0,1375
26163163479,1345,752,19,3,729,15,4,2,733
26099099061,2846,2307,1684,66,468,36,60,2,623
26099099292,3470,2739,1897,55,394,52,314,3,842
26099099135,2526,1845,1482,44,194,24,91,1,363
26049049013,2613,1955,1154,101,636,75,10,2,801
26163163182,1207,925,74,27,831,18,1,0,851
26163163632,745,576,1,3,569,3,0,0,575
26139139093,3300,2523,2349,42,27,46,35,3,174
26131ZZZZZZ,0,0,0,0,0,0,0,0,0
26131131008,406,368,355,0,1,10,1,0,13
26139139038,2376,1819,1672,47,8,45,29,0,147
26025025011,2294,1689,1203,88,163,39,169,0,486
26131131003,26,21,18,0,0,3,0,0,3
26125125268,3154,2393,2179,51,36,43,48,0,214
26125125205,2669,2141,1488,86,204,40,331,0,653
26125125067,2012,1490,1224,94,69,52,19,2,266
26125125472,3402,2803,2335,144,164,65,80,2,468
26125125196,1915,1483,1364,42,34,9,25,2,119
26125125197,1871,1427,1310,40,12,24,28,2,117
26125125481,1907,1534,1046,35,285,10,136,1,488
26125125475,2754,2181,1494,63,344,11,239,5,687
26161161003,1672,1570,988,113,78,27,373,2,582
26121121058,2488,2042,1812,53,86,48,23,3,230
26125125454,1063,869,787,29,21,14,11,1,82
26125125287,2668,2148,613,268,1164,52,77,2,1535
26125125218,2346,1698,1177,30,49,16,410,0,521
26125125217,2381,1782,1377,66,35,25,272,1,405
26125125298,1635,1207,931,48,57,24,146,2,276
26161161126,1156,983,690,60,179,32,35,0,293
26091091013,1583,1301,1219,34,2,31,6,0,82
26113113001,429,332,311,12,1,4,1,0,21
26161161052,1557,1242,964,43,122,22,76,2,278
26125125189,3759,2997,2547,71,132,47,181,0,450
26125125106,2493,1977,1078,30,597,18,254,1,899
26125125230,2764,2078,1728,80,30,35,192,2,350
26091091011,2298,1826,1685,49,5,45,15,2,141
26091091006,4824,4090,3237,411,291,90,66,1,853
26021021029,2342,1750,1523,68,42,28,63,0,227
26125125511,1696,1349,1190,38,50,18,40,0,159
26125125328,3487,2614,1840,222,139,102,244,6,774
26125125420,1786,1382,869,27,51,7,427,0,513
26109109020,616,481,459,6,5,9,2,2,22
26061ZZZZZZ,0,0,0,0,0,0,0,0,0
26165165010,897,681,656,6,4,10,2,0,25
26139139096,1809,1397,1253,49,29,44,6,1,144
26047047014,1328,1091,957,17,7,69,31,9,134
26081081138,1554,1212,996,33,126,10,47,3,216
26081081235,2368,1759,1101,433,193,58,18,0,658
26081081195,2774,2097,1924,53,44,30,37,5,173
26029029004,284,215,203,4,2,1,5,1,12
26029029013,671,552,513,7,2,19,6,3,39
26065065079,1619,1267,878,186,159,42,26,0,389
26065065029,2205,2189,1246,101,576,0,259,7,943
26065065004,2605,1943,1726,92,37,46,39,1,217
26065065028,3588,3549,2100,179,941,5,311,20,1449
26081081059,1876,1275,1158,25,15,20,50,2,117
26081081245,2894,2364,1645,340,258,66,67,9,719
26081081144,1612,1249,535,94,583,20,31,1,714
26081081126,1789,1356,713,101,438,30,99,3,643
26163163900,2278,1746,885,75,681,48,52,8,861
26163163902,3619,2882,1740,164,843,71,74,2,1142
26049049011,3226,2462,2070,118,138,110,31,9,392
26049049056,1530,1119,26,12,1077,15,2,1,1093
26163163380,1242,804,20,4,769,22,0,0,784
26163163802,1497,1022,525,25,56,7,392,1,497
26163163369,874,641,9,8,628,2,3,0,632
26163163643,1464,1096,48,33,1004,29,8,1,1048
26163163273,1625,1197,34,10,1155,5,0,1,1163
26163163606,1002,722,10,9,696,5,1,2,712
26163163874,3142,2652,2173,200,90,60,119,2,479
26163163392,1784,1430,314,30,1070,40,5,1,1116
26163163264,1066,833,16,7,802,7,3,2,817
26163163983,2818,2223,1948,147,62,54,24,3,275
26163163231,745,571,64,16,496,6,2,0,507
26163163773,2187,1817,1427,70,232,24,51,0,390
26163163962,2151,1746,1346,64,246,33,37,2,400
26163163453,1029,854,19,7,818,17,0,2,835
26163163157,853,606,14,4,583,5,4,0,592
26163163158,809,662,35,5,612,4,1,0,627
26163163628,1069,807,0,3,801,5,1,1,807
26163163072,3225,2260,2051,36,60,6,70,0,209
26163163681,1953,1547,1267,33,190,16,38,1,280
26163163767,2143,1812,1641,37,55,28,39,0,171
26005005012,1745,1149,628,434,39,27,7,1,521
26163163152,1768,1426,36,5,1376,22,6,0,1390
26081081127,2674,2249,1488,149,485,20,110,3,761
26075075026,1775,1361,1137,55,99,38,33,2,224
26163163579,1401,917,204,647,61,61,1,0,713
26163163191,1682,1267,28,7,1225,9,4,4,1239
26163163115,1471,1194,986,83,58,38,22,1,208
26163163929,3154,2460,1827,143,356,86,48,4,633
26065065040,2681,2058,1220,278,442,91,54,1,838
26069069006,1528,1305,1227,15,10,30,10,0,78
26099099064,1613,1332,1213,15,50,16,25,0,119
26099099007,1819,1384,997,27,185,52,110,3,387
26049049037,2258,1673,1516,51,25,32,24,0,157
26049049036,1336,1015,955,19,9,10,12,0,60
26049049194,1574,1297,1126,37,66,31,25,2,171
26163163201,1839,1480,148,20,1288,22,13,0,1332
26049049168,1894,1414,1137,64,150,30,32,0,277
26065065016,2793,2749,1828,155,607,10,134,0,921
26087087028,2068,1618,1473,47,4,67,2,0,145
26163163949,1379,1305,1169,30,46,13,33,2,136
26163163697,7185,4956,2470,50,500,41,1862,4,2486
26163163400,893,721,89,30,594,15,3,0,632
26163163438,1079,823,10,1,802,13,8,0,813
26163163373,213,157,6,4,146,6,1,0,151
26163163349,608,457,7,2,446,4,2,1,450
26163163375,908,761,13,4,743,7,2,0,748
26163163501,785,605,38,11,550,7,4,0,567
26163163243,1821,1336,19,10,1305,20,2,0,1317
26163163412,833,594,20,5,570,11,2,0,574
26099099087,2208,1799,1514,43,107,63,73,0,285
26111111002,2493,2021,1906,24,12,42,7,0,115
26163163783,1499,1177,1000,55,45,34,35,1,177
26163163280,1328,1002,54,13,936,5,10,0,948
26163163095,2202,1644,1415,91,73,20,42,3,229
26163163784,1258,977,890,28,31,11,18,3,87
26077077040,1605,1234,1098,42,39,13,31,2,136
26087087033,1839,1507,1428,35,5,33,7,0,79
26097097004,638,477,414,3,1,53,2,0,63
26077077075,1977,1573,1439,51,21,33,26,0,134
26161161121,2770,2084,1852,80,30,32,66,3,232
26161161143,2940,2156,802,117,1177,50,24,6,1354
26161161057,1887,1538,1239,47,169,51,11,2,299
26147000001,3,2,1,1,0,0,0,0,1
26111111017,1764,1354,1282,20,9,21,11,0,72
26093093002,1755,1509,1414,39,16,24,11,1,95
26111111035,1802,1433,1280,33,32,9,56,1,153
26093093010,3167,2336,2102,70,30,64,48,1,234
26093093024,1211,924,855,20,3,15,22,0,69
26071071005,316,250,242,0,0,4,2,0,8
26151151015,815,572,554,9,1,6,0,0,18
26147147019,1736,1380,1266,39,13,27,14,0,114
26045045034,2556,1915,1709,98,36,48,20,0,206
26145145004,1882,1469,1377,29,14,26,8,0,92
26125125008,1836,1541,1158,83,107,37,155,1,383
26045045015,2220,1760,1381,103,192,29,56,3,379
26125125112,1925,1562,1138,26,220,16,148,1,424
26125125330,2592,1927,1324,72,33,11,473,1,603
26125125377,1693,1434,146,19,1251,23,14,0,1288
26125125340,1753,1544,1309,32,93,23,67,2,235
26161161095,3105,2426,2121,55,139,56,40,0,305
26125125425,637,485,343,6,19,5,103,0,142
26125125186,2139,1781,1431,56,112,46,115,0,350
26125125220,1591,1044,811,23,52,7,141,1,233
26125125515,3991,3325,2381,169,328,54,393,2,944
26125125184,2622,2167,1725,67,178,63,117,1,442
26041041002,1595,1252,1154,12,9,50,15,1,98
26125125247,1599,1309,610,36,606,14,44,3,699
26139139054,2329,1838,1471,246,44,44,44,6,367
26045045031,1782,1369,1267,40,18,22,11,0,102
26045045024,1506,1199,723,86,297,25,68,3,476
26125125149,3012,2230,1982,82,55,47,54,4,248
26125000002,36,25,19,4,0,2,0,0,6
26051051017,1001,821,773,9,3,21,5,0,48
26025025024,2784,1957,1208,263,372,84,33,3,749
26139139083,2397,1792,1506,150,34,29,85,2,286
26139139008,3182,2324,2214,39,19,20,15,4,110
26125125506,2094,1729,1590,32,28,29,21,0,139
26061061019,422,341,324,2,1,2,1,0,17
26077077086,2410,1857,1550,69,101,60,80,1,307
26127ZZZZZZ,0,0,0,0,0,0,0,0,0
26125125133,1501,1233,1120,53,22,29,7,0,113
26125125207,3290,2560,1315,116,244,20,858,0,1245
26115115037,2054,1524,1215,58,152,40,55,0,309
26115115032,2187,1861,1616,71,122,36,25,0,245
26125125068,1376,1085,996,32,20,21,4,0,89
26125125229,2899,2080,1405,136,99,36,388,0,675
26159159002,2121,1630,1479,36,40,44,14,2,151
26077077077,2482,1848,1649,64,53,34,48,0,199
26163163498,1267,971,58,15,885,23,3,4,913
26163163495,1082,826,5,23,802,13,6,1,821
26163163698,2488,1715,1197,29,120,22,338,10,518
26099099337,1541,1156,1062,26,16,24,28,2,94
26099099338,2332,1786,1649,48,26,19,44,1,137
26163163742,1613,1286,973,170,87,49,8,2,313
26121121063,2248,1723,1394,91,160,42,27,2,329
26115115008,2799,2278,1997,119,51,67,24,1,281
26025025055,1415,1117,857,52,153,33,22,0,260
26021021018,1876,1424,1240,44,52,59,8,0,184
26099099276,1081,899,764,48,29,20,17,1,135
26125125385,2476,2139,314,24,1567,30,196,2,1825
26125125001,2299,1811,1680,29,26,35,17,1,131
26099099174,2237,1800,1067,47,601,50,48,3,733
26105105014,1266,1058,973,27,18,24,14,1,85
26081081038,2903,2171,2041,32,23,7,27,1,130
26081081250,2840,2170,1805,128,79,29,136,2,365
26081081247,2251,1715,1466,88,41,23,93,0,249
26081081194,2901,2310,2016,77,93,64,54,5,294
26081081096,1578,1292,1026,85,126,41,34,3,266
26099099194,2828,2392,2172,47,89,39,34,1,220
26099099195,2800,2344,2074,60,95,73,36,2,270
26099099201,3856,3013,2652,58,83,37,160,5,361
26099099310,2521,2148,1744,33,186,47,118,1,404
26017ZZZZZZ,0,0,0,0,0,0,0,0,0
26163163433,498,355,13,8,340,0,0,0,342
26163163190,871,683,39,3,625,13,12,0,644
26163163431,406,303,11,2,291,1,0,0,292
26017017035,1911,1529,1455,32,9,21,2,0,74
26099099062,2778,2348,2055,34,172,17,50,0,293
26163163266,1612,1222,28,25,1175,14,2,0,1194
26163163434,486,356,14,9,311,3,22,0,342
26163163383,866,662,15,14,632,3,5,0,647
26099099015,2350,1925,1595,92,170,37,46,3,330
26163163596,1969,1467,62,29,1379,17,7,0,1405
26163163084,3347,2103,1922,46,28,9,66,2,181
26163163175,1709,1295,18,9,1266,14,4,1,1277
26099099085,1861,1511,500,45,942,15,11,0,1011
26163163206,1204,918,26,8,875,27,0,1,892
26163163946,1314,1089,774,47,175,55,31,4,315
26163163387,938,663,52,11,599,2,3,0,611
26163163282,833,610,17,1,585,5,1,0,593
26163163812,1986,1705,1548,33,39,24,45,0,157
26065065074,2308,1705,878,249,470,33,84,1,827
26081081049,1894,1279,1170,30,19,11,35,2,109
26099099329,1904,1544,1383,43,72,21,9,1,161
26099099213,1293,1054,955,45,17,10,17,2,99
26099099037,1165,936,663,23,232,7,8,2,273
26099099091,2345,1986,1721,43,124,41,55,1,265
26099099072,2161,1626,664,41,886,52,12,0,962
26163163588,2295,1506,514,251,685,38,29,2,992
26163163189,790,605,43,5,554,12,0,0,562
26163163197,1174,826,17,3,807,6,4,0,809
26099099154,3474,2530,2256,63,87,54,60,4,274
26099099152,1759,1398,1294,27,15,34,12,0,104
26093093062,1680,1275,1185,10,4,61,13,0,90
26111111008,1373,1114,1050,3,10,27,8,0,64
26139139026,3098,2296,2156,55,24,23,38,4,140
26139139021,2588,1850,1749,31,5,14,28,3,101
26113113003,473,376,363,3,2,4,3,0,13
26125125415,1840,1426,1276,42,29,46,25,0,150
26125125435,2327,1785,1096,62,57,12,539,0,689
26125125027,2382,1942,1638,62,98,14,108,3,304
26129129003,1361,1080,1027,16,3,20,6,0,53
26161161038,2130,1708,1465,60,57,35,82,0,243
26161161083,2732,2049,1106,102,398,32,412,3,943
26161161037,3166,2639,1759,168,330,38,350,5,880
26125125202,2676,2111,1468,80,137,19,405,1,643
26067067007,1953,1543,1433,33,10,35,12,0,110
26125125157,2461,1925,1776,56,17,13,34,0,149
26125125070,1956,1692,1517,39,27,49,56,5,175
26125125194,2470,1908,1644,87,61,62,32,3,264
26125125402,1749,1320,908,36,283,14,73,0,412
26125125262,2594,2065,1726,132,64,17,102,3,339
26125125489,3117,2554,1794,36,475,12,219,1,760
26077077098,1466,1127,1038,25,12,21,15,0,89
26077077042,1628,1307,932,134,206,44,11,0,375
26109109003,239,191,186,0,1,2,0,0,5
26125125141,2108,1653,1532,37,13,49,13,1,121
26003ZZZZZZ,0,0,0,0,0,0,0,0,0
26003003003,34,26,21,1,1,1,2,0,5
26081081118,2253,2064,1703,127,118,38,83,1,361
26081081145,2014,1457,489,143,796,52,20,0,968
26047047018,918,774,706,17,4,35,5,0,68
26065065054,3020,2368,1517,164,413,54,227,2,851
26163163236,831,661,61,5,592,2,6,0,600
26081081117,2237,1870,1268,196,308,53,52,7,602
26065065047,2489,2003,1198,210,402,63,148,0,805
26163163313,1421,1012,32,10,938,8,27,1,980
26163163239,932,705,14,11,679,14,4,1,691
26163163634,1413,1005,43,46,913,19,1,5,962
26081081001,1620,1276,1072,44,44,14,95,0,204
26163163389,1580,1160,197,30,935,4,5,1,963
26163163539,708,511,9,33,462,7,4,1,502
26163163561,204,139,37,84,17,7,2,1,102
26163163617,2357,1512,847,151,471,15,40,3,665
26143143010,262,235,228,2,0,1,1,0,7
26099099134,2343,1655,1397,40,109,25,80,1,258
26163163971,2340,1799,796,65,544,25,356,0,1003
26163163972,2138,1775,761,53,825,40,96,0,1014
26163163786,2096,1680,1414,61,90,42,49,2,266
26163163416,523,378,19,2,354,4,2,0,359
26163163254,1360,1080,15,10,1056,6,0,0,1065
26049049167,2208,1754,1053,84,499,36,72,1,701
26163163076,3248,2197,2074,29,22,9,46,0,123
26065065103,1902,1431,1064,47,88,32,211,0,367
26163163230,1443,1169,139,16,997,28,6,6,1030
26163163180,1729,1222,314,24,866,17,15,1,908
26163163947,2099,1668,1401,50,140,42,27,3,267
26163163089,2211,1409,1238,13,15,1,100,0,171
26099099272,2091,1693,1526,30,35,23,66,1,167
26049049128,1785,1481,1292,49,85,37,14,1,189
26163163345,932,699,21,7,674,11,2,0,678
26163163333,52,37,0,0,37,0,0,0,37
26163163430,1345,930,24,6,901,10,2,0,906
26065065030,3914,3907,2930,120,624,33,196,1,977
26099099316,2783,2218,1852,51,159,49,107,2,366
26099099016,2691,2146,1980,44,51,38,22,0,166
26099099138,2174,1720,1592,33,18,25,42,0,128
26049049176,1713,1299,1141,55,11,69,5,1,158
26163163012,1625,1320,1148,109,22,22,21,1,172
26163163631,1417,1024,18,8,997,9,2,1,1006
26163163314,972,655,21,3,625,2,5,0,634
26099099219,2537,1975,1646,130,86,13,85,0,329
26099099125,2318,1889,1358,111,269,43,88,1,531
26163163977,1453,1254,1026,81,73,27,34,0,228
26163163154,2538,2054,47,32,1969,27,6,0,2007
26163163509,777,595,58,19,510,7,5,2,537
26111111012,813,676,622,14,4,14,6,0,54
26159159005,2151,1547,1366,75,29,34,20,1,181
26159159004,3440,2567,2306,83,57,65,39,3,261
26161161050,2170,1753,1507,51,80,19,81,3,246
26161161030,2361,1949,1141,99,419,52,252,0,808
26161161048,1983,1656,1012,154,312,36,140,3,644
26151151001,687,537,503,21,4,8,0,0,34
26077077080,1949,1487,1249,80,65,51,51,0,238
26115115013,1584,1270,1178,33,10,36,10,2,92
26125125142,2895,2305,2122,59,13,58,23,1,183
26125125118,4446,3644,1855,76,599,33,1021,1,1789
26145145058,1678,1327,1079,120,73,27,31,0,248
26125125429,2844,2146,1555,58,77,17,419,5,591
26125125391,2776,2439,533,59,1733,39,98,5,1906
26125125390,2217,1858,324,28,1444,29,34,1,1534
26125125109,1632,1297,811,23,146,17,294,0,486
26125125357,2498,2098,1828,56,123,27,66,0,270
26125125183,2006,1720,1386,71,130,43,82,3,334
26125125368,1869,1489,160,10,1297,15,22,1,1329
26145145032,759,629,596,12,4,8,1,0,33
26125125360,1312,992,87,12,878,17,6,0,905
26139139052,2143,1621,1127,346,85,31,40,1,494
26055055010,3313,2676,2469,50,20,65,33,4,207
26125000003,2009,1671,1437,64,64,46,37,7,234
26125125488,2273,1855,1569,58,115,20,80,0,286
26125125471,3047,2504,2088,119,156,23,98,0,416
26091091025,1601,1239,1064,94,41,27,17,0,175
26025025020,1740,1283,847,117,264,45,13,3,436
26125125037,2523,1932,1683,39,71,22,104,0,249
26125125404,1298,988,889,17,26,3,44,1,99
26059059008,1916,1546,1429,38,28,31,14,3,117
26139139062,2740,2053,980,650,81,62,313,7,1073
26099099045,1064,754,275,16,443,13,13,0,479
26123123017,952,673,560,89,10,8,7,2,113
26115115011,2241,1820,1706,30,13,21,27,1,114
26099099108,2194,1766,1560,56,61,35,35,1,206
26081081169,3514,2622,1652,296,383,46,237,2,970
26081081171,3202,2326,1543,157,426,33,184,4,783
26081081048,1742,1225,1111,38,30,9,31,0,114
26081081054,3004,2199,2028,81,24,44,19,0,171
26099099313,1443,1128,631,32,407,19,34,0,497
26081081246,3425,2636,1987,339,178,65,68,1,649
26163163092,1533,1131,811,38,175,12,88,0,320
26163163008,2500,2027,1763,137,62,33,32,0,264
26163163419,999,707,26,17,676,6,2,0,681
26163163359,486,393,3,3,387,10,1,0,390
26099099156,2561,1938,1766,23,69,35,32,3,172
26163163343,721,559,14,7,536,3,3,0,545
26163163376,1436,1037,29,4,992,18,10,0,1008
26163163921,3134,2718,1417,154,1061,47,63,6,1301
26163163131,3112,2208,1908,76,69,31,95,7,300
26163163872,2738,2251,1724,132,272,73,46,2,527
26163163147,1169,888,46,15,818,16,5,0,842
26163163221,77,59,0,0,59,0,0,0,59
26065065021,1572,1361,952,67,139,15,186,4,409
26099099191,1242,1013,917,21,24,19,20,0,96
26099099111,1945,1566,1419,14,26,16,77,1,147
26163163244,803,627,18,8,600,11,3,1,609
26163163428,777,573,16,1,553,13,4,0,557
26099099057,1232,999,821,26,100,11,31,0,178
26099099259,2324,1821,1635,23,58,26,65,2,186
26099099266,2714,2228,2031,50,44,32,62,1,197
26099099163,3649,2745,2033,74,473,71,78,3,712
26125125113,2694,2128,1236,50,676,33,136,0,892
26161161066,2474,1979,1830,47,27,34,22,2,149
26161161018,2114,1672,1149,93,77,18,334,3,523
26161161033,1931,1850,1205,150,106,8,371,2,645
26161161015,1840,1645,1120,89,82,17,275,6,525
26161161012,1584,1443,648,109,51,13,616,1,795
26125125259,1942,1487,1344,43,46,20,39,0,143
26125125295,2479,1994,1629,98,130,24,110,4,365
26161161147,2295,1913,1316,72,356,19,136,2,597
26045045017,2344,1884,1220,185,414,26,57,3,664
26125125469,3796,3065,2617,128,125,92,94,1,448
26081081031,2717,2059,1939,32,9,40,26,2,120
26081081229,2737,2184,1425,440,111,36,187,1,759
26081081028,2857,2405,2100,83,73,38,90,0,305
26065065102,2181,1765,1227,71,104,23,350,1,538
26163163193,1866,1461,30,9,1418,11,11,1,1431
26163163194,1769,1271,5,5,1262,9,5,0,1266
26163163195,987,728,11,1,706,11,5,0,717
26163163107,2057,1538,1340,86,51,21,27,5,198
26163163953,1786,1384,1078,54,158,38,50,1,306
26163163620,1206,913,12,19,875,16,3,2,901
26163163215,1630,1159,20,12,1123,31,6,2,1139
26081081185,3143,2345,2155,68,38,42,29,1,190
26163163217,1747,1320,29,11,1280,13,0,0,1291
26163163482,1238,1008,178,24,781,18,17,1,830
26163163893,2009,1607,1341,112,81,57,18,2,266
26163163604,760,512,9,10,492,5,1,0,503
26163163968,1798,1453,1226,48,91,22,49,1,227
26049049211,2068,1620,1475,31,35,40,6,0,145
26163163378,1318,1036,230,13,771,17,17,1,806
26163163853,2515,2024,1560,106,214,43,94,4,464
26065065017,3595,3310,2503,134,418,37,207,4,807
26049049096,868,637,334,45,237,13,15,0,303
26049049112,1559,1272,695,31,481,31,44,0,577
26049049158,1926,1502,1327,55,61,27,28,0,175
26049000016,2053,1850,1266,72,351,25,124,0,584
26099099092,1984,1694,1368,44,217,30,35,2,326
26065065055,2440,1838,993,235,496,51,93,2,845
26163163704,2318,1928,666,26,1184,31,44,1,1262
26163163695,5072,3618,1782,36,270,16,1496,3,1836
26163163226,834,700,129,7,542,5,10,4,571
26163163778,2881,2381,2070,69,64,49,111,0,311
26163163291,936,719,9,10,697,11,0,0,710
26163163612,481,363,5,3,350,1,0,0,358
26163163342,65,49,1,0,47,0,2,0,48
26093093012,1473,1139,1082,15,4,17,17,0,57
26093093033,2720,2125,1900,66,38,37,32,0,225
26163163255,1306,1005,11,11,982,12,3,3,994
26163163082,2828,1790,1634,28,26,15,70,1,156
26163163908,3705,2303,803,172,1257,46,50,5,1500
26077077056,1623,1218,806,77,292,34,12,1,412
26077077011,1816,1464,1184,57,134,35,53,1,280
26123123002,706,565,545,4,2,5,3,0,20
26161161106,2153,1577,1115,185,199,44,46,2,462
26093093030,1010,843,789,15,2,19,8,2,54
26157157020,1563,1276,1162,43,22,32,7,0,114
26125125392,2513,2264,390,14,1825,24,30,0,1874
26125125150,3010,2441,2188,47,91,72,22,1,253
26125125099,2773,2193,1546,40,332,14,273,5,647
26125125010,2372,1848,915,158,625,42,117,3,933
26125125308,1466,1033,702,68,38,16,202,0,331
26125125498,2547,1993,1442,25,254,4,248,0,551
26129129015,577,457,432,8,1,15,0,0,25
26077077001,1482,1242,1164,17,16,25,6,0,78
26125125227,1671,1132,1023,20,26,10,42,0,109
26021ZZZZZZ,0,0,0,0,0,0,0,0,0
26115115021,2486,1933,1740,57,37,65,13,3,193
26161161013,5958,5392,3066,269,333,16,1666,0,2326
26099099052,1538,1319,1202,20,49,7,39,0,117
26115115004,1387,1108,1023,20,11,32,9,0,85
26081081042,2208,1572,1370,22,28,22,121,3,202
26081081037,1854,1435,1320,36,27,17,30,1,115
26163163725,1960,1494,164,41,1284,37,5,4,1330
26163163370,1240,940,61,39,838,7,7,1,879
26163163974,3487,2780,2245,129,242,66,83,5,535
26163163763,2304,1897,1730,60,40,20,27,1,167
26163163149,1719,1256,15,4,1225,28,2,1,1241
26081081125,2867,2298,1452,159,472,45,176,3,846
26099099113,1960,1586,1434,29,28,26,49,0,152
26163163033,1947,1544,1193,61,79,28,172,1,351
26099099220,2271,1824,1569,66,53,24,99,0,255
26041041012,750,610,576,1,0,18,5,0,34
26125125095,2489,2119,1467,35,479,17,108,0,652
26161161082,2416,2033,1207,139,320,51,323,4,826
26161161093,3697,3091,1359,250,815,76,611,4,1732
26125125453,2607,2214,1811,91,118,41,134,2,403
26125125431,2151,1629,1046,56,33,21,445,0,583
26125125493,2272,1929,1166,27,467,10,257,0,763
26077077079,2400,1763,1471,55,82,22,105,3,292
26109109019,816,648,612,8,0,14,6,0,36
26081081002,3199,2206,1844,45,28,37,226,0,362
26089089013,337,271,249,1,5,10,4,1,22
26081081152,2311,1737,1524,43,50,26,77,6,213
26065065096,2740,2063,1537,92,170,35,228,1,526
26081081242,2651,2045,1278,470,191,49,66,5,767
26163163901,1822,1460,1219,90,78,41,23,2,241
26163163512,595,454,22,1,422,6,0,0,432
26163163384,709,519,26,11,483,4,3,1,493
26163163227,1146,975,142,16,802,9,9,3,833
26163163573,1487,1155,24,109,1009,24,4,0,1131
26081081133,3925,2928,1479,273,920,67,249,2,1449
26163163502,839,617,31,11,565,10,12,2,586
26049049015,2593,1995,1591,72,223,51,46,2,404
26163163623,1174,896,16,25,865,2,2,1,880
26065065062,2386,1992,1129,182,567,40,92,6,863
26099099223,3058,2368,2100,57,53,30,105,4,268
26163163108,1789,1281,1129,66,21,15,39,1,152
26163163014,1550,1231,1031,138,19,24,12,2,200
26163163850,1176,803,23,29,754,8,4,0,780
26163163034,2553,1942,1310,64,157,18,395,5,632
26099099327,2946,2401,1652,66,390,35,239,2,749
26155155018,1334,1033,928,40,19,31,7,0,105
26077077064,2161,1785,1362,71,293,36,39,0,423
26093093078,2897,2212,2069,57,18,28,18,3,143
26093000002,0,0,0,0,0,0,0,0,0
26125125101,2566,2192,1383,36,325,4,423,1,809
26125125396,1806,1493,183,28,1259,24,9,2,1310
26125125306,1619,1287,918,53,72,15,226,2,369
26125125088,2284,1784,1591,37,47,28,52,5,193
26151151004,1277,968,883,45,10,26,3,0,85
26125125219,2019,1592,1263,53,52,15,195,0,329
26139139081,3362,2695,2506,91,18,22,46,4,189
26125125499,2468,2036,1638,48,215,16,110,0,398
26159ZZZZZZ,0,0,0,0,0,0,0,0,0
26139139103,1339,995,829,80,36,16,25,1,166
26081081237,1637,1277,736,343,116,38,62,0,541
26099099132,1855,1365,1184,32,77,5,64,1,181
26099099009,2842,2156,1310,68,624,48,82,1,846
26163163262,1086,786,35,10,729,12,2,0,751
26163163912,2290,1862,1670,91,18,55,25,3,192
26163163496,1098,866,31,5,817,19,14,1,835
26163163022,2457,1891,1287,94,312,49,142,0,604
26099099279,77,70,65,0,2,0,3,1,5
26099099234,3807,3118,2245,58,397,37,365,3,873
26163163686,1868,1436,1167,67,123,28,47,0,269
26099099107,1997,1606,1495,25,22,3,47,3,111
26113113007,1184,933,876,18,1,34,4,1,57
26125125256,2834,2189,1732,197,98,58,88,2,457
26125125310,1327,1070,854,69,37,20,84,0,216
26077077044,1858,1425,1180,86,87,26,40,2,245
26103103035,213,169,163,0,2,4,0,0,6
26153ZZZZZZ,0,0,0,0,0,0,0,0,0
26081081244,1846,1432,1007,158,224,33,15,5,425
26065065095,2131,1649,1227,49,55,18,290,0,422
26081081241,2644,2060,1285,420,249,66,56,2,775
26049049005,1486,1170,1034,53,17,31,22,2,136
26049049070,2491,1924,1351,112,400,42,14,6,573
26163163459,3321,3174,1198,117,1546,63,277,3,1976
26163163127,1563,1191,983,22,137,11,27,1,208
26163163779,2594,2103,1904,36,73,29,50,3,199
26163163240,1203,931,36,8,885,5,2,0,895
26163163011,1396,1153,878,106,97,26,49,0,275
26049049160,1515,1190,985,23,108,25,45,2,205
26163163207,1162,912,17,3,887,13,0,0,895
26163163329,1580,1187,45,16,1115,14,12,0,1142
26163163330,772,596,47,6,545,2,0,0,549
26163163609,2165,1545,23,9,1511,20,3,1,1522
26099099252,3388,2656,2235,37,88,13,275,5,421
26163163776,2103,1751,1531,39,70,29,71,1,220
26163163510,835,644,14,11,627,3,3,0,630
26147147046,315,249,235,4,4,1,2,0,14
26125125107,2322,1874,1240,41,466,22,97,3,634
26121ZZZZZZ,0,0,0,0,0,0,0,0,0
26099099325,817,628,457,15,118,20,17,1,171
26099099286,2448,1910,1129,23,243,18,494,1,781
26081081220,2824,2185,1929,94,59,42,50,0,256
26099099116,3206,2351,1681,142,399,48,68,1,670
26163163774,1803,1440,1095,66,183,59,45,1,345
26163163503,936,734,34,6,680,5,1,0,700
26163163396,1495,1046,28,9,1001,18,5,0,1018
26163163121,1688,1261,1026,22,163,6,37,2,235
26163163944,1491,1128,733,38,292,20,40,1,395
26163163122,2388,1665,1256,36,322,24,28,1,409
26163163146,1026,722,10,11,705,9,2,0,712
26099099147,4543,3806,2778,136,773,94,24,0,1028
26111111042,1708,1318,1192,37,20,30,28,4,126
26161161124,2354,2050,1210,123,642,38,49,2,840
26055ZZZZZZ,0,0,0,0,0,0,0,0,0
26103ZZZZZZ,0,0,0,0,0,0,0,0,0
26031031005,390,310,259,2,6,38,0,0,51
26081081170,2991,2104,1238,186,499,42,150,1,866
26163163288,959,704,0,2,697,6,5,0,704
26065065093,1899,1584,1360,97,54,23,51,2,224
26163163232,984,797,31,4,750,12,5,3,766
26163163049,2249,1724,1314,68,67,24,239,3,410
26163163136,1920,1461,1308,34,63,2,41,4,153
26163163270,1036,783,8,6,768,13,3,2,775
26049049087,0,0,0,0,0,0,0,0,0
26049049090,1264,913,139,17,752,11,3,0,774
26163163237,731,565,9,3,552,12,4,0,556
26163163890,2335,1865,1516,115,129,58,55,1,349
26163163403,1440,1050,96,11,932,28,10,0,954
26163163682,1992,1541,1298,43,107,3,72,5,243
26093093067,2954,2336,2200,38,9,53,19,0,136
26161161028,1576,1312,1043,56,113,28,65,0,269
26125125353,2268,1872,1624,55,48,37,90,2,248
26125125131,1938,1570,1460,29,11,32,20,0,110
26099099047,2943,2418,1378,75,901,48,30,6,1040
26125125417,1988,1580,1457,30,16,32,29,0,123
26081081113,2377,2106,1758,107,120,46,68,1,348
26081081141,1066,865,600,75,151,13,19,0,265
26099099179,3096,2652,2306,46,213,28,39,0,346
26099099229,2100,1645,1347,27,68,19,179,0,298
26163163794,2163,1676,1135,43,51,7,438,1,541
26163163499,486,351,1,5,348,1,3,1,350
26139ZZZZZZ,0,0,0,0,0,0,0,0,0
26125125102,2375,1916,1286,44,230,15,335,3,630
26125125312,1925,1408,1058,47,48,12,226,1,350
26163163300,604,463,9,7,441,9,0,0,454
26163163414,1652,1153,16,11,1126,1,0,1,1137
26163163128,1915,1418,1254,39,68,9,43,1,164
26069ZZZZZZ,0,0,0,0,0,0,0,0,0
26163163425,1279,947,32,4,904,14,1,1,915
26049049026,1090,862,769,44,13,18,5,0,93
26099099066,2589,2100,1737,65,202,36,40,0,363
26125125098,2879,2349,1559,59,479,10,235,1,790
26073073020,2875,2557,2092,122,145,92,101,1,465
26099099198,2512,2070,1880,29,78,36,25,0,190
26163163042,1879,1498,1130,48,155,23,123,0,368
26081081148,1482,1044,812,34,33,14,156,1,232
26163163700,3799,2276,1782,24,95,17,315,1,494
26163163200,729,590,10,14,577,4,0,0,580
26163163234,1663,1369,246,31,1065,27,21,2,1123
26163163626,962,708,4,4,691,10,1,1,704
26049049178,1313,929,649,48,200,21,9,4,280
26125125093,1974,1579,795,42,145,19,577,2,784
26125125509,3295,2475,2170,103,49,59,43,1,305
26163163067,2497,1820,1040,59,172,18,520,2,780
26065065105,2295,1820,1170,147,219,48,246,1,650
26125125105,3494,3037,1673,71,754,36,508,1,1364
26005005004,1443,1102,1015,19,30,36,6,0,87
26161161006,2116,2052,1065,125,95,21,748,1,987
26163163242,511,396,1,2,393,12,0,0,395
26111111025,2046,1587,1358,77,62,51,27,8,229
26111111023,2307,1910,1537,78,50,41,165,10,373
26077077062,3025,2426,1226,161,867,47,150,0,1200
26125125389,2937,2586,580,101,1716,51,179,1,2006
26105ZZZZZZ,0,0,0,0,0,0,0,0,0
26125125224,160,122,101,5,1,5,9,0,21
26163163133,1788,1286,1173,32,38,21,19,0,113
26081081019,3169,2319,1112,613,497,47,73,0,1207
26163163298,1317,962,18,6,931,15,2,1,944
26161161144,2622,2362,1525,119,597,39,76,2,837
26161161007,2971,2816,1696,184,192,6,703,2,1120
26099099013,2576,2038,1844,22,91,36,26,0,194
26081081168,1754,1395,894,180,155,25,144,1,501
26009ZZZZZZ,0,0,0,0,0,0,0,0,0
26125125094,2885,2205,778,42,228,38,1113,2,1427
26163163204,920,723,22,9,677,12,4,1,701
26049049028,1232,973,884,25,16,38,5,0,89
26099099048,2520,2004,1763,34,148,17,36,1,241
26099099261,1919,1565,1240,60,153,22,91,8,325
26163163469,1658,1562,307,47,1185,17,22,1,1255
26163163464,1158,1028,42,11,952,20,11,0,986
26125125005,2819,2281,876,100,440,29,832,2,1405
26163163591,825,545,73,12,459,7,3,1,472
26077077018,1043,852,629,25,151,14,23,2,223
26163163439,663,499,7,2,492,1,1,0,492
26125125100,2205,1927,1004,110,440,18,346,0,923
26163163641,635,468,6,5,459,7,3,0,462
26161161032,2047,2012,1374,96,209,12,329,1,638
26161161014,3708,3687,2773,113,535,3,176,34,914
26005005041,4,4,4,0,0,0,0,0,0
26005ZZZZZZ,0,0,0,0,0,0,0,0,0
26125125187,453,442,296,2,135,1,8,0,146
26053ZZZZZZ,0,0,0,0,0,0,0,0,0
