GEOID,TOTAL_POP,TOTAL_VAP,WHITE_VAP,HISPANIC_VAP,BLACK_VAP,NATIVE_VAP,ASIAN_VAP,PACIFIC_VAP,MINORITY_VAP
35009000036,400,300,184,99,3,15,1,0,116
35009000028,789,573,149,399,19,16,3,0,424
35009000035,1068,808,631,130,18,15,9,1,177
35045000030,1395,1020,683,150,12,146,32,4,337
35045000109,1402,1029,254,251,48,465,11,2,775
35006000022,532,422,3,9,0,404,0,1,419
35006000021,804,581,0,12,2,514,0,0,581
35006000020,1285,944,5,34,4,892,3,7,939
35006000004,662,539,320,115,2,108,5,1,219
35006000006,316,247,145,55,8,45,1,0,102
35006000014,1086,809,344,324,11,149,5,7,465
35006000017,2112,1540,5,23,4,1515,4,0,1535
35006000029,1123,802,21,30,5,764,5,1,781
35009000041,1029,756,246,432,59,15,11,0,510
35009000021,1089,807,348,377,47,30,25,2,459
35009000009,2190,1554,360,1020,131,49,36,0,1194
35009000018,2470,1772,1081,399,138,45,109,10,691
35009000038,854,599,410,94,43,16,46,1,189
35009000039,885,699,520,118,12,13,32,1,179
35009000010,863,663,447,175,15,31,11,1,216
35009000004,900,691,547,102,3,35,6,1,144
35041000006,530,400,300,90,2,8,1,0,100
35035000017,1462,1216,761,300,71,38,46,3,455
35035000047,1422,1076,487,420,81,69,48,4,589
35035000059,2262,1610,860,304,244,69,108,33,750
35035000056,2009,1302,38,141,10,1199,4,1,1264
35035000011,2013,1417,42,131,4,1324,5,3,1375
35035000022,714,543,287,178,41,22,14,4,256
35035000028,696,530,332,141,16,24,18,1,198
35035000051,1478,1147,677,334,84,46,32,6,470
35035000030,815,607,347,189,36,27,9,4,260
35045000016,1689,1286,15,31,4,1256,3,0,1271
35045000018,1505,1046,8,17,2,1035,1,0,1038
35045000014,466,385,18,8,1,361,4,0,367
35045000077,948,682,358,230,5,90,3,0,324
35045000051,1917,1397,426,493,16,472,9,0,971
35045000011,857,648,10,7,3,614,20,0,638
35045000010,794,647,3,10,0,638,0,2,644
35045000044,1456,1097,474,283,13,332,14,2,623
35045000057,1402,1088,806,166,5,103,3,1,282
35045000103,1381,1027,669,216,19,113,15,1,358
35045000102,639,473,234,108,3,140,3,0,239
35045000090,1043,766,466,189,8,100,9,2,300
35045000017,219,163,0,1,0,160,2,0,163
35045000013,1208,925,7,15,3,910,3,0,918
35045000036,935,720,385,176,8,160,4,4,335
35045000027,1989,1320,281,181,15,861,12,2,1039
35045000110,1730,1118,70,199,16,846,11,1,1048
35009000031,1830,1418,812,374,130,35,59,6,606
35037000001,232,188,171,10,1,4,0,1,17
35009000026,1242,900,233,555,85,37,8,2,667
35045000006,493,400,5,3,0,394,0,0,395
35045000015,937,661,4,16,2,655,0,1,657
35045000021,1624,1156,408,72,9,673,14,0,748
35045000059,1166,884,624,111,10,136,6,7,260
35045000003,1244,932,9,9,4,918,1,0,923
35009000015,1810,1270,507,552,152,55,44,4,763
35009000023,751,608,416,140,31,20,11,0,192
35009000034,154,115,96,17,3,1,1,0,19
35025000061,1884,1274,216,970,55,30,4,3,1058
35025000036,2087,1434,264,1077,59,54,5,0,1170
35025000015,1272,870,411,411,13,20,12,0,459
35025000009,1222,853,369,442,23,14,16,2,484
35025000013,2540,1747,568,1112,26,47,7,2,1179
35015000042,99,69,45,20,1,4,0,0,24
35025000062,618,452,242,192,8,10,1,0,210
35025000071,1659,1162,505,582,24,49,8,4,657
35025000073,1436,1060,401,612,17,24,1,0,659
35025000031,2440,1728,366,1203,122,62,11,7,1362
35009000032,705,517,302,136,47,17,20,1,215
35061000001,673,551,240,215,12,81,15,1,311
35061000043,1051,830,333,447,14,36,10,0,497
35061000040,896,712,203,460,17,46,4,1,509
35061000042,1574,1047,413,570,11,56,22,1,634
35061000041,1074,811,313,421,36,53,15,3,498
35061000003,1066,853,297,456,17,84,13,1,556
35061000007,1497,1134,435,658,14,51,14,2,699
35061000059,1547,1224,407,703,15,91,10,1,817
35061000039,2081,1576,743,686,42,83,45,4,833
35061000019,1772,1546,605,790,74,88,4,1,941
35061000037,1745,1508,609,763,54,103,1,0,899
35061000052,1101,845,269,544,13,33,13,0,576
35061000023,1262,947,266,633,10,47,9,4,681
35061000027,1458,1104,571,462,20,39,12,3,533
35006000015,1489,1272,568,472,64,180,13,2,704
35006000028,1096,807,165,457,14,196,8,2,642
35006000005,1177,925,270,51,3,616,5,0,655
35006000026,1694,1184,176,27,8,985,19,1,1008
35006000001,274,241,193,29,4,28,0,0,48
35006000027,1078,950,244,544,71,109,11,1,706
35006000019,1141,1035,469,455,35,84,8,0,566
35045000065,1058,846,673,93,2,54,6,0,173
35045000061,1443,1121,850,170,0,74,9,1,271
35045000008,1593,1224,3,5,2,1217,1,0,1221
35045000130,1447,967,3,10,3,959,2,6,964
35045000005,1679,1215,13,20,9,1164,23,8,1202
35045000060,1341,1065,823,171,4,61,12,0,242
35045000067,1922,1392,820,347,4,225,15,1,572
35045000066,929,783,510,183,4,68,12,0,273
35045000007,488,390,5,6,0,385,0,0,385
35045000131,913,682,14,4,1,639,26,1,668
35045000004,1788,1314,18,11,9,1281,7,0,1296
35061000014,1367,1096,422,619,20,56,6,0,674
35061000004,1333,1075,539,447,14,78,4,6,536
35061000020,357,299,91,201,5,9,1,1,208
35061000051,1283,993,313,627,9,43,6,0,680
35041000008,1427,1046,183,835,23,22,6,0,863
35061000006,1053,819,306,454,8,55,2,0,513
35061000060,979,801,401,372,5,25,4,2,400
35035000016,1556,1346,770,213,227,43,103,26,576
35035000008,1259,1016,838,122,9,24,7,1,178
35035000057,879,768,632,93,9,18,0,0,136
35035000058,91,75,68,5,0,5,1,0,7
35035000007,444,370,311,40,5,16,6,3,59
35035000005,381,336,279,45,5,15,2,0,57
35035000009,956,820,701,72,4,33,14,0,119
35035000014,1054,833,408,362,13,68,11,2,425
35035000055,1087,846,574,218,15,46,3,1,272
35051000002,1249,1103,890,125,10,61,13,0,213
35035000015,2024,1575,956,482,37,56,25,12,619
35035000019,713,563,152,348,43,22,14,4,411
35041000005,365,269,212,48,2,3,1,0,57
35005000044,87,58,37,17,0,3,2,0,21
35041000009,2301,1747,969,648,46,57,33,6,778
35035000024,1616,1275,801,337,63,50,32,9,474
35035000035,1800,1527,1175,209,58,48,34,8,352
35035000018,1489,1210,807,239,53,47,47,7,403
35035000040,820,649,440,119,52,19,13,4,209
35035000021,1259,970,598,234,71,48,33,2,372
35035000004,79,65,56,6,0,3,0,0,9
35035000003,39,36,29,4,0,3,0,0,7
35041000004,455,347,266,72,1,5,0,0,81
35005000045,47,36,13,22,1,0,0,0,23
35041000010,2002,1532,870,509,81,42,39,7,662
35025000072,1680,1221,628,540,14,30,4,3,593
35025000012,1050,738,139,580,10,16,3,0,599
35025000003,1086,811,460,323,4,20,3,1,351
35005000071,643,490,301,183,1,6,1,0,189
35005000013,1623,1130,477,587,12,53,13,0,653
35017000030,617,551,470,49,4,19,8,0,81
35017000031,104,80,64,14,1,2,1,0,16
35017000033,841,664,366,248,8,38,9,6,298
35017000032,355,289,94,182,1,16,3,2,195
35005000036,1394,1082,566,460,23,28,10,0,516
35005000105,1882,1659,695,825,88,52,2,1,964
35005000072,1402,1021,248,740,20,33,7,5,773
35005000074,731,538,140,383,2,10,6,0,398
35017000012,1037,843,553,243,10,20,13,1,290
35017000038,1285,1038,635,331,20,31,22,4,403
35017000013,1103,928,625,233,13,32,11,0,303
35025000054,1447,991,150,779,52,33,6,1,841
35025000011,1967,1280,289,945,26,25,6,2,991
35013000163,2202,1371,75,1258,17,34,14,6,1296
35013000164,1667,1218,96,1102,6,33,1,2,1122
35013000015,1552,1225,397,793,11,52,9,2,828
35013000162,2458,1735,222,1462,24,70,17,2,1513
35013000016,1248,1001,176,813,6,41,7,5,825
35013000054,1091,941,477,300,62,44,76,7,464
35013000114,707,604,359,198,13,18,19,0,245
35013000064,1248,925,317,554,14,55,6,0,608
35005000103,666,503,169,311,3,17,8,0,334
35005000010,1085,840,619,191,6,11,5,1,221
35017000008,1017,813,431,339,12,29,8,0,382
35017000036,658,528,296,204,10,25,2,0,232
35017000026,806,619,124,476,9,27,0,0,495
35017000027,707,518,79,401,8,41,2,0,439
35017000005,1242,1083,751,270,15,47,9,2,332
35017000009,628,524,178,322,3,24,3,1,346
35017000004,115,105,75,25,4,5,1,1,30
35017000024,654,515,115,376,4,32,1,0,400
35025000002,73,51,34,15,2,0,0,0,17
35025000014,1938,1352,380,929,24,24,11,0,972
35017000034,800,644,117,508,6,35,2,1,527
35017000023,442,339,162,173,1,9,0,0,177
35013000017,1633,1265,204,1040,12,30,4,1,1061
35013000116,1932,1554,880,492,63,43,74,4,674
35013000130,1455,1135,499,534,52,60,22,3,636
35013000059,1495,1137,414,631,48,51,34,0,723
35013000011,1891,1270,22,1232,7,26,7,0,1248
35013000159,1827,1242,19,1218,4,18,2,2,1223
35059000009,102,76,69,6,0,1,1,1,7
35059000004,1074,849,498,293,27,39,7,6,351
35059000001,511,387,279,85,3,16,6,4,108
35013000019,1504,1323,1014,237,41,38,13,5,309
35013000146,1046,836,383,408,10,50,5,0,453
35029000014,1279,1066,695,298,16,59,17,1,371
35013000082,1101,847,126,704,5,35,3,1,721
35013000051,837,676,238,384,19,32,20,0,438
35013000105,3101,2200,908,1059,87,98,85,7,1292
35013000122,2096,1570,553,958,23,56,24,4,1017
35013000121,1010,724,175,516,9,28,6,3,549
35013000062,1733,1248,472,677,48,57,33,4,776
35025000016,1207,852,166,649,15,25,11,0,686
35013000103,1422,1141,481,555,37,42,55,1,660
35013000096,1591,1255,398,814,13,30,1,2,857
35013000074,1668,1169,272,842,21,36,14,2,897
35013000120,303,223,66,146,6,5,0,0,157
35013000101,1817,1447,379,1013,19,44,25,2,1068
35013000066,1555,1202,361,784,24,53,8,1,841
35013000132,885,672,219,415,9,34,10,0,453
35013000133,1135,811,279,498,24,33,12,1,532
35013000053,1875,1597,430,852,134,73,142,4,1167
35013000083,1462,1150,485,600,28,55,11,0,665
35013000127,1582,1127,313,781,17,45,8,0,814
35013000135,1201,920,370,463,38,51,32,2,550
35025000021,734,519,277,214,12,14,1,0,242
35025000041,3459,2429,942,1119,224,94,81,1,1487
35025000043,2296,1596,556,900,76,67,17,0,1040
35025000027,1650,1175,703,383,42,36,20,5,472
35025000025,848,650,424,184,14,18,11,0,226
35025000042,1318,867,342,464,33,23,7,3,525
35025000057,1192,871,520,296,14,27,17,1,351
35025000056,2315,1963,655,1118,115,93,0,1,1308
35025000020,1363,1045,575,361,78,32,14,5,470
35013000080,1148,845,16,827,4,6,2,1,829
35013000160,1083,774,13,761,4,13,0,0,761
35013000022,1773,1198,321,830,29,45,13,2,877
35013000145,2517,1809,385,1353,34,86,30,1,1424
35013000065,1668,1164,143,1000,11,25,6,2,1021
35013000131,1638,1147,337,754,41,54,6,9,810
35013000118,2389,1616,502,977,49,88,32,4,1114
35013000117,1717,1191,212,939,29,53,9,0,979
35013000119,1668,1242,310,866,32,70,15,1,932
35013000079,1665,1194,154,1024,6,27,4,1,1040
35013000042,748,560,78,448,11,49,11,2,482
35013000071,905,734,408,282,26,25,9,2,326
35013000112,1850,1355,695,514,51,53,71,5,660
35013000142,1566,1237,691,435,43,37,50,0,546
35013000139,1803,1476,840,489,62,42,71,0,636
35013000140,897,670,323,274,47,26,21,2,347
35013000034,1508,1204,323,842,17,46,8,1,881
35013000001,1359,928,127,786,3,25,2,0,801
35051000001,1636,1347,742,556,8,45,6,2,605
35041000015,777,580,320,227,5,19,3,0,260
35041000019,893,671,456,193,9,14,5,0,215
35041000002,1059,801,504,210,28,32,20,3,297
35053000024,435,354,133,202,7,19,3,0,221
35053000027,1432,1042,366,623,9,54,3,1,676
35053000013,795,650,358,222,3,85,5,0,292
35053000026,99,74,46,21,2,9,0,0,28
35053000021,155,126,79,47,0,3,0,0,47
35053000006,687,539,157,345,11,37,9,1,382
35053000014,379,326,171,112,3,59,2,0,155
35053000011,728,586,261,294,6,29,4,2,325
35059000006,1384,1154,484,570,56,62,13,6,670
35025000017,1098,775,124,612,18,24,16,1,651
35053000012,92,71,29,30,4,6,0,0,42
35041000018,1059,752,435,283,10,28,15,1,317
35009000030,828,626,305,287,15,29,0,3,321
35041000014,1730,1458,747,484,142,37,52,17,711
35041000001,1339,953,352,529,36,22,15,6,601
35041000012,1364,988,518,373,26,62,17,6,470
35025000044,1602,1077,358,634,60,50,2,0,719
35025000033,1443,960,401,502,33,32,7,2,559
35025000053,2737,1787,258,1297,218,27,6,5,1529
35025000059,1031,667,108,474,79,15,1,0,559
35025000055,980,743,123,576,41,10,3,2,620
35025000058,1068,735,33,565,127,14,4,5,702
35025000052,1388,952,199,653,71,40,11,4,753
35025000010,2269,1622,657,863,41,74,7,1,965
35025000074,892,638,288,331,4,14,1,0,350
35005000012,742,560,417,116,4,17,3,4,143
35017000002,554,476,367,77,1,23,6,0,109
35059000007,773,610,326,261,7,25,2,0,284
35035000020,768,600,198,293,83,19,16,6,402
35053000016,202,153,76,55,2,18,4,0,77
35053000025,137,117,55,56,0,4,1,0,62
35053000015,1559,1095,34,40,3,1035,11,3,1061
35023000006,662,523,337,156,11,12,5,3,186
35023000005,262,235,192,28,2,5,1,3,43
35005000025,718,517,239,246,18,11,1,1,278
35005000051,720,507,79,386,28,13,3,1,428
35025000022,2251,1561,776,648,37,48,61,1,785
35025000019,1157,901,553,269,23,23,38,6,348
35025000029,2102,1514,572,757,100,59,40,5,942
35025000023,1971,1469,777,531,74,39,53,2,692
35017000037,746,574,383,172,8,16,2,1,191
35017000011,1107,853,515,284,10,52,8,3,338
35005000104,164,122,79,33,2,6,1,0,43
35015000040,279,216,139,56,1,16,1,0,77
35017000019,735,604,198,360,8,34,13,2,406
35017000014,1274,1005,496,443,24,54,17,1,509
35017000016,1278,1016,468,480,12,42,16,2,548
35023000001,1114,820,273,519,10,22,5,3,547
35006000025,491,363,10,19,0,341,1,1,353
35005000101,1590,1109,324,746,7,18,10,3,785
35005000092,994,738,327,387,10,17,2,1,411
35005000102,1166,854,256,579,2,20,6,3,598
35005000106,830,603,217,365,5,13,4,1,386
35005000094,1383,971,228,694,42,17,12,0,743
35005000095,1394,927,131,737,42,32,4,1,796
35017000028,844,671,141,505,6,31,7,0,530
35017000001,633,511,436,44,3,20,5,2,75
35017000035,125,105,92,8,0,3,3,0,13
35023000003,1097,864,241,606,11,16,3,3,623
35015000036,1369,1057,727,279,5,39,5,1,330
35015000049,645,471,252,211,1,6,0,1,219
35015000019,985,773,509,207,15,41,11,4,264
35015000037,1762,1304,868,313,28,44,54,1,436
35015000039,753,552,304,228,2,24,1,0,248
35015000006,1088,800,389,374,5,29,7,2,411
35015000033,906,669,341,299,4,24,10,1,328
35015000050,1354,1012,512,458,4,32,1,1,500
35005000001,965,771,520,213,7,28,7,0,251
35005000046,232,170,111,49,0,10,1,1,59
35005000052,1267,931,276,632,18,31,10,1,655
35005000034,843,618,181,413,9,15,1,1,437
35005000061,965,691,81,573,29,33,7,2,610
35005000063,1147,901,208,656,32,22,4,1,693
35005000064,1386,983,109,826,32,18,6,2,874
35005000041,2195,1588,900,612,17,65,9,3,688
35031000004,784,595,2,6,1,588,2,0,593
35031000005,1453,1112,29,22,6,1041,22,0,1083
35031000001,2508,1498,10,7,24,1456,17,1,1488
35031000014,1883,1334,105,47,3,1185,6,2,1229
35031000013,787,564,8,3,6,555,3,1,556
35031000015,1462,982,4,3,3,976,0,0,978
35031000051,778,578,2,3,0,576,1,0,576
35031000008,718,517,0,3,0,514,0,0,517
35031000023,1500,1014,4,6,6,1010,0,0,1010
35031000036,540,385,44,69,4,291,4,1,341
35031000035,1200,792,38,239,16,509,9,2,754
35015000021,1086,811,381,358,31,36,29,0,430
35015000020,1485,1173,617,463,31,58,12,5,556
35015000025,658,500,286,165,18,15,9,0,214
35015000012,378,275,99,159,6,3,2,2,176
35015000017,1569,1191,671,463,20,45,4,1,520
35015000014,1034,745,258,442,38,15,4,2,487
35015000009,2215,1579,536,953,33,42,15,5,1043
35015000032,1566,1092,236,829,19,26,4,4,856
35015000007,1721,1332,818,453,21,33,14,2,514
35015000031,1092,832,375,420,16,17,10,0,457
35015000041,1205,855,401,420,2,29,2,2,454
35015000001,849,632,322,272,8,41,2,1,310
35015000030,184,136,97,27,4,6,4,1,39
35015000003,1345,936,365,510,18,37,19,3,571
35015000053,1296,902,334,500,7,43,12,2,568
35043000027,277,241,73,129,6,37,1,0,168
35043000021,474,401,92,268,7,41,2,0,309
35043000118,1361,1109,754,271,32,31,29,5,355
35043000063,857,640,314,247,29,49,19,0,326
35043000095,1866,1311,11,155,3,1231,5,2,1300
35043000020,1353,973,0,122,3,971,0,0,973
35043000117,552,463,254,144,15,27,40,4,209
35043000083,867,697,420,232,19,10,26,3,277
35043000062,1038,838,483,241,31,50,43,3,355
35043000136,918,706,464,170,34,31,18,5,242
35043000014,763,531,1,16,3,525,0,0,530
35043000026,449,319,3,7,1,312,0,0,316
35043000009,1066,741,1,15,2,729,2,0,740
35043000091,1899,1319,3,9,5,1306,2,0,1316
35055000001,782,674,458,154,12,32,4,0,216
35043000008,690,518,5,49,1,480,0,1,513
35043000087,1594,1207,187,961,8,67,3,2,1020
35043000001,1291,1008,255,712,4,62,3,0,753
35043000050,1794,1320,729,445,33,81,48,4,591
35043000111,1320,958,453,397,16,70,42,1,505
35043000135,904,706,345,270,40,43,29,0,361
35043000082,1361,1023,459,477,25,53,32,9,564
35043000127,1443,943,461,354,59,65,24,5,482
35043000069,1813,1326,630,533,36,88,47,17,696
35043000057,808,657,501,120,4,22,18,1,156
35001000003,614,454,199,166,21,27,54,1,255
35043000033,2101,1832,965,634,88,124,44,1,867
35043000114,759,726,539,124,23,31,10,3,187
35043000076,810,776,630,98,16,18,11,1,146
35043000133,549,518,421,64,4,15,10,1,97
35043000055,430,410,309,65,6,15,20,2,101
35043000035,1709,1330,724,460,25,120,36,8,606
35043000004,949,721,159,494,5,78,7,0,562
35043000019,684,509,1,6,2,498,0,1,508
35043000085,1078,788,293,417,20,63,6,5,495
35043000138,1692,1250,624,525,54,54,21,0,626
35043000030,1452,1035,507,408,27,67,45,2,528
35043000096,1024,812,418,333,12,45,13,0,394
35001000174,1208,951,376,440,33,70,49,4,575
35001000116,1013,765,373,298,34,38,36,7,392
35001000002,1132,931,482,361,33,40,39,0,449
35043000022,658,500,90,280,9,121,4,0,410
35043000025,1244,885,25,10,2,855,0,0,860
35043000023,323,282,114,151,1,11,4,0,168
35043000139,1195,847,413,329,62,33,32,5,434
35043000086,1382,871,410,348,43,49,45,6,461
35043000129,1472,958,446,314,54,57,101,4,512
35043000128,1292,914,422,355,54,45,62,3,492
35043000072,2338,1607,815,541,66,75,150,15,792
35006000024,721,567,7,9,3,549,2,5,560
35006000007,952,762,261,446,10,57,10,0,501
35015000038,254,187,135,47,0,6,0,0,52
35015000035,1572,1203,724,407,8,51,19,5,479
35015000002,1145,889,301,526,28,23,17,1,588
35015000022,1718,1214,124,1024,32,48,9,3,1090
35015000024,1101,838,491,314,11,32,4,0,347
35015000004,1182,814,383,379,13,24,9,2,431
35028000021,790,572,397,71,15,22,70,5,175
35028000005,1145,873,661,137,8,28,43,2,212
35028000018,559,433,275,94,23,22,30,0,158
35045000108,966,717,490,104,8,111,6,3,227
35045000064,1057,822,571,171,5,67,2,5,251
35045000076,1665,1217,554,363,2,275,19,0,663
35045000073,1290,987,392,511,4,93,6,1,595
35006000016,657,515,223,228,17,40,1,2,292
35045000072,1385,1132,620,416,3,73,7,4,512
35045000075,1548,1055,411,329,8,304,12,0,644
35045000079,1119,823,368,213,4,235,4,0,455
35045000074,1908,1324,613,357,17,338,22,2,711
35045000071,640,499,314,66,7,111,1,1,185
35055000032,249,221,38,175,1,17,2,1,183
35055000028,506,406,59,326,2,32,0,1,347
35055000002,297,247,74,164,0,15,4,0,173
35031000017,1657,1211,242,113,4,872,11,0,969
35031000016,1026,719,33,20,6,640,26,1,686
35031000049,1525,1160,368,269,15,479,48,0,792
35031000054,1126,850,20,26,3,807,2,1,830
35031000050,412,293,66,43,9,175,13,1,227
35031000022,1409,1029,31,36,5,976,1,1,998
35031000065,1339,1066,160,48,1,868,2,2,906
35031000058,1592,1092,140,195,18,787,1,3,952
35031000025,1096,807,45,7,1,754,1,6,762
35047000022,457,378,163,204,4,11,1,0,215
35047000031,1016,824,263,532,9,28,2,3,561
35047000021,821,684,237,405,10,38,2,1,447
35047000033,102,86,34,49,0,2,4,0,52
35047000014,104,95,34,57,0,4,0,0,61
35047000015,289,262,174,79,2,8,3,1,88
35047000018,388,325,56,248,2,9,5,2,269
35047000020,233,177,21,148,0,8,1,0,156
35047000019,888,691,194,461,6,32,3,4,497
35047000017,229,163,12,149,0,2,1,0,151
35047000032,290,242,64,164,1,7,2,1,178
35047000006,705,560,95,442,8,35,16,2,465
35047000010,649,545,203,322,9,19,3,3,342
35047000024,967,807,246,547,1,21,8,2,561
35047000023,1652,1317,238,1033,7,62,13,6,1079
35047000016,1257,1021,337,657,5,25,4,0,684
35047000012,1250,1033,304,644,38,50,11,2,729
35047000013,269,195,28,158,0,8,2,1,167
35007000017,568,464,121,332,1,22,5,0,343
35029000012,2025,1445,237,1138,25,39,21,6,1208
35029000003,1793,1488,854,565,12,49,14,1,634
35029000013,1332,1032,579,387,17,57,12,3,453
35029000016,1252,928,369,529,9,21,8,1,559
35029000017,1337,954,301,617,5,25,3,0,653
35029000011,1665,1240,245,947,33,43,15,5,995
35029000015,1205,986,330,585,40,31,20,11,656
35055000019,1114,903,289,573,6,46,3,1,614
35055000044,975,799,415,337,13,41,6,5,384
35055000021,637,516,177,314,3,21,6,1,339
35055000045,977,775,245,478,4,54,5,1,530
35055000026,256,204,63,120,8,23,8,7,141
35055000047,1258,1005,423,476,19,94,20,0,582
35055000035,797,662,354,259,4,30,11,2,308
35055000008,414,360,232,115,1,4,3,1,128
35055000009,1312,1173,715,374,2,40,23,0,458
35055000005,654,520,76,425,2,17,2,0,444
35055000033,80,62,57,4,2,0,2,0,5
35007000003,490,381,177,172,2,24,2,1,204
35007000004,761,661,300,307,15,38,6,0,361
35007000019,353,250,82,165,0,5,0,0,168
35029000001,1115,741,205,491,29,28,7,3,536
35029000002,1946,1577,716,795,11,56,5,4,861
35031000052,743,581,169,54,5,363,7,1,412
35031000018,339,248,12,7,5,227,5,2,236
35031000024,1620,1201,66,40,5,1104,1,0,1135
35031000045,1053,842,223,175,29,328,108,3,619
35031000055,918,667,46,32,1,599,4,0,621
35031000021,1706,1284,155,517,14,642,15,2,1129
35031000019,2044,1454,12,29,8,1434,0,0,1442
35031000056,1138,814,335,145,25,249,81,0,479
35031000003,1344,948,60,15,5,881,0,0,888
35031000057,722,551,12,21,0,531,1,1,539
35031000039,979,766,185,150,11,406,34,2,581
35031000020,1677,1230,44,55,7,1149,4,5,1186
35031000007,1174,911,4,11,4,904,0,0,907
35031000006,2060,1488,6,12,0,1475,0,0,1482
35031000053,1246,859,2,21,2,848,0,0,857
35055000018,1080,929,566,283,11,51,13,2,363
35055000043,796,639,304,299,8,26,21,1,335
35055000020,1040,870,300,519,6,56,9,4,570
35055000023,94,90,49,37,0,7,0,1,41
35055000036,169,122,7,11,1,106,1,0,115
35029000006,1627,1225,478,689,32,49,16,2,747
35029000007,1320,979,266,669,10,22,14,1,713
35029000005,1053,795,381,393,6,12,10,0,414
35051000011,1359,1124,739,310,15,68,14,2,385
35051000010,879,803,645,122,2,32,5,1,158
35051000005,689,580,407,138,3,30,2,0,173
35051000004,611,522,384,110,1,29,3,1,138
35057000017,1506,1203,811,294,14,92,12,2,392
35057000005,1531,1212,760,343,15,63,22,2,452
35049000125,1135,892,649,191,7,40,8,1,243
35001000229,1336,933,427,416,34,72,34,1,506
35001000264,1543,1004,329,519,53,68,60,7,675
35001000231,1585,1115,400,496,84,92,80,8,715
35001000127,2513,1714,701,757,81,111,108,8,1013
35001000606,1030,775,370,319,33,45,31,5,405
35001000117,1430,967,380,466,48,63,46,7,587
35001000205,2526,1954,859,899,40,124,61,6,1095
35001000085,1181,937,441,386,31,55,54,1,496
35001000093,2372,1805,32,205,4,1660,9,2,1773
35001000099,1752,1414,327,1033,18,67,7,1,1087
35001000213,511,399,223,126,22,19,15,0,176
35001000554,767,643,373,218,10,28,12,2,270
35001000164,1125,981,284,547,48,126,25,1,697
35001000211,533,452,117,261,18,63,2,1,335
35001000212,1216,946,187,613,50,112,23,4,759
35001000392,498,410,356,26,5,6,19,1,54
35001000539,823,709,554,91,7,23,28,7,155
35001000567,197,151,96,39,3,0,10,2,55
35001000475,1324,1055,457,448,49,80,45,2,598
35001000477,2400,1855,605,985,103,132,71,14,1250
35001000132,1386,1257,435,588,119,148,25,9,822
35001000434,585,483,182,250,21,41,10,0,301
35001000183,758,651,342,254,15,21,18,0,309
35001000279,709,563,150,376,13,24,13,0,413
35027000013,696,592,336,191,10,49,4,1,256
35027000002,391,325,148,169,4,7,0,0,177
35027000017,516,431,339,60,3,17,0,0,92
35027000028,178,151,115,34,0,0,1,0,36
35027000015,554,430,177,223,3,23,3,0,253
35027000001,313,268,204,53,3,11,2,0,64
35027000025,977,837,583,198,12,43,10,0,254
35027000007,815,690,479,164,10,30,9,5,211
35027000020,522,462,385,65,7,7,1,1,77
35027000019,266,231,165,63,1,3,0,0,66
35057000007,1475,1122,665,372,16,70,15,0,457
35057000015,587,472,268,186,4,31,0,0,204
35049000070,2383,1886,964,714,31,116,83,1,922
35049000111,1574,1346,811,381,32,93,42,5,535
35049000112,1137,903,229,593,10,73,15,0,674
35049000008,891,826,582,183,8,26,18,3,244
35049000119,489,445,322,94,0,20,7,1,123
35007000010,363,334,163,156,7,13,1,0,171
35007000016,1470,1150,506,611,6,63,8,6,644
35031000012,389,267,10,13,5,253,1,2,257
35031000062,682,508,9,8,1,495,0,1,499
35031000011,474,339,7,1,3,331,0,0,332
35031000002,669,501,16,34,4,461,1,1,485
35001000171,2312,1950,866,708,130,185,119,12,1084
35001000089,1396,1132,419,470,85,124,40,1,713
35001000172,1097,852,396,334,50,69,37,2,456
35049000140,1622,1142,206,896,7,36,11,0,936
35049000106,1337,967,187,736,8,53,26,0,780
35049000064,1679,1142,58,1053,15,31,5,2,1084
35049000031,1158,990,323,584,21,78,26,1,667
35049000074,1508,1224,410,705,23,69,28,4,814
35049000092,1326,1101,517,520,7,55,15,3,584
35049000113,958,881,712,116,22,12,18,2,169
35049000071,789,745,613,84,4,19,11,0,132
35049000065,584,538,451,50,6,23,5,0,87
35049000083,833,766,633,80,0,19,17,2,133
35049000147,985,885,679,131,9,33,35,7,206
35049000152,988,915,735,127,20,11,11,2,180
35049000146,692,666,574,51,5,12,15,1,92
35049000005,1329,1062,275,716,6,81,11,7,787
35049000012,1322,1070,298,708,8,45,33,0,772
35049000093,1300,1033,265,753,2,26,2,0,768
35049000003,751,631,124,496,3,11,3,2,507
35049000004,167,139,38,99,0,3,0,0,101
35049000049,983,790,294,432,13,37,13,0,496
35031000060,443,310,3,0,2,306,0,0,307
35007000007,408,313,175,118,2,8,3,4,138
35007000002,518,415,197,198,4,12,1,0,218
35057000011,159,117,62,51,1,3,0,0,55
35057000003,409,320,116,180,4,22,3,3,204
35055000034,1305,989,386,556,14,52,11,0,603
35055000046,214,195,154,19,3,12,1,0,41
35055000022,135,122,42,72,0,11,2,0,80
35055000007,725,633,562,56,7,12,1,0,71
35055000017,1657,1254,426,761,7,79,4,0,828
35055000042,1397,1084,427,595,14,56,8,0,657
35055000041,1099,897,359,473,18,61,6,0,538
35031000029,1436,1068,8,9,2,1054,2,0,1060
35049000013,999,840,408,385,5,44,14,2,432
35049000094,1090,955,689,208,5,30,27,0,266
35049000098,772,672,287,352,6,28,3,0,385
35049000034,982,815,400,354,16,41,18,1,415
35049000035,432,352,164,153,6,17,15,0,188
35049000019,298,245,147,92,1,3,0,0,98
35049000007,1200,905,333,479,11,75,24,2,572
35049000128,898,764,169,493,10,99,8,6,595
35055000037,1539,1300,739,483,9,54,6,1,561
35028000001,964,783,643,80,6,21,23,2,140
35028000015,1227,875,617,136,17,22,72,4,258
35028000008,1335,1141,690,226,34,29,156,3,451
35028000007,616,489,366,67,5,8,24,1,123
35049000016,513,437,335,62,12,20,9,1,102
35001000092,1611,1336,400,875,28,51,4,1,936
35003000006,247,212,184,26,1,4,0,0,28
35003000005,313,276,219,42,3,9,1,1,57
35003000008,273,249,217,18,1,10,0,0,32
35003000007,456,420,334,48,2,22,6,0,86
35019000005,461,338,59,277,0,6,0,1,279
35027000014,1049,869,639,196,6,28,7,0,230
35027000016,217,200,141,47,1,6,0,0,59
35027000004,679,552,474,63,0,9,3,0,78
35027000003,824,706,555,110,6,35,2,0,151
35027000027,338,293,244,34,1,5,3,1,49
35001000460,1354,1201,712,348,29,75,60,1,489
35001000448,581,411,195,109,22,20,67,0,216
35001000507,772,660,392,187,33,30,28,1,268
35001000478,1733,1329,344,780,97,109,39,7,985
35027000023,503,371,153,181,9,25,3,1,218
35027000011,1723,1300,537,661,8,107,9,0,763
35027000018,547,414,182,200,8,29,5,1,232
35027000022,433,321,136,158,4,32,9,0,185
35027000005,716,623,520,77,3,25,1,0,103
35027000026,1007,880,688,157,9,22,12,0,192
35007000022,794,671,441,206,7,38,1,2,230
35027000012,656,537,267,257,2,13,2,1,270
35001000258,1973,1447,878,246,183,45,95,33,569
35001000363,1865,1241,781,223,119,30,79,12,460
35001000094,799,593,86,460,17,27,11,1,507
35001000081,2394,1689,701,771,75,88,74,10,988
35001000118,2050,1411,598,577,89,104,93,7,813
35001000530,1105,958,667,181,26,43,26,6,291
35001000306,910,714,349,240,31,73,31,6,365
35001000001,2090,1501,598,728,71,118,42,4,903
35001000129,1274,951,395,420,57,50,48,7,556
35001000128,1454,1096,479,518,27,71,18,2,617
35001000056,1956,1458,215,1132,39,117,13,3,1243
35001000137,2263,1580,200,1205,63,107,27,2,1380
35001000059,2296,1571,120,1317,45,136,20,2,1451
35001000252,718,621,408,144,30,16,28,6,213
35001000232,1449,1278,625,436,61,104,65,1,653
35001000100,1268,1121,429,289,25,341,54,4,692
35001000101,1446,1212,491,348,87,132,200,4,721
35001000161,1496,1088,179,700,51,168,26,2,909
35001000163,527,458,187,240,14,31,5,0,271
35021000001,229,202,113,80,5,9,6,2,89
35021000003,47,37,35,2,0,0,0,0,2
35021000002,381,322,157,153,4,13,1,0,165
35027000021,1110,922,610,238,4,67,11,2,312
35001000425,1321,1003,566,222,28,34,164,3,437
35001000470,1214,942,513,195,23,19,189,4,429
35001000456,691,574,364,162,10,7,36,0,210
35001000467,617,479,296,123,9,29,22,1,183
35001000274,631,538,316,159,19,30,16,0,222
35001000151,1067,880,256,576,18,61,3,1,624
35001000155,1125,863,331,458,40,44,14,3,532
35001000181,379,337,157,160,3,17,6,0,180
35001000263,812,699,267,373,22,48,14,0,432
35001000313,549,450,195,174,19,45,19,3,255
35001000015,1686,1419,603,708,31,82,25,3,816
35001000088,1481,1416,463,749,123,105,2,3,953
35001000250,1482,1124,181,910,14,33,5,2,943
35051000007,1286,1112,777,253,4,67,18,1,335
35051000008,1312,1066,669,330,17,53,17,0,397
35051000009,153,123,81,25,4,15,0,0,42
35057000018,892,674,367,250,8,44,10,3,307
35057000006,1660,1302,710,484,14,93,5,4,592
35057000008,257,204,72,122,2,8,1,0,132
35049000068,503,471,407,44,0,11,5,0,64
35049000081,1083,927,470,418,7,36,20,1,457
35049000129,636,553,435,80,3,12,9,0,118
35049000102,912,836,532,272,5,19,8,1,304
35049000037,1369,1165,656,439,24,34,25,2,509
35049000101,998,899,477,328,28,39,16,2,422
35049000053,714,647,438,156,7,22,18,1,209
35049000044,1109,1027,758,210,18,35,12,2,269
35049000110,691,634,535,64,8,12,4,1,99
35049000139,752,665,521,96,6,28,16,3,144
35049000069,651,591,487,68,7,14,4,1,104
35049000036,636,600,478,79,7,10,16,4,122
35001000302,1150,969,640,203,31,39,63,1,329
35001000309,995,840,561,163,8,18,93,2,279
35001000269,1149,779,119,585,34,39,29,0,660
35001000145,1469,1042,240,662,71,87,34,7,802
35001000141,2590,1717,276,1273,89,88,40,2,1441
35001000144,1412,994,145,795,20,51,5,1,849
35001000054,1832,1239,195,839,94,107,57,6,1044
35001000270,1412,1038,122,885,8,30,9,2,916
35001000143,2203,1506,68,1378,19,63,11,1,1438
35001000247,2540,1652,305,1139,83,120,69,4,1347
35001000142,1598,1059,172,734,67,75,51,2,887
35001000268,1060,676,79,533,28,51,15,4,597
35001000267,1517,1109,113,900,36,59,21,2,996
35001000138,1358,973,80,805,42,50,23,3,893
35001000130,2136,1507,206,1154,71,93,37,3,1301
35001000149,1427,1003,133,795,30,52,20,5,870
35001000265,1769,1224,135,973,42,119,38,1,1089
35001000036,1326,1059,139,865,21,53,12,0,920
35001000545,1259,991,471,336,47,99,69,3,520
35001000058,1820,1122,94,937,14,94,4,4,1028
35001000136,2593,1749,224,1319,63,168,38,2,1525
35001000031,1586,1151,6,25,11,1126,4,4,1145
35001000057,1669,1426,769,460,81,86,54,2,657
35001000018,1304,1075,304,707,22,53,7,0,771
35001000214,772,734,389,205,34,70,42,4,345
35001000613,450,401,190,128,18,55,25,0,211
35001000017,967,805,383,363,11,31,23,0,422
35001000259,557,444,140,280,4,20,4,2,304
35001000587,667,521,395,88,3,20,24,0,126
35001000586,978,860,603,144,22,26,63,3,257
35001000537,514,436,368,39,2,12,16,1,68
35001000585,515,464,351,69,9,5,26,0,113
35001000603,718,624,498,63,1,13,50,0,126
35001000588,766,654,463,129,5,14,42,0,191
35001000602,872,737,463,124,28,25,92,0,274
35001000011,719,616,336,237,26,32,14,2,280
35001000126,572,483,202,253,13,15,6,1,281
35001000079,1360,1083,470,481,49,53,57,4,613
35001000179,1387,1135,525,501,20,63,42,0,610
35001000597,1004,812,608,171,0,25,3,1,204
35001000557,870,705,540,133,9,8,7,0,165
35001000577,916,734,557,124,10,32,15,2,177
35001000596,666,535,388,120,10,20,7,1,147
35001000154,1094,853,231,568,30,48,9,0,622
35009000020,1919,1407,422,816,146,30,31,4,985
35009000003,414,307,196,96,1,10,3,4,111
35037000011,1275,981,506,426,17,28,19,4,475
35037000012,716,570,388,163,5,10,1,1,182
35037000009,1429,1095,489,532,25,62,9,0,606
35011000002,810,635,424,190,2,20,3,10,211
35001000569,923,813,684,70,10,19,31,1,129
35001000574,745,623,532,46,11,7,32,0,91
35001000169,973,798,325,379,16,60,32,0,473
35001000030,1029,872,471,270,47,53,38,4,401
35001000189,921,718,247,388,44,55,13,1,471
35001000178,795,676,339,259,20,34,41,7,337
35001000025,1354,1020,364,516,49,40,65,0,656
35001000096,1575,1216,358,784,20,55,5,3,858
35001000098,986,771,203,503,19,52,2,1,568
35001000109,136,104,35,62,2,3,1,0,69
35001000471,697,563,325,174,6,23,36,0,238
35001000153,1207,975,282,604,27,74,30,1,693
35001000074,1464,1137,195,874,13,57,20,4,942
35001000503,848,653,318,255,20,63,17,2,335
35001000095,1188,862,50,783,17,31,3,1,812
35001000375,731,656,228,264,23,62,108,1,428
35001000377,780,666,412,158,20,31,30,0,254
35001000521,1405,1120,630,264,48,109,93,3,490
35001000292,1195,964,390,387,68,86,33,3,574
35001000310,1238,1077,648,310,24,49,62,3,429
35001000329,1630,1206,317,628,89,97,85,7,889
35001000323,2012,1501,313,914,96,185,35,3,1188
35001000007,1534,1210,431,664,18,92,15,3,779
35001000219,798,663,327,298,5,21,21,0,336
35001000370,1242,1042,393,403,70,152,44,4,649
35001000420,1041,853,422,299,48,81,34,4,431
35001000414,516,416,236,123,11,12,28,2,180
35001000303,724,612,284,296,6,31,6,0,328
35001000566,891,769,557,142,7,24,29,1,212
35001000385,715,638,376,164,36,58,10,0,262
35037000007,1392,999,313,631,21,44,7,6,686
35037000002,132,92,72,12,1,7,0,0,20
35037000006,644,538,399,112,5,24,3,0,139
35009000001,152,122,100,16,2,5,2,0,22
35037000003,392,320,242,64,2,15,4,0,78
35037000004,104,88,67,16,0,1,0,0,21
35001000412,773,673,365,229,22,49,16,4,308
35001000411,752,699,322,187,74,104,26,3,377
35029000009,1399,1031,315,693,14,21,6,3,716
35029000010,1146,816,236,524,13,39,21,4,580
35039000046,1544,1239,94,1073,9,88,9,1,1145
35039000036,1168,933,130,769,10,47,3,6,803
35039000027,159,131,25,102,0,3,0,0,106
35039000020,1194,980,359,578,23,67,3,1,621
35039000021,256,204,47,85,2,76,7,0,157
35039000019,434,367,177,178,2,10,1,0,190
35039000038,2073,1634,282,1299,12,50,10,3,1352
35039000001,849,739,329,378,4,23,4,1,410
35039000045,1576,1056,38,104,22,942,29,0,1018
35039000024,1915,1306,40,136,7,1164,15,1,1266
35039000043,891,713,90,607,6,19,1,0,623
35039000002,1529,1197,157,993,13,47,4,2,1040
35039000013,1579,1292,99,1170,8,40,3,1,1193
35039000029,135,115,9,12,0,100,3,1,106
35039000026,457,390,104,276,2,18,1,1,286
35039000030,393,309,57,241,2,8,3,0,252
35011000003,502,409,241,157,6,10,13,5,168
35011000001,136,101,79,20,2,3,0,0,22
35061000050,756,516,110,380,14,16,7,2,406
35061000028,1634,1183,269,853,21,63,12,3,914
35061000049,2062,1414,394,939,16,81,6,4,1020
35061000017,1522,1184,392,704,35,65,22,2,792
35061000055,1321,1009,390,534,22,58,14,9,619
35061000054,1136,859,296,488,19,53,17,0,563
35061000044,2018,1390,544,694,55,81,58,3,846
35045000001,1476,1145,9,22,3,1128,6,1,1136
35045000009,492,397,8,8,2,385,1,0,389
35001000042,1280,973,81,811,41,51,10,2,892
35001000052,2464,1768,207,1456,36,113,21,1,1561
35001000224,423,366,127,205,11,25,3,0,239
35045000078,1106,823,484,226,6,114,5,2,339
35045000019,806,525,6,5,3,515,1,1,519
35045000052,945,713,316,246,16,138,1,0,397
35045000026,1005,728,115,65,2,556,7,4,613
35045000022,1548,1151,206,134,8,814,11,0,945
35039000041,1629,1167,42,209,6,981,2,3,1125
35039000018,760,639,208,406,4,27,3,2,431
35035000002,35,30,25,0,2,0,1,1,5
35035000013,1250,962,419,438,8,100,10,4,543
35035000027,1019,786,495,223,32,35,11,5,291
35035000012,1568,1247,701,431,16,111,9,0,546
35035000038,241,193,111,73,7,7,1,0,82
35035000026,1050,834,457,260,84,31,23,2,377
35039000034,46,41,8,29,4,1,0,0,33
35039000016,531,442,111,322,5,14,2,2,331
35039000007,1542,1148,42,216,9,935,5,0,1106
35039000008,628,507,62,419,6,25,2,0,445
35003000001,708,631,410,168,15,31,3,0,221
35003000003,401,367,316,38,2,11,0,0,51
35013000149,896,814,467,256,28,24,34,0,347
35013000073,723,635,387,175,15,28,43,1,248
35013000056,961,747,289,404,25,53,14,2,458
35013000150,730,594,330,231,13,18,11,0,264
35013000040,1373,1065,316,682,33,62,19,3,749
35013000055,1963,1627,610,790,63,56,136,3,1017
35013000168,2093,1448,14,1423,7,40,5,0,1434
35013000169,2066,1451,19,1423,3,18,4,0,1432
35013000013,1717,1215,11,1200,9,18,1,0,1204
35013000167,1433,1061,17,1032,7,19,6,1,1044
35013000043,930,660,140,476,26,28,7,1,520
35013000006,1128,779,473,139,82,36,58,11,306
35013000021,1067,993,772,158,21,14,23,1,221
35013000134,1436,1108,324,728,18,55,17,2,784
35013000005,861,635,175,423,4,32,14,3,460
35009000008,1927,1445,538,687,184,55,29,0,907
35009000002,364,253,175,60,5,7,5,1,78
35009000006,1153,737,84,561,85,34,5,0,653
35061000062,1881,1348,361,950,5,39,9,2,987
35061000057,1240,1015,367,595,6,30,12,4,648
35061000058,1645,1133,433,635,19,44,7,6,700
35061000008,967,680,259,386,13,18,11,2,421
35061000056,1853,1311,276,982,9,56,7,8,1035
35061000024,1272,874,29,841,0,27,7,0,845
35061000022,1337,966,378,495,45,67,21,1,588
35061000016,1557,1083,213,816,7,64,8,4,870
35061000031,873,662,205,411,6,47,6,0,457
35061000046,984,779,270,475,6,31,6,0,509
35061000033,1043,756,248,464,6,33,6,2,508
35061000029,1092,889,403,420,22,39,17,4,486
35061000035,1092,831,219,578,10,41,3,0,612
35061000015,1045,836,283,497,4,53,16,0,553
35006000009,1629,1177,302,432,19,399,44,0,875
35035000031,704,575,312,188,29,35,17,0,263
35006000018,429,350,68,230,6,60,0,2,282
35045000050,2445,1801,547,303,52,873,54,4,1254
35045000055,1234,919,565,175,3,169,8,0,354
35045000035,1406,1014,430,194,22,353,25,7,584
35035000010,772,647,512,80,11,30,6,1,135
35035000053,865,685,464,173,6,24,18,3,221
35035000054,1021,801,516,234,14,34,6,6,285
35045000045,2132,1499,523,356,18,599,24,6,976
35045000058,1238,964,632,211,6,110,5,1,332
35045000080,1517,1063,442,309,5,310,6,2,621
35045000068,1777,1226,646,331,10,236,14,0,580
35045000053,1420,1033,247,392,10,411,5,0,786
35045000105,1089,827,464,200,6,166,6,0,363
35035000048,1552,1193,624,354,94,41,69,20,569
35035000049,2094,1571,1082,247,103,46,97,14,489
35035000001,2597,2183,562,1447,51,115,19,0,1621
35035000041,1973,1259,50,1196,5,31,0,0,1209
35035000045,1178,712,42,664,4,7,5,1,670
35035000046,1388,960,10,942,5,29,0,0,950
35035000044,1608,1123,72,1019,28,22,7,2,1051
35035000042,1672,1170,157,991,17,27,4,1,1013
35035000043,1001,639,26,598,5,14,3,0,613
35045000069,1637,1170,666,257,10,239,5,2,504
35061000036,808,633,239,362,5,42,7,0,394
35045000020,1156,884,12,12,1,870,0,0,872
35045000120,1287,945,6,8,2,933,3,0,939
35045000025,1021,759,380,87,16,282,6,0,379
35061000026,756,578,152,387,16,49,4,0,426
35041000017,1190,888,454,390,14,23,7,1,434
35015000016,2249,1612,540,983,44,65,12,9,1072
35005000023,1114,782,280,428,42,35,10,2,502
35015000034,1816,1341,589,669,28,43,4,7,752
35015000051,1803,1355,695,587,17,40,10,4,660
35015000018,1334,1020,590,373,18,36,9,1,430
35015000043,1093,803,359,381,14,43,16,0,444
35015000023,1433,1017,412,544,22,32,14,9,605
35015000029,100,77,63,11,0,2,1,0,14
35045000063,1222,914,569,179,8,159,10,3,345
35041000013,693,526,242,216,26,27,13,1,284
35031000009,1719,1224,50,42,22,1095,16,7,1174
35043000079,313,274,232,23,3,18,3,1,42
35043000124,1302,955,413,434,54,69,14,4,542
35043000067,1655,1237,611,495,54,91,34,2,626
35043000073,1112,883,502,292,26,43,29,1,381
35043000125,1510,1006,394,483,50,96,26,10,612
35043000068,1657,1095,440,466,75,94,38,1,655
35043000084,1794,1138,507,480,55,83,34,12,631
35043000126,842,580,222,299,21,34,14,2,358
35043000137,1254,866,372,388,54,41,28,5,494
35043000049,1166,918,488,301,27,83,26,1,430
35043000016,378,294,83,162,4,42,6,2,211
35043000024,624,481,1,10,1,472,0,0,480
35043000075,2145,1518,656,656,54,132,54,10,862
35043000080,2658,1855,822,778,97,148,49,23,1033
35043000134,1557,1044,466,431,55,85,39,9,578
35043000104,1213,923,418,367,34,75,36,3,505
35043000120,1081,762,285,377,38,69,12,0,477
35043000065,999,739,292,263,28,141,23,11,447
35043000121,743,563,272,235,19,29,15,0,291
35017000039,805,655,350,275,12,18,12,1,305
35005000085,784,561,229,294,14,13,13,1,332
35005000022,1121,849,470,321,20,37,12,2,379
35007000001,808,676,517,128,6,15,5,2,159
35007000008,1192,1021,816,140,9,36,15,3,205
35007000009,259,212,159,35,0,11,3,1,53
35031000048,1476,1061,49,260,9,785,4,0,1012
35031000063,1268,867,67,220,5,585,17,0,800
35049000043,710,615,394,170,14,13,20,3,221
35013000078,1479,1114,314,730,25,68,13,2,800
35013000151,1884,1367,240,1061,14,55,18,0,1127
35013000154,2261,1584,35,1530,7,36,2,1,1549
35013000008,1462,1079,75,974,9,22,1,1,1004
35013000138,656,511,231,214,26,19,35,2,280
35013000137,1189,994,538,350,37,20,60,3,456
35013000067,1602,1354,708,516,50,47,53,1,646
35013000136,931,750,307,397,16,17,21,4,443
35013000115,1207,996,463,490,24,27,11,0,533
35013000018,1001,842,288,492,9,55,7,1,554
35059000008,235,184,158,21,4,1,1,1,26
35053000020,416,313,124,175,0,6,3,0,189
35013000100,945,763,348,397,6,17,3,0,415
35013000007,1712,1300,439,815,22,58,13,3,861
35013000004,1336,1039,200,813,7,75,5,2,839
35013000128,1119,790,286,425,35,36,27,1,504
35013000129,1240,945,360,523,26,46,21,2,585
35013000095,345,249,45,198,0,7,5,0,204
35013000111,246,205,135,64,2,7,3,1,70
35013000084,1162,926,378,508,21,28,3,3,548
35013000045,1208,892,232,607,52,47,9,2,660
35013000165,1030,700,144,522,7,18,19,0,556
35013000014,2494,1875,456,1377,27,37,17,1,1419
35013000166,1544,1202,336,812,22,47,19,2,866
35013000048,2006,1573,434,1023,82,81,7,4,1139
35013000106,1010,770,379,301,25,6,55,1,391
35013000143,1120,932,512,353,18,35,32,3,420
35013000144,816,683,294,321,28,20,30,1,389
35053000009,120,94,59,30,0,5,3,0,35
35053000002,1128,923,470,349,16,35,46,2,453
35053000001,974,818,302,458,10,48,18,1,516
35053000019,722,597,246,329,6,27,5,0,351
35039000037,344,263,39,207,3,14,5,1,224
35039000005,1126,881,71,675,11,153,7,5,810
35013000003,1218,868,111,748,6,22,3,3,757
35013000158,1524,1059,23,1029,10,27,4,1,1036
35013000012,776,583,77,495,7,10,2,0,506
35013000157,1974,1448,74,1365,7,35,4,0,1374
35005000083,771,612,279,302,15,25,4,1,333
35005000006,1340,1054,558,412,22,36,36,2,496
35013000155,709,524,62,453,6,18,3,2,462
35013000156,1089,746,22,717,2,6,1,0,724
35013000010,997,660,8,648,1,16,3,0,652
35023000004,377,283,234,35,3,5,1,2,49
35013000148,812,720,553,135,11,10,11,0,167
35013000108,468,395,155,213,10,12,11,1,240
35013000093,460,358,40,299,4,23,4,2,318
35013000076,1489,1104,193,863,17,40,18,2,911
35013000035,715,599,154,421,6,37,6,3,445
35053000005,607,466,75,343,23,46,4,1,391
35013000023,1565,1147,220,873,18,50,11,6,927
35043000119,914,766,456,242,25,32,26,2,310
35043000064,883,746,454,234,13,34,18,2,292
35043000052,626,514,276,173,18,44,13,0,238
35043000115,947,724,431,229,16,31,19,2,293
35015000013,1532,1157,342,753,43,25,10,5,815
35015000011,1339,982,228,680,31,30,21,4,754
35007000005,861,713,244,436,1,26,4,1,469
35047000026,1829,1480,203,1210,20,41,7,0,1277
35047000011,293,244,23,216,5,10,0,0,221
35047000030,825,696,93,574,10,19,6,4,603
35047000003,909,739,117,595,11,29,2,2,622
35043000113,677,616,452,125,1,38,8,1,164
35043000054,506,432,246,148,8,14,6,1,186
35001000012,1080,927,425,429,13,33,12,0,502
35001000139,1282,992,95,879,11,37,2,3,897
35001000043,1772,1281,130,1085,19,58,19,2,1151
35001000236,850,593,49,525,19,18,4,0,544
35001000040,1510,1158,131,978,27,50,13,0,1027
35001000055,1184,895,136,606,58,100,28,7,759
35001000233,1489,1095,157,780,59,106,27,5,938
35001000034,1663,1203,166,932,39,95,9,1,1037
35001000538,1229,1049,687,245,17,57,39,1,362
35001000006,1047,886,357,455,22,60,15,6,529
35001000220,834,664,416,210,10,31,12,3,248
35001000008,505,439,204,221,0,9,5,3,235
35001000469,1075,887,613,192,13,17,52,1,274
35001000560,932,747,543,126,3,26,44,1,204
35049000018,1580,1213,844,276,15,68,14,4,369
35049000030,810,755,571,132,4,23,12,0,184
35049000123,413,396,285,89,0,6,12,3,111
35043000047,1589,1146,434,618,45,60,26,7,712
35043000109,1560,1132,494,483,46,86,41,1,638
35043000110,1236,895,498,346,7,25,14,4,397
35043000056,746,660,489,141,9,14,6,1,171
35043000099,696,586,373,175,18,28,13,1,213
35043000036,762,638,376,198,12,29,17,3,262
35043000071,1948,1460,623,636,86,105,48,8,837
35043000131,545,456,274,124,23,12,16,1,182
35043000074,684,617,357,196,18,34,23,5,260
35043000130,837,704,371,284,3,39,17,5,333
35043000132,714,673,590,59,10,17,4,1,83
35043000039,1025,808,479,270,20,34,29,1,329
35043000103,1275,1002,513,374,33,75,19,3,489
35043000029,535,395,35,48,12,321,4,1,360
35043000044,962,760,420,292,18,25,15,4,340
35043000107,1150,890,439,344,31,84,23,2,451
35043000059,577,456,244,167,23,26,8,3,212
35043000053,909,738,516,173,9,29,20,1,222
35047000028,1242,989,115,847,17,19,3,1,874
35047000008,1117,885,110,757,7,19,5,1,775
35015000027,870,666,386,209,12,20,43,1,280
35015000047,769,600,399,154,11,23,10,2,201
35019000004,333,261,52,193,5,11,11,1,209
35003000002,732,648,534,76,5,23,8,2,114
35003000009,94,93,79,4,2,4,2,0,14
35043000028,838,727,550,106,11,36,16,2,177
35043000089,780,673,475,154,7,25,19,7,198
35043000090,542,479,332,113,9,17,7,5,147
35043000005,425,413,322,67,7,8,2,1,91
35031000034,897,675,50,304,5,348,11,2,625
35031000038,819,564,44,284,16,263,3,0,520
35047000007,847,651,100,532,5,21,4,1,551
35047000005,2059,1580,163,1334,18,50,30,1,1417
35031000026,612,478,285,31,6,154,11,1,193
35055000030,96,76,19,57,2,3,0,0,57
35019000003,989,771,132,600,13,21,8,0,639
35019000001,1014,806,145,610,5,32,37,2,661
35019000002,1655,1410,286,1016,66,53,10,0,1124
35031000028,1376,931,40,40,3,820,52,1,891
35031000043,1333,977,360,251,3,351,36,1,617
35031000044,547,409,190,121,10,62,34,1,219
35031000041,1077,806,92,275,14,442,22,0,714
35043000081,1460,1218,731,355,52,47,43,3,487
35043000108,958,778,390,322,14,44,16,3,388
35043000045,916,757,376,295,28,55,14,3,381
35031000031,1375,920,166,206,10,554,35,4,754
35033000008,360,290,76,205,4,5,5,1,214
35033000011,364,305,58,231,7,10,2,1,247
35033000009,196,167,48,110,5,9,3,2,119
35033000010,230,196,69,116,2,13,1,0,127
35033000007,268,217,36,176,1,13,4,3,181
35043000037,1658,1254,776,363,21,73,30,3,478
35043000100,2233,1492,832,508,53,54,75,2,660
35043000101,1223,817,428,283,22,63,36,10,389
35043000018,530,486,369,86,7,13,10,0,117
35043000078,372,301,231,40,6,22,7,0,70
35055000006,1280,986,218,727,10,31,10,1,768
35055000014,810,675,350,279,5,35,6,1,325
35043000098,1383,1229,810,334,25,38,28,4,419
35033000004,337,282,37,239,5,12,2,1,245
35049000080,1933,1300,110,1167,4,36,8,0,1190
35049000145,1647,1121,40,1064,5,44,2,3,1081
35049000109,2658,1956,338,1558,17,79,29,4,1618
35049000117,798,651,280,321,14,27,20,0,371
35049000077,877,770,410,277,14,48,19,2,360
35049000079,1673,1283,170,1064,10,58,18,3,1113
35039000004,1719,1332,182,1048,14,97,24,2,1150
35049000011,1040,934,599,289,9,20,19,0,335
35049000052,1503,1265,536,592,19,61,67,6,729
35049000051,479,411,176,190,6,16,20,3,235
35051000012,1652,1348,881,343,22,80,39,1,467
35057000001,1136,868,394,444,15,32,2,2,474
35049000134,818,737,613,83,9,26,9,1,124
35049000107,814,741,609,90,9,20,16,0,132
35049000118,1136,931,156,748,9,30,2,1,775
35049000001,964,771,269,459,0,35,22,1,502
35049000085,1325,1006,656,280,11,48,15,2,350
35049000148,1192,959,621,253,11,57,4,6,338
35057000019,606,470,279,174,2,14,3,1,191
35049000122,480,437,255,142,7,17,12,1,182
35049000022,695,638,431,167,4,26,12,2,207
35057000010,733,614,387,192,12,16,4,0,227
35057000004,280,234,106,115,3,13,1,1,128
35057000009,671,560,304,227,8,13,2,0,256
35047000002,1394,1198,449,561,92,72,26,5,749
35057000012,127,109,59,45,1,3,1,0,50
35037000010,734,578,170,375,9,33,6,2,408
35029000004,1599,1171,190,956,7,27,4,0,981
35001000045,1292,975,83,870,11,34,4,2,892
35001000071,2333,1844,219,1548,30,89,13,6,1625
35001000032,1217,843,136,627,50,66,1,1,707
35001000190,1094,809,56,694,37,31,17,2,753
35001000033,1344,1014,123,837,33,21,11,7,891
35001000048,1171,806,83,688,19,28,6,7,723
35001000234,1640,1279,156,1058,19,75,9,5,1123
35001000046,2052,1574,214,1281,49,69,14,5,1360
35001000519,693,541,279,168,39,20,44,1,262
35039000035,788,699,287,382,4,47,4,0,412
35055000013,1208,966,45,81,4,870,2,1,921
35055000004,645,552,296,240,4,8,5,1,256
35055000003,171,147,25,108,2,1,2,0,122
35049000149,1863,1332,371,870,35,63,36,5,961
35049000089,1323,1090,499,488,22,81,19,8,591
35049000086,2131,1613,451,1009,22,96,74,1,1162
35049000151,1693,1265,364,774,41,61,57,1,901
35027000006,1169,1022,811,161,8,24,8,2,211
35001000326,1574,1174,218,768,90,125,23,10,956
35001000062,1118,885,167,672,19,31,5,2,718
35001000063,976,757,114,600,18,34,9,2,643
35001000286,1436,1042,189,649,72,119,44,0,853
35001000379,1509,1142,201,680,131,162,18,2,941
35001000378,1301,1081,302,518,78,149,58,2,779
35001000591,1101,768,206,366,96,64,42,3,562
35001000321,1030,832,309,412,39,76,15,2,523
35001000167,1118,894,296,488,64,50,33,2,598
35001000023,726,620,236,321,14,43,19,0,384
35001000419,668,563,276,208,22,24,49,3,287
35001000339,744,592,334,194,11,29,22,1,258
35001000474,591,485,248,202,4,28,4,2,237
35049000124,507,457,270,159,2,25,4,0,187
35049000033,1286,1156,594,466,19,53,31,2,562
35049000027,672,610,382,178,10,22,14,0,228
35049000130,720,668,434,176,13,42,12,3,234
35049000015,1192,973,716,180,20,49,5,1,257
35049000039,857,714,196,462,14,44,4,3,518
35049000099,845,719,244,446,6,27,3,3,475
35001000289,726,558,290,136,14,18,106,2,268
35001000350,791,610,365,157,17,11,69,0,245
35001000349,1371,1015,486,273,54,35,200,2,529
35001000325,1534,1237,765,304,55,56,86,6,472
35001000391,527,444,365,41,9,5,19,1,79
35001000072,1274,974,122,798,26,34,4,3,852
35001000442,926,767,270,388,20,69,39,2,497
35001000443,832,680,231,351,19,64,31,2,449
35001000502,1435,1148,542,474,40,101,12,3,606
35001000452,674,541,334,121,9,32,41,5,207
35001000562,1064,965,605,254,24,50,44,8,360
35001000396,781,762,607,120,17,15,11,0,155
35001000067,2244,1675,215,1397,36,72,6,1,1460
35001000131,650,581,260,234,38,58,6,0,321
35043000093,897,794,571,170,3,36,10,0,223
35043000012,669,578,379,175,2,23,9,1,199
35043000013,575,493,352,100,17,13,12,1,141
35049000057,1155,947,478,407,14,37,19,4,469
35049000120,554,495,405,62,4,12,11,0,90
35047000029,666,515,70,430,10,15,2,0,445
35047000004,1295,970,126,801,19,46,15,1,844
35031000037,373,276,24,121,6,127,3,2,252
35031000033,2154,1418,112,504,20,841,17,1,1306
35011000004,250,215,74,137,3,3,1,0,141
35039000025,264,218,153,39,2,19,0,0,65
35039000023,311,253,32,199,8,8,17,1,221
35039000040,1738,1348,143,1115,15,66,25,1,1205
35039000006,364,316,112,197,3,4,0,5,204
35039000012,1046,777,78,674,7,37,6,0,699
35039000033,123,101,36,59,1,9,1,0,65
35039000042,318,255,51,193,4,13,1,1,204
35001000251,506,445,310,85,6,31,22,0,135
35001000508,692,543,280,207,15,42,21,7,263
35001000463,743,585,355,151,18,46,28,4,230
35001000316,1151,913,436,326,59,73,30,2,477
35001000417,1127,950,403,411,49,73,30,8,547
35001000421,1419,1133,525,415,48,104,55,11,608
35001000415,586,463,229,149,10,32,57,0,234
35001000104,598,427,41,348,35,20,0,1,386
35001000165,576,516,278,191,8,21,13,3,238
35001000278,979,811,347,281,66,88,57,5,464
35001000372,586,485,234,185,13,33,25,0,251
35001000282,1633,1411,563,585,96,144,60,7,848
35001000492,553,460,278,138,20,37,8,2,182
35001000120,1856,1295,300,808,80,131,23,3,995
35001000157,1043,809,300,408,43,58,23,1,509
35001000158,1446,1085,309,616,64,91,43,1,776
35001000146,2366,1548,220,1192,43,113,24,6,1328
35001000600,1151,839,189,427,108,100,34,1,650
35001000140,1632,1123,103,946,29,55,12,0,1020
35001000020,1123,895,348,442,38,78,19,0,547
35001000207,689,562,245,282,6,25,23,0,317
35001000428,1107,971,620,196,48,49,75,3,351
35057000002,670,581,232,327,9,13,3,1,349
35001000084,2022,1592,665,638,85,197,52,2,927
35001000200,501,392,214,152,11,12,7,1,178
35001000459,1020,863,394,389,31,53,17,1,469
35001000422,1472,1125,427,500,25,67,124,2,698
35001000589,1674,1263,563,334,53,35,284,2,700
35001000241,804,737,333,241,26,107,63,5,404
35001000358,1630,1607,634,583,100,171,174,16,973
35001000004,822,694,484,159,7,16,20,1,210
35001000604,1125,803,52,691,26,62,9,1,751
35001000239,1854,1323,104,1152,25,76,22,5,1219
35001000147,1709,1075,55,993,9,41,3,3,1020
35001000049,634,444,25,404,3,14,4,1,419
35001000408,972,823,476,259,22,65,18,0,347
35001000086,1570,1244,382,793,8,60,25,3,862
35001000010,2323,1847,773,771,66,199,78,8,1074
35001000548,770,653,462,130,17,30,26,1,191
35001000393,484,420,271,106,13,18,20,0,149
35001000039,953,745,176,509,20,38,19,0,569
35001000208,1411,1114,381,615,29,88,33,8,733
35001000111,617,508,195,247,21,45,15,0,313
35001000346,2372,1818,537,902,101,315,49,1,1281
35001000525,1370,1098,520,396,42,108,73,4,578
35001000009,1323,1052,283,694,11,79,10,2,769
35001000221,1759,1575,614,561,84,294,71,8,961
35001000337,2151,1513,284,1113,34,100,24,10,1229
35001000327,1144,867,258,498,47,84,23,4,609
35001000106,636,504,66,402,9,36,2,2,438
35001000266,1668,1244,242,732,230,56,30,1,1002
35001000103,555,428,36,332,37,35,3,2,392
35001000134,1342,951,267,526,66,57,58,2,684
35001000159,781,608,196,338,24,39,26,2,412
35001000399,1095,805,254,407,63,53,50,2,551
35001000160,1692,1401,618,625,66,67,57,6,783
35001000394,1579,1141,296,627,50,109,72,0,845
35001000599,1125,805,189,493,36,50,67,1,616
35001000336,1516,1113,215,736,51,128,23,2,898
35001000318,1820,1371,270,897,92,141,18,0,1101
35001000273,1434,1165,631,322,86,68,78,9,534
35001000029,2089,1533,410,932,59,150,35,3,1123
35001000485,1187,930,549,280,15,57,46,3,381
35001000487,815,651,494,119,6,13,17,0,157
35045000107,1348,1010,709,164,18,107,9,2,301
35045000106,954,722,407,114,13,175,18,4,315
35045000031,678,504,393,73,1,17,20,0,111
35009000016,68,55,45,9,0,1,0,0,10
35009000033,1426,999,438,486,38,37,5,1,561
35025000032,1073,736,391,306,24,18,3,0,345
35025000024,986,729,437,240,17,16,17,0,292
35025000028,1293,912,405,404,55,40,20,1,507
35009000025,1133,787,89,643,50,27,11,4,698
35061000021,1498,1156,402,692,18,52,20,2,754
35061000053,828,645,242,371,2,35,8,1,403
35061000025,1139,881,237,606,22,32,4,4,644
35006000008,1373,976,190,530,21,257,20,3,786
35061000038,1618,1199,528,573,33,36,35,6,671
35061000030,1128,850,402,383,19,38,9,6,448
35061000047,1340,1065,467,534,26,53,4,5,598
35045000039,1165,874,617,128,9,89,26,5,257
35041000003,136,93,65,25,0,3,0,0,28
35005000002,856,616,359,222,12,20,3,0,257
35017000018,811,729,348,268,77,29,6,15,381
35017000025,651,478,73,401,1,13,1,0,405
35017000029,663,503,211,271,8,12,4,0,292
35013000107,1360,1190,807,296,20,26,30,2,383
35013000152,715,620,396,166,31,22,18,0,224
35013000077,553,454,316,106,7,19,13,0,138
35013000099,1980,1495,608,819,23,55,37,3,887
35013000063,1646,1264,543,675,19,44,6,8,721
35013000058,1916,1886,1158,540,90,38,65,32,728
35013000047,1385,1075,214,785,48,59,23,3,861
35013000039,943,757,323,384,30,38,11,1,434
35013000041,660,549,118,378,28,52,5,3,431
35013000089,987,785,371,353,34,39,12,6,414
35013000061,1434,1106,428,583,47,53,17,4,678
35013000030,936,746,269,415,35,52,1,2,477
35013000088,522,403,143,251,2,21,12,0,260
35013000087,646,496,268,216,4,19,4,1,228
35013000123,898,722,439,252,7,21,9,0,283
35025000034,968,726,173,515,20,13,14,0,553
35025000026,2673,1903,893,928,21,61,12,0,1010
35053000008,1547,1231,453,594,32,83,87,0,778
35053000022,125,97,49,36,4,5,5,1,48
35045000101,1049,744,174,245,1,336,2,1,570
35045000100,1226,861,297,236,1,324,9,1,564
35045000056,1631,1232,431,278,21,536,15,7,801
35053000004,458,351,89,238,6,24,3,1,262
35025000035,1575,1103,216,794,71,38,5,2,887
35017000020,967,838,486,303,8,42,11,4,352
35005000014,1637,1265,605,536,52,42,52,4,660
35005000015,664,483,279,181,17,10,3,2,204
35005000047,35,27,4,16,0,6,0,0,23
35006000023,207,157,2,8,0,152,0,0,155
35005000081,663,447,169,265,5,13,3,1,278
35005000062,1223,916,139,730,23,28,12,3,777
35005000073,746,547,253,285,5,10,1,1,294
35005000032,958,695,242,420,22,14,1,0,453
35005000024,787,597,180,380,11,30,4,0,417
35005000031,1616,1103,370,648,24,38,35,2,733
35015000026,1264,922,535,340,13,25,5,4,387
35045000049,1424,1042,561,207,8,242,38,0,481
35045000104,977,712,406,138,12,136,22,3,306
35045000012,664,521,0,1,0,521,0,0,521
35028000004,664,520,367,106,7,30,11,1,153
35031000010,1093,808,38,16,11,724,33,1,770
35031000061,315,226,0,0,1,225,1,0,226
35007000014,309,264,158,99,3,11,2,3,106
35031000046,918,703,263,231,19,180,30,1,440
35057000016,622,522,259,225,10,28,4,1,263
35029000008,2334,1644,313,1274,16,33,33,2,1331
35001000202,1113,893,464,339,31,28,38,1,429
35001000114,1087,860,452,335,13,51,27,2,408
35001000605,726,549,211,267,9,29,43,3,338
35001000260,844,656,147,480,6,29,10,1,509
35001000091,1143,866,211,622,5,13,19,0,655
35001000410,1302,1140,671,363,27,77,10,6,469
35001000466,846,703,353,255,22,30,51,2,350
35051000003,351,306,220,67,3,33,2,0,86
35001000065,1499,1155,183,929,25,42,8,3,972
35001000248,1498,1215,433,378,107,235,82,1,782
35001000173,1186,890,294,433,35,97,60,6,596
35001000078,727,545,286,186,23,39,29,2,259
35001000556,732,590,450,110,8,21,2,1,140
35001000555,767,633,477,94,8,33,13,0,156
35001000573,584,448,287,127,11,20,2,2,161
35049000135,1653,1299,320,838,51,103,25,0,979
35049000066,1049,811,103,682,7,32,5,1,708
35049000136,953,708,177,489,12,38,5,1,531
35049000038,1386,1194,607,470,20,63,41,11,587
35049000108,1173,921,273,546,21,45,41,0,648
35049000096,957,830,471,293,15,44,23,2,359
35049000029,815,677,378,252,14,14,17,4,299
35049000072,841,766,652,64,16,21,8,1,114
35049000114,832,736,543,146,12,34,7,2,193
35031000030,2182,1624,18,23,3,1594,5,2,1606
35049000054,1031,911,588,189,25,48,67,0,323
35049000103,999,892,610,203,16,35,49,0,282
35015000008,1223,830,504,280,10,17,11,2,326
35055000011,630,559,316,211,1,16,12,1,243
35028000013,824,641,525,41,3,19,44,2,116
35028000012,801,569,471,50,5,12,24,0,98
35028000011,1270,953,668,167,13,30,74,2,285
35028000010,1361,990,670,173,10,15,119,1,320
35028000016,1093,823,584,144,10,16,58,1,239
35001000426,745,578,434,90,6,19,34,0,144
35001000584,539,399,272,91,5,17,26,0,127
35001000505,803,651,361,226,15,49,19,2,290
35001000367,1173,786,57,662,17,47,27,9,729
35001000060,1402,1045,83,914,20,48,14,1,962
35001000148,1198,867,95,688,57,45,8,1,772
35001000484,1116,935,566,228,48,86,24,3,369
35001000465,1563,1396,775,447,83,70,32,2,621
35001000197,1201,959,273,589,19,71,43,2,686
35001000608,715,568,418,109,7,13,25,1,150
35001000541,986,767,515,157,13,21,53,4,252
35001000501,829,639,423,128,6,8,71,4,216
35001000572,608,492,296,173,12,18,6,2,196
35001000021,1424,1128,486,507,60,81,17,5,642
35001000209,1243,994,427,447,39,71,28,0,567
35001000324,2001,1502,505,735,43,96,149,3,997
35001000319,1840,1495,635,500,113,95,184,13,860
35001000364,496,408,295,67,6,17,31,1,113
35001000365,1006,830,490,217,33,38,72,6,340
35001000262,1646,1227,135,1063,5,46,3,0,1092
35001000135,1200,982,168,719,36,104,18,5,814
35001000551,581,446,120,301,3,29,5,3,326
35001000552,944,774,567,152,7,29,5,0,207
35001000314,873,739,384,227,32,69,45,0,355
35001000594,1321,948,569,215,20,29,123,3,379
35001000447,1131,875,564,181,15,15,86,0,311
35001000479,791,619,404,124,8,14,62,2,215
35051000006,399,361,280,57,6,15,7,2,81
35049000056,1172,920,480,340,21,50,40,8,440
35049000105,1076,843,390,364,14,36,34,3,453
35049000133,808,582,174,349,6,29,42,2,408
35049000067,1399,1050,197,784,40,39,14,3,853
35049000138,1242,871,179,638,15,34,16,5,692
35049000137,905,636,133,468,13,48,7,0,503
35049000045,614,542,417,101,2,22,7,2,125
35001000121,1339,1145,706,306,32,82,35,5,439
35001000170,1829,1297,443,676,58,108,50,6,854
35001000087,1105,827,314,394,50,60,32,4,513
35001000261,1043,762,254,407,46,58,15,4,508
35001000176,1463,1158,533,444,59,92,61,7,625
35001000276,539,455,259,178,1,10,11,0,196
35001000150,583,491,352,120,5,10,3,0,139
35001000184,829,731,443,232,13,38,13,3,288
35001000558,851,661,489,131,12,19,13,0,172
35001000570,415,357,278,57,10,17,3,0,79
35001000242,886,798,396,233,41,87,73,1,402
35001000216,912,836,413,275,37,81,61,4,423
35001000543,891,706,260,330,39,61,24,0,446
35001000277,875,741,254,449,14,42,7,0,487
35001000177,2144,1689,855,608,65,135,43,3,834
35001000019,947,749,443,236,31,25,25,4,306
35001000041,1491,1031,130,810,48,81,8,1,901
35001000237,1656,1199,117,996,48,61,19,0,1082
35001000053,1294,955,100,814,20,52,2,0,855
35001000080,2120,1538,608,685,98,135,54,4,930
35001000230,908,711,295,343,25,39,24,1,416
35001000384,972,871,538,194,39,79,35,1,333
35009000040,1052,810,550,175,35,38,25,4,260
35009000019,889,666,447,141,33,18,26,3,219
35009000014,1196,875,512,285,50,19,20,0,363
35001000210,1005,813,344,397,21,38,24,4,469
35001000125,742,653,374,208,25,43,16,1,279
35001000595,988,840,648,157,3,29,8,1,192
35001000578,743,646,440,147,9,49,12,1,206
35001000553,1082,870,646,157,14,30,21,4,224
35001000511,1046,782,453,224,33,61,32,5,329
35001000253,1255,1124,600,286,44,119,87,6,524
35001000044,1302,866,38,804,2,41,12,2,828
35001000240,2003,1556,245,1260,24,67,5,0,1311
35001000005,930,776,407,343,8,28,9,2,369
35037000005,1066,902,703,173,3,20,0,2,199
35001000293,741,606,238,266,33,54,27,1,368
35001000335,1848,1446,536,582,132,215,34,4,910
35001000344,1065,946,555,263,35,72,30,2,391
35001000338,1337,1157,589,376,43,110,66,3,568
35001000444,687,601,253,296,12,34,22,3,348
35001000550,925,797,454,235,39,41,44,5,343
35001000455,1813,1473,692,546,32,116,119,5,781
35001000369,1406,1071,478,451,33,54,76,5,593
35001000218,1227,983,446,423,25,55,63,3,537
35039000039,2163,1683,403,1223,3,65,14,3,1280
35039000003,1246,1023,125,826,3,76,17,0,898
35039000022,106,83,9,72,2,2,0,0,74
35035000050,1423,1291,722,290,169,30,74,4,569
35013000052,2500,2085,738,1030,143,128,120,13,1347
35013000094,1537,1081,304,672,59,51,22,2,777
35013000086,1336,1088,412,653,7,52,4,3,676
35013000124,1200,937,284,623,8,26,15,2,653
35013000009,1218,828,14,798,11,29,0,3,814
35009000029,1394,1037,393,494,94,43,41,5,644
35061000012,1549,1194,435,670,32,61,20,2,759
35045000081,762,562,311,154,7,93,8,0,251
35035000025,1015,798,490,198,51,32,40,1,308
35035000006,219,189,168,10,0,10,0,0,21
35035000033,1098,868,429,361,46,38,8,4,439
35045000070,1450,1068,511,318,9,246,3,2,557
35045000054,2065,1507,622,559,19,324,1,0,885
35045000028,1059,767,469,148,27,128,9,3,298
35043000006,721,581,170,364,16,42,0,2,411
35017000022,1583,1232,414,761,14,47,21,3,818
35013000113,981,806,468,263,25,14,42,2,338
35013000069,1284,1086,467,537,48,55,26,3,619
35013000029,891,649,110,518,13,20,5,1,539
35013000024,1951,1429,369,1008,31,56,13,1,1060
35013000147,1680,1246,288,896,23,60,19,2,958
35013000038,1859,1461,603,773,54,39,14,0,858
35013000026,1064,777,273,438,29,38,19,1,504
35013000060,694,454,35,410,3,19,1,2,419
35013000020,2107,1567,404,1100,25,54,20,1,1163
35039000028,105,87,28,53,0,4,1,0,59
35013000057,879,731,403,297,7,35,4,2,328
35013000141,940,813,548,148,29,15,75,4,265
35013000102,754,646,314,269,16,35,15,3,332
35006000002,323,266,21,221,2,27,2,2,245
35043000112,879,743,463,210,27,44,14,1,280
35043000123,1165,853,439,304,39,63,25,1,414
35043000066,1584,1108,424,513,39,105,35,8,684
35043000122,1031,778,349,342,29,53,38,5,429
35043000058,1088,833,474,264,17,55,29,2,359
35043000116,855,676,400,221,17,35,16,1,276
35015000010,2064,1545,378,944,142,78,26,3,1167
35047000027,1468,1146,185,910,13,46,10,4,961
35047000009,423,345,168,166,3,6,4,3,177
35001000013,978,748,453,244,10,32,11,3,295
35001000518,1358,1038,622,270,34,35,80,5,416
35001000526,966,819,611,154,12,35,14,2,208
35001000500,1105,904,625,225,11,39,24,0,279
35049000091,589,529,437,72,3,5,11,2,92
35049000010,748,688,561,85,10,9,15,1,127
35049000131,586,543,435,76,7,14,9,2,108
35049000023,1189,980,321,525,5,169,11,1,659
35015000015,1391,1035,386,600,29,25,10,4,649
35043000015,965,744,1,1,5,739,4,0,743
35043000077,1026,736,1,8,1,735,1,0,735
35028000003,782,598,434,126,10,23,21,2,164
35028000002,887,674,562,67,1,6,22,0,112
35003000004,355,320,224,80,5,7,6,1,96
35047000001,693,586,172,380,17,39,0,1,414
35033000005,399,345,76,252,6,17,4,3,269
35043000032,821,656,343,241,21,52,10,3,313
35043000002,1059,792,133,592,10,76,4,0,659
35043000088,1356,1056,122,830,7,110,7,2,934
35043000003,1036,821,185,527,22,104,13,0,636
35043000092,1041,899,631,213,10,30,13,1,268
35043000011,747,634,438,151,8,23,17,1,196
35043000061,1296,996,502,420,23,37,17,5,494
35033000002,697,572,82,483,9,18,3,1,490
35033000001,700,603,93,499,3,14,3,0,510
35049000017,479,438,324,81,3,27,9,1,114
35049000153,952,887,631,188,10,31,25,3,256
35049000082,737,719,656,34,3,11,10,1,63
35049000090,685,627,462,138,3,13,16,1,165
35049000060,662,518,111,364,3,51,5,2,407
35033000006,219,186,38,144,3,15,2,1,148
35057000013,1573,1252,670,471,25,71,18,7,582
35049000150,961,787,390,351,9,27,14,1,397
35049000014,501,414,122,249,19,22,6,3,292
35049000088,975,796,315,431,0,37,8,2,481
35049000126,2237,1845,307,1392,71,101,11,4,1538
35049000002,474,383,85,276,2,20,3,0,298
35049000115,909,722,545,130,7,31,11,3,177
35049000073,1065,866,612,189,5,34,21,2,254
35049000040,690,487,44,62,5,395,6,1,443
35037000008,630,477,242,203,10,21,10,5,235
35001000317,805,661,330,223,30,66,33,4,331
35001000047,719,563,88,430,9,33,9,2,475
35001000222,1027,772,331,311,62,37,51,8,441
35001000201,1147,906,469,345,32,50,22,6,437
35001000381,578,526,370,94,15,34,16,1,156
35001000076,1015,776,167,572,19,22,15,1,609
35001000611,1071,793,350,329,47,69,26,5,443
35001000228,1399,956,426,384,59,62,30,1,530
35001000115,1758,1197,521,538,44,87,41,4,676
35001000612,1192,841,343,387,20,64,50,2,498
35001000227,1498,1024,429,441,41,67,45,7,595
35001000193,905,681,209,417,16,41,15,1,472
35001000194,1516,1232,388,769,25,68,11,0,844
35039000014,913,738,77,650,3,9,3,0,661
35039000015,383,321,20,298,0,3,0,0,301
35055000015,928,830,486,273,11,54,15,2,344
35055000040,1009,821,271,462,17,67,22,1,550
35055000010,656,529,321,191,2,6,3,0,208
35015000028,954,667,466,162,13,14,16,2,201
35015000048,1117,842,511,260,12,27,32,0,331
35001000119,1606,1228,300,742,76,83,60,1,928
35001000156,853,693,216,401,26,42,12,5,477
35001000607,989,777,211,462,33,78,10,4,566
35001000196,1047,821,162,539,39,82,7,3,659
35001000482,869,740,501,175,20,18,25,3,239
35001000516,913,748,431,223,29,50,43,13,317
35001000389,1060,910,464,306,46,80,44,0,446
35039000009,762,611,61,501,10,42,5,1,550
35001000486,548,460,305,118,10,10,23,0,155
35001000398,670,543,359,127,9,28,20,2,184
35001000355,627,524,374,102,13,19,21,0,150
35043000007,631,488,76,366,2,54,8,3,412
35049000021,1062,918,564,253,9,33,47,0,354
35049000095,1157,1067,780,190,18,25,41,1,287
35049000025,981,883,414,393,22,49,28,1,469
35001000077,1521,1185,193,962,11,26,6,5,992
35001000354,598,494,340,107,15,28,19,0,154
35001000341,674,569,347,137,12,38,33,4,222
35001000374,589,479,299,134,13,35,19,0,180
35001000533,797,656,333,229,30,66,19,2,323
35001000311,955,807,335,285,56,107,54,2,472
35001000162,1497,1223,461,642,47,123,15,0,762
35001000575,901,790,654,81,11,21,28,1,136
35001000203,811,658,303,252,36,41,42,3,355
35001000082,876,682,370,246,16,16,19,3,312
35001000050,2146,1536,234,1144,76,106,35,5,1302
35001000215,634,585,288,177,24,43,68,0,297
35001000535,933,744,313,333,26,50,22,6,431
35001000499,915,760,388,295,29,50,14,3,372
35001000435,1469,1171,438,501,68,157,41,0,733
35001000038,1695,1149,166,811,63,107,35,4,983
35001000199,1125,870,105,713,11,41,10,2,765
35009000027,592,423,113,261,38,12,3,0,310
35045000038,1756,1284,663,237,21,348,27,1,621
35009000011,2346,1708,858,632,113,55,50,7,850
35009000022,1067,768,226,464,54,22,9,1,542
35009000012,1758,1275,570,562,96,48,23,9,705
35025000030,887,604,315,244,24,18,7,0,289
35061000045,993,801,272,483,4,48,11,2,529
35061000032,1005,763,266,450,19,35,5,1,497
35006000013,752,628,160,380,14,89,7,2,468
35045000047,867,636,457,82,10,70,11,1,179
35061000048,1242,988,496,449,23,24,5,1,492
35035000036,1812,1367,734,410,121,41,81,8,633
35025000018,1026,770,316,402,25,23,11,2,454
35005000009,1695,1286,800,378,16,44,39,0,486
35005000003,1153,789,395,316,25,24,34,2,394
35005000091,1530,1012,337,611,32,34,14,2,675
35005000093,1786,1236,440,694,43,53,18,0,796
35005000042,1139,816,227,571,10,26,4,0,589
35013000033,1122,872,329,511,29,31,7,0,543
35013000002,1210,829,95,718,10,22,1,0,734
35013000097,1724,1252,80,1159,10,27,6,0,1172
35013000170,2345,1708,32,1674,7,16,4,1,1676
35013000044,1002,779,124,596,22,51,10,3,655
35013000037,725,632,302,289,14,46,6,1,330
35053000003,1683,1448,681,543,46,79,107,9,767
35013000068,1265,921,277,552,47,48,40,1,644
35053000010,422,296,26,239,3,25,9,2,270
35005000020,715,560,327,196,9,22,19,0,233
35005000021,1184,898,552,267,27,25,20,1,346
35017000010,323,284,176,97,1,8,1,0,108
35005000008,1270,999,591,338,15,16,33,6,408
35005000005,1022,760,447,264,11,27,22,1,313
35005000084,1596,1119,447,622,31,27,5,1,672
35017000021,202,190,112,61,4,8,4,0,78
35017000017,467,376,250,114,1,7,3,1,126
35017000006,42,40,25,11,0,1,2,0,15
35017000007,557,500,423,58,5,12,2,0,77
35005000007,1165,845,536,275,14,31,3,2,309
35006000012,653,484,192,184,16,79,16,5,292
35045000023,1422,1026,429,87,11,503,13,5,597
35055000039,994,845,372,425,8,46,8,1,473
35055000012,1125,968,561,355,3,43,11,1,407
35055000024,339,274,25,240,0,14,1,0,249
35055000029,220,191,53,133,1,17,0,0,138
35055000031,64,48,8,37,0,4,0,0,40
35005000017,859,702,511,158,5,20,11,0,191
35005000011,599,461,325,95,2,10,22,0,136
35005000004,997,749,371,328,15,29,19,1,378
35007000015,603,476,301,159,5,25,2,1,175
35001000590,1376,1006,522,293,26,43,130,3,484
35001000458,916,652,295,105,18,22,212,2,357
35001000423,1204,877,404,228,24,26,197,7,473
35001000361,962,769,526,139,8,10,89,0,243
35001000598,563,435,324,55,10,12,39,0,111
35001000362,606,472,344,79,4,16,26,0,128
35001000429,860,710,512,119,23,10,38,0,198
35001000490,1028,861,554,190,29,67,41,3,307
35001000090,2314,1701,209,1433,28,62,7,0,1492
35027000024,985,796,460,261,11,61,23,0,336
35027000009,877,723,492,187,8,26,11,0,231
35001000068,1389,1118,457,517,36,95,30,0,661
35001000175,1087,850,371,379,46,64,12,6,479
35049000061,1275,1003,198,646,14,172,11,0,805
35049000141,1102,748,118,590,7,49,13,1,630
35049000075,1170,871,163,648,15,51,31,1,708
35049000116,2299,1715,319,1258,32,61,52,4,1396
35028000017,1188,1012,645,135,27,34,151,1,367
35028000009,785,678,457,139,19,16,41,0,221
35001000333,821,702,428,196,31,28,31,0,274
35001000334,669,574,432,89,22,6,21,0,142
35001000016,1073,851,360,437,12,52,12,4,491
35001000559,1055,880,656,160,11,29,10,0,224
35001000576,860,687,553,95,4,19,15,2,134
35001000542,1135,871,367,372,50,99,23,10,504
35001000473,729,583,245,252,35,45,13,7,338
35001000246,1546,1074,216,614,96,127,71,2,858
35001000523,959,769,440,219,24,56,42,4,329
35049000087,656,494,38,194,3,320,3,6,456
35001000430,1045,769,533,164,14,41,35,3,236
35001000291,1152,876,375,380,29,95,40,1,501
35001000593,751,640,454,124,9,13,40,3,186
35001000427,935,696,418,149,9,12,111,2,278
35001000468,984,767,476,189,10,18,75,1,291
35001000110,1271,1061,485,412,36,113,30,2,576
35001000307,766,651,417,144,22,23,50,4,234
35001000356,591,495,331,111,6,28,22,0,164
35001000582,593,485,316,131,6,42,2,0,169
35001000123,1010,902,455,352,27,76,23,4,447
35001000188,455,403,167,198,8,42,6,1,236
35001000185,1017,878,507,299,20,40,19,4,371
35001000198,1219,925,89,750,45,67,25,5,836
35001000285,1307,1014,308,509,70,125,32,6,706
35001000413,1897,1646,857,560,53,129,87,7,789
35001000457,1107,828,482,188,20,27,102,4,346
35001000592,1237,926,601,178,9,15,127,2,325
35001000424,924,732,420,154,25,25,118,2,312
35001000298,2074,1531,659,549,130,132,109,4,872
35039000031,874,734,153,566,3,32,2,0,581
35039000032,514,414,79,314,2,22,4,0,335
35039000011,1198,985,211,721,6,73,12,1,774
35039000044,1107,896,251,617,6,38,1,1,645
35039000017,306,236,81,134,9,14,5,0,155
35013000092,512,418,59,334,3,23,10,0,359
35013000036,576,445,80,340,10,38,0,4,365
35009000017,1457,1123,713,241,89,38,47,8,410
35061000011,943,755,446,254,4,64,2,0,309
35045000121,910,654,99,51,8,507,6,1,555
35045000037,1026,728,411,138,10,165,3,2,317
35035000032,1044,827,418,284,61,47,36,1,409
35035000052,1596,1188,835,203,78,38,43,2,353
35035000029,1074,873,548,214,61,22,27,7,325
35061000013,880,663,26,56,10,599,3,3,637
35061000009,1010,796,429,310,2,66,3,0,367
35045000034,1133,873,360,144,14,342,26,1,513
35061000002,1031,818,170,579,14,57,16,4,648
35045000040,1530,1127,532,250,21,327,11,5,595
35031000064,1455,1075,9,10,3,1058,1,2,1066
35031000027,1008,729,20,6,0,703,5,0,709
35013000104,573,477,308,135,8,21,15,0,169
35013000081,445,372,101,254,3,19,6,0,271
35047000025,575,482,140,327,6,15,4,1,342
35001000498,1614,1245,544,381,92,218,40,2,701
35043000042,1791,1302,584,522,55,136,46,11,718
35043000070,2167,1552,599,807,34,106,30,7,953
35015000045,878,723,499,158,20,28,25,2,224
35015000046,857,606,345,228,7,20,4,2,261
35015000005,1163,818,467,288,16,26,7,1,351
35031000032,709,533,69,97,7,361,18,2,464
35049000048,911,798,574,181,9,30,15,3,224
35049000100,742,681,519,66,24,12,56,1,162
35049000132,568,521,356,132,7,18,10,1,165
35007000021,827,661,306,336,2,38,1,0,355
35049000020,637,548,358,147,11,11,19,0,190
35049000121,617,535,290,217,7,21,4,0,245
35001000561,712,586,360,145,47,31,17,1,226
35001000395,904,734,440,217,29,45,15,3,294
35001000235,1909,1630,579,653,57,257,123,4,1051
35049000042,881,758,395,292,20,47,30,2,363
35049000142,613,582,495,69,4,8,5,0,87
35049000143,538,466,213,211,10,31,15,0,253
35049000144,646,558,242,281,3,27,9,2,316
35049000078,835,693,361,267,4,40,23,4,332
35049000084,1151,909,655,188,21,52,9,1,254
35027000010,678,493,254,189,4,44,8,0,239
35001000152,827,687,356,302,10,17,11,0,331
35001000506,753,607,357,154,30,63,18,3,250
35049000058,2135,1625,220,1288,14,78,48,2,1405
35001000187,1221,1020,397,574,14,57,6,0,623
35001000283,974,726,195,398,43,77,29,7,531
35049000127,371,343,265,61,9,5,3,0,78
35049000047,547,501,389,76,9,10,9,0,112
35043000017,377,320,151,125,2,33,4,0,169
35049000055,995,888,728,134,0,5,12,0,160
35049000104,956,824,626,138,8,27,26,2,198
35001000288,611,488,139,327,7,20,11,1,349
35001000097,1151,894,243,626,11,38,1,0,651
35001000122,523,462,222,175,19,40,20,0,240
35001000371,980,786,492,177,26,59,50,1,294
35001000107,893,764,341,293,61,51,41,3,423
35001000061,1387,1054,150,859,8,84,7,3,904
35001000035,1164,922,129,729,30,70,8,1,793
35001000083,736,593,285,255,33,43,15,0,308
35001000249,1621,1377,516,631,67,128,76,3,861
35001000305,1677,1312,574,422,98,185,54,1,738
35001000037,1614,1318,260,976,33,86,17,2,1058
35001000343,728,609,412,139,9,17,28,0,197
35001000431,1025,857,355,380,43,79,25,4,502
35001000610,1466,1058,486,411,65,83,38,7,572
35001000069,1275,932,389,378,65,78,37,7,543
35001000244,871,751,560,124,10,30,32,6,191
35001000441,833,701,261,310,30,95,25,0,440
35001000472,544,441,255,156,14,14,14,0,186
35001000226,704,584,87,415,55,46,21,2,497
35001000488,923,781,540,158,22,39,26,0,241
35009000005,1043,725,254,438,23,16,5,1,471
35045000032,927,650,221,70,8,336,24,0,429
35045000062,1358,1055,652,214,18,145,17,1,403
35009000013,1038,752,404,268,49,29,14,0,348
35006000010,1450,975,207,466,13,283,29,6,768
35045000002,1843,1269,27,17,0,1220,16,1,1242
35041000007,674,502,167,319,10,19,4,1,335
35061000018,1038,817,455,305,10,51,8,1,362
35041000011,810,582,359,185,12,18,0,1,223
35005000016,803,642,262,328,20,29,23,0,380
35013000031,824,698,304,349,15,33,7,2,394
35017000015,1339,1048,404,592,22,32,14,2,644
35023000002,666,514,73,423,3,17,6,0,441
35015000052,1755,1232,661,514,16,30,13,0,571
35015000044,1415,1012,351,607,24,51,15,0,661
35043000038,968,813,450,278,33,52,12,5,363
35043000102,683,570,365,166,21,21,8,2,205
35055000027,529,439,84,327,0,30,4,0,355
35031000047,1100,812,29,182,32,615,18,14,783
35001000497,872,695,470,164,19,27,21,2,225
35031000059,440,348,115,93,11,122,22,0,233
35027000008,1530,1239,868,251,3,91,31,4,371
35001000571,709,608,435,138,8,20,0,0,173
35001000579,1027,862,641,186,4,31,4,0,221
35001000320,1129,886,371,272,15,45,204,6,515
35001000328,1704,1327,477,513,69,113,203,2,850
35001000360,672,582,420,110,4,10,44,0,162
35001000568,819,658,474,117,12,15,28,0,184
35007000012,360,300,146,150,0,6,2,0,154
35028000019,704,558,429,84,7,19,24,1,129
35028000020,529,402,295,64,3,19,21,1,107
35001000496,683,548,377,120,7,25,23,2,171
35001000524,541,412,272,88,14,14,27,0,140
35001000409,1476,1275,412,478,102,262,74,7,863
35001000359,830,695,365,220,32,71,36,5,330
35049000059,1660,1278,377,828,8,99,9,0,901
35001000546,963,815,509,238,16,55,24,2,306
35001000527,376,285,210,43,1,3,24,6,75
35001000284,984,785,291,348,70,52,45,4,494
35001000271,805,695,459,165,31,48,8,0,236
35001000022,1485,1200,521,588,42,71,18,1,679
35001000124,809,743,297,345,36,66,19,1,446
35001000383,867,800,430,250,35,58,36,2,370
35001000353,397,366,221,105,10,25,8,1,145
35001000397,633,487,311,127,14,17,21,7,176
35001000454,698,559,332,131,22,37,41,3,227
35001000514,1272,1018,552,309,42,74,50,1,466
35001000495,1568,1205,560,367,123,139,40,7,645
35001000312,1025,849,352,330,52,92,39,3,497
35001000540,1517,1219,694,375,55,71,53,3,525
35013000072,771,655,260,345,23,25,13,1,395
35009000037,1455,1145,823,172,65,24,40,2,322
35061000061,820,687,285,362,3,33,14,0,402
35061000005,1292,963,339,544,18,72,13,0,624
35045000033,1531,1150,495,193,22,435,14,3,655
35045000048,1364,991,692,172,4,115,16,0,299
35035000037,891,727,397,254,39,28,27,13,330
35035000023,860,637,329,224,44,30,19,0,308
35005000082,975,701,241,420,34,29,3,3,460
35041000016,387,305,156,132,3,5,5,1,149
35043000041,1107,894,521,305,22,47,24,0,373
35043000106,801,603,366,197,17,28,8,5,237
35013000025,748,580,199,345,6,44,10,0,381
35005000035,1111,765,308,386,24,43,10,1,457
35013000032,383,302,72,215,5,20,2,2,230
35013000028,2063,1442,167,1184,51,85,13,5,1275
35001000388,850,717,396,221,17,26,53,0,321
35001000513,508,386,226,108,15,21,16,5,160
35001000366,890,773,351,250,35,97,47,3,422
35001000453,1533,1367,772,374,44,134,51,1,595
35049000050,1195,1012,492,457,17,61,11,5,520
35049000154,1325,1020,179,806,6,61,9,1,841
35049000062,1134,898,167,713,5,31,6,1,731
35049000009,739,675,480,152,2,26,7,0,195
35057000014,151,97,75,19,1,3,0,0,22
35055000038,824,722,352,319,7,22,9,0,370
35001000464,684,556,303,208,11,38,20,1,253
35001000280,1539,1316,427,526,171,216,47,3,889
35001000275,1395,1166,387,480,126,205,17,2,779
35001000407,1135,954,545,304,37,53,26,3,409
35001000512,1296,1035,612,257,51,42,66,4,423
35049000063,1099,966,713,156,13,35,32,3,253
35039000010,1257,984,174,753,12,51,15,0,810
35001000461,766,602,274,213,28,52,40,1,328
35001000462,691,512,233,171,22,50,55,0,279
35001000438,1390,919,239,365,100,187,88,5,680
35001000581,2145,1509,415,692,135,246,63,2,1094
35001000256,840,685,418,172,36,42,23,3,267
35001000401,931,750,344,313,27,38,49,2,406
35001000180,492,403,261,105,8,15,12,0,142
35001000347,1996,1518,486,634,120,253,69,1,1032
35001000373,849,693,294,310,36,59,14,3,399
35001000580,775,620,390,171,12,21,25,6,230
35001000186,1444,1186,302,731,41,93,36,10,884
35045000041,1212,900,698,123,16,61,17,0,202
35006000011,1527,1122,294,597,19,189,32,6,828
35009000007,1701,1129,231,676,209,36,21,1,898
35006000003,139,118,15,103,0,3,0,0,103
35035000039,1077,842,489,227,58,38,27,8,353
35025000051,1204,861,169,597,46,22,38,0,692
35013000110,902,765,574,146,12,19,18,1,191
35013000153,687,596,455,113,6,7,12,1,141
35013000109,751,632,346,230,16,31,24,2,286
35013000125,2035,1352,430,844,49,32,25,12,922
35013000126,1539,1085,354,674,33,49,21,3,731
35013000090,1328,1001,312,614,29,43,25,1,689
35045000042,1154,844,559,162,10,101,9,2,285
35005000033,921,626,197,394,15,17,0,0,429
35043000060,1448,1056,470,420,78,80,32,7,586
35028000014,1045,786,597,119,8,15,41,1,189
35055000025,280,213,42,162,1,9,0,1,171
35007000020,717,572,134,430,5,27,1,0,438
35001000404,885,697,428,217,19,34,14,6,269
35001000402,833,698,416,219,35,34,18,0,282
35001000195,973,772,192,511,23,49,15,1,580
35001000108,481,389,271,109,2,12,4,0,118
35001000304,645,561,365,117,14,18,52,1,196
35001000446,705,599,303,238,21,29,21,0,296
35001000583,715,580,391,126,20,19,23,1,189
35001000563,581,477,330,95,28,31,12,1,147
35001000403,661,540,240,232,21,38,17,4,300
35001000532,1023,794,440,264,35,39,19,2,354
35001000168,1027,817,191,544,28,64,11,7,626
35001000026,1159,920,302,516,32,85,20,0,618
35001000024,866,715,305,342,26,43,18,3,410
35061000010,1207,952,387,515,13,48,7,1,565
35045000046,1405,1045,626,165,19,245,6,2,419
35017000003,68,62,48,11,2,3,0,0,14
35013000161,1749,1330,260,1024,27,26,10,1,1070
35013000075,1781,1299,254,1009,9,17,4,3,1045
35013000049,1036,799,209,512,27,49,27,2,590
35053000017,218,165,53,89,3,23,3,2,112
35053000018,1091,827,246,517,9,47,7,1,581
35013000027,1303,1007,204,752,38,40,7,5,803
35005000090,916,706,216,436,35,22,13,2,490
35001000515,704,565,375,144,17,25,18,0,190
35043000034,1105,937,602,210,39,82,27,0,335
35049000041,1561,1157,266,779,22,90,26,1,891
35033000003,419,336,87,242,2,26,1,0,249
35001000070,1456,1000,226,580,56,102,62,7,774
35001000105,788,625,48,551,22,24,1,1,577
35001000433,753,631,197,372,13,71,14,1,434
35001000432,1616,1341,498,621,60,158,45,5,843
35001000476,1074,877,436,341,27,70,26,0,441
35001000027,2058,1720,497,911,98,196,74,4,1223
35001000382,536,468,321,103,6,17,25,1,147
35001000352,631,553,416,91,2,10,24,1,137
35001000491,756,632,356,179,29,32,39,0,276
35001000204,1230,976,377,509,39,48,22,4,599
35001000112,916,747,348,331,18,42,29,1,399
35001000437,607,512,208,216,21,63,11,0,304
35001000342,398,367,207,108,10,27,28,0,160
35001000166,537,473,252,152,26,35,10,1,221
35013000085,1227,920,330,547,8,43,9,3,590
35043000043,1501,1173,527,520,64,55,34,15,646
35007000018,230,192,64,116,3,17,2,0,128
35001000489,1390,1156,627,386,34,74,48,3,529
35028000006,850,680,482,127,5,19,51,0,198
35001000287,1199,971,268,534,49,118,36,3,703
35001000400,712,613,340,181,28,44,26,2,273
35001000281,1265,1031,317,425,101,202,21,2,714
35001000223,584,534,249,157,23,54,57,0,285
35001000206,1132,900,339,499,27,36,11,1,561
35001000609,692,539,220,270,30,31,10,0,319
35001000340,1182,904,144,718,21,39,9,0,760
35001000073,1107,844,203,597,22,39,8,2,641
35001000051,1767,1248,92,1035,66,72,7,5,1156
35001000332,1158,934,457,365,50,47,45,2,477
35001000331,1468,1100,426,429,68,175,22,0,674
35045000024,834,609,291,79,9,236,7,1,318
35045000043,1378,992,446,199,20,336,12,3,546
35045000029,982,760,388,119,10,244,10,2,372
35031000040,669,511,108,117,9,248,33,1,403
35005000043,1145,827,223,578,10,43,4,1,604
35001000300,921,742,356,261,34,77,19,2,386
35043000094,785,710,492,158,20,39,21,1,218
35043000097,1056,852,453,304,16,47,31,0,399
35043000031,940,777,406,286,24,51,30,1,371
35043000040,1005,800,351,375,20,63,27,1,449
35043000105,731,546,234,233,26,44,9,1,312
35055000016,1123,953,520,331,22,78,14,3,433
35049000024,1123,1001,476,458,25,45,19,1,525
35001000601,1308,1120,658,360,28,39,46,3,462
35001000504,750,614,306,252,22,41,8,2,308
35049000026,640,587,317,214,17,37,7,5,270
35001000182,732,606,178,370,16,38,8,0,428
35001000445,783,638,253,283,33,69,36,5,385
35001000028,1863,1388,343,814,84,164,32,5,1045
35001000294,921,789,578,150,19,19,29,1,211
35009000024,1983,1506,922,384,105,52,53,3,584
35009000042,1046,733,311,338,39,25,30,1,422
35053000023,165,131,45,73,5,23,2,1,86
35001000245,792,628,354,191,45,41,26,2,274
35001000133,947,819,215,466,41,108,17,2,604
35001000254,928,780,498,180,41,44,17,1,282
35007000011,297,235,110,113,3,9,3,0,125
35049000046,544,475,342,81,3,12,29,4,133
35001000066,1337,1056,205,791,17,59,12,0,851
35013000098,810,655,338,294,8,12,6,1,317
35043000010,438,390,269,48,5,65,0,0,121
35043000046,1761,1331,594,601,35,104,35,12,737
35049000097,748,629,366,208,10,18,26,0,263
35049000032,1106,970,426,480,9,30,19,1,544
35049000006,436,303,4,11,0,292,0,1,299
35007000013,199,147,90,51,0,5,2,0,57
35001000315,811,688,315,246,31,64,56,2,373
35043000048,1205,976,487,379,46,57,32,6,489
35001000416,691,546,256,208,38,49,9,4,290
35001000493,631,503,330,116,18,28,19,2,173
35001000517,921,757,459,202,19,35,40,3,298
35001000529,1736,1498,791,385,85,155,101,2,707
35001000368,421,339,235,79,3,8,16,1,104
35001000295,992,837,496,244,28,51,43,0,341
35001000297,2115,1608,655,644,101,184,67,2,953
35001000014,1576,1258,433,715,31,80,21,5,825
35001000520,636,513,335,117,12,26,27,0,178
35001000390,658,537,402,76,8,19,32,1,135
35001000272,602,516,364,96,8,38,14,1,152
35013000070,863,698,283,352,18,23,36,2,415
35049000076,1247,1063,513,483,14,64,23,2,550
35001000480,1280,1076,677,224,49,87,54,2,399
35001000192,826,671,206,406,11,54,9,0,465
35001000351,403,355,251,89,9,16,10,0,104
35001000534,1254,989,508,357,41,60,53,0,481
35001000483,1053,870,486,228,40,94,25,3,384
35001000380,491,387,249,94,13,14,26,1,138
35001000510,1336,1180,615,422,31,66,57,2,565
35035000034,957,713,419,218,41,16,21,7,294
35001000549,1420,1200,657,342,62,101,65,7,543
35001000436,764,621,260,288,28,35,24,0,361
35001000544,1495,1261,621,459,61,76,72,2,640
35001000531,1443,1145,529,354,78,154,31,4,616
35001000405,1209,993,461,356,50,117,42,5,532
35061000034,581,446,208,202,10,27,1,0,238
35001000386,510,432,298,90,12,25,7,0,134
35001000345,934,859,308,338,40,150,33,0,551
35001000440,686,528,222,202,59,55,44,2,306
35001000418,1731,1529,863,402,70,78,113,1,666
35053000007,219,185,57,115,1,8,5,1,128
35013000091,931,702,186,482,14,44,10,0,516
35001000322,716,565,201,282,27,69,19,2,364
35001000450,657,539,374,96,9,22,43,1,165
35001000255,1719,1338,521,570,98,174,52,5,817
35001000564,587,470,362,62,5,14,29,1,108
35001000243,1018,955,474,273,58,95,73,2,481
35013000046,818,601,155,417,21,21,5,2,446
35001000113,1098,891,444,384,16,39,25,0,447
35013000050,647,503,169,292,22,21,17,1,334
35001000522,611,505,315,140,17,7,28,2,190
35001000494,701,581,333,192,15,24,24,0,248
35001000481,1099,893,367,301,63,158,38,2,526
35001000064,773,577,112,440,10,7,15,0,465
35001000387,617,526,357,112,11,29,21,0,169
35001000528,425,345,248,62,14,12,17,0,97
35001000565,1140,958,590,212,48,110,22,2,368
35001000102,785,648,230,272,69,76,42,3,418
35049000028,576,555,458,59,6,12,12,2,97
35001000075,646,508,63,420,8,18,13,0,445
35001000301,945,807,501,186,25,37,70,4,306
35001000225,327,267,55,186,13,20,2,0,212
35001000357,479,418,268,97,21,20,22,1,150
35001000191,793,660,211,400,18,53,9,0,449
35001000299,711,564,319,175,32,23,16,1,245
35001000348,786,673,421,157,18,42,40,4,252
35001000536,650,494,247,192,19,32,19,1,247
35001000296,1291,976,419,408,62,98,35,11,557
35031000042,336,270,94,42,8,89,42,0,176
35001000547,1157,906,452,342,58,58,24,8,454
35001000509,521,419,240,130,19,18,10,1,179
35001000439,2341,1936,786,708,113,266,60,1,1150
35001000449,539,484,356,61,16,31,19,1,128
35001000376,1494,1253,680,312,46,124,106,0,573
35001000308,653,541,389,110,9,22,16,0,152
35001000406,548,458,234,156,22,36,24,0,224
35043000051,0,0,0,0,0,0,0,0,0
35001000290,491,424,319,64,15,15,30,0,105
35001000451,974,851,450,269,56,42,47,2,401
35001000330,1592,1200,427,460,136,215,4,1,773
