GEOID,TOTAL_POP,TOTAL_VAP,WHITE_VAP,HISPANIC_VAP,BLACK_VAP,NATIVE_VAP,ASIAN_VAP,PACIFIC_VAP,MINORITY_VAP
55099004857,797,712,673,10,4,6,10,2,39
55099004862,488,427,405,2,0,6,3,0,22
55099004865,220,173,168,0,1,0,0,0,5
55099004863,172,129,128,0,0,0,1,0,1
55099004858,163,129,126,0,0,1,1,1,3
55099004859,308,253,241,6,0,5,1,0,12
55099004889,481,389,382,0,1,1,3,0,7
55099004884,563,425,393,8,0,17,3,0,32
55099004872,727,609,591,8,3,3,1,0,18
55099004882,499,366,331,6,5,5,6,10,35
55099004887,544,457,444,1,0,5,0,2,13
55099004880,423,338,304,12,0,12,4,1,34
55099004870,441,407,395,1,0,4,1,0,12
55099004871,665,559,540,5,0,9,3,1,19
55099004856,184,165,150,1,0,10,0,0,15
55099004855,441,370,355,1,0,8,0,1,15
55135006989,384,302,280,12,0,5,4,0,22
55135006943,642,486,438,25,6,15,1,0,48
55135006990,516,420,393,15,5,5,2,1,27
55135006963,675,531,504,4,1,8,5,0,27
55017000595,902,704,625,24,4,12,32,1,79
55017000593,544,394,357,9,2,14,9,0,37
55017000580,882,678,624,8,3,12,23,0,54
55017000588,911,738,684,8,3,11,10,2,54
55017000587,1403,1083,1009,11,8,19,26,0,74
55127006278,587,489,432,31,2,6,6,0,57
55127006268,90,68,51,16,0,0,0,0,17
55127006277,1936,1518,1235,178,51,13,47,1,283
55127006271,1465,1257,980,163,55,34,29,2,277
55127006276,862,609,485,97,5,18,8,0,124
55127006218,1471,1107,950,113,12,15,12,0,157
55127006204,308,224,182,35,1,4,1,0,42
55127006219,702,479,404,37,6,9,11,0,75
55127006222,635,470,336,99,24,10,3,0,134
55127006233,600,473,337,109,3,15,7,1,136
55127006231,340,273,208,48,7,6,5,1,65
55127006174,482,368,313,43,0,8,3,0,55
55127006175,614,492,451,14,3,16,5,0,41
55127006176,805,659,620,20,3,10,4,0,39
55127006285,744,562,533,8,3,13,6,0,29
55127006151,2097,1992,1637,204,91,12,43,3,355
55127006150,467,399,367,13,5,1,6,0,32
55127006164,660,502,451,39,1,8,5,0,51
55127006283,835,693,660,11,3,6,3,0,33
55127006173,861,707,634,26,2,13,13,3,73
55127006159,711,566,465,64,8,22,2,2,101
55127006158,875,626,504,87,9,14,4,1,122
55127006289,939,747,696,24,6,7,6,0,51
55127006291,805,586,553,21,5,9,1,0,33
55127006288,975,756,713,29,9,8,0,0,43
55127006292,1239,985,888,41,14,25,8,0,97
55127006296,1041,808,607,169,11,15,5,2,201
55127006297,972,638,558,54,3,18,1,0,80
55127006241,589,408,361,37,0,5,3,0,47
55127006239,683,547,455,39,5,13,15,0,92
55127006242,0,0,0,0,0,0,0,0,0
55127006211,1027,842,590,180,14,9,31,2,252
55127006181,426,360,352,2,2,2,4,0,8
55135006931,318,253,250,1,0,0,2,0,3
55135006968,678,468,455,5,0,3,2,0,13
55135006962,923,721,636,40,15,11,3,2,85
55135006947,944,726,656,21,2,24,5,0,70
55135006985,867,727,693,15,4,5,7,0,34
55135006988,729,597,570,5,1,8,5,0,27
55135006930,727,696,660,13,8,14,3,0,36
55135006941,331,262,258,1,0,1,2,0,4
55135006940,447,349,336,7,0,2,3,0,13
55135006925,400,334,318,7,1,9,2,1,16
55135006984,1043,826,769,20,5,12,15,0,57
55135006998,550,455,434,9,1,6,0,0,21
55135008074,0,0,0,0,0,0,0,0,0
55099004878,549,407,377,2,0,10,3,14,30
55099004877,532,449,424,5,4,9,3,4,25
55135006936,735,526,468,21,5,14,8,0,58
55135006911,693,571,492,30,8,20,8,1,79
55099004861,261,238,227,0,0,1,6,0,11
55099004860,644,552,519,3,1,23,2,0,33
55099004886,292,251,244,1,2,7,2,0,7
55099004873,690,538,472,7,3,10,11,30,66
55099004875,170,150,138,4,0,4,2,1,12
55099004874,394,313,285,2,2,11,3,10,28
55125006134,624,567,556,6,0,2,0,0,11
55125006124,528,480,458,4,0,6,2,0,22
55125006121,944,858,822,9,2,20,4,2,36
55067002994,726,626,599,3,3,8,7,2,27
55067002991,253,221,209,1,0,1,0,0,12
55067003020,907,725,692,8,0,18,5,0,33
55067003006,813,628,587,8,6,18,1,0,41
55067003011,890,702,674,8,2,10,7,3,28
55067003005,467,385,374,3,1,5,0,0,11
55067003023,1123,864,789,19,9,37,7,0,75
55067003009,854,729,677,13,1,26,5,2,52
55135006982,505,422,401,9,3,1,0,0,21
55135006916,321,280,269,2,0,5,1,0,11
55135006927,306,257,242,3,0,2,3,0,15
55135006906,689,575,546,15,3,5,0,0,29
55135006996,567,449,415,19,3,6,2,0,34
55135006919,681,553,518,20,1,6,0,0,35
55135006918,826,662,627,21,0,12,1,0,35
55135006956,462,348,326,14,0,4,0,0,22
55135006908,442,327,301,21,1,1,0,0,26
55135006924,774,579,542,26,1,6,1,0,37
55135006979,371,284,277,1,0,4,0,0,7
55135007001,271,211,203,5,0,0,2,1,8
55135006967,435,341,319,8,1,10,0,0,22
55135006969,851,675,638,18,2,15,0,0,37
55135006952,0,0,0,0,0,0,0,0,0
55135006991,841,715,695,2,1,13,1,1,20
55135006994,598,454,410,17,0,14,2,1,44
55135006987,621,482,472,2,4,3,1,0,10
55135007002,650,589,558,11,2,6,13,0,31
55135006973,654,539,511,7,3,11,3,0,28
55135006974,595,455,441,3,1,4,0,0,14
55135006960,487,380,360,8,3,11,1,0,20
55135006959,461,359,335,16,0,6,1,0,24
55009000383,2108,1750,1528,102,32,37,47,3,222
55009000309,902,693,603,29,11,17,30,3,90
55009000382,1950,1552,1395,59,25,38,28,0,157
55009000385,2117,1618,1449,53,24,33,41,1,169
55009000206,2051,1520,908,448,67,63,60,5,612
55009000254,2130,1516,729,558,55,87,137,0,787
55027001487,588,449,430,11,3,3,1,0,19
55027001565,660,539,517,18,2,7,0,0,22
55067002988,91,77,73,0,2,0,0,0,4
55067002995,143,120,118,0,0,2,0,0,2
55067003022,914,710,674,6,4,22,1,0,36
55125006123,805,732,705,12,3,8,5,0,27
55125006127,497,443,416,0,4,12,3,0,27
55125006126,643,556,502,12,0,24,11,0,54
55125006119,436,343,329,3,1,2,3,0,14
55125006116,827,634,238,13,13,377,0,2,396
55125006108,1055,931,899,10,4,16,6,4,32
55009000282,957,700,658,38,1,4,0,0,42
55141007305,1526,1180,1072,37,16,25,30,4,108
55141007304,1306,1094,1012,34,13,17,18,1,82
55141007296,1407,1107,998,23,13,17,45,0,109
55141007302,937,683,574,21,15,11,59,0,109
55141007289,1098,838,761,20,11,6,33,2,77
55141007356,980,831,746,26,18,14,26,0,85
55141007264,790,603,585,9,1,7,1,0,18
55141007349,1870,1403,1219,61,29,43,46,2,184
55141007372,524,394,356,10,9,10,9,1,38
55141007283,152,122,117,4,2,0,0,0,5
55141007324,230,196,185,3,3,0,2,0,11
55053002396,177,153,145,3,2,4,1,0,8
55053002390,155,116,109,1,0,7,0,0,7
55141007303,1208,951,879,17,13,6,36,1,72
55141007348,513,410,387,2,1,9,7,0,23
55141007284,819,643,599,10,7,8,15,0,44
55141007268,181,127,107,5,0,13,1,0,20
55141007341,674,529,481,7,0,28,9,2,48
55141007360,567,449,383,12,18,8,22,0,66
55141007371,1818,1375,1208,62,26,44,30,0,167
55141007373,660,494,440,27,10,6,9,0,54
55027001547,675,540,511,17,3,5,6,0,29
55027001548,342,294,263,19,4,6,1,0,31
55027001514,562,473,456,7,2,3,3,0,17
55027001601,912,746,722,7,8,6,1,0,24
55027001559,289,232,225,4,2,1,0,0,7
55027001515,329,283,264,11,0,5,2,0,19
55027001516,251,206,195,6,0,3,0,1,11
55009000269,2404,1925,1724,62,9,31,86,1,201
55009000218,1376,1098,975,30,13,27,46,0,123
55009000247,1790,1431,1282,65,8,25,38,1,149
55009000333,727,596,590,4,0,1,0,0,6
55009000239,838,619,609,4,1,1,0,0,10
55099004866,366,283,273,1,1,4,0,0,10
55099004864,189,156,150,0,0,1,1,0,6
55141007338,844,700,635,28,6,19,7,1,65
55141007339,807,640,594,21,6,13,0,1,46
55141007262,322,235,225,2,1,3,0,3,10
55141007261,224,152,152,0,0,0,0,0,0
55141007362,356,289,252,11,1,6,19,2,37
55141007359,917,748,648,33,7,21,38,2,100
55141007363,580,459,391,14,18,11,24,0,68
55125006130,635,551,466,5,0,80,0,1,85
55125006137,599,482,271,7,1,201,1,0,211
55125006143,537,446,437,4,1,5,0,0,9
55125006141,523,434,396,10,3,19,4,3,38
55125006138,105,71,63,5,0,1,2,0,8
55027001602,445,341,319,13,2,4,2,0,22
55027001518,571,450,421,7,0,6,4,0,29
55027001519,530,406,364,16,3,18,5,1,42
55009000234,2636,2068,1188,618,124,73,94,2,880
55009000387,1388,1074,916,69,27,28,18,1,158
55009000341,1128,779,711,24,20,7,12,0,68
55009000324,875,591,519,51,3,1,7,0,72
55009000348,1146,860,808,30,6,11,4,1,52
55085004221,380,307,285,2,3,6,2,0,22
55085004263,485,399,384,6,2,5,4,0,15
55085004239,610,504,486,4,1,6,0,0,18
55085004270,425,359,352,3,0,0,2,0,7
55085004259,1038,904,882,7,0,15,0,0,22
55085004278,783,656,610,8,0,16,7,1,46
55085004245,321,282,266,2,6,2,2,0,16
55085004258,469,399,386,2,0,4,4,0,13
55085004246,900,756,729,9,0,16,0,0,27
55085004255,139,118,113,0,0,3,0,0,5
55085004233,808,665,649,3,0,6,6,0,16
55085004249,1011,854,823,11,3,13,2,0,31
55085004226,914,802,731,10,35,18,7,0,71
55125006103,300,263,238,8,1,10,1,0,25
55125006133,987,872,822,8,3,10,3,0,50
55125006125,303,256,250,4,2,2,2,0,6
55125006122,250,235,227,4,0,3,1,1,8
55125006135,939,850,819,7,1,14,4,1,31
55027001525,792,627,606,6,5,8,1,0,21
55027001460,932,744,705,11,4,12,5,0,39
55027001480,881,731,674,29,1,7,13,0,57
55027001463,1544,1216,997,129,53,16,10,2,219
55027001481,989,791,683,73,8,14,8,0,108
55027001471,1071,845,740,55,22,24,14,3,105
55027001464,1546,1249,1056,146,17,13,11,0,193
55027001588,922,774,751,7,0,12,0,0,23
55027001589,373,285,267,15,1,4,2,0,18
55027001501,756,633,610,10,0,9,3,0,23
55033001739,248,196,194,1,0,0,0,1,2
55033001752,147,115,114,0,1,0,0,0,1
55033001750,603,451,429,5,6,6,4,0,22
55033001778,1372,1285,1105,45,39,16,78,0,180
55033001786,1600,1505,1337,43,51,28,53,1,168
55033001779,1354,1082,974,13,17,20,53,0,108
55127006207,875,688,494,186,0,7,0,0,194
55127006161,793,608,463,111,1,16,9,1,145
55127006162,780,594,452,110,17,11,1,2,142
55127006212,963,725,534,175,4,11,5,1,191
55127006209,624,497,401,80,2,9,10,2,96
55127006298,1111,877,804,23,14,13,6,1,73
55127006258,38,34,27,6,0,2,2,0,7
55127006224,788,596,367,205,5,23,7,0,229
55127006208,738,615,556,39,6,9,2,0,59
55127006195,818,656,606,22,9,8,4,0,50
55127006194,637,491,461,19,4,6,0,0,30
55127006193,609,517,496,11,4,3,3,0,21
55127006237,964,724,612,85,2,18,4,1,112
55127006236,1022,761,674,57,3,11,3,2,87
55127006185,473,373,350,16,0,1,0,0,23
55127006183,946,735,708,17,0,3,7,0,27
55127006184,620,495,459,18,3,9,3,0,36
55127006295,378,309,295,8,1,0,4,1,14
55127006186,1008,883,815,34,6,10,13,0,68
55127006188,450,383,365,7,1,3,3,0,18
55127006187,677,556,511,27,6,8,12,1,45
55127006189,761,596,500,60,2,12,9,0,96
55127006294,1185,869,669,154,15,24,15,0,200
55127006263,405,337,318,13,2,2,1,0,19
55127006262,590,450,422,14,2,7,1,0,28
55127006251,351,290,275,5,0,3,1,0,15
55127006261,0,0,0,0,0,0,0,0,0
55127006264,345,282,252,17,4,1,3,0,30
55127006163,560,437,402,14,1,9,4,0,35
55127006265,975,703,591,91,6,9,8,0,112
55127006156,902,751,643,86,11,16,9,0,108
55127006240,733,560,505,41,5,3,4,0,55
55127006192,641,511,426,41,4,12,16,2,85
55127006160,222,136,121,4,2,2,3,0,15
55127006293,806,654,620,19,1,2,6,0,34
55027001557,938,732,696,16,2,11,5,0,36
55085004243,717,637,587,7,2,19,9,0,50
55085004280,260,216,208,2,0,4,2,0,8
55085004257,993,850,813,8,2,16,5,1,37
55085004252,832,705,680,6,0,8,2,0,25
55085004273,875,744,707,6,1,17,10,0,37
55085004276,909,759,722,11,1,10,9,0,37
55085004272,950,804,767,15,1,9,7,1,37
55033001743,1484,1160,1080,20,4,18,22,3,80
55033001790,751,617,582,11,4,11,6,0,35
55033001774,408,331,317,3,0,6,3,0,14
55033001781,1582,1241,1064,31,24,36,83,1,177
55033001784,1279,1206,1041,43,33,23,56,2,165
55033001780,1540,1306,1139,21,32,36,62,2,167
55033001756,209,157,155,1,1,2,0,0,2
55033001787,478,371,352,2,2,7,3,1,19
55033001770,460,347,324,6,3,8,1,1,23
55033001769,504,384,377,1,1,1,0,2,7
55085004275,734,610,560,11,4,25,8,0,50
55085004274,833,640,567,15,14,30,13,1,73
55009000220,2357,1931,1297,201,202,159,86,3,634
55009000198,2457,1725,929,492,127,107,78,1,796
55009000310,2067,1565,1177,129,124,100,40,0,388
55009000330,2808,1877,804,684,176,143,98,1,1073
55009000320,1457,988,425,368,117,62,31,2,563
55009000281,1146,863,658,91,47,49,19,1,205
55009000394,1421,1166,989,71,18,50,42,2,177
55009000210,1320,1126,1004,20,24,26,56,1,122
55009000284,1633,1378,1174,60,40,46,52,2,204
55009000197,1543,1228,1127,19,12,51,15,3,101
55009000323,11,8,0,7,1,1,0,0,8
55009000253,2063,1716,1497,59,39,76,31,4,219
55009000292,819,587,488,73,3,27,2,0,99
55009000318,613,486,473,6,0,7,0,0,13
55009000205,732,551,491,36,1,17,7,0,60
55017000611,946,732,699,11,3,4,2,1,33
55017000609,994,828,803,8,1,8,4,1,25
55017000608,914,723,699,5,3,6,5,2,24
55017000604,2069,1537,1440,17,9,33,20,2,97
55037001942,183,153,137,4,0,5,3,0,16
55037001938,26,22,22,0,0,0,0,0,0
55037001944,429,344,327,4,2,11,0,1,17
55037001950,407,371,356,4,0,3,0,2,15
55037001941,371,313,305,3,2,1,1,0,8
55085004282,886,743,725,2,7,4,1,0,18
55085004269,193,154,154,0,0,0,0,0,0
55085004238,144,119,114,3,0,1,1,0,5
55085004267,996,814,779,6,3,18,2,0,35
55085004261,388,337,323,4,0,3,3,3,14
55085004240,897,732,680,11,7,19,8,2,52
55085004241,931,773,739,8,3,12,2,0,34
55085004271,732,610,573,2,0,22,4,0,37
55085004237,923,726,671,5,2,26,9,0,55
55085004253,617,518,497,6,3,14,0,0,21
55125006118,636,520,482,10,4,14,3,1,38
55125006109,682,568,536,4,1,19,5,0,32
55009000335,892,687,621,28,7,21,12,0,66
55009000258,1433,1078,1015,11,6,23,11,1,63
55009000349,1633,1224,1086,59,16,42,23,1,138
55009000267,1622,1235,1070,43,25,54,29,1,165
55009000396,1947,1504,1427,21,6,26,13,0,77
55009000215,1987,1479,1406,20,6,14,16,0,73
55027001466,844,619,544,53,10,7,6,1,75
55027001473,961,729,577,97,25,10,7,2,152
55027001465,1353,1025,897,75,17,14,10,2,128
55027001593,659,520,479,21,4,13,8,0,41
55027001510,715,550,500,31,4,8,6,0,50
55027001517,0,0,0,0,0,0,0,0,0
55019000699,826,513,500,5,2,2,1,0,13
55037001948,66,57,55,1,0,0,1,0,2
55085004260,467,402,387,3,0,4,3,0,15
55085004242,890,724,709,1,1,6,8,0,15
55085004247,200,153,146,1,3,3,1,0,7
55015000484,1094,826,777,26,3,8,7,1,49
55015000520,556,416,399,9,0,5,4,0,17
55015000497,993,742,641,71,3,22,3,1,101
55015003031,0,0,0,0,0,0,0,0,0
55015000498,782,562,542,5,1,7,0,0,20
55015000468,703,572,560,6,0,5,0,0,12
55027001530,753,554,507,22,8,12,4,0,47
55027001529,1158,936,818,64,18,23,9,0,118
55009000367,1988,1514,1166,89,92,89,88,0,348
55009000311,1576,1238,1117,22,24,50,33,2,121
55009000314,1427,1070,959,25,20,22,41,0,111
55009000262,1152,899,801,39,26,22,9,1,98
55009000236,1274,1000,895,35,19,28,17,1,105
55009000347,382,336,329,1,1,3,3,0,7
55027001459,782,577,548,11,2,2,7,0,29
55027001462,365,297,275,11,1,5,0,0,22
55027001599,28,25,25,0,0,0,0,0,0
55027001491,519,444,333,9,91,4,2,0,111
55027001604,376,296,263,20,0,8,1,0,33
55009000213,808,555,499,18,9,8,12,2,56
55009000204,1574,1006,928,16,15,19,20,0,78
55009000212,262,191,136,13,14,11,12,0,55
55009000201,1226,916,841,21,5,4,34,0,75
55009000306,617,395,366,11,2,7,11,0,29
55009000298,1391,1052,862,90,30,26,55,0,190
55009000217,1553,1148,801,196,22,49,83,1,347
55009000244,3005,2271,1861,204,63,63,100,2,410
55009000243,1295,999,941,25,6,14,15,1,58
55009000196,1833,1346,1245,29,16,29,26,0,101
55009000264,1102,854,747,52,8,20,30,3,107
55009000203,2057,1666,1251,138,71,112,115,8,415
55009000293,2883,2155,1608,242,91,154,80,7,547
55125006111,343,314,299,7,1,3,5,0,15
55125006112,725,612,582,8,1,13,1,1,30
55027001544,579,440,415,14,1,7,3,1,25
55027001592,310,248,234,4,2,3,4,0,14
55027001539,752,603,521,48,9,12,6,0,82
55027001591,223,180,176,1,0,2,0,0,4
55009000261,2921,2188,1826,164,34,67,91,4,362
55009000265,1871,1483,1210,137,20,27,77,0,273
55009000327,3946,3121,2725,159,68,53,103,10,396
55009000363,1544,1228,1097,29,7,19,65,0,131
55009000273,988,736,663,4,6,21,41,0,73
55009000377,693,544,487,8,9,13,30,0,57
55009000374,266,223,200,3,2,8,12,1,23
55009000351,932,723,672,10,16,19,10,0,51
55009000263,1083,835,805,10,0,2,10,0,30
55009000223,3028,2255,1944,74,45,146,44,1,311
55009000207,830,626,496,24,18,70,29,3,130
55009000277,3093,2344,1575,163,101,506,43,1,769
55015000506,813,606,516,56,5,17,1,6,90
55015000508,860,686,646,24,5,1,8,1,40
55015000472,104,91,82,1,1,2,5,0,9
55015000471,631,511,501,4,1,3,1,1,10
55015000499,759,599,547,34,3,11,2,1,52
55015000496,728,573,521,30,0,9,4,0,52
55075003380,753,577,559,6,1,7,2,0,18
55075003377,411,339,296,14,4,6,10,0,43
55075003393,1454,1104,953,67,18,49,10,2,151
55075003392,1327,1057,934,49,22,30,19,3,123
55075003399,1488,1175,1088,37,7,29,9,1,87
55045002206,1144,897,788,64,18,19,9,0,109
55045002218,1105,910,826,56,5,15,11,1,84
55045002219,1270,957,877,38,5,23,7,2,80
55045002216,1232,997,946,20,6,11,11,0,51
55045002224,1077,818,710,83,3,11,7,1,108
55093004617,830,651,625,9,3,11,2,2,26
55093004615,724,551,509,25,1,5,8,1,42
55093004660,923,727,668,27,2,13,6,1,59
55093004623,805,658,604,16,7,17,8,1,54
55019000677,840,562,552,3,2,1,1,1,10
55019000711,0,0,0,0,0,0,0,0,0
55019000712,0,0,0,0,0,0,0,0,0
55019000680,398,314,299,4,4,4,1,0,15
55019000684,344,260,239,8,1,8,1,0,21
55019000652,738,465,448,7,1,5,4,0,17
55019000705,215,188,185,1,0,1,0,0,3
55075003431,1295,1180,1138,10,0,19,5,1,42
55075003432,418,364,358,1,0,3,2,0,6
55075003430,299,262,251,1,0,8,1,1,11
55045002254,842,659,631,18,1,2,5,2,28
55045002226,1265,1056,974,55,6,11,7,1,82
55075003407,1093,861,781,30,3,23,7,3,80
55075003410,427,327,317,2,0,7,2,0,10
55075003405,865,702,676,3,2,12,2,0,26
55075003401,680,529,500,7,1,5,4,0,29
55075003400,689,536,515,11,2,2,1,1,21
55075003379,362,275,270,1,0,1,2,0,5
55075003404,660,547,515,7,0,13,4,0,32
55075003403,493,395,329,54,1,9,0,0,66
55019000670,349,286,261,3,1,23,0,0,25
55053002406,18,15,13,1,0,1,0,0,2
55019000687,713,527,506,9,2,6,3,0,21
55019000668,381,273,257,8,3,3,0,0,16
55019000673,549,394,359,21,3,4,1,1,35
55019000690,295,199,192,7,0,0,0,0,7
55019000656,145,101,96,1,0,1,2,0,5
55019000674,663,393,385,3,1,3,1,0,8
55019000706,85,51,50,0,0,0,0,0,1
55019000666,247,194,164,15,0,15,2,0,30
55019000658,325,273,234,23,4,7,0,0,39
55019000701,280,229,198,24,4,4,2,0,31
55019000720,0,0,0,0,0,0,0,0,0
55019000675,522,360,288,65,8,1,2,0,72
55041002108,102,84,63,0,1,19,0,0,21
55041002099,113,86,56,1,0,28,1,0,30
55041002098,530,440,418,3,1,16,0,0,22
55137007056,431,363,313,33,0,14,1,0,50
55137007052,230,197,178,8,3,4,3,0,19
55137007042,619,496,471,6,2,3,3,0,25
55137007057,706,633,592,23,3,12,5,2,41
55137007059,996,833,802,8,1,9,6,1,31
55115005774,554,432,391,8,3,18,4,0,41
55115005806,269,231,216,7,1,7,0,0,15
55115005775,314,251,216,20,2,9,3,0,35
55115005770,495,409,369,5,2,28,3,1,40
55115005771,320,237,152,10,8,72,0,0,85
55089004572,351,283,236,13,8,7,20,0,47
55089004534,2225,1735,1487,58,99,28,59,2,248
55089004575,804,628,582,21,10,9,4,0,46
55089004542,1017,798,769,4,3,10,10,0,29
55089004556,1855,1396,1292,33,25,11,25,0,104
55089004541,1182,882,804,26,11,11,21,0,78
55089004524,937,777,735,16,3,12,11,0,42
55089004540,774,628,588,28,2,9,4,0,40
55089004502,312,273,247,14,6,0,4,0,26
55089004530,1659,1324,1242,42,14,17,5,2,82
55089004544,739,596,571,14,1,1,3,2,25
55089004583,1554,1255,1171,31,11,12,13,4,84
55033001785,1381,1233,1065,41,52,22,46,1,168
55033001782,1732,1368,1235,39,22,15,38,1,133
55089004545,1733,1299,1209,17,13,17,33,2,90
55089004492,1766,1520,1391,33,34,14,29,0,129
55033001768,326,236,221,2,2,6,0,1,15
55033001741,758,603,577,3,3,12,1,1,26
55033001771,985,696,636,7,6,9,35,0,60
55033001734,673,513,493,8,1,1,1,1,20
55033001755,1100,809,752,22,7,19,1,0,57
55033001738,498,393,377,2,0,7,5,0,16
55033001753,369,287,276,2,3,6,0,0,11
55033001737,258,198,192,1,2,4,0,0,6
55033001751,1611,1247,1190,7,3,8,38,0,57
55033001742,1670,1282,1196,9,3,23,39,0,86
55115005804,356,291,285,1,1,3,0,0,6
55115005809,0,0,0,0,0,0,0,0,0
55115005768,620,448,434,4,1,6,3,0,14
55115005769,8,7,5,2,0,0,0,0,2
55115005808,6,6,6,0,0,0,0,0,0
55115005764,774,607,575,10,2,20,4,0,32
55115005797,228,150,144,1,3,3,1,0,6
55137007022,568,396,381,12,0,2,0,0,15
55137007006,169,115,111,4,0,0,0,0,4
55129006318,88,82,78,0,0,2,2,0,4
55129006317,192,151,143,3,0,2,1,0,8
55129006311,245,229,221,1,0,4,0,1,8
55129006341,47,38,29,1,3,3,3,0,9
55129006312,396,373,362,2,0,9,0,0,11
55129006313,766,643,605,8,0,25,5,1,38
55129006319,142,120,118,0,0,1,0,0,2
55129006314,504,425,395,2,2,21,1,1,30
55049002345,436,340,334,4,1,2,0,0,6
55093004658,676,516,465,16,5,20,0,0,51
55093004610,1006,757,724,7,4,13,7,0,33
55033001773,234,192,173,7,3,6,1,1,19
55075003385,713,526,500,6,4,12,0,0,26
55075003397,320,251,237,7,0,7,1,0,14
55075003387,726,548,504,27,5,10,0,0,44
55045002251,524,383,348,17,2,12,2,1,35
55049002340,588,443,431,5,2,5,1,0,12
55049002302,611,490,463,14,3,2,7,1,27
55049002337,616,480,465,4,5,5,1,0,15
55049002342,391,301,285,6,3,5,1,0,16
55049002339,207,155,151,1,0,1,0,0,4
55049002335,206,162,156,2,0,2,1,0,6
55049002350,268,196,187,6,1,1,1,1,9
55049002357,218,197,192,4,0,2,0,0,5
55049002358,99,83,80,2,0,0,0,0,3
55049002307,1175,956,922,10,2,12,5,0,34
55079003868,1858,1203,291,735,152,42,14,1,912
55079003869,752,582,384,110,55,22,14,0,198
55079003670,1994,1363,242,937,146,95,37,2,1121
55079003667,2074,1445,317,844,262,51,35,6,1128
55079003782,2249,1459,173,61,1121,18,88,4,1286
55079003784,1011,744,135,43,549,4,25,2,609
55079003769,1157,742,85,37,543,9,73,2,657
55079003763,1340,1015,436,87,368,24,117,3,579
55079003786,2214,1591,171,55,1349,14,22,0,1420
55079003886,3178,2089,317,1518,192,95,66,8,1772
55079003881,551,337,55,255,22,0,4,0,282
55079003864,3083,2024,387,1501,96,157,28,0,1637
55079003778,2195,1605,144,57,1351,16,58,1,1461
55079003779,1042,833,59,33,731,10,12,2,774
55079003922,1532,940,327,185,113,8,309,0,613
55079003927,1528,1186,854,224,40,33,39,5,332
55079003531,1525,1148,874,151,66,21,44,2,274
55079003513,1249,927,663,145,86,31,8,2,264
55079003565,1707,1340,1073,88,59,34,81,1,267
55079003764,3411,2692,672,92,1831,27,89,1,2020
55079003896,2857,2286,1856,210,77,67,75,6,430
55079003858,2327,1765,1055,420,182,100,46,2,710
55079003860,2881,2355,2047,125,79,44,62,1,308
55079003728,1513,944,56,34,837,5,16,0,888
55079003729,1489,1047,52,26,958,23,2,0,995
55079003730,1393,930,45,32,840,10,17,0,885
55079003750,477,305,36,15,253,2,5,0,269
55079003625,2801,2005,182,84,1717,15,35,0,1823
55079003740,1142,738,93,30,588,8,32,0,645
55049002352,339,284,260,18,0,3,0,1,24
55049002353,72,56,53,0,0,2,1,0,3
55045002252,485,372,344,19,3,4,2,0,28
55045002253,819,624,609,2,2,6,0,0,15
55063002931,1221,938,899,14,8,11,5,0,39
55063002924,966,739,710,6,5,7,10,1,29
55063002840,1115,889,693,39,60,25,71,2,196
55063002871,1907,1406,1081,49,90,35,143,2,325
55063002872,2168,1683,1399,48,77,17,125,0,284
55063002873,2861,2482,2082,58,153,45,137,3,400
55063002854,3075,2548,2260,62,68,56,89,3,288
55063002861,748,622,582,12,11,7,5,1,40
55063002868,0,0,0,0,0,0,0,0,0
55125006102,710,624,592,1,3,22,4,1,32
55125006132,528,461,439,6,1,9,3,1,22
55125006113,326,264,154,6,4,106,1,0,110
55125006136,118,107,105,1,0,0,0,0,2
55085004251,705,605,583,3,2,3,0,0,22
55085004228,808,696,669,4,4,13,1,0,27
55085004232,602,521,504,3,2,6,0,0,17
55085004230,420,355,328,7,1,14,0,0,27
55085004250,723,629,613,5,1,7,1,0,16
55115005746,199,164,153,4,0,7,0,1,11
55115005793,208,146,141,3,0,5,0,0,5
55115005794,852,658,630,2,3,12,7,0,28
55115005761,762,558,525,7,3,6,10,0,33
55115005762,824,606,587,12,0,4,0,0,19
55115005750,530,424,260,13,0,152,1,0,164
55015000513,1209,888,730,52,26,20,58,0,158
55015000514,1789,1339,1195,44,15,16,71,2,144
55015000533,189,147,131,6,5,6,2,1,16
55015000489,2251,1678,1419,142,13,25,54,1,259
55015000527,9,6,1,1,0,2,2,0,5
55015000485,173,128,102,10,0,2,5,0,26
55015008001,0,0,0,0,0,0,0,0,0
55015000532,961,681,631,12,5,8,18,2,50
55015000503,404,295,274,5,6,4,6,0,21
55015000501,1058,747,718,9,2,9,9,0,29
55015000519,338,247,216,10,3,7,8,0,31
55015000518,524,408,362,15,7,7,17,0,46
55015000502,870,658,630,5,5,1,13,0,28
55015000483,487,414,397,7,3,2,6,0,17
55015000534,13,6,2,0,1,0,3,0,4
55015000493,348,284,272,4,0,4,0,1,12
55015000494,774,619,582,11,5,13,7,0,37
55105005348,1727,1284,864,164,193,43,33,1,420
55105005136,1821,1718,984,206,253,14,235,18,734
55105005343,1573,1115,387,354,349,45,2,0,728
55041002093,324,289,287,0,0,1,0,0,2
55041002103,325,310,303,1,1,6,0,0,7
55031001731,1424,1145,959,25,27,112,11,1,186
55031001729,628,502,426,13,26,30,3,0,76
55031001673,425,339,288,4,10,31,8,0,51
55031001728,1889,1452,1282,20,36,80,17,3,170
55031001695,656,532,503,4,1,15,1,0,29
55031001694,350,294,283,0,0,3,0,0,11
55137007024,745,615,538,64,4,7,2,0,77
55137007031,725,553,390,148,7,5,0,0,163
55137007048,919,738,699,13,3,16,1,2,39
55079003870,1974,1700,1288,233,79,36,56,4,412
55129006308,207,172,158,0,1,10,2,0,14
55129006307,127,113,104,2,0,6,1,0,9
55129006315,566,455,406,2,3,24,0,2,49
55079003621,2012,1436,173,63,1175,27,28,0,1263
55079003777,1710,1214,93,33,1067,15,25,2,1121
55079003857,2608,2066,1690,205,80,63,33,0,376
55079003776,1346,987,103,23,788,17,71,0,884
55079003713,2199,1644,360,107,905,19,284,5,1284
55079003712,2420,1779,615,78,804,41,293,1,1164
55079003538,1104,857,680,97,45,27,12,0,177
55079003477,1725,1488,1228,66,76,21,90,0,260
55079003986,2048,1820,1532,92,51,15,128,3,288
55119005942,208,175,173,0,1,1,0,0,2
55119005945,265,203,200,0,0,3,0,0,3
55119005960,232,178,174,0,0,4,0,0,4
55105005124,2981,2394,2171,75,46,27,42,3,223
55105005222,2578,2109,1914,69,57,30,28,0,195
55105005201,332,282,257,4,8,7,5,0,25
55105005176,2045,1609,1428,72,46,34,30,1,181
55041002084,152,137,130,4,0,1,0,2,7
55079003652,2939,2631,1763,478,222,61,124,3,868
55079003673,1759,1301,452,631,217,51,19,0,849
55079003657,2058,1360,136,1021,141,43,61,3,1224
55079003648,2751,1732,207,1268,184,81,93,0,1525
55137007029,1006,799,746,20,6,7,14,1,53
55137007027,656,524,488,27,0,8,0,1,36
55137007015,461,371,337,17,1,9,4,0,34
55137007060,418,318,300,4,1,8,3,0,18
55137007058,496,386,350,19,0,2,3,0,36
55137007053,924,655,480,162,4,5,5,0,175
55137007039,558,462,416,36,2,2,2,0,46
55137007037,393,319,282,27,0,5,0,0,37
55137007040,667,570,541,16,4,12,1,0,29
55137007055,384,302,280,5,3,3,3,0,22
55115005779,770,584,441,24,10,104,1,4,143
55137007013,434,349,303,17,3,18,4,1,46
55137007004,87,70,69,1,0,0,0,0,1
55115005757,413,335,305,4,2,15,11,0,30
55115005776,761,566,395,26,11,135,2,0,171
55137007043,180,150,144,3,0,4,0,0,6
55033001759,323,260,248,3,1,6,2,0,12
55033001758,251,199,186,7,3,4,6,0,13
55031001706,1076,857,757,22,26,38,10,1,100
55031001707,615,513,453,8,8,34,5,0,60
55031001685,681,521,482,1,4,21,3,1,39
55031001698,156,129,125,0,1,4,0,0,4
55031001697,874,722,680,1,0,28,3,0,42
55031001700,757,652,614,9,0,17,2,0,38
55015000505,816,591,478,99,1,12,0,0,113
55079003603,1825,1250,33,70,1113,14,38,2,1217
55079003722,2444,1680,322,50,1129,16,177,1,1358
55079003724,2246,1697,474,51,1096,28,63,2,1223
55119005963,498,417,402,2,1,7,1,1,15
55119005964,1234,930,910,13,1,1,3,2,20
55119005976,588,436,405,13,3,10,5,0,31
55119005969,530,400,387,5,0,3,3,0,13
55119005970,581,444,412,13,2,10,3,0,32
55119005973,547,459,420,29,1,3,7,0,39
55079003973,2545,2088,1678,179,116,36,78,3,410
55079003974,2720,2283,1648,205,169,62,213,1,635
55079003963,1911,1520,1242,141,70,32,37,1,278
55079003999,1213,865,696,37,8,2,109,1,169
55079003948,1951,1545,1335,72,28,10,79,1,210
55079003981,1844,1422,1149,77,38,15,138,0,273
55079003534,1431,1116,907,125,42,30,13,0,209
55079003535,1634,1230,912,190,69,44,19,0,318
55079003690,1448,1004,20,23,958,13,9,1,984
55079003701,493,367,6,13,340,3,5,1,361
55079003631,1857,1366,41,44,1266,31,10,1,1325
55079003623,1757,1357,334,61,945,24,17,2,1023
55079003755,1002,765,318,134,249,41,60,5,447
55079004041,1005,819,665,53,59,13,27,0,154
55079003902,2286,1669,917,534,144,70,36,4,752
55079003898,2201,1792,1189,373,160,65,33,6,603
55079003742,1167,777,215,47,473,9,38,0,562
55079003741,1117,686,74,31,559,10,14,2,612
55079003751,1043,683,81,43,547,12,24,0,602
55079003795,2439,1767,493,120,1111,19,47,1,1274
55079003803,1236,892,26,18,851,4,5,0,866
55119005959,723,539,506,16,3,7,1,0,33
55119005974,585,445,405,17,10,7,9,1,40
55119005957,563,422,395,7,2,7,5,4,27
55043002129,127,111,105,1,0,5,0,0,6
55043002147,402,321,318,1,0,2,0,0,3
55043002113,552,433,421,2,1,7,1,0,12
55043002149,575,467,443,4,2,9,4,1,24
55043002184,561,413,394,14,0,3,2,0,19
55043002191,1317,1043,949,29,32,6,21,0,94
55043002202,158,120,117,2,0,1,0,0,3
55043002201,118,92,82,8,1,0,0,0,10
55043002183,282,201,192,7,0,1,1,0,9
55043002133,624,521,499,8,2,3,2,0,22
55105005382,1230,992,748,63,116,26,34,0,244
55105005234,1494,1183,864,185,69,36,40,2,319
55105005233,443,366,302,33,16,9,7,1,64
55105005194,576,487,455,11,3,9,3,0,32
55105005196,441,348,332,3,1,8,3,0,16
55105005208,715,565,542,5,2,13,1,0,23
55105005356,0,0,0,0,0,0,0,0,0
55105005189,873,711,668,15,12,7,9,1,43
55105005207,0,0,0,0,0,0,0,0,0
55105005206,6,4,0,4,0,0,0,0,4
55105005304,708,588,562,21,3,4,0,0,26
55105005188,490,368,314,28,3,14,6,0,54
55105008078,0,0,0,0,0,0,0,0,0
55105005166,2241,1841,1464,94,168,61,50,3,377
55105005164,2807,2174,1943,97,54,24,39,7,231
55105005165,2720,2144,1816,133,119,40,24,1,328
55105005182,215,168,163,1,0,3,1,0,5
55105005205,630,523,455,21,18,15,5,1,68
55105005243,928,741,697,16,7,11,2,2,44
55105005198,392,318,297,8,2,10,2,0,21
55105005204,2065,1658,1294,143,139,26,54,1,364
55079003586,2463,1905,1441,191,109,22,152,4,464
55119005952,910,675,629,36,1,3,4,0,46
55119005956,677,507,487,11,1,0,0,1,20
55079003913,973,796,632,105,15,26,17,0,164
55079003919,1837,1443,1159,185,43,39,25,1,284
55079003711,2618,1957,572,91,1129,40,148,5,1385
55079003714,3757,2485,498,132,1595,39,254,1,1987
55079004036,1299,1026,791,66,117,15,36,0,235
55079003851,1884,1380,1278,19,35,9,31,2,102
55079003841,1965,1493,1036,96,179,29,142,1,457
55079003581,1907,1432,1168,99,39,27,97,1,264
55079003580,2012,1539,1341,104,28,11,48,0,198
55079003582,1682,1286,1026,118,45,17,77,0,260
55079003888,2288,1769,1139,417,129,59,53,6,630
55079003899,2641,2092,1460,372,160,83,51,5,632
55079003914,1344,1058,799,169,34,27,28,3,259
55079003918,1726,1390,1056,250,37,27,13,0,334
55079003920,1719,1381,976,206,90,58,73,2,405
55079003854,1630,1368,1137,64,39,22,98,4,231
55079003855,2146,1623,1488,38,34,19,39,0,135
55079003839,2327,2008,1666,63,123,34,105,2,342
55079004013,1673,1340,928,97,255,26,39,2,412
55079003852,2329,1801,1567,52,49,17,87,5,234
55079004016,1505,1195,880,108,129,43,38,6,315
55079003762,1889,1357,323,80,866,24,82,1,1034
55079003629,2887,1982,86,107,1804,39,17,3,1896
55079003821,692,602,467,19,72,0,34,1,135
55079003794,1114,915,725,37,123,6,23,0,190
55063002930,789,597,570,4,2,12,8,0,27
55063002934,478,369,353,5,2,1,5,1,16
55075003418,255,233,228,0,1,2,0,0,5
55075003429,514,471,445,5,1,8,2,0,26
55075003426,852,691,674,7,1,4,3,0,17
55075003422,610,477,460,5,0,7,0,0,17
55075003421,267,221,200,5,1,11,3,0,21
55045002228,747,613,573,6,3,14,3,1,40
55045002241,959,754,735,5,1,5,6,1,19
55045002242,434,314,285,5,3,16,2,0,29
55045002222,309,212,179,11,2,7,10,0,33
55045002243,525,396,375,9,2,7,2,0,21
55045002208,969,741,700,13,7,5,4,1,41
55129006336,649,527,488,8,1,22,4,2,39
55133006594,851,672,612,20,12,0,21,1,60
55133006819,866,786,749,16,7,6,7,0,37
55133006606,859,734,655,31,12,15,20,0,79
55133006607,775,579,492,30,8,15,31,0,87
55133006691,988,772,716,20,10,8,7,3,56
55071003118,725,548,532,3,1,3,5,0,16
55071003119,575,490,466,10,1,6,3,0,24
55071003136,151,132,126,0,0,3,2,1,6
55071003123,795,613,573,17,3,6,5,0,40
55133006804,1740,1376,1119,161,45,34,27,1,257
55133006799,2059,1701,1376,174,68,19,54,4,325
55133006680,2403,1848,1214,429,137,43,25,0,634
55109005537,1083,821,745,18,15,21,22,0,76
55109005542,674,554,519,10,9,5,10,0,35
55109005554,982,683,648,7,3,8,9,0,35
55109005540,1027,744,707,7,5,13,1,1,37
55109005538,768,549,511,4,7,13,9,3,38
55109005539,694,506,463,16,7,8,4,3,43
55109005460,747,570,531,15,2,8,3,0,39
55109005530,831,636,590,23,0,7,5,0,46
55109005533,435,316,299,5,3,10,0,0,17
55109005453,993,760,700,6,3,14,20,0,60
55109005562,1146,814,773,13,3,15,4,0,41
55109005544,809,640,573,25,16,11,12,1,67
55109005461,500,396,366,17,2,4,0,0,30
55109005551,587,413,379,8,10,9,5,0,34
55109005573,5,1,0,0,1,0,0,0,1
55109005575,885,665,620,18,7,9,7,1,45
55109005568,21,16,9,5,0,0,2,0,7
55109005567,276,208,196,6,4,0,2,0,12
55109005471,839,651,616,9,7,12,5,0,35
55109005451,638,467,455,6,0,3,2,0,12
55109005547,752,588,557,1,2,14,5,0,31
55109005563,712,597,570,8,6,3,7,1,27
55109005546,554,433,407,4,3,8,6,1,26
55109005577,965,734,626,20,70,8,5,1,108
55109005553,830,609,563,8,4,18,7,0,46
55109005526,751,586,538,12,5,8,18,1,48
55109005556,1043,815,767,24,7,10,3,2,48
55109005558,623,469,456,4,1,1,2,0,13
55109005527,473,374,364,9,1,1,1,1,10
55133006758,2478,2027,1411,124,82,15,380,6,616
55133006654,2033,1686,1340,171,49,22,89,3,346
55133006624,696,547,457,18,14,9,51,0,90
55133006760,2694,2030,1790,105,49,14,51,2,240
55133006829,2784,1966,1716,81,40,11,111,0,250
55133006869,0,0,0,0,0,0,0,0,0
55133006684,3136,2407,2010,218,55,32,69,4,397
55133006868,718,577,518,32,8,10,9,0,59
55133006560,533,449,409,13,7,6,10,1,40
55133006845,909,732,688,10,11,5,9,0,44
55133006561,577,440,419,10,3,2,4,1,21
55133006605,509,357,336,5,2,7,6,0,21
55133006672,1059,858,819,9,4,5,12,3,39
55133006710,1512,1259,1188,22,13,10,18,0,71
55133006719,1952,1420,1209,34,35,27,106,0,211
55133006723,836,629,583,10,3,5,25,0,46
55055002470,705,539,442,66,13,12,7,0,97
55055002435,884,686,594,81,0,8,1,0,92
55055002473,867,697,666,8,3,1,6,3,31
55055002471,794,627,485,109,22,3,9,0,142
55083004175,1004,789,721,20,2,29,7,0,68
55083004205,854,646,586,21,2,33,4,1,60
55083004202,643,515,498,6,1,7,1,0,17
55083004170,618,470,449,5,1,6,8,0,21
55083004179,285,242,225,7,1,7,2,0,17
55083004176,892,715,670,10,4,20,4,0,45
55083004183,632,481,449,11,2,14,1,0,32
55083004182,886,716,692,2,3,14,0,0,24
55083004152,0,0,0,0,0,0,0,0,0
55055002461,659,486,441,15,4,19,9,0,45
55055002467,1044,772,649,84,9,12,8,2,123
55055002465,424,319,300,4,4,6,1,0,19
55055002466,456,342,326,4,2,5,5,1,16
55055002503,93,74,69,1,1,1,2,1,5
55055002521,716,586,552,27,6,4,1,0,34
55055002518,432,331,291,24,10,6,2,1,40
55055002454,330,278,253,8,1,8,2,0,25
55055002443,1658,1314,1120,131,24,30,10,2,194
55055002517,743,530,411,98,8,12,1,2,119
55055002516,340,265,192,51,9,10,2,0,73
55055002481,788,621,585,14,2,11,5,1,36
55055002480,2,0,0,0,0,0,0,0,0
55055002482,835,647,598,18,5,17,1,0,49
55049002315,932,738,703,14,1,10,1,1,35
55049002311,119,92,91,0,0,1,0,0,1
55049002314,105,85,77,1,0,0,4,0,8
55049002347,258,192,180,2,2,7,0,0,12
55085004266,793,639,592,15,5,20,11,0,47
55083004184,465,342,320,5,13,1,1,0,22
55083004186,628,486,444,11,7,17,6,0,42
55075003382,226,196,192,0,0,4,0,0,4
55075003381,525,450,420,6,0,10,5,1,30
55075003383,274,217,210,1,2,5,1,0,7
55071003127,1057,894,833,7,9,15,22,0,61
55071003128,1081,906,848,16,7,13,19,0,58
55071003113,634,509,497,5,2,1,0,0,12
55133006650,3515,2851,2536,121,45,17,88,1,315
55133006662,2243,1744,1492,78,45,10,92,4,252
55071003166,1904,1457,1142,116,108,43,42,2,315
55071003111,499,387,378,5,0,1,3,1,9
55071003135,600,477,467,6,0,2,2,1,10
55133006526,1151,850,817,13,1,4,7,0,33
55133006649,761,578,542,11,6,1,3,0,36
55133006789,3132,2523,2083,189,90,40,127,5,440
55079003474,1731,1406,1186,68,60,12,62,1,220
55079003861,2860,1905,261,1315,240,89,107,4,1644
55079003689,2311,1715,53,73,1594,37,11,0,1662
55031001687,593,460,437,1,2,16,1,0,23
55031001688,577,464,438,1,2,16,0,0,26
55049002355,553,438,418,4,2,8,4,2,20
55049002356,357,279,266,2,0,5,4,0,13
55049002306,62,48,38,7,1,3,2,0,10
55061002801,738,566,529,20,6,8,3,0,37
55061002798,964,754,723,14,3,5,2,0,31
55079003813,696,551,461,18,33,5,36,0,90
55079003822,45,39,26,0,2,1,5,0,13
55119005965,935,682,637,17,6,11,6,1,45
55119005967,523,399,373,15,3,2,3,0,26
55119005940,216,185,181,0,0,3,0,0,4
55079003814,1372,1180,790,65,218,15,100,1,390
55079003830,1000,782,638,37,56,20,35,0,144
55079003831,209,177,162,5,11,0,1,0,15
55079003617,2782,2736,1968,194,325,36,165,13,768
55079003611,4012,3852,3051,256,323,53,204,4,801
55079003685,1938,1262,106,57,1088,26,23,1,1156
55079003937,1672,1410,1193,126,30,17,36,1,217
55079003511,1850,1473,1177,146,86,32,26,2,296
55079003710,1734,1344,254,61,967,16,48,1,1090
55079003758,1814,1328,189,70,1026,17,42,0,1139
55079003939,1827,1492,1190,169,61,42,17,3,302
55079003748,2477,1893,368,305,1090,49,121,4,1525
55079003672,2508,1943,340,989,544,65,53,9,1603
55079003694,1170,1025,421,68,477,4,70,4,604
55079003700,2045,1496,537,232,677,46,19,4,959
55079003503,1495,1063,960,18,15,6,54,1,103
55079003699,1431,1063,723,63,141,14,123,0,340
55119005961,471,379,371,0,0,7,1,0,8
55091004600,594,472,445,8,2,7,1,0,27
55091004601,235,188,182,0,1,2,1,0,6
55031001681,340,296,276,2,0,8,1,0,20
55031001718,1486,1253,1036,30,59,112,20,3,217
55031001719,331,245,217,1,11,10,5,0,28
55031001730,735,583,501,11,13,27,28,0,82
55031001680,344,279,270,1,1,9,0,0,9
55031001679,714,571,536,6,3,20,2,0,35
55079003516,1099,904,785,55,16,10,33,0,119
55079003820,1069,919,717,31,128,13,35,4,202
55079003819,697,542,386,15,76,16,45,4,156
55079003801,1051,783,37,18,702,28,14,1,746
55091004593,66,57,50,5,0,0,3,0,7
55091004592,627,460,429,24,3,1,4,0,31
55129006310,311,264,246,7,1,7,0,0,18
55115005807,701,515,461,11,5,28,6,0,54
55115005799,527,410,391,0,0,13,2,0,19
55115005766,715,594,578,5,1,8,2,0,16
55115005763,374,310,297,3,3,5,0,0,13
55105005296,954,769,743,10,4,5,0,0,26
55105005318,291,236,233,3,0,1,0,0,3
55105005294,772,593,571,2,4,8,0,0,22
55105005150,913,724,674,14,13,8,8,0,50
55105005119,851,623,540,38,19,21,6,1,83
55105005379,903,636,589,23,0,7,9,1,47
55105005283,588,450,410,13,11,6,3,0,40
55105005381,309,254,243,5,0,4,2,0,11
55105005364,776,578,528,27,4,5,15,0,50
55105005281,0,0,0,0,0,0,0,0,0
55105005277,571,437,401,19,6,2,7,1,36
55105005377,388,300,274,17,5,2,1,0,26
55105005378,0,0,0,0,0,0,0,0,0
55105005135,742,588,541,18,8,10,2,0,47
55105005276,702,497,464,14,3,14,0,1,33
55105005321,811,619,588,14,1,5,2,0,31
55105005133,767,598,540,16,8,19,12,0,58
55105005282,8,4,0,4,0,0,0,0,4
55105005175,2952,2110,1470,227,246,88,92,5,640
55105005174,2860,2168,1745,146,154,51,62,0,423
55129006304,783,713,662,7,0,13,6,2,51
55129006305,201,152,146,1,0,3,0,0,6
55129006306,548,445,398,9,6,16,10,0,47
55039001977,321,249,235,4,0,5,3,0,14
55039001976,360,274,263,5,0,5,0,0,11
55039001975,652,499,485,5,2,3,4,0,14
55039002078,2694,2243,1946,139,63,30,37,3,297
55039002073,2055,1603,1419,81,41,35,22,1,184
55039002021,1865,1448,1278,59,50,38,16,3,170
55039002022,1680,1210,970,95,80,32,30,1,240
55029001660,357,282,258,15,5,6,0,0,24
55029001647,325,249,221,5,8,4,3,0,28
55029001618,671,610,587,12,1,8,1,0,23
55029001619,557,499,460,22,10,5,1,1,39
55029001612,434,397,369,20,1,1,3,0,28
55029001623,587,506,494,6,0,3,1,0,12
55029001622,758,689,666,7,1,4,4,1,23
55029001638,345,318,306,4,1,1,1,0,12
55078003470,758,502,17,8,4,484,2,3,485
55078003469,705,499,30,23,4,460,1,2,469
55078003471,918,552,20,12,3,527,3,1,532
55078003473,1036,790,315,24,11,462,0,0,475
55078003472,838,550,83,14,2,463,2,1,467
55075003396,795,677,642,9,4,12,4,0,35
55075003395,311,251,242,0,1,2,0,0,9
55075003373,836,677,629,18,5,26,1,0,48
55075003423,316,278,267,1,0,8,2,0,11
55075003420,289,219,200,10,5,7,0,0,19
55075003424,607,538,510,3,4,11,4,1,28
55007000181,823,764,736,1,0,15,1,0,28
55007000164,471,391,362,3,1,13,3,0,29
55007000179,315,274,260,2,0,4,2,0,14
55011000420,396,326,320,2,0,2,1,1,6
55011000414,320,277,251,13,2,10,0,1,26
55011000416,403,320,311,6,0,1,0,1,9
55011000423,254,217,207,4,0,2,0,0,10
55011000403,313,237,225,8,1,2,0,0,12
55011000415,574,463,444,8,4,4,3,0,19
55007000165,560,445,423,6,3,13,0,0,22
55115005780,765,574,413,16,3,135,4,1,161
55115005749,501,395,331,9,2,54,1,0,64
55115005803,238,186,157,3,0,20,1,0,29
55115005772,538,448,441,2,1,4,0,0,7
55115005773,708,554,511,10,3,24,4,0,43
55115005753,529,456,418,16,0,22,0,0,38
55049002313,1212,857,821,12,6,13,3,0,36
55049002312,445,347,343,1,0,0,0,0,4
55007000157,436,332,297,4,3,24,4,0,35
55007000166,853,741,706,2,3,13,1,1,35
55007000169,544,439,420,4,4,11,1,1,19
55021000732,666,444,421,5,4,5,3,0,23
55053002395,303,245,240,1,0,3,1,1,5
55137007021,730,584,553,18,1,4,2,0,31
55137007009,448,356,330,9,0,14,1,0,26
55115005743,575,444,399,12,1,32,1,0,45
55079004042,1983,1522,919,322,202,58,47,2,603
55079004015,1344,1115,822,143,110,28,16,2,293
55079003871,1361,1176,920,139,48,49,42,1,256
55079004034,2215,1783,1280,88,241,35,134,2,503
55079003856,2882,2440,1980,111,141,28,179,1,460
55079003600,1122,802,14,11,778,5,1,0,788
55079003688,2032,1412,28,22,1348,17,10,2,1384
55105005232,1547,1247,845,184,137,31,23,0,402
55105005199,1249,976,602,136,197,18,12,1,374
55105005153,910,707,656,33,8,5,5,0,51
55105005263,567,461,438,6,3,11,1,0,23
55105005184,217,172,159,3,2,1,0,0,13
55105005161,2995,2257,1830,242,72,59,36,3,427
55105005162,2878,2311,2099,71,41,29,58,9,212
55105005121,2777,2182,1918,119,48,57,32,2,264
55105005122,2858,2297,1936,163,86,49,69,5,361
55105005138,1684,1300,1013,102,143,22,23,0,287
55105005140,1865,1402,1076,179,86,32,14,0,326
55139007240,2256,1792,1614,56,52,26,43,0,178
55139007184,2367,2003,1844,43,46,40,34,0,159
55069003075,506,416,409,1,0,1,4,0,7
55069003078,702,532,497,9,2,14,6,0,35
55069003087,469,409,399,3,0,2,3,0,10
55017000544,997,716,689,14,2,7,0,0,27
55017000603,493,368,339,5,4,11,0,0,29
55017000617,1557,1557,793,121,565,69,24,0,764
55017000618,16,10,10,0,0,0,0,0,0
55017000612,26,19,16,2,0,0,1,0,3
55017000616,629,447,424,8,11,0,0,0,23
55017000600,543,389,361,10,4,7,2,0,28
55001000032,558,516,508,5,0,0,1,0,8
55001000035,741,650,627,10,1,5,0,0,23
55001000031,622,536,487,8,4,17,5,0,49
55001000011,422,341,310,9,8,11,5,1,31
55001000040,19,16,16,0,0,0,0,0,0
55001000044,1031,826,729,28,13,32,10,2,97
55057002564,519,407,324,11,2,68,1,0,83
55001000039,86,81,12,43,25,1,0,0,69
55001000041,0,0,0,0,0,0,0,0,0
55057002552,690,561,534,6,1,15,5,0,27
55001000012,178,157,145,9,0,2,0,0,12
55001000030,138,125,117,2,0,2,0,1,8
55023000838,628,480,454,3,1,10,0,1,26
55003000047,635,539,437,15,7,70,8,2,102
55003000051,710,619,511,13,7,77,10,1,108
55065002957,459,308,285,8,5,4,2,1,23
55065002938,107,76,76,0,0,0,0,0,0
55021000764,410,337,313,16,4,5,0,1,24
55021000781,619,416,371,23,10,7,6,1,45
55021000767,868,653,589,28,7,17,10,3,64
55053002393,470,351,333,8,0,2,5,0,18
55053002386,392,313,293,9,2,3,3,0,20
55053002400,398,286,230,44,4,8,2,0,56
55053002403,487,360,321,23,1,10,0,0,39
55053002427,505,370,145,18,23,190,5,1,225
55053002423,495,352,161,21,14,165,3,0,191
55053002417,630,559,512,2,6,28,6,0,47
55057002553,57,52,52,0,0,0,0,0,0
55015000524,850,669,627,18,0,18,0,0,42
55015000521,432,317,268,30,1,9,2,0,49
55015000537,0,0,0,0,0,0,0,0,0
55015000474,774,624,589,15,3,18,1,0,35
55015000510,872,659,566,67,7,9,8,2,93
55079003745,945,606,135,30,372,9,69,0,471
55079003746,908,559,12,36,201,5,310,3,547
55079003543,754,651,519,57,33,30,15,2,132
55079003552,712,699,620,16,27,10,16,1,79
55079003544,757,639,509,78,51,9,2,0,130
55079003817,953,746,525,28,161,10,26,4,221
55079003818,559,465,216,3,201,0,46,0,249
55079003816,945,717,414,40,238,15,14,0,303
55079003646,1677,1198,392,46,712,16,24,4,806
55079003555,1045,787,641,54,13,26,55,1,146
55079003572,553,418,338,32,9,5,32,0,80
55079003842,1855,1423,1175,61,142,27,34,2,248
55119005941,693,551,531,6,0,11,0,0,20
55119005943,308,232,230,0,0,0,1,0,2
55119005954,710,555,530,3,1,6,4,0,25
55049002351,456,368,360,3,1,1,0,0,8
55031001693,184,143,137,3,0,3,0,0,6
55031001696,436,370,334,6,0,17,5,1,36
55031001692,632,487,452,0,3,14,1,0,35
55109005505,1069,819,761,23,8,7,11,1,58
55109005504,1175,935,866,20,7,10,16,1,69
55109005496,1249,996,914,28,5,11,23,2,82
55109005454,209,158,155,0,0,3,0,0,3
55109005458,880,670,641,15,2,8,2,0,29
55109005456,702,511,482,3,2,4,16,0,29
55015000522,607,550,487,16,9,4,31,0,63
55015000480,1013,772,738,10,3,7,12,0,34
55097004829,452,387,357,4,2,7,13,0,30
55097004780,930,707,614,8,11,8,58,1,93
55097004831,862,672,625,14,6,11,15,0,47
55097004773,208,190,163,6,5,5,10,1,27
55097004847,7,6,6,0,0,0,0,0,0
55097004850,13,9,5,1,0,0,1,0,4
55097004791,965,778,676,52,9,5,33,3,102
55097008058,0,0,0,0,0,0,0,0,0
55097004833,9,5,1,0,2,1,0,0,4
55097008057,6,4,1,0,1,2,0,0,3
55139007241,622,531,522,2,0,3,5,0,9
55139007105,835,638,595,12,4,8,11,1,43
55139007099,1258,865,821,11,6,5,19,0,44
55065002963,161,136,132,4,0,0,0,0,4
55065002962,187,149,148,0,0,1,0,0,1
55023000834,932,713,694,1,2,4,4,1,19
55023000839,244,184,178,4,0,0,0,0,6
55023000845,887,743,709,10,1,8,2,0,34
55023000832,70,68,63,0,1,2,2,0,5
55023000811,988,777,742,10,5,9,7,2,35
55023000844,785,619,590,13,1,14,2,1,29
55003000050,745,548,455,14,0,56,23,0,93
55065002959,575,437,430,2,0,3,1,0,7
55065002960,474,363,347,13,2,8,1,0,16
55065002945,224,171,156,6,1,9,1,0,15
55065002939,444,324,314,3,2,6,1,0,10
55055002451,956,796,752,11,8,19,3,0,44
55055002455,1248,996,923,31,8,14,25,0,73
55017000561,704,576,548,2,5,17,4,0,28
55017000594,2445,1943,1761,48,31,29,45,0,182
55017000579,254,194,192,2,0,0,0,0,2
55017000574,845,652,618,14,2,6,6,1,34
55093004629,115,98,93,0,0,1,2,0,5
55093004616,447,359,337,16,5,4,0,0,22
55093004642,1067,816,749,36,14,10,1,1,67
55093004632,815,638,618,6,2,7,2,0,20
55093004641,660,510,477,7,6,10,3,0,33
55093004644,765,613,578,13,1,10,6,0,35
55093004630,914,702,671,6,3,5,9,1,31
55093004634,757,613,573,11,11,9,4,0,40
55093004653,1508,1136,1056,21,14,15,17,1,80
55093004637,651,517,500,3,2,3,1,1,17
55093004650,1199,1078,932,42,45,42,29,0,146
55093004662,1882,1369,1249,41,28,21,23,1,120
55015000470,676,543,496,24,1,11,2,1,47
55015000473,324,264,247,7,3,6,1,0,17
55017000542,486,424,414,3,0,2,2,1,10
55017000538,981,763,734,3,1,10,3,0,29
55001000029,75,70,68,0,0,0,1,0,2
55001000027,940,834,799,10,2,15,7,2,35
55001000028,144,122,117,4,0,1,0,0,5
55001000005,913,769,725,23,0,12,4,1,44
55001000015,648,543,500,11,12,9,13,0,43
55001000007,116,91,88,2,1,0,0,1,3
55001000038,113,97,90,0,2,1,1,1,7
55001000006,349,288,258,16,3,6,0,0,30
55001000042,492,412,396,4,4,8,0,0,16
55001000023,1068,1061,402,103,457,91,16,0,659
55001000022,399,348,299,29,4,18,3,0,49
55001000021,493,402,371,16,5,7,2,1,31
55069003064,364,309,295,2,0,7,3,0,14
55097004820,732,567,537,13,2,4,5,0,30
55097004752,803,629,596,13,2,21,0,1,33
55139007244,1196,905,776,49,27,25,26,0,129
55139007172,942,700,617,20,6,22,23,2,83
55139007068,1235,975,884,32,19,9,26,0,91
55069003066,50,44,43,1,0,0,0,0,1
55069003049,567,437,428,2,0,3,5,0,9
55069003026,806,670,654,6,1,6,0,0,16
55069003080,831,715,686,13,0,10,2,0,29
55069003074,529,440,386,18,5,16,4,0,54
55069003083,317,277,271,1,1,2,0,0,6
55069003084,519,429,402,7,3,10,6,0,27
55069003068,0,0,0,0,0,0,0,0,0
55069003067,386,312,302,2,2,5,1,0,10
55069003086,309,275,270,4,1,1,1,0,5
55083004157,399,325,300,12,0,5,1,0,25
55083004158,546,450,431,3,3,10,0,0,19
55083004203,709,584,547,6,4,10,4,1,37
55055002522,738,617,561,12,2,5,7,2,56
55055002479,917,745,695,30,3,2,8,1,50
55055002487,1016,840,793,24,5,6,4,1,47
55055002478,984,739,602,105,20,2,4,0,137
55055002464,0,0,0,0,0,0,0,0,0
55055002442,2057,1388,1202,127,25,18,14,3,186
55055002438,1896,1394,1103,193,40,33,13,0,291
55055002515,947,711,569,74,35,11,20,0,142
55055002456,1028,806,684,73,13,21,7,0,122
55055002434,669,540,471,32,3,9,0,0,69
55083004171,474,355,330,8,1,11,0,1,25
55049002320,275,223,209,1,1,4,2,6,14
55049002341,185,144,139,1,0,0,1,3,5
55073003211,1940,1527,1215,37,26,33,201,2,312
55073003208,1811,1521,1285,48,28,21,134,1,236
55073003215,1827,1391,1041,52,34,34,225,2,350
55073003351,2087,1613,1460,26,23,32,68,0,153
55073003285,168,124,123,0,0,1,0,0,1
55073003343,737,587,567,1,2,6,4,0,20
55073003356,999,777,737,7,6,7,20,1,40
55073003363,180,138,130,5,1,1,2,0,8
55073003358,1831,1446,1252,49,18,29,86,1,194
55073003213,1762,1414,1190,39,14,21,143,2,224
55073003230,1715,1314,969,31,27,27,255,2,345
55073003364,3,2,2,0,0,0,0,0,0
55073003240,624,504,474,4,3,8,13,0,30
55073003333,0,0,0,0,0,0,0,0,0
55073003228,5,4,2,1,0,1,1,0,2
55073003232,0,0,0,0,0,0,0,0,0
55073003359,7,5,1,1,0,0,0,0,4
55073003360,1976,1649,1418,33,14,18,139,2,231
55073003234,0,0,0,0,0,0,0,0,0
55073003278,769,590,551,28,3,3,5,1,39
55073003237,928,702,676,14,2,3,5,0,26
55073003239,815,631,583,7,3,15,18,0,48
55073003189,634,428,414,6,3,2,1,1,14
55073003210,1,1,1,0,0,0,0,0,0
55073003226,1586,1278,998,50,41,62,118,6,280
55073003218,1696,1413,1107,74,91,56,93,2,306
55073003219,1695,1287,890,59,46,42,244,7,397
55073003355,934,688,664,6,0,2,5,0,24
55073003340,570,433,409,8,0,4,12,0,24
55073003338,628,463,438,13,0,3,0,0,25
55053002420,890,700,632,24,3,33,8,2,68
55053002416,661,534,512,1,2,20,0,0,22
55053002387,301,238,228,5,0,4,0,0,10
55053002385,674,512,496,5,1,6,0,0,16
55131006446,778,628,577,18,12,12,3,0,51
55131006449,998,774,740,15,0,7,8,2,34
55131006496,13,5,3,1,0,0,1,0,2
55131006459,1353,1067,1012,13,8,9,24,0,55
55131006394,2120,1640,1566,9,10,11,21,0,74
55117005885,952,753,726,7,5,7,6,0,27
55117005863,421,343,293,39,2,3,4,0,50
55117005865,806,602,556,23,1,2,12,0,46
55117005864,352,278,258,8,4,1,4,1,20
55117005881,927,665,596,8,2,6,43,0,69
55117005896,526,396,351,8,3,5,25,0,45
55131006415,490,424,400,7,5,7,4,0,24
55131006469,898,697,657,11,11,7,0,0,40
55131006498,1024,700,645,16,15,3,21,0,55
55131006482,1280,1044,952,31,24,13,8,3,92
55131006456,542,421,414,1,1,3,2,1,7
55131006351,821,734,705,11,2,9,5,1,29
55131006409,839,656,636,4,4,6,3,0,20
55131006405,241,198,194,3,0,0,0,0,4
55131006460,1093,823,745,18,12,15,25,0,78
55077003447,784,650,619,16,1,6,4,0,31
55131006434,1555,1233,1125,32,33,9,36,1,108
55073003366,1197,894,742,21,23,15,95,0,152
55073003221,1404,1048,805,50,33,22,132,1,243
55073003349,1493,1124,1021,23,6,18,51,1,103
55073003334,1570,1252,1072,31,26,16,99,2,180
55073003214,1818,1364,1082,28,36,24,190,0,282
55073003192,724,580,541,4,3,16,14,0,39
55073003348,732,588,536,11,3,4,29,0,52
55073003346,887,731,686,3,1,11,30,2,45
55095004678,909,682,648,10,1,7,3,0,34
55095004680,1154,927,863,32,15,16,5,0,64
55095004722,995,747,726,9,0,10,3,1,21
55095004675,824,610,546,35,0,32,3,1,64
55017000620,777,612,572,18,1,9,11,0,40
55017000578,1974,1448,1218,18,35,35,138,2,230
55059002713,1785,1453,1221,111,44,28,40,1,232
55059002638,1333,1073,948,64,20,17,25,0,125
55059002678,1790,1406,1156,148,64,18,21,4,250
55059002657,2546,2033,1552,213,121,25,110,1,481
55059002738,1195,951,751,86,86,19,17,0,200
55059002712,1594,1140,948,80,51,22,46,1,192
55059002711,3,2,1,1,0,1,0,0,1
55059002633,1887,1592,1272,110,79,25,100,4,320
55059002644,1243,960,601,183,130,38,10,3,359
55059002645,2326,1965,1385,222,291,50,27,1,580
55059002674,561,415,250,83,63,13,6,0,165
55059002646,1014,919,595,173,170,10,16,1,324
55065002956,830,671,622,25,6,14,1,1,49
55023000813,538,404,384,2,4,5,5,2,20
55023000812,430,297,285,4,0,1,4,0,12
55109005569,505,402,386,5,0,5,5,0,16
55109005564,715,507,461,17,6,8,7,0,46
55109005466,914,704,660,11,7,11,5,0,44
55109005566,1004,749,697,20,4,14,11,1,52
55109005565,930,704,621,19,15,36,9,2,83
55109005497,761,536,466,33,8,15,6,0,70
55109005490,796,577,548,9,3,7,3,0,29
55109005487,720,585,529,16,12,12,15,7,56
55109005532,673,530,503,8,0,5,9,0,27
55105005171,1270,984,872,38,20,23,24,6,112
55105005123,2620,2048,1660,154,155,24,48,0,388
55105005172,2194,1721,1578,63,18,16,34,2,143
55105005131,975,651,598,25,3,9,12,1,53
55105005370,271,222,198,6,0,6,3,0,24
55105005373,1918,1437,1275,78,19,32,24,0,162
55105005372,43,30,30,0,0,0,0,0,0
55105005369,848,709,669,12,8,11,3,0,40
55105005203,0,0,0,0,0,0,0,0,0
55059002734,1717,1253,819,302,93,17,23,3,434
55059002754,604,469,345,69,35,14,6,1,124
55059002757,910,645,446,122,46,26,18,0,199
55059002758,43,35,23,4,7,2,0,0,12
55059002647,1403,945,361,299,255,35,13,1,584
55059002735,892,657,361,191,74,18,20,4,296
55113005721,672,519,421,19,6,72,6,0,98
55113005728,622,472,338,28,10,81,7,1,134
55113005708,901,770,667,7,3,91,4,1,103
55113005707,393,328,156,2,4,168,0,0,172
55113005698,333,290,283,1,2,3,1,0,7
55113005694,229,170,149,0,2,11,1,0,21
55113005697,311,269,248,5,0,6,2,0,21
55113005695,134,122,107,9,0,2,2,0,15
55113005718,711,574,535,8,1,27,3,0,39
55113005712,659,546,263,10,11,274,3,1,283
55113005719,595,444,390,2,3,42,6,0,54
55017000552,887,674,642,6,0,6,11,0,32
55017000562,955,748,688,6,3,12,29,0,60
55017000547,777,599,563,5,4,10,0,0,36
55021000782,626,508,475,11,4,2,10,4,33
55021000777,0,0,0,0,0,0,0,0,0
55021000741,581,451,426,3,2,5,3,4,25
55021000776,1017,807,741,41,15,2,4,0,66
55021000793,812,687,662,8,4,12,0,0,25
55021000792,1179,938,865,38,7,8,19,0,73
55021000803,803,641,618,16,1,5,2,1,23
55021000804,844,647,600,20,9,7,8,0,47
55053002389,491,396,366,7,6,7,4,2,30
55053002399,143,95,94,1,0,0,0,0,1
55053002397,477,390,363,8,0,6,4,0,27
55107005427,81,69,65,2,1,1,1,0,4
55107005392,215,137,125,2,1,3,4,0,12
55107005444,348,283,279,2,0,1,0,0,4
55107005424,319,257,232,14,0,5,1,0,25
55107005437,71,53,53,0,0,0,0,0,0
55107005441,17,17,17,0,0,0,0,0,0
55107005422,102,87,81,2,1,1,1,0,6
55107005430,104,99,97,0,1,1,1,0,2
55107005399,93,71,68,0,1,0,0,0,3
55107005416,105,79,78,0,0,1,0,0,1
55107005410,781,594,567,9,0,10,3,2,27
55059002607,901,708,617,39,13,23,6,0,91
55059002608,575,419,388,8,6,10,3,0,31
55059002627,609,475,449,13,2,1,4,0,26
55059002737,1428,1023,587,194,204,30,23,3,436
55059002739,1499,1108,871,164,25,38,24,0,237
55059002753,1980,1565,881,458,270,22,69,4,684
55059002776,823,683,585,66,12,19,12,1,98
55059002687,611,486,413,42,5,12,1,0,73
55059002710,1887,1449,1237,103,27,23,45,2,212
55059002637,1473,1194,1055,62,31,17,25,0,139
55059002634,1552,1271,1116,70,45,19,11,2,155
55017000621,0,0,0,0,0,0,0,0,0
55017000627,216,162,133,7,3,3,13,2,29
55065002951,783,609,569,16,3,12,4,1,40
55003000074,579,387,31,20,3,352,0,0,356
55003000075,802,594,121,9,12,464,2,2,473
55065002958,138,100,98,0,1,1,0,0,2
55065002946,312,232,226,5,1,2,2,0,6
55065002941,570,437,421,9,0,1,0,0,16
55065002967,366,283,277,5,0,0,0,0,6
55065002968,946,712,692,3,1,7,3,0,20
55065002947,248,181,177,1,1,2,2,0,4
55003000056,723,572,478,15,5,63,5,3,94
55003000055,722,597,488,7,9,97,1,2,109
55003000054,656,542,408,16,7,111,0,0,134
55003000077,921,567,522,2,2,32,1,0,45
55003000078,146,69,65,0,0,4,0,0,4
55089004547,350,248,191,6,10,1,40,2,57
55089004563,374,296,266,9,8,0,9,0,30
55065002961,101,80,80,0,0,0,0,0,0
55107005409,116,99,95,3,1,0,1,0,4
55087004393,464,355,340,7,1,13,2,0,15
55087004313,421,312,304,0,3,5,0,0,8
55087004369,284,200,195,1,0,4,0,0,5
55057002588,295,246,241,3,1,1,1,0,5
55057002589,53,40,35,0,0,2,0,0,5
55057002549,830,714,685,8,10,7,6,0,29
55057002572,674,582,469,15,77,18,2,0,113
55057002571,585,462,425,19,4,9,3,0,37
55057002570,659,490,433,16,13,16,6,0,57
55121006018,381,320,306,8,1,6,0,0,14
55121006003,853,687,662,5,2,8,7,0,25
55121006002,1755,1342,1299,8,5,12,8,0,43
55121005990,264,210,192,18,0,4,0,0,18
55121006031,675,509,439,61,2,9,0,0,70
55121006030,1633,999,468,523,5,42,1,1,531
55121005991,1052,720,354,355,5,71,2,0,366
55087004420,620,486,470,2,2,5,3,1,16
55087004382,455,340,311,6,2,13,5,0,29
55109005473,461,366,356,5,1,3,0,0,10
55109005457,587,426,416,4,1,3,0,0,10
55109005467,1244,977,908,37,3,18,11,0,69
55109005474,767,561,530,9,0,8,8,1,31
55109005512,803,604,552,9,18,4,15,2,52
55109005472,966,767,734,5,6,3,9,1,33
55049002317,311,246,226,8,0,5,4,0,20
55079003885,1991,1794,1393,246,54,40,56,0,401
55079003502,1430,982,866,29,14,3,57,0,116
55079004009,1748,1303,368,86,818,10,29,2,935
55079003882,2401,1674,299,1202,74,53,100,6,1375
55079003482,2160,2052,1608,128,161,27,117,8,444
55079003765,2016,1202,189,56,864,17,90,2,1013
55079003739,2042,1263,78,38,1105,12,54,0,1185
55079003738,1773,1080,34,27,946,28,76,2,1046
55079003732,2594,1824,58,71,1670,28,14,0,1766
55095004665,637,528,504,10,3,10,0,0,24
55095004702,1024,806,771,15,0,6,9,0,35
55095004703,724,600,578,4,3,11,6,1,22
55013000445,493,425,393,4,6,21,1,0,32
55013000430,487,450,422,1,0,18,0,0,28
55095004705,820,632,608,2,3,11,3,0,24
55095004715,917,722,679,2,3,14,5,0,43
55095004720,935,682,629,13,11,18,6,0,53
55095004729,406,309,290,2,1,5,2,0,19
55013000458,711,604,468,6,11,118,6,1,136
55013000442,96,93,82,0,0,7,1,0,11
55107005400,551,484,457,11,2,8,4,0,27
55107005447,420,330,324,4,1,1,0,0,6
55021000731,848,685,642,6,4,12,4,0,43
55021000736,908,714,679,12,11,7,5,0,35
55021000738,756,628,592,17,3,7,7,1,36
55021000728,921,750,719,9,1,10,7,0,31
55021000733,857,590,568,10,0,5,3,3,22
55021000795,457,369,330,15,5,15,4,0,39
55021000775,1038,840,807,6,5,9,7,0,33
55021000798,653,514,503,3,2,5,0,0,11
55021000794,619,495,386,32,41,21,9,0,109
55039002041,647,542,516,12,3,5,4,0,26
55039002023,851,640,555,28,13,27,17,2,85
55039001981,921,694,583,64,11,21,15,0,111
55039002054,902,675,595,31,15,16,14,1,80
55039001971,436,368,355,5,2,2,1,0,13
55039001970,331,246,236,5,0,1,3,0,10
55005000093,683,569,556,3,0,4,1,2,13
55005000094,1043,888,864,5,1,9,2,0,24
55005000095,825,628,596,7,1,8,7,1,32
55005000116,24,17,13,1,2,0,3,1,4
55005000154,1,1,1,0,0,0,0,0,0
55075003413,596,451,421,9,5,11,6,0,30
55075003415,358,310,300,2,0,1,1,0,10
55075003416,739,653,640,5,0,3,3,0,13
55029001611,956,818,733,55,6,15,4,0,85
55029001637,358,331,324,4,0,1,0,0,7
55029001613,68,60,59,1,0,0,0,0,1
55029001617,539,475,446,8,2,9,2,3,29
55029001616,679,574,553,2,4,6,2,2,21
55073003327,448,367,318,18,17,6,10,0,49
55073003324,869,640,621,6,1,8,0,0,19
55051002363,424,330,312,1,1,8,3,0,18
55051002374,328,312,309,3,0,1,0,0,3
55051002364,490,406,391,0,0,11,0,0,15
55051002382,401,326,307,0,1,11,2,2,19
55003000061,738,596,522,7,1,58,5,1,74
55005000096,667,507,483,5,1,9,2,1,24
55005000124,441,342,275,13,39,12,1,0,67
55005000111,424,325,290,15,4,12,2,0,35
55005000121,1042,844,682,16,115,12,15,1,162
55005000127,377,307,240,2,54,3,8,0,67
55005000125,882,648,419,21,176,19,6,1,229
55005000081,670,541,512,8,2,17,0,0,29
55133006596,1634,1334,1282,29,3,9,8,0,52
55133006885,2122,1760,1643,37,22,22,30,0,117
55133006543,785,598,569,7,1,6,2,0,29
55133006661,839,660,627,17,3,5,5,0,33
55133006533,868,654,598,22,4,21,6,0,56
55071003096,761,625,600,7,2,7,3,0,25
55071003144,747,611,572,11,2,12,7,2,39
55059002730,118,90,70,12,6,2,0,0,20
55059002732,2453,1981,1593,156,132,21,72,2,388
55059002731,800,719,552,78,61,10,18,0,167
55059002756,431,347,223,64,48,6,5,0,124
55059002723,681,536,429,52,30,11,10,0,107
55059080028,13,9,2,1,4,0,0,0,7
55059002672,1239,899,412,244,222,22,5,5,487
55059002639,330,255,213,30,3,4,3,0,42
55059002719,1990,1540,1154,125,191,23,44,3,386
55059002720,942,765,633,54,43,20,10,1,132
55059002718,783,602,448,101,24,23,13,2,154
55059002778,0,0,0,0,0,0,0,0,0
55059002717,1386,1103,738,133,212,14,12,0,365
55059002709,790,680,565,48,38,11,20,1,115
55059002626,1257,1048,963,38,3,15,12,3,85
55059002628,1458,1140,1036,59,16,15,13,0,104
55079003972,2127,1690,1237,195,152,59,62,1,453
55079003911,1209,943,661,196,37,17,31,3,282
55079003890,1460,1153,803,220,60,29,45,1,350
55079003525,1276,972,764,133,32,39,9,1,208
55079003837,1425,1168,961,51,91,20,35,2,207
55079003632,2219,1652,130,59,1450,25,25,0,1522
55079003847,1983,1549,1366,53,67,16,33,1,183
55079003848,1853,1414,1262,43,58,9,37,2,152
55031001705,575,470,427,5,0,28,5,0,43
55031001690,656,497,472,5,3,16,0,0,25
55031001703,1096,846,791,5,6,24,4,3,55
55031001704,355,288,266,3,3,9,0,0,22
55031001715,626,521,476,8,3,22,7,2,45
55031001711,1114,872,814,7,8,30,8,0,58
55031001710,292,218,190,3,5,9,3,0,28
55031001712,589,446,415,1,11,10,8,0,31
55031001675,466,365,329,3,3,19,0,0,36
55031001678,379,299,276,6,1,7,2,0,23
55031001677,228,194,188,0,1,3,2,0,6
55043002198,292,218,215,0,1,1,1,0,3
55043002169,568,352,339,8,3,4,2,1,13
55043002154,457,355,322,8,5,11,4,0,33
55043002199,80,53,51,0,1,1,0,0,2
55043002139,407,298,286,12,0,0,0,0,12
55043002141,720,585,545,17,7,7,8,0,40
55043002142,660,494,474,8,1,7,2,0,20
55043002143,665,448,417,12,3,5,5,0,31
55039002077,993,776,722,29,4,8,10,0,54
55039002072,1358,1142,1062,41,6,20,11,2,80
55039003004,0,0,0,0,0,0,0,0,0
55039002053,949,750,614,90,33,2,13,0,136
55039001982,837,618,396,193,10,10,10,0,222
55039002064,0,0,0,0,0,0,0,0,0
55039002069,990,800,737,33,7,8,4,0,63
55039001967,309,238,232,1,1,1,1,0,6
55039002045,0,0,0,0,0,0,0,0,0
55039002005,627,532,512,11,0,2,3,0,20
55039002000,544,394,373,7,2,7,3,2,21
55039001979,785,608,587,11,1,2,5,0,21
55039001994,806,662,633,14,2,8,5,2,29
55039002016,1979,1568,1229,130,101,40,57,2,339
55039002015,2134,1640,1184,310,79,37,29,0,456
55039002018,2254,1640,1279,142,122,43,47,3,361
55039002058,1925,1534,1414,50,23,21,22,1,120
55039002026,1955,1492,1319,73,46,32,14,0,173
55039002020,1933,1499,1370,56,29,21,18,1,129
55039002033,2330,1739,1571,63,15,24,61,1,168
55039002030,2112,1621,1411,127,25,40,21,2,210
55039002031,2058,1609,1442,86,35,17,24,0,167
55039001972,962,739,705,17,4,9,3,2,34
55039002032,1712,1432,1321,48,22,20,24,2,111
55039002014,2043,1554,1365,83,49,35,17,7,189
55039002066,1914,1420,1096,183,61,47,37,2,324
55039002017,1988,1524,1333,88,45,23,18,1,191
55039001991,829,681,661,6,3,3,4,1,20
55089004533,1100,829,737,16,13,1,54,1,92
55089004562,1384,1034,904,30,33,8,58,0,130
55071003115,826,670,634,15,3,6,1,0,36
55071003122,0,0,0,0,0,0,0,0,0
55071003183,3,3,2,0,1,0,0,0,1
55133006855,443,345,305,8,4,3,19,0,40
55133006627,1915,1410,987,34,29,17,336,0,423
55133008071,0,0,0,0,0,0,0,0,0
55133006746,2399,1799,1354,59,42,11,319,0,445
55133006747,1085,864,793,15,10,9,35,0,71
55133006598,2615,1744,1528,50,18,23,122,2,216
55133006698,863,664,571,33,13,0,45,0,93
55133006762,2301,1744,1371,193,69,16,80,5,373
55133006806,1439,1101,945,118,9,20,16,0,156
55133006683,2486,2093,1755,164,49,24,89,1,338
55133006852,1023,790,701,34,7,10,32,0,89
55133006853,31,18,15,0,0,2,1,0,3
55133008068,0,0,0,0,0,0,0,0,0
55083004188,367,258,234,8,2,6,1,0,24
55083004185,914,721,670,9,2,17,6,1,51
55083004199,653,511,478,5,3,13,2,0,33
55083004201,996,778,751,4,2,10,5,0,27
55083004200,311,252,246,3,0,3,0,0,6
55055002502,590,482,455,10,4,7,0,2,27
55055002497,1300,969,844,66,16,18,25,0,125
55055002496,975,780,647,94,13,15,9,2,133
55129006331,141,126,120,3,0,2,1,0,6
55129006328,366,303,292,3,2,5,0,1,11
55129006330,101,93,92,0,0,1,0,0,1
55129006329,402,330,309,9,1,10,1,0,21
55129006327,628,545,516,3,0,23,2,0,29
55129006333,194,186,182,3,0,1,0,1,4
55041002091,414,344,292,4,17,27,0,0,52
55041002090,437,345,305,6,8,26,1,3,40
55041002083,422,356,333,3,0,14,0,2,23
55041002101,392,305,273,0,1,32,0,0,32
55041002102,498,334,57,8,3,277,0,2,277
55041002092,450,336,286,5,4,38,2,0,50
55041002089,412,296,279,2,0,12,1,0,17
55041002106,383,304,268,4,1,27,3,0,36
55055002514,770,637,602,14,4,8,5,1,35
55055002504,562,486,450,17,2,9,7,0,36
55083004155,309,306,295,1,0,6,2,0,11
55133006731,2154,1783,1567,64,65,24,51,0,216
55133006838,2498,1959,1835,33,15,17,46,3,124
55133006835,3098,2488,2239,69,51,17,69,0,249
55133006591,2208,1839,1592,28,37,14,153,2,247
55133006655,722,613,487,81,15,15,11,3,126
55133006584,1781,1479,1359,36,12,12,50,0,120
55133006850,744,590,552,21,4,3,8,0,38
55133006657,623,502,473,12,2,7,4,0,29
55133006530,486,403,373,7,2,11,1,0,30
55133006528,865,703,676,1,4,13,2,0,27
55133006826,283,238,236,1,0,0,0,0,2
55133006679,637,458,433,3,1,9,7,1,25
55133006618,1959,1586,1380,73,24,19,75,5,206
55133006564,2042,1606,1416,22,35,17,94,4,190
55063002890,1426,1025,951,11,5,10,42,1,74
55063002881,1261,856,820,7,1,7,21,0,36
55063002883,1419,1066,971,16,14,12,41,2,95
55063002879,621,440,411,3,1,1,16,0,29
55063002891,133,89,85,2,1,3,0,0,4
55063002884,998,718,671,4,12,1,26,3,47
55063002876,1050,719,602,10,7,11,85,0,117
55063002892,846,678,634,3,5,10,26,0,44
55063002903,2548,1872,1648,42,28,16,129,2,224
55063002901,660,483,460,6,7,9,1,0,23
55063002900,1308,1012,795,29,37,14,132,2,217
55063002906,807,625,597,3,1,9,8,0,28
55063002894,874,676,591,9,6,13,54,0,85
55063002907,2477,1883,1691,41,23,21,97,0,192
55063002897,1629,1214,1053,27,33,13,78,0,161
55063002896,1556,1231,1086,22,20,17,79,0,145
55063002844,1509,1240,1128,15,10,13,67,4,112
55021000801,0,0,0,0,0,0,0,0,0
55021000808,607,508,480,8,7,6,7,0,28
55021000788,723,590,524,42,8,10,3,0,66
55021000762,747,627,566,28,16,7,1,0,61
55021000789,383,317,276,16,12,11,3,0,41
55053002419,864,683,623,8,2,47,3,1,60
55053002421,981,755,664,17,16,44,4,1,91
55021000735,378,271,263,1,1,2,2,0,8
55021000730,161,141,138,1,0,0,0,0,3
55025001082,1699,1388,1076,116,102,30,61,4,312
55025001028,3186,2229,1682,151,189,70,141,1,547
55025000866,571,439,375,18,14,11,17,1,64
55025001284,719,660,566,44,13,14,18,4,94
55025001067,1002,792,545,97,86,17,42,0,247
55025001015,7,7,2,0,0,3,2,0,5
55025000875,948,712,678,13,7,10,2,0,34
55025000888,572,456,352,51,24,16,19,0,104
55025001093,50,27,16,2,6,0,3,0,11
55025000948,554,478,414,19,17,7,14,2,64
55025001088,2164,1685,1026,309,216,55,114,8,659
55025001106,3374,2919,2517,132,117,41,117,0,402
55025001091,12,10,4,3,1,1,0,0,6
55025001047,15,12,0,6,4,0,0,0,12
55025001440,688,565,534,6,5,2,13,0,31
55025003032,0,0,0,0,0,0,0,0,0
55025001092,3668,2968,1878,383,427,91,227,2,1090
55025001089,2200,1900,1342,74,87,24,359,9,558
55025001054,0,0,0,0,0,0,0,0,0
55025000958,0,0,0,0,0,0,0,0,0
55025001101,2686,2060,1180,286,371,51,188,3,880
55025001193,630,504,485,10,6,0,1,1,19
55025000956,9,7,4,0,0,0,3,0,3
55025001090,187,173,136,13,11,5,10,1,37
55025001412,586,467,408,17,20,7,19,2,59
55025001172,3582,2810,2103,130,153,41,372,4,707
55025001398,2472,1592,1356,75,29,16,110,3,236
55025003041,0,0,0,0,0,0,0,0,0
55025001035,3439,2798,2064,172,103,28,393,2,734
55025001401,2145,1748,1514,84,46,17,77,0,234
55025001050,5,2,0,2,0,0,1,0,2
55025001030,3006,2347,1768,223,148,26,179,2,579
55025001173,4244,3293,2598,214,148,31,298,2,695
55025001174,0,0,0,0,0,0,0,0,0
55025001058,48,36,21,5,2,1,8,0,15
55025001399,1946,1463,1275,66,32,22,55,2,188
55025001409,735,571,528,16,3,9,8,0,43
55025001051,0,0,0,0,0,0,0,0,0
55025000998,1937,1458,1271,37,20,20,94,0,187
55025001400,1678,1187,1076,34,20,10,44,0,111
55025001137,3193,2819,2390,105,83,36,201,14,429
55025001148,2292,1802,1066,275,332,27,103,2,736
55025001138,1573,1423,950,99,186,12,181,0,473
55025001070,6,6,3,0,1,1,0,1,3
55025001141,1375,1228,1038,50,77,12,43,1,190
55025001164,4850,3915,3040,212,368,48,240,7,875
55025001071,12,12,9,0,0,2,0,1,3
55025001153,2963,2444,1941,137,204,24,138,6,503
55025001069,15,5,0,0,3,0,2,0,5
55025000871,269,222,205,3,4,0,6,3,17
55025001073,77,57,22,12,12,5,10,1,35
55025001068,0,0,0,0,0,0,0,0,0
55025001065,6,5,0,3,3,3,0,0,5
55025001066,14,12,6,4,2,0,0,0,6
55025001060,0,0,0,0,0,0,0,0,0
55025000923,388,304,281,7,6,1,8,0,23
55025001119,1374,1120,929,74,75,20,21,2,191
55025001097,1146,893,722,50,55,9,50,3,171
55025001108,800,666,570,20,40,7,17,0,96
55025001056,2746,2182,1742,117,198,36,83,1,440
55003000063,178,164,161,0,0,1,0,0,3
55003000062,83,80,80,0,0,0,0,0,0
55003000049,788,644,578,9,2,46,11,1,66
55025001449,759,546,463,26,25,7,14,0,83
55025000970,0,0,0,0,0,0,0,0,0
55025001450,697,504,438,25,19,2,23,0,66
55025001451,1840,1266,1107,51,52,35,25,0,159
55025001384,1923,1415,1158,88,86,43,56,6,257
55025001383,1963,1428,1161,46,77,25,112,4,267
55025001377,1536,1193,1012,69,61,20,35,2,181
55097004765,729,619,549,24,27,9,16,0,70
55097004769,786,684,586,39,17,16,14,0,98
55097004763,711,559,474,22,7,16,42,0,85
55133006536,651,479,453,8,4,7,4,0,26
55133006542,923,737,703,10,2,12,5,0,34
55133006669,695,534,499,15,5,3,6,1,35
55133006545,949,723,665,23,2,14,10,0,58
55133006547,884,694,669,15,5,3,3,0,25
55133006670,1048,755,678,27,5,27,13,0,77
55133006664,1759,1368,1219,83,16,6,31,1,149
55133008072,5,4,0,4,0,0,0,0,4
55133003027,0,0,0,0,0,0,0,0,0
55133006875,0,0,0,0,0,0,0,0,0
55133006659,676,546,501,20,10,4,10,0,45
55133008070,8,6,4,0,1,0,0,0,2
55133006848,910,722,675,25,2,13,4,0,47
55133006671,717,529,499,17,3,4,7,0,30
55133006849,646,591,558,19,2,6,7,0,33
55133006706,792,686,649,16,1,13,5,0,37
55051002373,375,301,282,4,2,6,3,0,19
55051002372,426,348,326,5,0,18,0,0,22
55119005950,338,258,250,5,0,1,1,1,8
55119005948,478,327,316,5,0,2,0,0,11
55079003875,2242,1556,336,1050,102,82,67,4,1220
55079003846,2089,1625,1483,47,46,12,31,0,142
55079003877,1890,1294,232,908,77,58,57,2,1062
55079003645,1593,1075,278,48,618,27,126,5,797
55079003637,1728,1127,131,43,899,17,60,2,996
55079003520,1073,805,631,94,46,27,17,0,174
55079003642,2732,1998,300,55,1542,33,98,2,1698
55079003681,1254,844,32,24,770,19,7,3,812
55079003702,742,488,44,12,427,5,2,1,444
55083004161,698,582,557,4,0,15,0,0,25
55023000820,727,621,586,6,4,10,5,2,35
55023000836,122,87,85,0,0,1,0,0,2
55023000837,623,473,458,1,2,7,2,0,15
55023000825,189,146,143,1,0,0,1,0,3
55133006713,1200,969,922,27,2,10,7,0,47
55133006645,865,714,686,10,3,11,4,0,28
55133006568,1094,867,819,19,10,7,13,0,48
55133006617,1556,1200,1067,25,10,15,72,2,133
55133006889,1129,863,807,11,9,6,22,6,56
55133006715,2216,1730,1560,65,38,12,43,4,170
55133006555,344,273,253,9,1,7,0,0,20
55133006554,624,488,465,7,0,7,4,0,23
55133006886,164,88,58,5,0,1,23,0,30
55133006674,1651,1135,1023,20,14,9,65,0,112
55089004518,1764,1349,1182,36,43,5,68,0,167
55089004548,985,670,527,19,24,5,94,0,143
55089004553,875,633,545,9,33,13,37,1,88
55061002805,748,544,529,4,2,2,4,3,15
55061002807,388,301,284,11,1,1,2,0,17
55061002806,380,289,265,21,0,3,0,0,24
55061002808,604,448,399,19,6,21,3,0,49
55061002785,870,712,690,8,3,5,0,1,22
55061002789,833,641,600,13,6,11,5,1,41
55061002787,514,421,405,0,4,6,1,0,16
55061002794,630,463,384,60,4,13,3,0,79
55061002796,375,291,278,9,0,6,0,0,13
55061002795,372,261,254,5,0,1,1,0,7
55001000009,615,545,527,7,3,5,1,1,18
55001000008,333,271,247,12,5,2,0,1,24
55001000033,558,522,506,1,3,7,2,0,16
55097004745,730,572,561,2,1,1,3,0,11
55097004749,501,390,375,3,1,0,4,0,15
55139007194,1004,791,759,7,1,15,5,1,32
55139007247,644,500,481,11,0,3,3,2,19
55139007157,2200,1862,1565,85,71,53,80,5,297
55139007100,1853,1457,1268,34,41,19,74,1,189
55139007158,1176,848,717,40,41,23,24,7,131
55139007132,827,656,613,12,4,12,6,1,43
55139007087,220,181,168,5,0,3,1,0,13
55139007216,2303,2049,1443,77,400,68,58,0,606
55139007098,746,612,573,5,6,9,1,0,39
55139007222,920,724,705,4,0,6,7,0,19
55139007102,868,735,717,3,0,5,3,0,18
55139007076,712,582,531,25,14,16,1,0,51
55139007231,1233,957,849,48,22,17,18,0,108
55139007226,647,555,460,41,19,24,11,0,95
55139007215,1652,1295,1164,27,32,24,38,1,131
55139007088,763,607,580,4,1,13,9,0,27
55139007063,2376,1870,1642,49,46,44,74,0,228
55139007139,298,257,248,0,0,1,7,0,9
55139007095,2298,1868,1739,27,27,28,38,1,129
55139007169,875,641,601,3,7,7,21,0,40
55069003062,530,438,423,3,0,3,6,0,15
55097004766,516,412,354,14,20,7,10,0,58
55097004767,1309,1062,928,33,31,29,35,2,134
55097004830,759,624,589,11,3,15,4,0,35
55097004771,610,512,452,13,15,11,22,0,60
55097004770,742,651,593,14,7,6,35,0,58
55097004819,616,445,423,9,4,2,3,0,22
55063002895,1379,1054,840,42,24,23,124,1,214
55063002905,1708,1312,1189,27,17,8,57,3,123
55071003131,1465,1165,951,58,32,25,73,0,214
55071003094,1334,1064,913,49,21,25,52,0,151
55071003126,1446,1137,1021,28,35,19,26,0,116
55071003116,390,316,304,4,0,6,0,0,12
55071003090,631,496,463,17,5,6,5,0,33
55071003165,1610,1238,1102,41,22,34,24,2,136
55071003156,1660,1373,1178,73,47,37,27,1,195
55071003110,793,672,645,6,1,14,2,2,27
55071003173,1441,1107,872,79,29,31,95,0,235
55071003174,2018,1483,1193,150,50,37,51,0,290
55071003103,587,477,460,0,0,7,4,0,17
55071003101,1884,1627,1437,67,54,7,60,3,190
55071003177,0,0,0,0,0,0,0,0,0
55071003169,1906,1567,1254,99,34,38,136,2,313
55071008082,8,4,3,0,1,0,0,0,1
55071003175,1,1,0,1,0,0,0,0,1
55071003163,1289,1039,973,14,12,11,19,4,66
55069003040,638,483,464,8,4,5,0,0,19
55069003033,605,479,426,15,9,16,4,2,53
55069003046,567,489,479,0,0,3,6,0,10
55069003035,550,466,434,19,1,8,2,0,32
55069003031,503,442,400,9,13,17,3,0,42
55069003032,66,60,58,1,1,0,0,0,2
55069003058,769,614,601,7,1,1,2,0,13
55069003055,181,152,150,1,0,0,0,0,2
55069003072,655,502,471,8,4,8,2,0,31
55097004755,623,510,484,12,3,6,5,0,26
55097004734,962,760,737,9,2,8,4,0,23
55097004817,902,718,705,8,0,2,1,0,13
55061002814,322,271,261,3,1,6,2,0,10
55061002815,450,370,337,15,0,11,3,0,33
55071003108,1522,1186,1010,38,21,40,50,1,176
55071003105,1036,822,796,16,0,4,0,1,26
55071003139,585,445,423,15,0,3,0,0,22
55071003142,466,367,347,2,1,14,1,1,20
55133006666,677,453,421,4,3,5,20,0,32
55133006871,804,600,567,6,12,3,12,0,33
55133006844,2260,1677,1565,43,7,15,22,0,112
55133006873,804,542,456,26,2,8,49,0,86
55133006651,939,690,654,18,4,7,7,0,36
55133006872,87,66,58,2,0,1,5,0,8
55133006860,892,695,660,11,3,8,16,3,35
55133003022,12,3,2,1,0,0,0,0,1
55071003097,719,569,549,10,0,4,2,0,20
55133006603,752,634,594,11,8,6,11,1,40
55133006701,858,640,605,9,3,8,10,1,35
55133006700,971,785,751,4,7,8,12,0,34
55133006644,2262,1767,1474,180,38,18,38,0,293
55133006774,2078,1618,1482,61,12,23,39,7,136
55133006769,2577,2155,1921,64,41,25,102,1,234
55071003130,1454,1124,1025,38,23,11,22,0,99
55071003125,1717,1383,1286,28,9,23,22,0,97
55133006818,1469,1153,946,44,40,10,112,0,207
55133006754,1462,1136,878,42,16,10,184,1,258
55133006608,558,413,386,12,3,8,1,0,27
55133006534,654,520,471,29,6,1,3,0,49
55063002852,2803,2350,2176,30,37,27,67,1,174
55063002832,2774,2201,1965,35,55,36,96,3,236
55063002848,1295,1115,1023,19,25,8,42,0,92
55063002853,960,766,746,3,3,6,4,1,20
55063002847,737,595,523,9,15,14,27,0,72
55131006401,1507,1211,1163,12,8,11,6,0,48
55131006349,1263,983,944,5,6,4,14,0,39
55131006464,720,585,568,2,5,1,5,0,17
55131006483,967,745,687,24,3,7,21,0,58
55131006511,984,641,591,26,8,7,7,2,50
55131006421,520,430,406,7,4,5,4,0,24
55131006366,935,782,759,9,5,2,3,0,23
55131006356,1032,865,769,51,14,12,17,1,96
55131006411,976,815,770,8,4,5,17,0,45
55131006389,586,463,441,6,8,2,4,0,22
55131006403,1782,1395,1259,18,28,8,74,1,136
55023000828,821,671,611,21,7,15,5,2,60
55063002869,1198,970,920,6,5,9,22,1,50
55063002830,909,710,604,22,17,15,52,0,106
55063002857,1373,1119,980,22,15,15,88,2,139
55063002843,1721,1376,1195,19,36,16,99,0,181
55063002845,721,589,506,24,6,4,43,1,83
55063002863,0,0,0,0,0,0,0,0,0
55063002928,783,592,581,1,0,5,4,0,11
55063002919,592,463,419,14,7,10,0,1,44
55063002935,368,292,273,4,1,1,4,2,19
55063002921,164,110,98,1,1,4,2,0,12
55063002929,684,535,510,12,3,3,5,2,25
55063002922,816,605,573,11,4,8,8,0,32
55063002918,776,555,521,11,1,8,11,0,34
55063002877,305,261,246,2,0,5,5,1,15
55063002893,623,474,434,8,3,6,22,0,40
55133006823,1782,1268,1159,32,8,14,38,0,109
55133006827,2561,1873,1734,55,4,22,46,2,139
55133006825,2020,1590,1497,34,6,21,13,0,93
55133006732,1875,1499,1233,62,75,13,115,3,266
55133006727,1389,1130,1018,39,34,21,18,2,112
55133006863,1277,1045,956,32,14,12,9,4,89
55133006673,1360,1063,960,45,23,13,11,1,103
55133006599,566,469,443,15,3,4,5,0,26
55133006663,977,715,630,39,11,7,10,1,85
55133006576,945,746,659,54,5,18,12,0,87
55043002197,385,326,307,7,2,3,3,1,19
55043002115,264,163,158,2,0,2,0,0,5
55043002159,173,128,121,3,0,1,1,0,7
55043002160,202,176,168,1,0,7,0,0,8
55043002155,909,822,471,56,266,24,9,0,351
55043002156,777,590,563,9,1,8,3,0,27
55043002168,187,123,121,0,1,1,0,0,2
55043002120,1881,1528,1339,53,54,22,43,0,189
55043002137,529,389,378,5,3,0,2,0,11
55043002152,723,516,508,5,1,1,0,0,8
55025001212,617,509,452,27,12,7,2,0,57
55025001198,748,596,504,42,15,11,15,1,92
55025001200,877,652,543,70,14,16,7,1,109
55025001194,567,409,349,30,15,5,10,0,60
55025001197,710,543,421,98,7,7,6,1,122
55025001087,1827,1569,1152,116,124,37,144,5,417
55025000886,908,736,639,21,21,15,42,1,97
55025001084,1661,1407,909,170,204,33,104,1,498
55025001331,1068,836,814,7,1,7,1,0,22
55025001330,803,652,609,19,3,5,9,1,43
55025000878,1062,815,750,21,12,10,9,1,65
55025001385,0,0,0,0,0,0,0,0,0
55025003033,0,0,0,0,0,0,0,0,0
55025001378,1319,926,776,51,43,7,42,0,150
55025000944,799,648,558,20,48,14,3,0,90
55025000941,1028,751,666,41,13,18,4,1,85
55025001211,727,592,556,27,7,5,0,0,36
55025001175,1423,1150,795,133,101,24,96,0,355
55025001170,2894,2200,1555,227,262,50,125,4,645
55025001118,6115,5278,3408,346,140,101,1294,4,1870
55025001120,3743,3517,2454,235,141,31,642,16,1063
55025001139,1670,1438,1163,86,51,20,114,0,275
55089004528,874,626,571,15,3,9,25,1,55
55089004555,724,549,510,5,12,2,20,0,39
55089004527,373,292,274,2,1,8,7,0,18
55089004569,2076,1928,1566,69,73,22,68,8,362
55089004590,2115,1501,1407,20,10,17,30,4,94
55061002812,413,335,322,7,0,3,0,0,13
55061002816,718,553,536,7,0,3,3,0,17
55061002818,289,248,245,0,0,3,0,0,3
55001000017,556,455,438,6,2,6,1,0,17
55001000016,585,517,464,19,6,20,7,0,53
55043002175,1043,787,774,2,1,1,6,1,13
55071003164,2053,1533,1385,58,26,26,25,1,148
55075003390,1521,1188,1071,29,28,35,19,2,117
55075003388,631,499,485,3,0,5,5,0,14
55075003386,1341,1189,1101,37,16,15,17,1,88
55031001689,423,333,309,4,0,11,4,0,24
55075003411,339,307,284,5,5,5,2,0,23
55075003412,512,402,391,0,1,5,1,1,11
55005000132,1238,912,820,19,11,24,21,1,92
55005000128,672,492,441,15,5,13,14,1,51
55061002793,626,500,485,8,0,1,0,0,15
55061002792,382,298,282,12,0,0,2,0,16
55107005415,261,194,184,0,1,1,1,0,10
55107005412,100,70,64,0,1,3,0,0,6
55087004406,2510,1903,1582,114,60,35,98,2,321
55087004402,1724,1473,1254,52,80,28,45,3,219
55087004286,3267,2514,2046,169,111,73,120,3,468
55087004328,1860,1397,1166,88,56,48,46,8,231
55087004424,447,332,319,1,3,6,3,0,13
55087004438,244,197,192,2,1,3,0,0,5
55087004310,972,748,689,13,12,16,17,0,59
55087004425,1103,804,736,13,6,10,36,0,68
55087004360,1020,786,700,23,18,23,19,1,86
55087004317,1122,874,672,84,12,21,77,0,202
55057002574,924,687,648,5,5,14,4,0,39
55057002577,717,581,546,7,5,16,4,1,35
55107005429,139,95,91,2,0,4,0,0,4
55107005397,525,347,327,5,0,5,2,0,20
55007000160,1246,854,175,29,12,661,7,3,679
55007000163,251,217,207,2,2,5,0,0,10
55007000170,508,445,421,2,3,14,1,0,24
55133006735,2175,1716,1351,45,148,25,129,0,365
55133006734,1417,1189,974,13,77,10,100,0,215
55133006737,1043,890,708,27,69,6,65,0,182
55133006743,2036,1534,1317,48,37,6,114,2,217
55133006609,2222,1697,1368,54,40,24,186,8,329
55133006764,1786,1443,1292,40,16,11,75,1,151
55133006771,172,139,119,5,0,0,12,0,20
55063002824,1839,1471,1311,21,43,28,61,1,160
55063002833,1270,1054,968,15,16,4,34,1,86
55063002846,1622,1368,1201,20,46,30,59,0,167
55029001640,1148,1028,978,28,2,18,4,0,50
55029001632,719,647,615,10,5,7,3,0,32
55029001628,692,566,534,29,0,1,1,0,32
55029001630,754,647,631,8,1,4,1,0,16
55029001625,811,724,683,17,3,8,4,0,41
55029001627,675,529,502,14,3,4,1,1,27
55029001626,498,400,378,7,1,8,0,0,22
55029001665,7,7,4,0,0,2,0,0,3
55029001659,119,104,92,3,1,7,0,0,12
55029001666,2,2,2,0,0,0,0,0,0
55029001670,9,0,0,0,0,0,0,0,0
55039002013,632,493,475,4,2,3,4,1,18
55039001986,497,399,392,1,1,2,1,0,7
55039002010,626,486,479,5,0,2,0,0,7
55039002050,449,374,360,9,1,5,0,0,14
55039001962,790,624,532,54,12,14,14,3,92
55039002012,553,414,393,13,2,0,4,0,21
55039001960,828,659,604,39,8,9,1,0,55
55039001968,922,747,716,17,2,6,2,0,31
55025001081,1479,1087,670,104,215,19,80,0,417
55025001130,2661,2115,1721,124,165,43,62,3,394
55039002060,48,31,24,5,0,0,0,0,7
55039002037,537,462,454,5,2,2,1,0,8
55039002059,100,78,72,2,1,0,2,1,6
55039002076,418,308,274,3,3,14,9,0,34
55039002057,1459,1198,1001,110,46,20,27,5,197
55039002035,919,737,709,7,2,12,4,0,28
55039002056,1767,1519,1217,119,87,47,59,2,302
55039001990,778,614,579,16,1,14,3,0,35
55039002029,8,0,0,0,0,0,0,0,0
55039002036,965,762,748,4,5,3,4,1,14
55025001059,266,157,60,8,5,2,83,1,97
55025001046,0,0,0,0,0,0,0,0,0
55025001271,1258,818,704,9,5,5,81,0,114
55025001270,1107,804,724,18,7,11,43,1,80
55025001275,785,576,522,16,11,7,20,0,54
55025001061,265,168,96,3,6,5,56,3,72
55025001045,4185,3034,2203,86,66,37,643,1,831
55025001213,2153,1603,1153,148,149,23,141,2,450
55025001216,1649,1308,1079,44,32,9,129,1,229
55025001223,1564,1401,1118,55,39,7,166,2,283
55025001274,878,630,565,12,4,9,28,0,65
55007000184,745,629,578,11,1,22,5,0,51
55103005074,827,666,621,14,3,15,4,0,45
55103005098,829,653,597,19,0,20,8,0,56
55103005082,333,271,256,4,1,5,1,0,15
55011000397,245,203,196,4,0,1,1,0,7
55011000410,515,364,352,2,0,3,3,0,12
55071003159,1758,1343,1180,53,20,29,52,3,163
55071003170,1533,1174,1006,68,19,26,61,1,168
55077003441,537,421,396,17,4,8,1,0,25
55131006395,1813,1407,1321,23,11,11,30,1,86
55131006379,1367,1111,1058,24,8,9,12,0,53
55131006382,1185,912,819,20,29,16,22,1,93
55131006432,832,649,621,11,6,5,3,0,28
55131006455,649,552,536,6,7,1,0,0,16
55025001441,612,487,452,3,3,6,19,0,35
55025001439,873,656,591,18,16,10,20,1,65
55025001425,1321,1042,948,47,21,13,12,1,94
55025001431,7,7,5,0,2,0,0,0,2
55025001424,1188,923,867,19,18,6,10,2,56
55025003036,0,0,0,0,0,0,0,0,0
55025001423,1603,1014,892,29,17,13,46,1,122
55025008005,0,0,0,0,0,0,0,0,0
55025001433,28,11,5,1,0,1,4,0,6
55025001442,1029,975,915,19,17,6,11,1,60
55025000946,24,15,7,0,3,4,1,0,8
55025001457,549,408,395,4,1,1,8,1,13
55025000949,787,647,593,19,14,7,10,0,54
55025001454,262,195,149,15,7,11,13,0,46
55025001453,730,545,479,25,8,6,25,1,66
55025000957,15,15,13,0,2,0,0,0,2
55025000959,9,4,0,2,0,0,2,0,4
55025001329,207,151,141,4,2,1,3,0,10
55025000880,886,661,623,13,3,3,20,0,38
55025000879,1078,825,790,11,10,4,4,0,35
55025001025,770,604,564,11,3,4,18,1,40
55025001023,1305,885,799,13,13,17,33,0,86
55025001156,1805,1467,1222,56,54,19,101,2,245
55025001135,2040,1742,1383,98,49,27,173,3,359
55025001041,2843,2300,1733,149,153,32,240,1,567
55025001043,2231,2048,1596,112,53,22,263,0,452
55025001410,633,510,477,6,9,10,8,0,33
55025001393,1224,873,766,31,26,7,36,1,107
55025001395,852,572,510,23,4,3,25,2,62
55025001036,4306,3488,2719,110,95,31,520,5,769
55025008004,0,0,0,0,0,0,0,0,0
55025003037,0,0,0,0,0,0,0,0,0
55025001063,40,31,21,1,1,0,8,0,10
55025000917,541,439,405,16,6,12,3,0,34
55121006025,417,319,293,12,2,3,5,0,26
55121005985,277,198,169,25,0,1,2,0,29
55121006015,256,195,191,1,1,0,1,0,4
55087004388,1015,782,755,14,0,9,3,0,27
55087004364,719,567,549,2,1,8,5,0,18
55087004334,2910,2202,1832,141,56,70,84,14,370
55087004371,1949,1878,1464,42,117,69,162,24,414
55087004415,427,319,232,68,2,9,2,0,87
55087004407,2058,1577,1325,85,39,34,79,1,252
55087004397,2020,1559,1330,83,38,40,65,1,229
55017000619,772,563,531,8,0,10,12,0,32
55017000546,856,688,666,5,2,4,9,1,22
55017000540,889,696,666,8,2,9,3,1,30
55017000573,153,133,128,1,1,0,2,0,5
55071003124,879,731,679,4,7,22,7,0,52
55133006588,1946,1473,1388,23,9,11,24,3,85
55133006577,1017,786,738,15,6,2,18,0,48
55133006589,897,691,648,8,2,8,19,0,43
55133006552,819,666,642,9,0,5,2,0,24
55005000085,1076,961,923,5,3,22,2,0,38
55107005386,538,446,411,5,2,13,1,0,35
55107005425,22,18,18,0,0,0,0,0,0
55107005402,156,120,113,3,0,1,0,0,7
55107005431,124,103,94,1,0,8,0,0,9
55133006565,2007,1566,1344,69,30,10,105,3,222
55133006686,1721,1300,1088,55,23,7,113,1,212
55133006816,748,535,495,28,2,7,3,0,40
55133006810,800,664,611,19,6,14,11,0,53
55133006695,523,367,314,15,9,9,18,0,53
55133006638,352,291,277,8,0,1,2,0,14
55133006631,411,352,329,3,2,8,7,0,23
55133006640,575,447,428,8,3,2,4,1,19
55133006633,615,494,481,9,1,1,1,0,13
55005000084,427,313,296,2,6,10,2,0,17
55005000083,533,413,401,2,0,9,1,0,12
55029001635,1005,812,783,7,1,10,3,0,29
55029001636,777,682,636,12,5,16,12,1,46
55017000570,903,675,631,10,3,11,7,0,44
55017000582,1165,909,860,6,2,20,3,0,49
55017000577,972,783,733,17,6,16,9,0,50
55005000109,870,683,643,17,3,16,5,0,40
55005000117,557,468,445,10,0,5,3,0,23
55005000087,701,568,518,30,3,7,4,0,50
55005000155,753,619,589,3,1,12,3,0,30
55005000080,185,153,144,0,0,4,4,0,9
55005000107,802,608,585,6,1,7,5,2,23
55005000120,532,412,376,12,1,10,2,0,36
55005000118,569,438,424,1,2,7,3,0,14
55005000112,308,257,233,14,2,8,0,0,24
55005000113,579,474,452,6,0,9,0,0,22
55005000115,705,545,496,22,3,12,0,0,49
55005000133,451,346,317,8,1,8,6,1,29
55005000134,183,140,131,1,1,3,0,1,9
55005000131,633,469,452,7,1,4,3,1,17
55005000086,743,607,579,12,1,7,3,1,28
55005000150,550,450,433,9,0,3,2,0,17
55005000151,655,462,392,33,7,17,5,0,70
55083004159,395,343,333,1,0,7,0,0,10
55083004181,572,437,427,0,2,8,0,0,10
55083004190,924,722,692,16,1,9,3,0,30
55055002501,531,441,408,19,4,4,3,0,33
55055002520,851,674,625,21,6,17,4,1,49
55055002458,932,717,638,43,9,13,3,1,79
55055002460,1043,734,616,64,8,11,20,0,118
55055002457,0,0,0,0,0,0,0,0,0
55055002459,897,720,675,32,4,5,0,0,45
55055002448,870,684,591,56,9,7,13,3,93
55055002476,1321,1047,952,65,4,15,13,0,95
55139007165,735,572,391,132,11,19,25,0,181
55139007151,1349,1044,849,75,23,23,58,0,195
55139007112,269,212,182,7,2,5,12,0,30
55139007081,962,800,720,15,13,14,28,1,80
55139007232,8,5,4,1,0,0,0,0,1
55139007173,826,686,674,4,0,7,0,0,12
55139007190,241,199,193,2,1,2,0,0,6
55069003085,630,529,518,1,0,1,4,0,11
55069003076,334,288,277,2,1,1,3,0,11
55097004768,529,386,314,33,19,5,22,0,72
55097004778,1244,1119,963,41,27,20,78,0,156
55097008059,0,0,0,0,0,0,0,0,0
55075003394,1315,961,875,21,9,48,6,1,86
55075003391,1237,988,905,24,10,23,8,1,83
55075003389,1436,1109,1028,31,6,24,7,2,81
55075003384,896,740,686,13,8,12,12,3,54
55025000887,947,685,592,44,14,14,22,0,93
55025001370,7,1,0,0,0,0,1,0,1
55025001367,0,0,0,0,0,0,0,0,0
55025001374,1375,1018,764,32,65,18,142,0,254
55025001361,3526,2739,2132,131,149,38,278,1,607
55025001369,362,325,265,19,37,0,4,0,60
55025000889,879,683,637,19,9,7,7,0,46
55025003044,0,0,0,0,0,0,0,0,0
55025001362,1366,970,597,74,100,22,169,0,373
55025001366,0,0,0,0,0,0,0,0,0
55025000906,561,414,386,5,11,0,9,0,28
55025000908,514,438,399,8,12,5,9,0,39
55025001017,734,560,530,4,4,5,15,1,30
55025001022,782,597,536,11,23,10,17,0,61
55025001375,2012,1444,1058,60,50,15,249,5,386
55025000942,581,426,390,20,4,3,5,0,36
55025000943,898,659,616,10,10,6,12,0,43
55025001083,318,279,208,6,55,7,7,1,71
55025001096,3562,3053,2503,192,202,78,76,2,550
55025000929,1048,788,708,31,15,25,9,0,80
55025000930,1002,782,725,22,12,5,15,0,57
55025000850,709,577,566,7,2,1,0,0,11
55025000927,1017,749,706,16,4,9,12,0,43
55025001391,871,710,677,9,5,6,5,0,33
55025001171,2242,1799,1382,140,123,22,124,2,417
55025001152,3737,2952,2474,133,83,32,218,3,478
55083004169,743,585,553,23,0,3,2,0,32
55083004168,537,409,390,9,4,6,1,0,19
55055002508,817,661,642,10,5,3,1,0,19
55055002449,1271,1011,895,78,10,19,10,0,116
55055002447,1372,1031,903,76,11,21,7,1,128
55055002437,1429,1140,996,93,11,23,12,2,144
55025001199,885,638,463,98,52,15,12,1,175
55025001042,1915,1485,742,265,357,24,93,7,743
55025001079,1455,1144,750,109,212,19,56,0,394
55025001078,3454,2944,2564,130,122,48,61,2,380
55025000935,537,425,408,2,0,5,4,1,17
55025000931,136,74,66,2,0,3,3,0,8
55025000928,901,678,643,17,2,1,8,0,35
55025000932,0,0,0,0,0,0,0,0,0
55025000934,957,776,738,24,0,3,9,0,38
55025008075,0,0,0,0,0,0,0,0,0
55025001315,672,552,506,18,20,6,1,1,46
55025001317,734,615,585,15,10,3,2,0,30
55047002297,172,148,143,1,2,1,1,0,5
55035001859,1146,879,779,16,14,10,52,1,100
55017000592,605,435,406,9,12,4,3,0,29
55017000556,381,260,246,10,2,3,0,0,14
55017000550,760,512,502,6,1,1,0,0,10
55017000559,498,380,374,1,1,2,0,1,6
55061002799,723,610,547,26,4,11,10,0,63
55129006301,669,566,527,7,6,20,6,0,39
55129006344,671,504,454,14,4,24,4,0,50
55129006321,442,355,346,1,0,5,0,0,9
55129006325,355,284,274,0,2,7,0,0,10
55129006326,64,54,52,0,0,2,0,0,2
55129006338,509,391,377,5,0,4,1,3,14
55139007145,622,481,448,6,3,12,5,1,33
55139007117,511,398,386,4,0,5,3,0,12
55139007186,669,496,463,12,1,4,5,0,33
55139007239,824,672,633,9,2,11,13,0,39
55139007243,24,21,13,1,1,2,4,0,8
55139007107,32,14,13,0,0,0,0,0,1
55139007156,89,54,38,3,4,0,9,0,16
55139007253,363,300,270,9,5,8,7,1,30
55139007252,91,63,63,0,0,0,0,0,0
55139007141,1630,1182,1057,23,11,19,68,2,125
55139080018,0,0,0,0,0,0,0,0,0
55139007083,724,564,535,16,0,12,2,1,29
55139007235,512,403,379,3,1,12,2,0,24
55139007079,972,779,672,47,18,24,9,2,107
55139007185,905,721,622,55,13,17,9,0,99
55139007228,895,693,632,26,9,9,8,3,61
55007000174,164,129,121,3,2,4,0,0,8
55007000171,244,190,178,2,1,8,0,1,12
55011000412,268,213,211,0,0,1,0,0,2
55105005309,899,706,662,19,2,12,3,0,44
55105005151,1086,767,704,40,7,8,5,0,63
55105005155,335,273,263,2,3,1,3,1,10
55035001861,2824,2280,2031,29,32,33,123,4,249
55035001862,2563,2004,1735,72,41,60,100,0,269
55035001854,2522,2048,1884,28,27,27,70,1,164
55035001924,590,464,438,10,3,7,8,1,26
55073003335,1647,1279,1025,45,20,36,151,1,254
55073003217,1882,1400,1139,66,20,39,123,1,261
55073003220,2047,1531,1174,52,56,28,216,3,357
55073003195,864,695,663,12,1,5,11,0,32
55073003196,636,494,463,19,2,5,7,0,31
55073003300,620,476,445,9,0,12,7,1,31
55073003316,342,262,239,7,5,3,4,0,23
55073003315,853,700,680,3,1,7,1,0,20
55073003305,262,217,209,2,0,6,1,0,8
55073003310,358,281,267,5,1,2,1,0,14
55035001827,1143,866,834,5,1,6,11,0,32
55035001896,0,0,0,0,0,0,0,0,0
55035001890,947,758,617,49,14,5,66,1,141
55035001928,1760,1354,1156,61,29,12,92,1,198
55035001917,0,0,0,0,0,0,0,0,0
55035001895,0,0,0,0,0,0,0,0,0
55035001825,730,566,544,2,0,7,10,1,22
55035001795,427,334,321,4,0,3,1,1,13
55035001923,955,723,641,11,6,3,54,3,82
55035001930,988,793,678,19,11,12,68,0,115
55035001922,248,199,179,1,3,0,15,0,20
55035001898,15,15,9,0,0,0,4,0,6
55035001932,0,0,0,0,0,0,0,0,0
55035001901,4,0,0,0,0,0,0,0,0
55035001814,913,739,684,9,2,2,31,0,55
55035001833,323,224,215,6,1,0,2,0,9
55047002270,276,220,208,1,1,5,3,0,12
55047002275,245,194,180,5,1,4,3,0,14
55047002274,189,162,150,5,0,5,0,0,12
55047002295,387,333,327,1,1,3,0,0,6
55047002294,183,157,151,0,0,3,0,0,6
55047002293,169,150,148,0,0,2,0,0,2
55047002298,738,640,615,2,2,8,6,0,25
55035001927,1419,1153,1051,27,33,13,19,0,102
55035001811,263,202,182,2,2,1,10,0,20
55035001911,0,0,0,0,0,0,0,0,0
55073003216,656,510,485,2,3,3,13,0,25
55073003224,339,208,197,1,0,3,7,1,11
55073003350,825,650,597,16,4,6,24,2,53
55073003367,657,505,460,13,6,7,10,0,45
55073003222,0,0,0,0,0,0,0,0,0
55073003227,514,427,389,4,8,4,25,0,38
55073003296,794,606,555,27,8,12,5,0,51
55035001802,1067,833,793,7,1,13,12,2,40
55035001807,1136,791,759,13,2,7,0,0,32
55035001920,947,741,689,3,5,13,15,5,52
55035001823,813,615,584,6,4,1,12,1,31
55035001926,1118,856,783,17,11,12,22,0,73
55035001808,1153,907,866,4,4,6,18,0,41
55035001910,26,16,16,0,0,0,0,0,0
55035001835,838,668,628,7,5,8,19,1,40
55035001831,413,317,305,6,2,5,0,0,12
55035001794,365,277,269,0,0,1,6,0,8
55035001874,787,600,514,21,6,17,36,3,86
55035001893,527,447,377,26,17,3,22,1,70
55035001886,123,82,76,2,2,0,3,0,6
55047002296,281,229,215,7,0,4,0,0,14
55047002289,889,760,738,8,5,4,2,0,22
55047002288,523,426,408,6,6,2,1,0,18
55047002291,443,370,355,6,8,1,0,0,15
55087004487,695,578,543,1,3,11,16,1,35
55087004379,892,732,646,22,13,3,46,0,86
55087004348,1869,1435,1228,63,44,21,82,0,207
55087004490,1641,1127,1012,24,26,10,59,0,115
55087004350,2861,2214,1958,54,41,31,127,0,256
55087004488,0,0,0,0,0,0,0,0,0
55087004324,44,30,26,0,0,2,2,0,4
55087003010,0,0,0,0,0,0,0,0,0
55087004368,50,29,28,1,0,0,0,0,1
55087004462,1856,1450,1304,54,13,20,53,1,146
55087004363,14,10,4,2,0,0,4,0,6
55087003012,0,0,0,0,0,0,0,0,0
55087004352,1839,1275,1126,37,22,6,77,1,149
55087004461,421,317,306,5,2,3,1,1,11
55087004333,1215,927,791,68,12,42,10,0,136
55087004479,0,0,0,0,0,0,0,0,0
55087004434,615,452,442,1,3,5,1,0,10
55087004384,2016,1705,1397,92,58,27,114,9,308
55087004398,1481,1157,1010,39,26,25,46,2,147
55087004427,691,523,474,25,4,13,1,1,49
55087004315,841,660,618,22,2,16,1,0,42
55087004356,873,607,576,17,3,12,2,0,31
55087004288,1141,885,766,64,22,7,28,0,119
55087004318,1546,1133,1030,47,8,18,16,3,103
55087004432,997,771,723,15,11,8,6,0,48
55087004327,1074,729,677,11,6,9,23,1,52
55087004399,579,444,433,1,0,10,0,0,11
55087004403,819,609,533,22,16,21,18,1,76
55087004308,749,593,529,23,14,10,18,0,64
55087004351,2011,1473,1218,116,42,29,70,3,255
55087004433,36,36,31,0,5,0,0,0,5
55087004316,2244,1688,1339,141,51,54,96,2,349
55087004341,0,0,0,0,0,0,0,0,0
55087004346,272,226,188,11,8,6,14,0,38
55087004367,2939,2183,1532,243,96,56,237,1,651
55087004366,1863,1373,1075,59,29,29,173,7,298
55087004463,1377,1096,952,40,23,19,63,0,144
55087004297,1135,840,802,11,2,14,7,0,38
55087004446,1800,1415,1245,55,16,28,65,0,170
55087004285,2055,1679,1501,54,21,35,65,0,178
55087004421,826,654,624,8,0,13,1,0,30
55087004440,806,621,593,9,4,10,4,0,28
55087004469,591,464,441,8,2,2,0,1,23
55065002969,505,355,273,75,5,0,2,0,82
55065002985,402,311,255,42,3,4,4,0,56
55065002954,483,385,300,71,4,9,0,0,85
55065002976,447,315,228,78,0,0,6,3,87
55065002955,196,150,129,14,0,6,1,0,21
55023000817,461,350,344,0,0,0,0,0,6
55023000818,270,217,210,3,2,5,0,0,7
55051002366,320,293,275,4,4,5,0,0,18
55051002361,172,133,127,0,2,3,1,0,6
55051002371,521,447,428,3,1,7,1,1,19
55133006619,2483,1988,1707,70,59,33,114,0,281
55133006590,988,798,701,35,18,11,33,0,97
55133006780,1312,1043,958,31,7,15,16,3,85
55063002915,557,438,418,12,1,6,0,0,20
55063002937,617,483,448,22,3,2,3,2,35
55063002899,99,77,72,3,1,3,0,0,5
55063002910,984,723,687,9,6,9,12,0,36
55081004111,131,120,51,34,30,3,23,20,69
55103005106,479,376,328,23,3,11,11,0,48
55081004117,759,579,551,13,2,14,2,0,28
55081004090,358,281,254,6,4,18,0,0,27
55081004098,0,0,0,0,0,0,0,0,0
55081004119,11,5,0,0,2,0,0,0,5
55081004118,481,360,312,16,13,16,3,0,48
55081004091,658,528,471,8,6,29,7,0,57
55081004093,33,23,19,3,0,1,0,0,4
55081004070,5,5,5,0,0,0,0,0,0
55081004103,673,530,442,20,11,46,8,0,88
55081004140,812,602,558,15,1,27,4,0,44
55081004088,931,682,628,17,13,7,12,0,54
55081004123,502,382,337,21,7,7,7,1,45
55081004054,654,502,459,17,6,3,7,0,43
55117005913,736,592,570,10,4,7,1,0,22
55117005909,1221,1088,702,69,283,33,9,0,386
55117005907,81,81,32,7,34,8,2,0,49
55117005908,927,837,560,49,196,15,12,0,277
55117005857,313,254,244,4,0,5,0,0,10
55117005825,3161,2621,1953,206,91,40,324,8,668
55117005915,3111,2423,1881,254,64,21,196,1,542
55117005851,1942,1504,1163,118,24,31,172,0,341
55117005852,2779,2073,1653,202,41,29,144,0,420
55117005847,377,324,280,12,6,5,19,1,44
55117005848,680,551,503,16,0,1,31,0,48
55117005880,879,724,665,9,4,7,38,0,59
55117005834,936,714,691,4,6,4,1,0,23
55077003461,960,794,760,8,3,17,2,2,34
55077003459,356,293,278,4,2,5,3,0,15
55077003448,748,650,624,7,4,7,3,3,26
55077003450,400,321,309,0,4,4,5,0,12
55077003438,366,296,277,7,2,8,4,1,19
55077003437,362,297,269,7,1,7,4,0,28
55117005874,882,720,700,5,0,8,4,0,20
55035001799,809,643,601,12,4,17,3,1,42
55047002286,495,392,372,16,1,1,1,0,20
55029001624,751,636,616,3,0,6,6,0,20
55029001610,385,319,302,7,0,0,8,0,17
55029001634,377,311,292,7,3,10,2,0,19
55051002377,435,408,402,3,2,0,1,0,6
55051002369,286,265,259,3,0,2,0,0,6
55065002944,112,74,54,19,0,1,0,0,20
55065002943,280,207,185,19,1,0,2,0,22
55003000053,757,591,450,3,17,109,8,0,141
55025001098,1445,1227,933,91,137,28,39,8,294
55025000912,1175,734,659,31,18,10,25,1,75
55025000911,850,551,492,17,12,5,21,0,59
55025000913,0,0,0,0,0,0,0,0,0
55025000924,923,734,692,18,3,0,11,0,42
55025000922,588,482,453,9,4,0,14,1,29
55025001421,1453,1083,1028,18,9,6,20,2,55
55025001396,1626,1283,1099,54,35,28,64,1,184
55025000996,1945,1483,1252,84,55,16,68,1,231
55025000995,1847,1654,1132,102,341,39,42,2,522
55025000997,966,789,685,41,20,9,29,0,104
55025000902,669,549,532,5,4,2,3,0,17
55025000910,1088,745,634,48,26,4,23,2,111
55025001390,677,529,469,35,6,13,15,1,60
55025001340,951,764,719,11,6,6,17,0,45
55025001147,1103,828,393,115,225,33,69,2,435
55025001006,2013,1401,513,545,237,57,102,2,888
55025001009,1529,1078,435,446,121,37,69,0,643
55025001115,2975,2870,2200,189,125,52,298,9,670
55025001114,4869,4520,3692,249,236,39,300,9,828
55025001124,4736,4571,3649,227,151,44,488,4,922
55025001122,2262,2183,1642,110,145,30,237,2,541
55025001123,1663,1605,1115,98,277,26,94,6,490
55091004596,654,495,471,5,1,6,6,0,24
55091004595,601,449,417,14,6,14,3,0,32
55091004599,423,332,315,4,3,5,1,1,17
55007000161,289,230,202,3,1,17,2,0,28
55007000178,101,67,54,0,2,11,0,0,13
55049002316,844,632,590,15,5,12,2,0,42
55117005840,365,311,296,9,0,4,2,0,15
55117005833,611,481,434,31,2,8,0,0,47
55117005900,748,596,551,18,2,5,18,1,45
55117005821,2483,1748,1096,284,104,37,218,6,652
55117005919,2001,1561,1195,113,40,20,188,0,366
55117005820,2437,1862,1409,162,49,32,209,2,453
55117005917,1408,1119,940,71,19,19,66,0,179
55117005923,432,351,308,14,1,7,16,0,43
55117005918,617,451,405,10,1,3,24,0,46
55117005916,14,13,8,0,3,0,0,0,5
55117005897,931,707,614,16,4,7,62,2,93
55117005903,892,788,753,9,4,9,8,2,35
55117005904,478,409,397,3,2,3,3,0,12
55117005846,1577,1248,1026,69,33,19,99,0,222
55117005924,1921,1447,1170,70,72,16,112,2,277
55117005914,890,724,662,12,3,7,36,2,62
55117005929,1071,827,732,25,5,14,37,0,95
55131006458,2210,1837,1656,114,20,24,13,1,181
55131006397,1599,1156,1061,49,15,13,12,2,95
55131006472,1906,1480,1334,58,29,28,18,3,146
55131006391,1708,1314,1193,44,37,24,8,1,121
55131006352,1209,905,819,19,17,8,40,0,86
55131006363,961,822,731,22,37,13,21,2,91
55131006427,1123,855,764,41,15,13,10,5,91
55131006470,1368,1070,976,59,15,24,1,0,94
55139007223,1055,787,706,29,6,16,14,0,81
55139007077,1817,1481,1225,79,11,23,136,0,256
55139007092,979,744,718,13,0,6,4,0,26
55139007122,859,670,637,7,2,14,3,0,33
55107005426,298,257,252,1,1,1,1,0,5
55107005387,103,91,85,5,0,0,0,0,6
55107005390,542,433,416,9,0,4,0,1,17
55107005393,443,322,309,6,0,2,1,0,13
55107005450,0,0,0,0,0,0,0,0,0
55107005411,88,66,58,1,0,2,1,0,8
55005000156,818,657,622,12,5,11,1,0,35
55005000152,554,435,372,20,2,22,6,0,63
55005000153,515,406,364,22,3,11,1,0,42
55075003417,693,637,608,8,2,10,3,0,29
55073003301,672,524,510,1,3,4,5,0,14
55073003302,672,513,488,10,0,5,8,0,25
55073003303,714,553,520,12,1,14,4,0,33
55073003268,974,731,668,16,3,11,30,2,63
55073003274,840,715,635,7,7,10,49,1,80
55073003229,1821,1371,1039,47,33,37,198,3,332
55073003238,526,414,366,9,4,5,24,0,48
55073003345,510,398,378,9,0,0,2,0,20
55073003354,462,357,338,7,1,7,4,2,19
55073003341,544,391,374,10,0,1,5,0,17
55073003255,490,382,350,9,3,11,6,1,32
55073003250,759,605,531,4,6,7,54,1,74
55073003357,413,318,297,1,2,6,12,0,21
55073003365,9,5,3,0,1,1,0,0,2
55073003361,3,2,0,0,2,0,0,0,2
55073003362,0,0,0,0,0,0,0,0,0
55073003212,8,4,0,0,1,0,3,0,4
55073003209,0,0,0,0,0,0,0,0,0
55073003201,873,649,629,10,1,3,1,0,20
55073003236,635,469,451,12,1,4,0,0,18
55073003241,1010,801,736,26,1,12,23,1,65
55073003271,648,493,453,3,5,21,5,1,40
55073003342,830,588,560,7,2,6,4,1,28
55073003314,515,431,415,7,1,3,1,0,16
55073003368,518,397,346,4,5,3,36,0,51
55073003371,441,355,311,8,9,7,24,1,44
55073003248,1684,1136,943,13,5,17,142,0,193
55073003286,621,507,480,7,2,7,5,0,27
55073003352,947,717,694,5,7,4,4,0,23
55073003344,1006,763,718,6,1,11,19,1,45
55073003353,0,0,0,0,0,0,0,0,0
55121005998,452,359,330,21,0,7,2,1,29
55121005989,437,324,300,12,2,8,1,1,24
55087004435,23,23,18,1,1,3,0,0,5
55087004451,1991,1384,1288,32,10,20,25,0,96
55087004452,2366,1721,1494,169,3,17,28,0,227
55057002580,427,311,291,3,0,5,4,1,20
55057002583,194,152,139,3,0,3,0,0,13
55057002579,283,212,202,4,2,3,1,0,10
55121005978,1061,807,769,17,4,6,5,0,38
55005000104,712,516,485,5,0,14,5,0,31
55057002537,300,245,231,4,1,4,2,0,14
55057002535,547,433,422,4,0,1,1,0,11
55057002536,155,130,129,0,0,0,0,0,1
55057002547,104,79,67,1,0,4,2,0,12
55057002546,488,399,372,9,0,7,5,2,27
55057002559,528,420,381,8,7,14,10,0,39
55057002560,1209,1135,728,66,288,44,14,0,407
55057002561,13,13,12,0,0,0,0,0,1
55057002555,305,240,210,7,2,15,2,0,30
55057002582,178,132,113,0,2,2,4,0,19
55057002584,253,240,157,8,63,9,2,0,83
55121006008,629,534,495,21,4,8,0,0,39
55121006027,174,139,113,26,0,0,0,0,26
55073003297,784,582,538,8,6,6,20,0,44
55073003283,663,547,520,8,5,2,7,1,27
55073003293,1135,902,837,8,5,14,34,0,65
55073003247,677,479,355,99,0,17,3,0,124
55073003235,756,534,508,7,3,12,1,0,26
55073003225,610,450,233,204,2,7,5,0,217
55073003273,976,766,701,7,6,11,39,1,65
55073003200,859,629,599,25,1,2,1,1,30
55073003265,885,705,627,18,13,15,29,1,78
55073003279,565,452,443,2,2,4,1,0,9
55073003311,637,528,504,5,5,4,4,2,24
55073003292,404,330,305,10,1,9,5,0,25
55073003282,786,597,539,14,1,8,29,0,58
55073003294,867,678,645,3,0,13,10,0,33
55073003280,531,420,376,14,11,10,6,0,44
55073003291,841,645,620,2,3,9,11,0,25
55073003263,664,529,490,9,3,7,23,0,39
55073003256,646,477,353,12,3,15,80,1,124
55073003260,1405,1070,927,32,20,25,68,0,143
55073003326,789,607,577,6,1,3,12,0,30
55069003041,699,534,511,12,2,3,1,0,23
55069003034,338,255,234,12,2,7,2,0,21
55097004810,451,334,284,26,3,7,14,0,50
55097004811,1916,1437,1209,120,25,24,64,2,228
55097004803,1637,1299,1114,75,29,15,51,1,185
55097004786,886,733,591,34,28,22,50,0,142
55097004795,794,629,564,13,15,6,29,0,65
55097004779,849,674,612,13,5,15,30,1,62
55097004793,897,743,673,24,0,11,34,1,70
55097004788,859,759,669,28,24,19,19,0,90
55097004790,668,538,462,31,6,11,26,0,76
55097004792,640,499,467,9,6,4,13,1,32
55097004846,0,0,0,0,0,0,0,0,0
55097004740,685,553,503,14,0,9,19,0,50
55139007146,2403,2021,1770,70,60,38,63,0,251
55139007229,2725,2220,1738,183,133,36,123,2,482
55139003030,0,0,0,0,0,0,0,0,0
55139007078,2264,2026,1841,39,23,27,95,1,185
55139007212,566,405,335,31,6,21,10,0,70
55139007214,447,320,283,29,2,3,5,0,37
55139007134,2433,1867,1632,67,68,44,60,2,235
55139007070,2153,1665,1469,37,41,40,78,2,196
55021000744,777,584,493,63,2,14,6,2,91
55021000746,491,378,356,11,2,3,3,0,22
55021000749,762,550,531,10,2,4,0,0,19
55139007211,445,356,335,4,5,8,1,0,21
55069003052,591,456,443,1,0,5,3,0,13
55069003056,588,471,454,4,1,7,3,1,17
55069003054,705,564,545,5,1,8,5,0,19
55069003069,458,411,397,5,1,7,2,1,14
55097004764,824,623,558,25,11,8,20,1,65
55139007234,1435,1044,891,85,7,13,38,2,153
55139007096,1472,1216,1120,27,11,15,41,0,96
55139007113,1228,1013,861,104,7,16,16,1,152
55139007191,9,5,0,2,0,3,0,0,5
55139080025,0,0,0,0,0,0,0,0,0
55139007072,0,0,0,0,0,0,0,0,0
55139007074,0,0,0,0,0,0,0,0,0
55139007238,0,0,0,0,0,0,0,0,0
55139080026,0,0,0,0,0,0,0,0,0
55139007067,0,0,0,0,0,0,0,0,0
55139007188,811,631,525,65,11,21,17,0,106
55139007242,1432,1167,984,64,46,25,50,0,183
55139007080,0,0,0,0,0,0,0,0,0
55139080024,0,0,0,0,0,0,0,0,0
55139080023,0,0,0,0,0,0,0,0,0
55139007179,865,634,606,8,1,4,10,1,28
55139007075,2,1,0,0,1,1,0,0,1
55139007065,917,743,705,15,7,9,4,0,38
55139007181,512,432,431,1,0,0,0,0,1
55139007148,553,449,419,6,8,9,3,0,30
55139007225,659,483,460,8,1,6,0,0,23
55061002804,932,729,685,34,2,4,1,0,44
55089004516,829,670,626,24,9,6,5,0,44
55089004559,830,645,602,15,6,4,14,0,43
55089004495,1167,925,764,35,57,8,59,0,161
55089004584,1753,1448,1199,47,124,6,73,0,249
55089004505,780,655,565,27,15,6,39,0,90
55089004551,1003,718,627,6,17,13,50,0,91
55089004531,1524,1225,1063,34,49,8,62,0,162
55089004508,811,635,588,20,7,4,12,0,47
55021000747,670,550,530,4,2,7,2,0,20
55021000768,775,591,567,7,2,8,2,0,24
55021000748,344,266,246,11,1,3,1,0,20
55021000790,407,324,302,8,3,4,3,0,22
55021000796,855,686,655,15,4,5,2,0,31
55021000799,1005,758,672,25,27,18,9,0,86
55021000791,775,697,667,10,5,2,4,0,30
55069003029,563,423,402,12,2,4,1,0,21
55069003028,288,235,202,13,6,8,3,2,33
55069003030,155,119,99,4,5,4,7,0,20
55069003039,715,577,548,9,2,9,4,0,29
55053002383,756,587,550,4,1,14,4,0,37
55053002412,561,429,401,6,0,12,2,0,28
55053002415,477,377,357,11,0,8,1,0,20
55053002413,90,75,70,2,0,2,0,0,5
55053002410,693,441,427,3,0,8,0,0,14
55053002425,1086,843,627,25,10,176,10,1,216
55087004423,1013,763,735,8,3,4,3,1,28
55087004284,2397,1722,1593,49,16,34,20,0,129
55087004338,949,746,704,6,3,12,17,0,42
55087004392,1332,998,904,41,15,12,16,1,94
55087004378,2023,1570,1466,23,12,42,24,1,104
55087080015,0,0,0,0,0,0,0,0,0
55087004383,1949,1456,1367,29,17,30,9,0,89
55087003011,9,7,4,0,3,0,0,0,3
55087080014,12,6,0,0,0,3,3,0,6
55087004486,8,5,1,2,0,2,0,0,4
55087004478,0,0,0,0,0,0,0,0,0
55057002578,802,604,568,7,9,7,4,0,36
55057002576,582,487,463,14,0,6,1,0,24
55001000043,540,459,441,2,5,5,2,0,18
55057002533,705,596,521,48,3,20,1,0,75
55057002566,444,353,332,4,2,9,1,0,21
55001000036,372,308,275,11,2,12,0,1,33
55121006022,240,176,169,2,3,2,0,0,7
55121005992,150,122,120,1,0,0,1,1,2
55121006021,436,316,280,21,5,4,1,0,36
55121005993,552,374,366,3,2,1,1,0,8
55139007101,2501,1954,1690,73,78,53,47,0,264
55139007119,1308,1036,891,54,28,17,42,0,145
55139007198,960,766,704,22,6,15,17,0,62
55139007204,1143,962,859,28,22,25,22,0,103
55139007159,1351,1052,969,36,14,8,16,2,83
55139007062,4,1,1,0,0,0,0,0,0
55139007114,576,435,416,9,0,3,6,0,19
55139007124,532,430,413,4,3,3,3,0,17
55139007073,857,604,549,12,4,12,20,1,55
55139007189,2234,2181,1350,142,606,76,25,0,831
55139007177,871,645,494,13,19,11,107,2,151
55139007233,773,644,588,6,10,10,25,1,56
55139007249,1836,1495,1227,44,75,14,130,2,268
55139007187,1889,1514,1302,41,63,32,61,0,212
55139007149,633,495,420,9,36,5,20,0,75
55139007144,2421,1874,1608,55,74,28,112,3,266
55139007196,245,193,175,4,4,1,11,0,18
55069003082,123,104,100,3,0,0,0,0,4
55069003073,479,374,351,4,0,10,2,0,23
55139007126,45,35,34,0,1,0,0,0,1
55139007246,870,720,692,6,3,7,10,1,28
55139007192,771,544,464,16,12,14,40,0,80
55021000722,781,589,555,17,1,2,9,5,34
55021000723,589,460,439,8,1,3,1,2,21
55021000740,658,563,527,9,0,10,7,0,36
55013000461,732,578,530,11,8,13,6,0,48
55013000452,303,224,196,9,4,12,3,0,28
55013000437,295,225,219,4,0,1,2,0,6
55095004710,458,369,345,10,5,8,0,0,24
55095004709,476,420,402,3,5,6,2,0,18
55095004712,798,656,617,11,5,15,2,0,39
55095004713,78,56,54,2,0,0,0,0,2
55095004714,0,0,0,0,0,0,0,0,0
55095004697,554,440,420,7,2,7,0,0,20
55095004727,550,396,358,8,7,18,2,0,38
55095004711,705,541,513,11,2,16,1,0,28
55095004717,640,516,435,13,4,60,0,0,81
55133006711,1291,1008,942,24,11,9,16,0,66
55133006753,2215,1717,1264,58,59,17,301,1,453
55071003098,814,655,636,6,0,6,7,0,19
55071003168,1446,1121,798,125,52,52,101,1,323
55071003171,1514,1222,1028,34,14,43,102,0,194
55071003179,3,2,1,1,0,0,0,0,1
55071003143,614,524,498,6,3,7,9,0,26
55071003133,679,560,537,4,0,9,4,0,23
55071003178,659,518,494,10,8,5,1,1,24
55013000426,576,472,370,2,8,83,1,1,102
55013000427,470,387,344,3,7,36,2,1,43
55095004721,948,750,724,11,1,5,7,0,26
55013000440,545,428,379,5,2,41,0,2,49
55029001644,595,483,465,5,2,9,1,0,18
55029001643,711,555,481,32,12,16,11,2,74
55029001654,595,507,459,24,4,8,5,0,48
55029001642,610,490,450,12,5,15,1,0,40
55029001641,695,551,476,44,15,11,4,0,75
55013000424,350,319,301,1,2,10,0,0,18
55013000463,233,218,215,1,1,1,0,0,3
55089004522,1098,1004,952,18,8,10,8,1,52
55089004525,944,738,650,32,19,24,11,1,88
55089004499,1034,849,773,15,12,8,40,1,76
55089004581,825,686,637,9,2,2,36,0,49
55089004580,883,638,519,13,5,11,81,1,119
55005000139,657,548,503,26,4,13,3,0,45
55005000138,1052,883,843,11,2,20,5,0,40
55005000144,692,534,493,9,9,17,2,1,41
55005000143,747,611,544,18,8,24,10,1,67
55005000088,800,656,613,15,5,12,4,0,43
55005000149,485,389,329,24,4,15,6,0,60
55005000145,591,485,457,11,4,8,5,0,28
55005000135,668,509,421,32,11,16,18,1,88
55005000146,1338,1133,1046,17,15,15,34,0,87
55005000108,846,699,670,7,0,7,7,0,29
55039002043,923,750,647,75,4,17,5,0,103
55101005043,573,474,445,12,3,7,2,0,29
55101005040,479,393,355,17,7,7,0,0,38
55101004951,2421,1849,1185,371,221,28,42,5,664
55101004956,2659,2030,1334,345,286,30,24,0,696
55101004960,1861,1414,770,282,289,50,34,3,644
55101004957,2591,1757,943,299,471,54,11,3,814
55101004890,1406,1045,909,87,12,22,13,0,136
55101005016,613,452,413,18,8,13,1,1,39
55101005021,1567,1273,1121,110,13,15,5,2,152
55101005017,2070,1577,1407,101,13,26,23,2,170
55101004997,720,557,438,64,27,9,17,3,119
55101004946,1374,930,160,353,426,27,1,1,770
55101004933,1438,984,199,321,455,20,4,3,785
55101004945,1555,1034,149,460,407,41,7,1,885
55101004988,931,686,644,20,2,6,7,0,42
55101005061,704,563,493,45,6,17,1,1,70
55101005060,583,470,418,28,1,9,1,1,52
55097004806,1601,1245,1092,44,12,14,83,0,153
55097004805,1547,1154,1035,29,24,19,49,3,119
55097004800,1550,1205,1117,22,9,15,46,0,88
55025000974,373,302,293,1,0,0,1,0,9
55025000976,193,158,153,0,0,3,1,0,5
55025000979,187,156,151,3,0,1,1,0,5
55025000981,561,464,441,7,2,4,7,0,23
55025001346,1618,1262,1138,38,36,20,24,5,124
55025001389,801,646,560,25,9,7,36,0,86
55025000904,803,587,484,29,20,12,41,0,103
55025003034,0,0,0,0,0,0,0,0,0
55025003035,7,3,0,1,0,1,1,1,3
55025001363,1629,1290,1094,69,36,21,68,0,196
55025001387,913,681,611,26,15,9,17,0,70
55025001376,1642,1245,977,65,146,23,25,1,268
55025001003,1147,871,722,37,19,11,75,0,149
55025001001,808,595,458,26,25,14,77,0,137
55025001004,1679,1412,1162,90,57,14,74,0,250
55025001002,1132,956,678,94,126,27,44,1,278
55025001179,453,389,278,32,47,9,28,1,111
55025001149,2458,1674,594,643,363,60,58,3,1080
55025000938,1117,843,779,20,9,8,18,2,64
55025001121,1276,1257,857,92,79,25,228,0,400
55025001026,153,117,95,7,10,2,1,0,22
55025001143,3557,2661,1246,717,483,91,165,0,1415
55025000921,982,786,725,30,6,10,11,2,61
55025003045,38,22,6,9,3,2,0,0,16
55025001039,3985,3466,2691,138,100,31,510,0,775
55025001165,1202,1124,799,101,124,11,90,0,325
55025001049,13,3,0,2,1,0,0,0,3
55025001267,377,300,267,12,4,5,17,1,33
55025001064,105,89,74,2,7,0,4,0,15
55025001276,813,616,557,15,6,6,25,1,59
55025001055,0,0,0,0,0,0,0,0,0
55025001038,0,0,0,0,0,0,0,0,0
55025001032,2283,1668,916,156,198,21,377,0,752
55025001052,0,0,0,0,0,0,0,0,0
55025001057,0,0,0,0,0,0,0,0,0
55025001053,0,0,0,0,0,0,0,0,0
55025001037,0,0,0,0,0,0,0,0,0
55025003043,0,0,0,0,0,0,0,0,0
55025001013,1809,1510,1300,62,51,20,93,1,210
55025001014,2098,1858,1577,113,61,20,87,3,281
55025001012,1531,1314,776,280,177,17,70,0,538
55025000999,1408,1253,1009,66,47,19,107,2,244
55025003039,0,0,0,0,0,0,0,0,0
55025001146,1965,1551,537,382,268,48,336,4,1014
55025000993,530,440,405,6,1,9,9,0,35
55025000991,801,659,626,8,1,5,7,1,33
55025001230,931,647,519,15,9,11,91,1,128
55025001231,1084,917,683,72,81,25,57,0,234
55025001233,835,678,558,39,29,13,34,0,120
55025001229,720,575,469,23,26,12,47,1,106
55025001232,1389,1151,966,72,24,10,70,2,185
55043002153,356,289,263,8,4,13,0,0,26
55043002150,331,271,265,3,1,2,1,0,6
55043002118,645,540,531,1,2,4,0,0,9
55043002117,814,635,622,5,4,0,2,0,13
55043002186,602,443,421,2,7,10,0,1,22
55043002162,285,194,192,1,0,1,0,0,2
55043002163,95,45,45,0,0,0,0,0,0
55043002144,580,427,398,18,4,5,2,0,29
55043002157,836,646,610,7,3,11,5,0,36
55043002158,768,586,571,7,0,0,1,0,15
55025001140,2399,2037,1661,102,109,47,98,3,376
55025001094,1956,1643,1198,161,168,50,68,4,445
55025000852,940,728,689,15,12,8,5,0,39
55025000854,510,415,394,3,3,0,1,0,21
55025001209,442,380,359,7,1,0,6,0,21
55101005014,643,495,438,32,6,16,2,3,57
55101004990,550,441,426,8,0,2,2,1,15
55101005019,843,704,661,21,2,9,8,1,43
55101004936,2428,1645,408,650,587,50,6,2,1237
55101004937,2673,1954,851,519,547,46,16,0,1103
55101004929,1995,1595,831,190,552,25,20,2,764
55111005610,1085,844,791,16,2,15,5,1,53
55111005600,781,627,584,28,5,7,1,0,43
55111005624,839,594,583,4,2,3,0,0,11
55111005670,470,357,346,4,2,4,0,1,11
55111005597,162,136,135,1,0,0,0,0,1
55111005677,468,349,344,1,1,0,0,0,5
55111005671,388,310,298,4,2,1,2,0,12
55111005687,506,411,375,17,3,11,5,0,36
55111005595,686,493,347,14,6,127,1,2,146
55111005668,309,253,231,4,1,13,3,1,22
55111005653,360,250,163,72,6,7,2,0,87
55111005614,1499,1222,728,396,38,40,21,2,494
55111005657,0,0,0,0,0,0,0,0,0
55111005628,1014,886,670,131,50,23,11,3,216
55111005654,20,5,4,1,0,0,0,0,1
55111005655,4,0,0,0,0,0,0,0,0
55123006076,702,533,513,9,6,3,3,1,20
55123006045,358,289,277,3,3,0,4,0,12
55123006099,341,253,236,3,1,5,0,0,17
55131006452,615,500,466,13,0,7,8,0,34
55131006388,981,804,756,26,6,12,3,0,48
55131006383,842,698,687,7,0,0,1,0,11
55077003468,585,474,454,6,3,5,2,1,20
55077003446,452,418,408,4,1,3,2,0,10
55123006086,224,159,146,3,1,3,2,0,13
55123006082,721,450,436,2,3,3,3,0,14
55123006087,104,83,82,0,0,0,1,0,1
55123006081,57,45,45,0,0,0,0,0,0
55123006065,730,577,550,10,0,6,5,0,27
55123006066,184,144,138,4,0,1,0,0,6
55025001448,987,818,739,22,12,12,23,3,79
55025001452,1132,781,713,30,9,9,16,1,68
55113005734,502,421,398,4,1,10,0,0,23
55123006079,958,696,677,4,2,8,2,0,19
55123006077,148,109,105,1,2,0,1,0,4
55025000915,0,0,0,0,0,0,0,0,0
55025000918,0,0,0,0,0,0,0,0,0
55025000907,877,635,596,8,7,13,16,0,39
55025001150,2436,1980,1644,93,108,38,107,3,336
55025001313,1290,866,795,30,16,12,9,0,71
55025001322,908,707,683,12,1,2,5,0,24
55025001312,1917,1208,1093,21,18,9,53,2,115
55025001308,617,467,428,13,9,10,3,0,39
55025001320,678,537,506,8,5,7,6,0,31
55025001085,2472,1864,1135,227,235,33,244,4,729
55025001019,1100,783,745,12,4,5,17,0,38
55025001018,677,500,472,3,7,9,7,0,28
55025001024,678,539,509,17,2,2,8,1,30
55101004998,660,503,456,18,6,8,5,0,47
55101004941,2944,2136,1135,525,427,60,17,3,1001
55101004944,2037,1462,359,473,597,50,4,3,1103
55101005056,2425,1790,1087,307,336,62,18,2,703
55101004942,2331,1796,888,439,428,45,11,7,908
55101004954,2925,2221,1726,241,215,22,23,4,495
55101004959,2104,1467,665,267,509,17,9,0,802
55123006088,550,427,413,1,0,10,0,0,14
55111005693,1326,1021,944,20,18,21,6,0,77
55111005662,718,580,474,46,29,24,10,4,106
55111005641,709,521,475,16,13,10,6,1,46
55101004961,1628,1260,1028,121,77,23,18,2,232
55101004940,1693,1287,935,189,118,26,7,3,352
55101004938,1704,1321,986,217,101,21,9,1,335
55101004939,2135,1530,898,277,306,32,20,1,632
55101005036,822,694,647,19,2,15,5,0,47
55101004928,794,641,621,13,0,5,4,1,20
55101004926,661,504,451,18,1,10,13,0,53
55101005034,846,675,644,20,1,1,8,0,31
55101005018,663,557,519,16,3,8,4,0,38
55101005031,571,445,425,8,1,3,8,0,20
55101005046,551,434,416,11,1,5,0,2,18
55101004974,782,600,549,18,4,14,11,2,51
55101004986,643,521,484,26,0,6,3,2,37
55025000883,1026,729,667,24,19,6,6,0,62
55025001333,945,770,710,12,9,9,13,1,60
55113005710,116,106,57,5,2,49,0,0,49
55113005716,615,379,42,6,4,335,0,2,337
55113005722,535,419,310,5,1,106,2,0,109
55113005720,616,494,432,8,2,50,0,0,62
55113005705,565,486,428,7,31,15,1,0,58
55113005713,435,416,396,7,0,4,1,0,20
55043002182,215,156,142,5,2,5,0,0,14
55043002119,594,451,410,18,5,1,9,0,41
55043002193,561,411,393,4,0,4,8,0,18
55043002121,1900,1736,1617,39,22,18,39,1,119
55043002194,405,306,286,7,1,2,6,0,20
55025000978,110,79,75,1,1,2,0,0,4
55025000975,457,381,354,8,1,5,3,1,27
55025001355,1820,1345,1247,31,17,8,26,0,98
55025001359,1664,1342,1213,53,32,13,27,0,129
55025008006,8,2,0,0,0,0,0,0,2
55025001356,1702,1235,1062,61,47,18,29,0,173
55025001031,849,693,470,75,82,12,58,2,223
55025001311,901,643,581,27,7,7,12,2,62
55025001326,457,404,395,5,1,2,3,0,9
55025001347,1523,1264,1154,21,45,17,27,2,110
55025003040,0,0,0,0,0,0,0,0,0
55025001016,971,764,706,18,8,12,15,2,58
55025001177,1056,843,391,275,107,39,51,2,452
55025001182,2,1,1,0,0,0,0,0,0
55025001188,617,460,138,199,115,8,15,0,322
55025001103,2456,1660,819,179,507,33,130,5,841
55025001381,2145,1574,1369,47,40,25,85,3,205
55025001382,2096,1555,1118,81,279,19,60,3,437
55025001373,1898,1300,1131,28,35,13,71,1,169
55025001132,3694,3342,2335,112,57,28,776,2,1007
55025000945,885,706,666,15,5,5,14,0,40
55017000545,857,643,610,8,2,14,2,0,33
55017000564,643,540,524,7,0,6,3,1,16
55017000571,233,169,164,0,0,1,3,0,5
55087004309,697,465,447,5,1,2,7,0,18
55087004459,593,475,451,11,0,7,2,0,24
55087004477,0,0,0,0,0,0,0,0,0
55087004381,759,576,545,4,1,7,16,0,31
55087004443,1599,1270,1056,83,26,24,81,0,214
55087004426,673,517,487,9,0,11,6,0,30
55025001157,2176,1592,1294,54,22,16,189,2,298
55107005436,554,472,457,4,3,10,2,0,15
55107005391,103,84,81,1,1,3,0,0,3
55107005440,330,267,246,5,2,3,3,0,21
55087004347,2010,1566,1374,49,31,56,33,4,192
55057002568,560,447,397,20,10,15,6,0,50
55057002573,592,456,414,19,6,13,0,0,42
55057002590,666,503,487,3,2,11,3,0,16
55057002594,383,304,295,0,1,8,0,0,9
55121005980,651,498,486,5,0,5,2,0,12
55121005981,634,507,487,9,1,11,0,1,20
55123006097,617,440,432,4,3,2,0,0,8
55117005813,2736,2230,1722,216,108,38,151,10,508
55117005819,1334,1005,663,191,64,27,63,2,342
55117005818,2141,1689,1146,208,102,55,179,6,543
55117005870,398,309,279,10,3,4,6,1,30
55117005868,736,573,531,12,5,7,10,0,42
55117005869,747,588,550,14,0,13,8,0,38
55117005867,689,526,497,7,1,3,7,0,29
55117005843,952,806,747,26,16,7,7,1,59
55117005901,609,500,472,13,6,7,7,1,28
55117005830,2011,1407,1034,132,40,34,160,5,373
55117005812,1687,1278,1045,94,35,23,69,1,233
55117005811,1432,1062,891,62,28,23,52,1,171
55117005810,2032,1610,1308,123,22,12,130,2,302
55117005828,2344,1730,1240,266,62,63,116,2,490
55117005837,871,666,636,12,3,9,3,0,30
55117005835,868,671,646,11,4,3,4,0,25
55117005872,542,427,407,6,1,14,5,0,20
55117005902,489,390,360,5,0,11,6,0,30
55117005855,467,370,349,12,1,7,1,0,21
55117005936,497,410,394,5,3,5,1,0,16
55131006416,1877,1431,1277,64,19,22,16,3,154
55131006428,2014,1473,1327,85,18,11,33,2,146
55131006510,922,746,712,12,6,3,8,0,34
55131006508,777,581,546,12,2,16,4,0,35
55131006376,795,632,592,12,2,13,7,0,40
55131006398,815,601,556,16,4,14,5,0,45
55131006473,678,511,488,7,4,12,0,0,23
55131006454,323,264,252,5,4,1,0,0,12
55051002360,54,48,47,1,0,0,0,0,1
55087004396,948,793,566,80,100,31,12,5,227
55087004375,321,250,173,9,4,64,0,0,77
55087004329,557,428,276,17,5,144,1,0,152
55087004429,859,620,247,36,15,346,5,2,373
55087004302,615,455,441,4,1,1,1,0,14
55087004400,415,376,349,12,0,6,9,0,27
55087004442,612,453,381,18,15,25,15,0,72
55087004465,397,301,285,7,2,1,6,0,16
55087004422,62,49,39,3,2,0,5,0,10
55087004391,934,748,706,9,9,6,11,0,42
55087004456,1516,1048,964,32,11,17,27,0,84
55087004450,2073,1487,1441,23,2,11,7,0,46
55087004394,621,477,465,1,2,7,3,0,12
55087004287,1541,1155,944,54,16,31,103,11,211
55087004294,1669,1285,1128,45,39,26,43,0,157
55107005385,283,212,184,11,3,4,5,0,28
55107005439,383,315,292,2,1,6,11,0,23
55025001430,633,483,416,35,21,3,7,0,67
55025001426,1498,950,833,25,20,5,56,2,117
55025001443,989,793,723,31,5,10,10,1,70
55129006316,515,423,403,2,2,9,2,0,20
55025001219,1162,911,790,46,14,9,34,0,121
55025001221,715,517,482,8,2,3,20,0,35
55025001161,2646,2204,1875,85,50,20,152,0,329
55101004991,347,285,268,10,4,3,3,0,17
55101004992,461,368,346,6,0,8,2,0,22
55101004979,672,579,535,30,2,11,2,0,44
55101004996,1255,983,934,30,4,8,4,1,49
55101004943,3042,2289,1642,319,252,59,30,1,647
55101004962,1746,1339,881,151,258,22,27,0,458
55111005648,669,492,459,23,0,3,0,1,33
55111005675,643,510,462,21,9,10,2,0,48
55111005647,656,490,423,36,18,10,3,0,67
55111005645,806,629,536,42,14,25,5,3,93
55111005651,742,556,497,37,6,9,4,0,59
55111005674,547,418,406,9,0,1,0,2,12
55111005673,406,302,290,8,2,1,0,0,12
55111005678,904,613,569,19,3,22,4,0,44
55111005672,775,565,444,96,9,6,7,1,121
55025001288,935,730,637,26,28,16,16,6,93
55025000877,899,719,688,12,6,7,4,1,31
55025001304,1076,768,727,12,11,4,7,2,41
55025001305,18,8,0,0,0,1,0,0,8
55025001323,737,584,556,11,6,2,0,0,28
55025001301,907,662,609,23,7,9,10,0,53
55025001298,895,691,620,24,13,17,5,0,71
55025001010,1195,900,278,242,349,35,30,0,622
55025001344,1712,1322,1219,41,18,9,30,2,103
55025001345,1560,1224,1137,31,18,15,21,3,87
55129006303,186,149,136,6,0,1,3,1,13
55129006339,96,77,77,0,0,0,0,0,0
55129006337,100,76,69,2,2,3,0,0,7
55111005637,1311,1010,911,34,20,25,12,0,99
55111005635,668,526,465,21,8,17,10,2,61
55111005598,1048,782,715,33,6,10,9,0,67
55111005684,1463,1063,977,42,7,12,18,1,86
55111005676,1018,788,704,50,11,20,2,0,84
55135006964,0,0,0,0,0,0,0,0,0
55135006981,493,332,307,14,2,8,0,0,25
55135006970,914,755,720,8,5,16,5,1,35
55135006971,353,293,288,2,0,1,0,0,5
55135006933,68,57,56,0,0,0,0,0,1
55135006966,481,363,333,11,3,6,5,0,30
55135006965,417,344,310,12,2,15,2,0,34
55135006939,412,304,298,2,0,4,0,0,6
55135007003,650,540,509,4,1,12,11,0,31
55135006929,405,314,295,10,0,7,1,0,19
55135006948,448,366,326,15,3,11,5,1,40
55135006942,644,456,422,15,1,3,9,1,34
55135006910,430,331,306,11,0,8,4,0,25
55101004934,1996,1410,459,432,489,38,19,4,951
55101004948,2654,1814,828,383,528,60,34,3,986
55101004947,2887,2218,1570,313,283,40,15,2,648
55111005639,1368,1054,941,67,10,26,13,1,113
55101004970,530,393,359,15,7,3,4,0,34
55101005028,793,658,606,32,1,11,8,0,52
55111005682,735,588,517,26,11,25,8,0,71
55111005590,759,591,511,51,3,16,3,2,80
55111005619,863,674,607,41,3,8,2,0,67
55101005050,1964,1537,1308,89,51,16,61,3,229
55101005047,1267,975,803,77,38,20,41,0,172
55101005053,1027,735,645,37,27,5,18,0,90
55101005002,796,593,447,79,33,21,13,0,146
55101005052,2051,1665,1430,113,73,18,16,0,235
55101005041,852,619,533,37,28,6,18,0,86
55101005051,734,635,524,50,28,24,8,1,111
55101005042,377,361,224,24,99,6,11,0,137
55101004969,390,352,329,13,2,0,1,0,23
55101004995,663,549,513,24,0,10,0,0,36
55101004891,668,516,463,17,2,24,8,0,53
55101004953,271,215,171,24,7,7,9,1,44
55101004950,2318,1831,1053,346,367,32,28,2,778
55101004923,922,697,522,115,35,16,3,0,175
55101004899,1299,1105,946,71,58,11,15,0,159
55101004896,1293,1000,821,73,56,26,21,2,179
55135007000,575,520,445,9,42,12,12,0,75
55135006999,811,629,585,22,3,12,2,0,44
55135006958,689,570,544,13,2,5,3,0,26
55135006923,603,445,388,26,11,15,7,0,57
55135006946,894,738,677,39,7,8,3,0,61
55135006945,188,155,149,1,1,3,2,0,6
55135006934,331,257,246,3,0,3,4,0,11
55125006140,402,320,296,10,3,5,6,1,24
55125006115,353,296,216,17,22,35,5,0,80
55125006142,89,79,75,1,0,1,0,0,4
55019000660,466,358,349,5,3,3,1,0,9
55019000681,592,458,443,8,1,2,4,0,15
55019000642,846,635,533,94,2,5,1,0,102
55127006157,882,657,467,158,11,15,14,1,190
55127006270,1246,1063,839,146,45,26,11,3,224
55127006190,691,531,457,56,7,10,4,0,74
55019000693,112,80,77,0,0,1,0,0,3
55019000686,118,105,101,2,2,2,0,0,4
55019000638,357,261,250,2,0,4,4,0,11
55019000672,714,504,469,26,5,3,2,0,35
55019000662,117,92,83,7,0,2,0,0,9
55019000718,1033,594,586,1,1,2,2,0,8
55019000713,438,313,292,11,2,2,4,2,21
55019000715,502,372,335,20,3,6,1,0,37
55019000717,400,297,177,106,1,2,7,0,120
55135006977,370,317,307,5,0,1,1,0,10
55135006935,705,586,567,8,0,7,4,0,19
55125006114,97,80,71,2,0,3,0,0,9
55127006152,552,467,410,27,4,16,5,0,57
55127006220,0,0,0,0,0,0,0,0,0
55127006215,1788,1438,1261,117,12,33,23,0,177
55127006223,933,695,487,168,11,22,11,2,208
55127006179,626,541,515,16,1,4,0,0,26
55127006182,605,460,399,31,4,7,9,0,61
55127006252,183,145,94,39,2,4,2,0,51
55127006191,784,625,545,51,3,13,6,0,80
55127006167,974,767,698,41,2,6,10,0,69
55127006178,458,385,359,17,0,4,3,0,26
55127006203,526,417,321,76,5,12,3,1,96
55127006266,737,546,356,112,47,21,4,0,190
55127006235,815,634,564,53,1,10,4,1,70
55127006250,477,370,288,43,10,11,9,0,82
55127006238,1016,776,679,68,2,13,3,0,97
55127006214,1764,1310,1143,102,14,27,17,0,167
55127006166,422,341,312,17,4,4,0,0,29
55127006216,1727,1286,1086,117,12,33,33,0,200
55127006217,1610,1199,961,188,7,24,12,0,238
55127006228,793,553,285,236,15,21,11,1,268
55127006227,639,427,294,119,7,6,5,1,133
55127006154,615,534,512,11,4,1,0,0,22
55127006153,857,676,605,52,10,11,7,0,71
55127006287,184,149,144,0,2,2,1,0,5
55067002997,846,694,642,19,2,20,2,1,52
55067003007,262,219,202,2,2,10,1,0,17
55067003002,603,522,494,9,1,9,2,1,28
55009000288,2334,1774,1458,123,56,87,52,2,316
55009000371,2596,1840,1210,216,188,151,115,3,630
55009000216,1780,1396,1139,73,61,77,47,3,257
55009000393,1277,936,887,5,9,8,23,0,49
55009000228,960,676,646,6,5,4,13,1,30
55027001536,100,84,80,0,0,3,1,0,4
55027001537,201,152,148,2,0,1,0,0,4
55027001538,443,336,323,9,1,3,0,0,13
55027001535,422,345,338,5,0,0,0,0,7
55027001534,309,262,245,9,1,5,0,0,17
55027001560,503,414,390,5,6,8,2,0,24
55027001552,551,448,418,13,8,1,0,0,30
55019000697,661,519,498,13,1,2,5,0,21
55019000683,394,308,291,8,2,2,3,0,17
55019000692,708,440,415,14,3,4,2,0,25
55019000671,591,351,347,2,1,2,0,0,4
55019000649,164,102,99,2,1,0,0,0,3
55019000710,286,194,187,2,0,2,0,0,7
55019000685,708,469,460,3,1,2,1,0,9
55027001563,341,262,240,8,3,3,0,1,22
55027001569,0,0,0,0,0,0,0,0,0
55027001570,0,0,0,0,0,0,0,0,0
55027001489,786,636,603,16,3,6,8,1,33
55027001490,257,193,148,42,3,0,0,0,45
55009000355,389,294,286,0,1,2,3,0,8
55009000238,700,526,499,3,3,18,3,0,27
55009000289,478,372,361,1,0,4,2,0,11
55009000274,738,573,505,22,9,20,3,0,68
55009000354,970,668,638,9,1,13,0,0,30
55009000235,695,526,509,6,6,1,1,0,17
55009000340,2563,2061,1644,134,74,126,103,1,417
55009000373,986,746,621,33,13,31,36,5,125
55009000200,1271,1063,913,39,33,50,23,0,150
55009000315,1234,1000,886,34,28,27,25,0,114
55009000308,2286,2164,1686,202,113,47,95,25,478
55009000350,2288,1672,1461,70,76,47,22,0,211
55027001558,890,736,718,3,3,7,1,0,18
55027001505,0,0,0,0,0,0,0,0,0
55027001504,9,8,7,0,0,0,0,0,1
55027001461,584,504,478,5,3,3,1,0,26
55027001506,677,518,500,11,1,6,0,0,18
55027001528,482,400,381,13,2,3,3,0,19
55027001527,474,367,364,2,0,0,0,0,3
55027001524,363,303,295,0,0,5,1,0,8
55027001495,1041,820,770,16,1,18,0,0,50
55027001477,552,417,327,78,1,6,2,0,90
55027001478,373,295,247,25,2,6,8,0,48
55027001474,1572,1285,1075,115,43,23,34,0,210
55027001472,1204,938,846,57,6,20,6,1,92
55027001476,730,596,569,11,7,4,4,0,27
55027001470,1222,992,897,50,13,8,17,0,95
55027001469,1056,790,723,36,11,13,8,0,67
55027001486,0,0,0,0,0,0,0,0,0
55027001479,518,412,391,3,0,7,6,0,21
55017000543,771,572,547,5,4,6,2,1,25
55009000270,2858,2229,1726,91,36,318,72,1,503
55027001603,644,549,531,2,0,2,0,0,18
55027001581,974,754,702,23,10,18,0,0,52
55027001600,0,0,0,0,0,0,0,0,0
55027001594,834,618,477,106,16,12,6,0,141
55027001475,924,679,587,71,5,12,2,0,92
55009000379,1305,949,840,39,20,23,24,3,109
55009000301,1218,898,796,23,13,20,35,0,102
55009000268,699,522,473,13,2,25,17,0,49
55009000352,438,364,345,6,4,6,5,0,19
55009000378,507,378,363,5,3,2,3,0,15
55009000359,25,17,13,1,0,2,0,0,4
55027001503,279,225,220,3,0,1,0,0,5
55027001499,596,472,404,44,8,7,4,0,68
55027001498,539,431,402,13,2,11,1,0,29
55027001497,469,373,346,15,2,8,0,0,27
55017000551,476,365,360,2,1,1,1,1,5
55017000581,537,398,371,3,2,8,0,1,27
55019000653,751,529,517,6,0,5,1,1,12
55017000563,465,348,333,9,2,3,0,0,15
55017000557,825,618,604,7,1,2,1,0,14
55017000585,226,186,184,0,0,1,1,0,2
55027001467,1205,935,830,80,11,4,8,1,105
55027001493,712,576,553,11,2,2,3,0,23
55027001492,397,308,266,18,7,9,8,0,42
55027001500,1536,1492,767,104,596,20,18,0,725
55027001554,683,507,456,24,6,3,13,0,51
55027001555,655,525,487,23,2,9,0,0,38
55027001571,581,440,420,6,1,2,1,0,20
55027001572,638,492,474,10,2,2,1,0,18
55027001509,396,291,278,11,1,0,0,0,13
55009000372,1086,858,767,36,19,24,14,1,91
55009000334,949,739,694,10,5,6,23,3,45
55009000328,1188,902,869,2,1,11,5,0,33
55009000331,1002,851,811,9,7,19,1,0,40
55009000251,1294,977,920,15,3,20,12,0,57
55009000233,2494,1767,1618,51,18,24,49,0,149
55017000568,390,299,290,5,2,0,1,0,9
55017000613,833,647,641,2,2,0,0,0,6
55141007315,643,496,446,21,2,21,2,0,50
55141007332,496,389,371,2,0,6,6,0,18
55141007314,650,473,433,18,3,9,3,0,40
55141007313,581,451,418,15,5,11,3,2,33
55141007312,575,461,422,13,3,17,2,0,39
55141007317,360,272,251,4,4,6,5,0,21
55141007340,34,26,25,0,0,0,0,0,1
55141007291,614,492,464,7,12,2,5,2,28
55141007290,639,514,478,11,5,18,9,1,36
55141007306,1106,865,831,3,8,14,6,0,34
55141007308,1276,1014,930,22,18,16,25,2,84
55141007297,225,174,160,7,0,7,0,0,14
55141007367,6,3,1,1,0,0,0,0,2
55141007271,832,638,587,10,7,11,16,0,51
55141007278,527,433,409,1,2,4,13,0,24
55141007353,1027,812,740,13,10,20,29,0,72
55141007365,4,2,0,2,0,0,0,0,2
55141007368,9,9,8,0,0,1,0,0,1
55141007369,2,0,0,0,0,0,0,0,0
55141007370,0,0,0,0,0,0,0,0,0
55141007352,1585,1283,1187,34,11,17,21,0,96
55027001578,1329,1046,929,57,10,18,20,1,117
55027001577,1064,816,728,54,16,14,4,0,88
55141007300,10,8,7,0,1,0,0,0,1
55141007266,539,417,398,2,10,5,3,0,19
55141007293,686,561,533,6,6,9,7,0,28
55141007330,615,472,456,5,1,4,4,0,16
55141007331,412,315,307,3,0,1,0,0,8
55141007329,433,340,324,13,1,3,0,0,16
55141007374,806,658,614,20,2,5,11,3,44
55141007364,150,114,113,1,0,0,0,0,1
55141007375,758,555,501,24,6,10,14,0,54
55141007281,747,555,535,8,2,2,4,0,20
55141007273,626,508,490,2,4,6,3,0,18
55141007274,804,612,593,6,1,6,3,0,19
55141007277,927,708,699,3,3,1,2,1,9
55141007346,173,137,126,1,0,5,1,1,11
55141007345,591,473,455,5,1,4,0,3,18
55141007347,253,197,191,1,1,1,2,0,6
55141007344,755,587,571,1,0,5,4,0,16
55141007276,707,574,540,8,4,7,6,0,34
55141007279,881,678,646,5,1,8,8,1,32
55141007288,643,544,478,26,14,14,14,2,66
55141007325,958,733,719,6,0,2,0,0,14
55141007326,223,194,189,0,0,1,1,0,5
55141007316,813,634,603,15,2,9,0,1,31
55141007354,990,768,674,29,5,16,37,0,94
55141007355,328,272,245,13,2,4,5,0,27
55067002989,915,779,747,2,1,13,6,0,32
55067003008,989,774,747,8,1,10,1,0,27
55067003014,380,315,300,4,0,7,3,0,15
55067002992,180,159,156,2,1,0,0,0,3
55067003001,226,188,182,3,0,1,0,1,6
55067003012,819,604,537,15,5,26,7,1,67
55067003016,890,674,608,20,8,24,9,1,66
55067003017,975,763,726,10,4,20,2,0,37
55127006199,359,323,273,45,0,3,3,0,50
55127006205,669,556,514,22,7,1,1,0,42
55127006230,629,548,449,84,2,8,5,0,99
55033001776,1403,1168,1054,15,30,12,45,4,114
55033001783,1651,1320,1205,26,18,23,43,2,115
55033001777,1949,1580,1436,24,21,24,63,2,144
55045002258,683,537,515,7,1,3,3,1,22
55045002237,1139,911,809,59,17,11,12,0,102
55045002207,919,731,674,22,4,21,7,0,57
55045002217,1259,936,833,58,4,12,11,4,103
55033001735,1427,1044,966,14,5,15,33,0,78
55033001762,609,430,417,1,0,5,2,0,13
55009000249,881,729,533,78,66,16,33,2,196
55009000259,4054,3683,2551,292,598,171,104,15,1132
55009000208,1967,1517,1400,29,28,37,24,0,117
55009000391,2305,1658,1465,43,17,27,84,1,193
55009000389,2034,1518,1391,24,19,50,28,2,127
55027001584,767,601,564,22,4,7,2,0,37
55027001586,677,534,494,20,4,8,5,0,40
55027001587,1899,1734,836,86,752,57,15,0,898
55033001757,408,318,307,1,0,1,0,0,11
55033001764,80,65,63,0,1,1,0,0,2
55033001760,1003,761,701,23,3,10,10,0,60
55033001736,233,188,178,4,0,0,2,0,10
55037001943,367,315,301,4,0,1,3,0,14
55037001952,181,161,160,1,0,0,0,0,1
55037001953,337,298,290,3,0,2,1,1,8
55045002257,562,450,415,8,5,15,5,0,35
55045002227,630,495,451,21,4,13,0,0,44
55045002256,274,235,221,4,0,1,2,1,14
55045002204,602,462,436,18,3,4,0,0,26
55009000226,379,299,288,5,1,2,1,0,11
55009000256,2083,1500,1411,26,13,30,13,0,89
55009000271,3009,2350,2056,58,17,132,69,1,294
55009000295,923,640,617,11,6,3,3,0,23
55009000297,2895,2095,1284,254,245,210,113,5,811
55009000395,2673,1988,1458,202,167,145,39,2,530
55027001508,890,729,670,25,4,19,7,1,59
55027001597,0,0,0,0,0,0,0,0,0
55027001550,0,0,0,0,0,0,0,0,0
55027001549,0,0,0,0,0,0,0,0,0
55027001575,1392,1072,937,79,10,19,15,0,135
55093004633,1635,1246,1107,62,32,21,19,1,139
55093004638,830,658,612,8,7,9,9,3,46
55093004648,466,354,338,0,3,4,1,0,16
55093004639,420,332,321,3,3,2,3,1,11
55093004626,478,382,362,4,1,4,0,0,20
55093004614,820,651,620,12,4,6,1,0,31
55093004656,492,377,362,4,4,4,2,0,15
55093004612,898,681,651,5,5,5,6,0,30
55093004611,140,107,98,6,0,0,0,0,9
55093004609,727,591,559,7,5,8,0,0,32
55093004625,1173,914,859,25,2,18,3,0,55
55093004647,738,612,595,3,2,4,5,0,17
55045002230,292,224,203,8,0,6,5,0,21
55045002214,846,635,613,7,5,4,3,0,22
55045002260,494,394,380,4,0,3,6,0,14
55045002259,507,396,384,8,1,0,2,0,12
55045002209,444,341,326,4,1,8,2,0,15
55045002261,0,0,0,0,0,0,0,0,0
55045002235,653,498,458,11,3,6,7,1,40
55045002231,776,571,535,9,6,3,3,0,36
55045002232,582,415,384,7,12,4,5,0,31
55045002205,242,177,168,5,0,0,4,0,9
55049002336,448,348,338,2,1,4,0,0,10
55079003908,2180,1727,1320,180,116,66,48,1,407
55079003906,2121,1700,1254,187,165,67,51,0,446
55079003800,1820,1292,95,44,1129,9,15,2,1197
55079003682,1234,916,29,37,840,11,6,0,887
55093004651,587,432,390,22,8,10,2,0,42
55093004655,1193,978,905,28,13,14,8,0,73
55093004646,847,616,580,9,8,3,12,0,36
55093004627,744,549,503,11,3,8,10,0,46
55093004645,770,585,559,8,1,6,8,0,26
55093004649,951,850,720,33,31,19,28,13,130
55093004654,2106,2020,1645,109,154,122,57,5,375
55093004622,1084,824,769,19,9,14,1,0,55
55093004635,686,521,484,8,7,11,9,1,37
55093004661,387,231,218,7,1,0,3,0,13
55093004636,407,325,311,3,0,4,5,0,14
55079004037,957,748,353,228,134,28,25,0,395
55079003912,1167,844,285,372,105,17,74,4,559
55079003867,1863,1304,305,926,78,75,17,0,999
55079003943,1759,1224,503,449,73,61,170,3,721
55079003970,1242,910,805,29,9,7,55,0,105
55079003921,2474,1757,658,456,373,36,249,8,1099
55079003947,1823,1315,689,398,63,29,159,4,626
55079003496,1367,933,849,26,7,12,35,1,84
55079003567,2182,1661,1360,129,71,18,75,0,301
55079003577,1961,1438,1165,88,22,30,130,1,273
55079003873,955,787,629,102,29,22,14,1,158
55079003996,2602,2123,1393,461,146,61,87,2,730
55079004022,1309,1039,648,54,288,18,31,1,391
55079004044,977,740,556,33,134,4,19,0,184
55079004017,2455,1828,946,90,752,23,24,3,882
55079004032,936,759,593,29,116,9,17,1,166
55079003720,3000,2165,706,122,1143,48,171,2,1459
55079003726,2019,1467,557,100,669,23,134,0,910
55079004033,2123,1711,1395,61,146,21,94,3,316
55141007333,784,632,617,5,3,5,2,0,15
55141007334,845,659,639,11,1,6,1,0,20
55141007376,1312,993,866,40,23,34,25,2,127
55141007350,756,586,517,23,11,7,27,1,69
55141007351,205,162,134,6,2,8,7,0,28
55141007265,839,687,639,18,9,10,8,0,48
55141007269,350,282,276,2,0,3,0,0,6
55141007343,320,262,248,5,1,5,3,0,14
55141007342,45,32,11,1,1,18,2,2,21
55141007361,627,485,443,9,5,14,11,0,42
55141007260,396,294,287,1,1,2,3,0,7
55141007318,897,666,611,7,9,21,17,1,55
55141007327,415,294,289,3,1,0,1,1,5
55105005152,1142,859,767,38,6,23,8,1,92
55105005117,852,683,579,44,34,20,6,0,104
55105005303,631,503,424,32,28,8,10,0,79
55105005118,286,248,221,16,9,1,1,0,27
55105005145,869,702,618,28,32,10,9,0,84
55105005137,1804,1246,613,368,227,39,5,1,633
55049002322,640,528,496,6,5,4,15,1,32
55049002332,619,475,429,15,5,11,10,0,46
55049002323,585,456,418,5,4,3,17,0,38
55049002333,617,475,437,7,9,8,8,0,38
55049002349,498,383,365,7,2,6,0,0,18
55105005146,400,321,297,20,0,1,3,0,24
55105005147,613,462,363,91,7,4,3,0,99
55105005183,766,599,587,6,1,4,2,1,12
55089004512,837,647,553,16,24,10,30,0,94
55055002485,1191,782,749,13,7,3,6,0,33
55055002436,618,506,475,10,3,0,5,1,31
55055002484,908,623,586,19,2,8,8,0,37
55083004180,483,382,367,6,0,10,0,0,15
55055002526,1054,833,783,29,1,6,6,1,50
55055002525,613,519,490,19,3,2,7,0,29
55055002446,1179,937,846,50,10,11,13,0,91
55055002477,790,621,534,60,5,9,6,0,87
55083004164,517,404,375,1,0,15,0,0,29
55083004163,215,171,153,2,0,15,0,0,18
55083004165,647,521,491,3,4,20,2,0,30
55133006689,758,615,580,22,8,5,1,0,35
55133006775,1014,755,711,16,0,12,15,0,44
55133006763,400,319,287,14,0,4,8,0,32
55133006843,647,520,499,10,0,4,3,2,21
55133003026,0,0,0,0,0,0,0,0,0
55133008069,8,7,3,0,0,2,1,0,4
55133006682,2002,1502,1329,90,11,9,56,0,173
55133006681,1779,1301,908,231,82,45,38,6,393
55133006865,12,10,8,2,0,0,0,0,2
55133006867,0,0,0,0,0,0,0,0,0
55055002512,737,584,535,24,4,11,2,2,49
55055002513,1010,796,460,241,39,14,35,5,336
55055002524,517,419,394,14,2,0,3,0,25
55055002475,1146,908,809,47,8,26,15,1,99
55105005383,561,453,380,21,32,12,5,0,73
55105005229,833,621,418,77,115,5,7,0,203
55105005342,787,557,235,115,173,28,13,1,322
55105005141,1825,1361,984,202,112,43,21,1,377
55105005298,1603,1173,865,181,72,34,10,1,308
55105005129,570,468,441,12,4,10,1,0,27
55115005786,776,521,368,28,11,110,9,0,153
55115005777,664,524,438,16,9,52,7,1,86
55115005788,823,689,624,8,8,44,2,0,65
55089004539,946,731,658,19,8,7,24,0,73
55041002079,173,159,153,2,3,3,4,0,6
55049002338,504,397,370,3,9,6,3,0,27
55049002321,177,148,143,0,0,3,1,0,5
55049002319,386,305,293,1,3,2,5,0,12
55031001676,758,563,532,1,3,14,3,0,31
55079003514,2089,1702,1435,112,41,33,86,0,267
55079003610,2721,2599,1999,154,275,45,126,5,600
55079003483,2469,2376,1705,144,385,35,113,2,671
55079003853,1996,1583,1373,53,81,23,35,3,210
55079003602,1532,1032,18,50,959,21,12,3,1014
55079003656,1959,1257,153,919,142,39,59,1,1104
55079003654,1211,804,89,644,71,17,5,1,715
55079003627,1511,1028,121,55,822,10,27,0,907
55079003669,1074,718,43,542,129,37,13,0,675
55079003647,1360,887,122,608,120,41,38,3,765
55115005805,155,130,124,0,0,4,1,1,6
55115005754,188,151,146,2,1,2,0,0,5
55115005745,810,590,137,6,3,448,2,4,453
55115005785,888,684,533,14,10,117,4,0,151
55115005737,517,418,407,1,0,8,2,0,11
55039002007,0,0,0,0,0,0,0,0,0
55039002042,858,661,633,12,0,11,0,0,28
55039001989,632,504,480,9,5,6,3,0,24
55039002034,751,649,618,17,3,3,2,0,31
55039002065,2239,1866,1412,206,120,44,98,4,454
55039002055,2183,1900,1479,87,212,77,44,4,421
55039002074,280,262,253,1,1,2,4,0,9
55039002075,99,91,79,3,4,1,4,0,12
55041002095,369,298,275,3,2,15,3,2,23
55041002097,433,347,321,5,2,7,6,7,26
55089004503,1073,833,798,15,7,5,5,0,35
55089004493,5,3,2,0,0,1,0,0,1
55089004552,776,611,580,8,5,6,8,0,31
55089004565,246,191,183,5,0,1,2,0,8
55079003859,2315,1874,1514,195,53,56,73,2,360
55079003590,857,667,591,40,17,10,10,0,76
55079003589,904,711,645,40,12,6,12,0,66
55079003975,2243,1888,1588,128,64,33,67,2,300
55079003962,1792,1542,1357,87,46,22,37,1,185
55079003924,1162,916,625,175,35,22,59,1,291
55079003942,1504,1091,743,192,51,25,104,0,348
55115005738,500,409,378,8,0,15,0,0,31
55115005800,461,389,246,1,0,136,1,0,143
55115005744,532,397,122,5,7,260,1,0,275
55137007034,776,564,477,61,2,17,4,0,87
55137007030,708,546,456,64,2,10,2,2,90
55115005752,485,387,371,8,0,7,0,0,16
55137007032,1144,1113,642,82,338,43,16,0,471
55115005782,819,623,500,21,0,101,1,0,123
55115005758,885,681,666,4,0,8,0,0,15
55115005795,341,267,256,3,2,8,0,0,11
55079003783,1141,780,62,28,636,7,52,7,718
55079003781,2308,1553,176,64,1235,18,90,2,1377
55079003691,1756,1293,49,51,1187,16,10,1,1244
55079004014,1200,1005,786,51,98,26,36,1,219
55079003736,1527,1204,518,109,450,37,105,2,686
55079004020,1891,1383,693,64,542,24,60,5,690
55079004018,1698,1325,886,75,291,18,62,5,439
55079003639,1877,1364,146,26,1054,23,135,2,1218
55079003964,2218,1723,1195,174,240,53,78,0,528
55079003971,2347,1885,1543,126,114,27,79,1,342
55089004585,1683,1326,1232,42,8,19,16,0,94
55123006090,232,190,180,2,2,3,0,0,10
55123006091,515,393,383,1,1,4,0,0,10
55123006096,923,550,530,7,1,4,0,0,20
55123006033,539,432,410,10,1,1,1,0,22
55123006042,586,460,434,4,5,2,3,0,26
55123006092,238,190,183,4,0,3,0,1,7
55123006063,192,128,125,2,1,0,0,0,3
55123006043,482,388,330,9,39,4,1,0,58
55089004507,450,341,326,6,0,7,1,0,15
55031001732,912,826,768,5,30,17,0,0,58
55039002063,128,98,77,7,2,5,7,1,21
55039002024,472,373,365,5,1,2,1,0,8
55039002070,0,0,0,0,0,0,0,0,0
55039002027,45,25,21,1,0,2,0,0,4
55063002858,3114,2506,2282,56,41,21,93,2,224
55063002860,3,2,2,0,0,0,0,0,0
55063002831,864,760,657,59,11,13,11,3,103
55063002834,909,727,632,19,26,11,28,2,95
55063002823,1278,1045,931,28,27,12,48,0,114
55063002864,3059,2457,2239,42,28,23,110,1,218
55063002826,800,632,577,6,14,11,25,1,55
55129006299,550,426,398,7,0,10,1,2,28
55129006302,586,465,430,12,0,18,4,0,35
55079003522,1117,917,797,62,12,25,18,0,120
55079003774,2151,1539,440,92,906,24,107,0,1099
55079003530,1399,1182,980,119,33,27,26,0,202
55079003529,991,827,668,96,46,17,6,0,159
55079003532,1484,1340,1136,108,37,21,41,0,204
55079003526,1211,969,820,98,18,20,14,1,149
55079003527,1510,1189,813,224,85,40,24,3,376
55079003677,965,688,109,104,484,10,5,0,579
55079003945,1363,1023,309,281,247,11,184,0,714
55079003812,849,647,589,16,15,6,18,1,58
55079003811,657,480,423,11,11,2,28,0,57
55079003492,1153,863,775,19,28,2,29,0,88
55079003506,2352,2055,1776,73,122,20,48,0,279
55079003500,1247,891,797,22,23,6,39,0,94
55079003497,1047,673,639,3,3,0,28,2,34
55079003879,3176,2095,290,1665,80,152,59,6,1805
55079003680,1361,1001,92,47,848,31,7,0,909
55079003838,1907,1404,1271,43,38,15,21,4,133
55079003578,2071,1518,1298,103,31,26,49,2,220
55079003569,1672,1201,923,91,33,39,119,1,278
55079003723,1396,1051,293,37,636,15,86,5,758
55043002196,235,193,191,2,0,0,0,0,2
55043002128,411,334,329,2,0,0,2,0,5
55043002146,696,572,557,3,3,2,7,0,15
55043002190,244,184,177,0,0,3,3,0,7
55043002125,1278,1032,951,28,26,1,20,1,81
55043002180,629,442,423,11,0,4,0,0,19
55043002181,633,460,433,18,2,4,3,0,27
55043002203,0,0,0,0,0,0,0,0,0
55043002176,543,413,397,7,1,2,1,0,16
55043002138,363,294,275,11,1,5,4,0,19
55007000176,554,454,422,0,0,23,2,0,32
55007000185,355,333,317,6,1,8,2,0,16
55007000167,512,417,372,2,2,31,2,0,45
55063002828,3598,3355,2940,109,139,44,125,4,415
55133006796,982,840,688,88,32,18,9,4,152
55133006803,1421,1216,971,150,41,17,19,0,245
55133006798,1123,886,633,175,36,19,23,0,253
55133006794,2174,1773,1386,226,46,46,68,0,387
55133006787,1424,1242,909,144,151,22,21,2,333
55133006791,144,143,126,9,0,5,4,0,17
55133006786,2206,1738,1162,410,79,58,48,0,576
55133006807,504,379,334,15,15,7,6,1,45
55133006738,1846,1457,1321,26,47,7,39,0,136
55133006610,1935,1463,1266,34,50,5,104,3,197
55133006739,2131,1532,1215,45,57,14,184,0,317
55133006890,1195,945,893,12,11,5,21,2,52
55133006675,1365,1073,999,24,6,17,22,0,74
55133006604,921,670,627,10,6,1,18,0,43
55133006894,0,0,0,0,0,0,0,0,0
55133006707,1332,1084,1033,17,1,8,12,4,51
55133006703,1067,821,781,7,5,9,9,1,40
55031001713,909,758,704,4,6,27,9,0,54
55017000615,1702,1331,1208,14,32,39,27,1,123
55017000586,1860,1439,1314,28,5,41,22,0,125
55001000018,287,228,216,1,0,3,3,0,12
55001000020,391,361,349,4,1,0,0,1,12
55039002003,551,428,413,6,0,7,3,0,15
55039002028,0,0,0,0,0,0,0,0,0
55039002061,882,674,616,42,8,10,2,0,58
55039002062,316,243,230,6,2,2,0,0,13
55011000413,697,528,512,3,0,2,3,0,16
55133006800,2014,1518,1309,123,28,24,28,0,209
55133006795,2784,2217,1785,249,87,33,71,4,432
55133006752,702,520,465,11,8,3,31,0,55
55133006749,1986,1470,1184,27,21,12,212,0,286
55133006615,526,429,415,8,2,0,1,0,14
55133008073,0,0,0,0,0,0,0,0,0
55133006856,0,0,0,0,0,0,0,0,0
55133006748,1599,1208,1072,29,18,11,75,0,136
55063002926,880,649,606,5,2,16,10,2,43
55063002908,406,297,278,4,3,0,6,0,19
55133006551,869,670,616,32,2,17,2,0,54
55133003025,10,9,3,0,0,0,2,0,6
55133006549,588,474,447,8,2,13,4,0,27
55059002767,896,786,641,53,56,5,27,2,145
55059002779,174,152,137,10,1,3,3,1,15
55059002766,674,527,483,8,9,6,22,0,44
55059002772,11,9,2,5,0,4,3,0,7
55059002733,637,483,395,39,39,9,4,0,88
55059002724,542,398,328,43,8,14,9,1,70
55059002771,0,0,0,0,0,0,0,0,0
55059002642,1859,1263,633,361,221,43,11,2,630
55059002641,1094,764,348,260,152,21,6,6,416
55059002727,1565,1070,437,415,183,36,10,2,633
55059002606,923,695,644,22,1,11,3,0,51
55133006831,230,190,169,8,2,7,1,0,21
55133006699,1687,1303,1213,38,6,16,18,2,90
55133006784,1434,1164,1058,40,10,20,18,1,106
55133006585,636,532,478,6,7,3,33,0,54
55041002105,132,111,108,1,2,1,0,0,3
55043002126,364,267,236,20,1,5,2,0,31
55109005476,855,623,564,12,5,6,21,0,59
55109005478,878,653,611,13,1,7,9,0,42
55109005510,340,243,233,2,0,2,1,1,10
55109005489,427,336,311,7,4,2,9,0,25
55109005488,564,405,379,9,2,6,7,0,26
55109005571,663,521,485,10,3,2,3,0,36
55109005582,567,409,394,6,3,3,4,0,15
55109005552,886,635,578,24,9,10,10,0,57
55039002019,2012,1566,1183,140,189,46,12,0,383
55043002179,625,468,458,0,4,1,1,0,10
55043002165,514,401,376,10,3,11,6,1,25
55055002505,887,701,650,21,9,11,8,3,51
55055002500,99,78,71,3,3,1,0,1,7
55059002629,1996,1487,1358,72,5,30,16,0,129
55059002624,494,400,370,18,1,3,5,1,30
55059002680,891,694,655,19,4,15,0,0,39
55059002621,838,646,590,32,2,6,6,0,56
55059002679,891,709,678,11,4,3,4,0,31
55059002770,717,607,552,23,2,9,9,2,55
55059003050,0,0,0,0,0,0,0,0,0
55059003052,0,0,0,0,0,0,0,0,0
55059002649,673,468,282,97,75,12,6,0,186
55059002689,1930,1503,1331,53,15,57,10,4,172
55059002691,1810,1403,1262,58,11,23,25,0,141
55059002640,1343,1044,835,136,53,25,7,0,209
55059002670,1443,1134,897,134,61,28,12,0,237
55133006828,1579,1261,1204,20,5,9,12,0,57
55133006724,2027,1528,1315,34,54,17,103,2,213
55039002039,497,399,386,6,2,1,4,0,13
55039002040,478,390,378,4,0,5,0,0,12
55039001966,746,558,535,16,0,2,2,0,23
55039002011,1455,1123,1036,31,10,16,15,1,87
55039001965,623,478,459,2,7,4,2,1,19
55017000555,735,596,559,8,4,11,7,0,37
55017000605,17,12,9,0,0,1,1,1,3
55003000064,648,518,495,5,4,12,1,0,23
55003000073,85,76,73,1,1,0,0,0,3
55003000072,52,42,40,0,1,0,0,0,2
55065002974,108,86,84,0,0,0,1,0,2
55065002984,989,756,683,63,3,4,0,0,73
55065002980,682,482,459,11,2,6,6,7,23
55065002983,112,70,67,3,0,0,0,0,3
55131006419,576,400,307,68,17,12,3,1,93
55131006479,750,590,549,9,9,10,8,1,41
55131006435,1708,1272,1123,18,38,12,80,6,149
55117005859,813,670,652,5,4,5,2,0,18
55117005858,638,515,492,11,0,6,5,0,23
55117005879,478,376,364,1,0,2,6,0,12
55117005927,0,0,0,0,0,0,0,0,0
55117005898,883,807,731,17,10,4,45,0,76
55117005925,0,0,0,0,0,0,0,0,0
55117005928,0,0,0,0,0,0,0,0,0
55117005926,0,0,0,0,0,0,0,0,0
55077003449,757,656,628,15,5,8,2,0,28
55039001957,759,637,576,22,8,12,16,1,61
55017000569,915,724,699,9,2,9,4,0,25
55017000553,748,563,551,3,1,2,1,0,12
55035001830,767,612,525,31,21,10,28,1,87
55035001916,15,4,3,0,0,0,0,0,1
55035008010,16,7,4,2,0,1,0,0,3
55035008011,0,0,0,0,0,0,0,0,0
55035001882,2366,1845,1610,52,43,30,96,6,235
55035001821,1134,862,797,15,4,11,32,0,65
55131006359,1203,1014,944,29,17,10,20,1,70
55131006371,1431,1052,946,42,30,24,4,1,106
55131006445,1200,897,822,39,11,11,10,2,75
55131006380,1050,902,816,48,15,11,9,0,86
55131006443,1374,1061,953,45,21,18,14,2,108
55131006404,1931,1474,1341,64,22,29,14,1,133
55131006436,957,764,740,7,1,3,5,0,24
55077003439,432,321,298,14,1,5,2,1,23
55123006080,669,538,528,2,0,0,1,0,10
55123006038,500,401,375,5,5,5,7,0,26
55123006041,624,474,449,13,2,2,5,1,25
55123006035,458,347,328,11,1,4,1,1,19
55123006037,495,410,392,4,1,4,5,0,18
55131006447,542,432,408,9,1,1,6,0,24
55131006355,680,546,513,13,3,9,2,0,33
55131006500,412,308,280,7,2,7,11,0,28
55103005067,633,479,459,5,2,3,2,0,20
55011000407,1007,865,842,9,5,9,1,1,23
55011000405,322,257,246,2,0,2,2,2,11
55105005351,1650,1269,785,209,227,37,18,0,484
55105005113,2049,1384,492,433,428,72,9,0,892
55109005545,752,564,497,22,3,24,5,1,67
55109005576,1078,771,714,16,8,15,17,0,57
55109005462,907,685,661,8,1,8,5,0,24
55109005520,1018,708,676,8,3,6,10,0,32
55109005493,759,502,478,6,0,6,3,1,24
55109005491,788,591,523,37,4,11,13,1,68
55109005492,560,404,377,12,5,3,10,0,27
55109005541,995,724,645,21,26,18,11,0,79
55109005522,497,348,330,11,2,0,3,0,18
55109005485,550,411,393,13,1,2,0,0,18
55109005483,624,467,431,8,4,11,5,0,36
55109005477,762,585,551,10,13,5,1,0,34
55137007023,398,329,294,21,1,12,3,2,35
55137007041,471,391,362,17,3,8,3,0,29
55137007045,477,410,378,14,1,8,1,1,32
55115005755,899,741,709,0,4,20,2,1,32
55137007025,619,540,504,11,1,6,8,1,36
55137007007,395,336,326,7,3,0,0,0,10
55137007050,780,625,568,29,5,15,8,1,57
55039002052,6,3,2,1,0,0,0,0,1
55003000060,349,292,278,5,2,4,1,0,14
55065002979,402,273,266,3,0,3,2,0,7
55023000829,832,640,619,5,0,8,2,1,21
55023000830,908,749,706,13,7,10,6,0,43
55083004156,832,754,728,5,1,11,5,0,26
55105005297,889,681,638,17,9,8,1,3,43
55105005149,917,690,615,55,1,8,6,0,75
55105005148,610,431,361,48,8,7,4,1,70
55105005127,894,643,616,13,3,1,2,0,27
55105005169,2127,1602,1472,51,26,14,33,0,130
55105005314,960,718,649,16,7,1,38,0,69
55105005170,2551,1878,1734,56,17,15,39,4,144
55105005173,28,16,6,3,1,1,4,0,10
55105005313,295,222,195,1,3,5,11,0,27
55105005158,627,490,462,17,2,4,4,1,28
55105005211,109,96,85,3,3,1,4,0,11
55105005210,2802,2206,1956,105,51,22,43,15,250
55105005212,11,4,0,0,0,0,2,1,4
55105005299,1757,1177,624,333,200,58,10,0,553
55105005142,1638,1179,613,246,288,34,12,2,566
55105005154,649,544,520,7,0,9,5,1,24
55105005273,714,580,537,15,0,12,10,1,43
55115005792,541,411,359,29,1,14,1,0,52
55055002469,599,478,446,16,3,3,7,0,32
55105005125,2835,2277,2047,78,43,38,51,1,230
55105005126,2717,2045,1702,190,99,32,19,0,343
55105005114,219,154,48,67,27,17,6,0,106
55071003157,2159,1831,1610,120,28,29,36,1,221
55071003155,592,464,422,15,6,16,8,1,42
55133006687,1309,1031,891,27,9,7,95,1,140
55133006778,716,569,523,23,6,7,6,3,46
55133006750,1527,1069,908,21,18,10,110,0,161
55133006626,1888,1409,1231,30,19,6,101,1,178
55119005966,240,200,175,23,0,1,0,0,25
55119005947,310,231,223,3,0,0,0,1,8
55079003955,2114,1660,1371,127,49,31,89,1,289
55047002282,1151,987,948,17,6,6,3,1,39
55047002299,4,3,3,0,0,0,0,0,0
55047002292,134,105,98,3,0,0,2,0,7
55035001921,652,498,468,10,2,9,5,0,30
55035001822,424,321,310,0,0,0,6,0,11
55035001885,1765,1489,1288,50,39,16,87,1,201
55035001907,122,87,74,4,0,2,7,0,13
55035001810,36,33,31,0,0,0,2,0,2
55035001934,12,12,12,0,0,0,0,0,0
55035001906,14,9,0,8,0,0,1,0,9
55035001849,686,598,542,3,20,8,15,1,56
55035001935,0,0,0,0,0,0,0,0,0
55035001908,8,5,5,0,0,0,0,0,0
55035001902,13,2,1,1,0,0,0,0,1
55035001909,15,13,8,2,0,3,0,0,5
55035001883,717,554,509,4,5,3,34,0,45
55035001884,673,568,473,24,20,10,37,3,95
55035001805,802,614,585,10,0,4,0,0,29
55007000158,389,354,319,1,4,19,1,0,35
55007000168,787,689,555,9,6,103,5,1,134
55007000177,261,238,223,1,0,4,0,1,15
55007000194,319,253,224,7,0,21,2,0,29
55007000188,720,606,537,19,11,46,3,0,69
55007000192,630,518,461,12,3,36,3,2,57
55007000191,160,131,101,3,0,23,1,0,30
55103005090,436,311,296,11,1,4,0,0,15
55103005097,8,5,5,0,0,0,0,0,0
55103005073,806,622,579,20,2,2,4,3,43
55103005087,166,105,99,2,2,2,0,0,6
55031001702,1568,1235,1155,10,9,45,6,2,80
55031001726,412,351,335,4,0,6,5,0,16
55031001671,924,793,734,19,6,30,11,0,59
55031001699,1168,954,911,2,3,24,3,0,43
55031001720,1598,1259,1078,26,40,81,22,2,181
55031001721,570,525,437,31,25,23,7,1,88
55031001674,359,286,262,3,5,8,6,0,24
55031001708,1790,1472,1274,32,62,77,15,4,198
55059002652,2049,1692,1443,133,51,28,34,0,249
55059002651,132,94,76,7,8,3,3,1,18
55059002745,1896,1378,940,286,90,40,20,2,438
55059002759,1474,1167,954,111,51,27,15,1,213
55059002654,1838,1439,1186,159,54,30,16,1,253
55059002742,879,683,505,111,39,19,12,1,178
55059002663,1269,992,820,78,55,30,6,1,172
55105005134,969,784,750,3,3,17,1,1,34
55105005371,2043,1587,1335,137,69,21,18,1,252
55079003609,2063,1343,35,59,1151,22,108,0,1308
55079003598,1608,1161,31,25,1101,22,5,0,1130
55079003721,1350,970,161,39,654,16,107,0,809
55079003993,1546,1205,889,181,49,59,53,1,316
55079003893,1180,852,646,120,37,22,22,1,206
55079003480,1561,1444,1135,110,106,21,78,7,309
55079003481,2105,1995,1369,138,216,40,234,6,626
55079003616,2083,2020,1017,135,729,31,97,1,1003
55079003752,1655,1562,1093,139,192,36,103,3,469
55079003749,3218,3124,2179,332,268,36,314,3,945
55079003754,4014,3877,3151,218,217,60,235,1,726
55079003608,2019,1766,815,153,671,37,107,2,951
55079003696,1521,1032,88,114,836,24,13,2,944
55079004011,1282,1051,696,60,264,19,32,3,355
55079004031,634,497,237,40,202,7,15,3,260
55079003798,1857,1287,198,59,1007,12,28,1,1089
55079003789,762,633,488,48,55,3,34,4,145
55079003545,660,571,475,72,7,5,8,0,96
55079003546,691,574,461,72,19,12,9,1,113
55035001804,1194,941,892,9,10,7,14,2,49
55035001878,2204,1869,1548,64,42,48,160,0,321
55035001871,1211,921,804,19,25,28,37,0,117
55035003003,6,4,4,0,0,0,0,0,0
55035001904,0,0,0,0,0,0,0,0,0
55047002287,1057,715,695,17,3,0,0,1,20
55055002445,1056,772,738,17,4,11,7,0,34
55055002507,816,655,627,14,4,5,3,0,28
55055002494,512,396,354,16,6,12,3,0,42
55055002486,780,582,563,5,2,5,6,0,19
55055002509,901,763,722,12,2,16,5,0,41
55083004219,1044,943,905,8,0,19,5,0,38
55083004154,329,309,297,3,0,2,2,0,12
55083004218,831,745,709,10,1,18,0,0,36
55083004209,830,660,616,4,1,13,6,0,44
55083004210,337,274,259,5,0,4,1,0,15
55083004153,490,430,418,4,0,3,1,0,12
55055002511,651,534,507,6,5,4,4,1,27
55055002530,946,781,720,25,1,15,6,1,61
55109005479,2147,1590,1470,32,28,19,26,0,120
55109005480,1602,1299,1154,45,31,27,32,3,145
55109005559,389,293,274,5,1,2,3,1,19
55109005482,1308,927,802,45,24,24,22,0,125
55109005481,1195,886,717,86,30,23,27,5,169
55109005452,678,505,479,6,3,7,6,0,26
55007000173,882,721,674,2,0,26,4,0,47
55069003051,859,702,687,4,0,8,2,0,15
55069003025,518,406,397,0,0,4,1,3,9
55097004751,554,464,450,2,0,5,2,0,14
55139007155,846,706,604,37,24,14,24,0,102
55139007245,1289,982,859,49,27,17,36,0,123
55139007106,811,646,562,51,3,12,24,0,84
55139007135,0,0,0,0,0,0,0,0,0
55129006322,749,577,539,3,0,13,2,0,38
55105005163,2824,2192,1849,161,93,60,27,3,343
55105005180,410,344,317,3,1,6,4,0,27
55105005181,237,196,188,2,1,2,5,0,8
55105005255,593,467,448,6,0,7,5,1,19
55105005312,658,470,438,13,6,8,0,0,32
55105005311,815,625,552,25,16,14,3,0,73
55059002671,1389,1172,956,106,71,29,17,2,216
55059002721,1919,1873,1369,233,172,31,62,4,504
55059002708,696,608,463,64,50,6,15,0,145
55059002750,1718,1274,855,237,153,43,19,0,419
55059002749,1454,1128,945,87,52,20,21,1,183
55059002667,1767,1390,1091,150,89,48,18,3,299
55059002653,1654,1271,1043,114,67,35,10,1,228
55059002665,786,615,413,118,59,18,15,1,202
55059002662,1327,1018,760,132,80,28,19,1,258
55059002777,8,4,0,0,0,0,4,0,4
55059080030,9,7,4,3,0,0,0,0,3
55059003049,5,4,2,1,0,0,0,0,2
55059002773,13,4,0,0,0,0,0,0,4
55059002765,0,0,0,0,0,0,0,0,0
55059002764,785,649,611,23,2,9,4,4,38
55059002752,36,12,7,0,5,0,0,0,5
55059002615,701,556,518,15,1,10,5,0,38
55059002617,603,473,447,12,3,8,2,1,26
55059002616,726,549,508,16,6,5,5,0,41
55069003065,478,378,363,3,0,6,3,0,15
55069003043,347,276,265,3,0,4,1,0,11
55083004194,708,578,522,26,2,15,3,0,56
55095004692,588,459,445,5,1,3,0,0,14
55095004725,934,715,648,20,14,23,4,1,67
55013000436,115,87,73,5,1,2,7,1,14
55013000464,709,584,508,17,6,34,11,0,76
55013000441,667,559,512,1,0,26,4,0,47
55013000447,359,298,284,7,0,3,2,1,14
55013000425,473,371,346,1,3,6,9,0,25
55013000429,400,295,242,6,3,37,4,1,53
55013000451,294,244,223,0,5,15,0,0,21
55013000449,408,333,323,1,2,5,0,0,10
55013000460,676,534,513,6,3,3,3,0,21
55095004677,455,353,328,2,0,12,3,0,25
55095004671,586,453,434,5,0,8,3,0,19
55007000193,138,129,101,0,1,27,0,0,28
55001000003,243,199,192,6,0,0,1,0,7
55001000002,638,471,437,14,6,12,3,0,34
55017000625,1,0,0,0,0,0,0,0,0
55017000623,581,416,387,5,6,5,11,0,29
55047002267,938,723,630,56,10,17,10,0,93
55047002266,847,646,576,44,6,11,5,2,70
55047002262,1027,824,735,56,8,17,7,1,89
55031001683,446,340,320,4,2,7,0,0,20
55007000183,316,303,294,1,1,2,1,0,9
55011000417,947,706,652,26,4,16,5,2,54
55053002384,530,371,351,11,0,9,1,0,20
55035001796,450,295,276,6,1,10,0,1,19
55035001793,451,360,341,6,3,8,0,0,19
55019000707,546,404,362,27,0,6,6,0,42
55021000786,716,578,541,12,7,16,0,2,37
55021000725,606,482,460,10,2,7,4,0,22
55021000784,1019,807,736,13,5,23,16,0,71
55021000756,798,608,566,13,12,11,3,0,42
55021000755,607,484,447,15,8,12,5,0,37
55021000783,655,463,448,4,5,4,1,0,15
55021000771,1094,844,760,27,12,20,26,0,84
55053002404,562,432,366,25,6,34,4,0,66
55053002405,153,118,104,11,0,2,0,0,14
55003000068,698,555,524,3,3,22,5,0,31
55003000059,284,228,212,4,2,10,0,0,16
55003000058,82,58,56,2,0,1,0,0,2
55065002940,154,117,113,3,0,0,1,0,4
55065002942,449,362,325,32,0,1,0,0,37
55065002970,429,320,246,60,5,5,3,0,74
55003000065,428,370,335,6,14,11,3,0,35
55003000046,750,600,533,4,0,48,10,0,67
55031001733,211,189,182,2,1,2,2,0,7
55035001848,522,433,416,0,5,3,9,0,17
55047002279,140,124,121,2,0,0,1,0,3
55103005081,516,408,396,9,0,1,1,0,12
55103005092,294,224,217,2,0,4,0,0,7
55103005085,222,139,133,0,3,3,0,0,6
55063002839,743,605,538,16,21,7,17,0,67
55063002836,867,809,764,13,1,10,19,0,45
55063002825,792,745,683,23,15,13,13,0,62
55063002837,3581,3548,3100,185,115,62,87,0,448
55063002829,1103,1024,849,48,52,24,57,1,175
55071003106,453,369,348,10,1,5,1,2,21
55071003100,952,719,637,59,0,19,4,0,82
55053002394,544,401,378,5,0,4,2,0,23
55021000766,906,695,629,21,10,16,9,1,66
55021000765,465,348,322,9,7,6,6,0,26
55021000770,302,243,218,15,5,3,0,0,25
55133006630,384,288,275,5,0,2,2,0,13
55133006629,1051,828,762,28,6,5,14,1,66
55133006550,953,729,694,14,5,5,3,0,35
55133006765,2101,1721,1469,98,52,33,54,3,252
55017000554,610,451,438,5,1,4,3,0,13
55001000013,587,496,453,25,3,6,6,2,43
55001000014,475,394,379,4,2,4,3,0,15
55133006634,779,642,593,11,3,17,14,0,49
55133006635,462,365,323,16,5,9,9,0,42
55103005108,398,308,257,34,3,5,6,0,51
55103005109,436,309,284,9,5,8,1,0,25
55103005102,470,350,312,13,22,8,3,1,38
55103005104,414,350,322,13,2,6,4,0,28
55103005100,420,331,317,7,2,1,2,1,14
55103005068,763,633,606,11,2,9,1,0,27
55103005069,492,377,364,3,1,5,4,0,13
55103005086,538,393,384,3,1,0,0,1,9
55103005077,435,350,339,2,0,3,2,0,11
55071003102,737,571,539,22,0,5,3,0,32
55071003141,452,369,345,5,0,5,6,0,24
55071003134,694,576,547,6,1,7,13,0,29
55063002913,1280,975,926,5,3,11,14,0,49
55063002920,860,655,614,5,6,9,14,0,41
55063002835,1848,1629,1301,77,156,24,71,4,328
55063002850,2293,1933,1578,71,97,41,144,2,355
55021000761,934,721,685,13,9,4,5,0,36
55021000754,530,420,407,0,0,9,1,0,13
55053002398,456,366,338,7,1,14,2,0,28
55097004814,446,344,318,12,0,10,0,0,26
55097004815,765,596,569,3,3,5,5,1,27
55097004796,916,707,643,13,7,7,35,1,64
55097004809,368,294,276,3,3,2,10,0,18
55139007123,846,673,626,3,5,5,30,0,47
55139007210,944,701,670,9,2,5,14,1,31
55059002648,1057,697,248,276,167,8,7,0,449
55059002611,751,579,534,20,9,8,5,0,45
55059002620,772,616,563,31,9,15,2,1,53
55059002601,5,3,0,2,0,0,0,0,3
55059002623,906,690,619,38,11,11,12,1,71
55059002622,786,625,587,22,0,10,0,0,38
55059002658,839,673,550,40,55,11,14,0,123
55059002664,1712,1314,921,174,173,37,18,5,393
55015000504,926,706,675,9,3,5,3,0,31
55121005986,781,538,512,12,2,2,2,0,26
55121006017,237,162,153,1,1,0,0,0,9
55121006005,196,164,159,1,0,2,0,0,5
55087004291,631,476,461,0,2,5,8,0,15
55057002585,35,28,23,3,0,1,1,0,5
55121006023,133,92,88,3,1,0,0,0,4
55121006024,629,525,493,27,3,1,2,1,32
55121006009,540,352,241,95,5,20,4,0,111
55121005999,1047,692,275,406,4,34,0,0,417
55081004126,302,237,221,5,5,4,3,0,16
55081004064,469,361,346,7,0,8,2,0,15
55133006612,2003,1519,1268,47,44,16,133,0,251
55081004068,536,425,368,13,17,12,12,1,57
55081004056,723,561,500,25,15,15,13,2,61
55081004060,557,442,412,5,3,16,3,0,30
55081004057,398,300,242,10,30,19,0,1,58
55113005725,498,396,328,7,0,56,5,0,68
55113005727,77,67,59,2,1,5,1,0,8
55113005730,133,113,101,3,0,4,0,0,12
55113005731,523,421,381,5,4,25,4,0,40
55113005726,65,30,21,0,0,9,0,0,9
55113005729,752,596,544,4,7,32,2,1,52
55113005717,630,393,43,2,2,348,0,2,350
55071003162,1929,1595,1487,36,18,13,31,1,108
55071003117,625,499,479,5,4,9,2,0,20
55071003112,773,598,580,4,0,9,3,0,18
55071003140,450,395,384,3,0,3,5,1,11
55071008083,0,0,0,0,0,0,0,0,0
55109005536,597,380,363,5,1,4,0,0,17
55109005531,971,663,611,21,1,5,7,1,52
55109005528,378,259,248,1,5,3,0,0,11
55113005703,325,260,237,5,0,18,0,0,23
55113005706,109,89,78,1,1,10,1,1,11
55113005699,232,208,195,2,0,6,0,0,13
55113005732,455,413,396,2,0,10,1,0,17
55087004321,939,693,607,74,2,11,0,0,86
55121006010,502,360,323,17,4,15,6,2,37
55087004359,1201,924,868,14,13,16,15,0,56
55087004387,494,371,337,13,6,9,6,0,34
55087004439,691,578,529,21,9,16,4,0,49
55057002558,682,538,514,11,0,7,2,1,24
55057002597,0,0,0,0,0,0,0,0,0
55057002567,621,516,485,5,3,7,9,1,31
55087004373,290,245,224,10,0,4,1,0,21
55087004311,290,222,184,22,6,8,0,1,38
55087004374,851,671,634,19,1,11,2,0,37
55109005550,249,179,176,2,0,1,0,0,3
55109005464,708,553,514,16,5,6,3,0,39
55077003456,124,105,105,0,0,0,0,0,0
55117005922,964,788,744,8,2,9,20,0,44
55117005883,576,440,400,19,0,8,10,1,40
55117005814,2099,1535,1099,193,33,45,149,0,436
55117005845,2567,1925,1564,114,51,29,165,2,361
55117005829,2599,1893,1273,266,89,64,238,4,620
55117005884,962,699,648,14,2,16,6,0,51
55117005827,1536,1088,680,202,46,28,122,2,408
55117005823,506,420,407,6,1,1,2,1,13
55131006399,1039,822,761,23,11,16,6,1,61
55131006390,769,568,529,12,5,9,14,0,39
55123006084,376,263,253,5,0,2,0,0,10
55123006044,251,179,177,0,0,0,1,0,2
55123006083,488,391,382,5,0,2,2,0,9
55005000148,447,365,343,8,7,7,3,1,22
55005000119,514,415,396,5,2,5,1,0,19
55005000105,556,447,415,18,3,6,4,1,32
55005000106,321,264,247,9,1,1,2,1,17
55139007111,1230,939,824,36,23,28,25,1,115
55139007103,1009,820,719,35,21,22,23,3,101
55139007175,1075,788,720,21,7,17,19,0,68
55139007219,2098,1653,1488,52,27,33,37,1,165
55139007176,1334,1031,957,19,9,21,23,0,74
55139007089,1434,1139,1048,22,6,13,31,0,91
55139007116,1123,823,600,76,78,22,49,0,223
55139007097,1742,1374,909,167,110,47,137,3,465
55087004362,385,312,244,28,8,8,24,0,68
55087004298,632,508,470,22,4,9,3,0,38
55087004365,521,393,376,3,2,9,3,0,17
55057002586,540,424,394,11,2,8,4,0,30
55057002534,647,474,442,4,3,11,7,0,32
55121005994,648,495,475,11,1,6,1,1,20
55121005995,568,406,396,4,0,3,1,0,10
55121005996,840,650,640,2,1,3,4,0,10
55081004095,82,67,65,0,0,1,1,0,2
55081004138,515,399,349,17,22,9,2,2,50
55081004096,794,672,570,16,47,21,19,3,102
55081008056,0,0,0,0,0,0,0,0,0
55081004104,0,0,0,0,0,0,0,0,0
55081004097,520,405,369,18,2,15,3,0,36
55081004139,688,542,435,18,34,26,25,1,107
55081004073,793,623,595,2,0,18,3,0,28
55081004074,544,417,374,10,15,14,6,0,43
55081004150,841,553,531,12,1,4,1,0,22
55081004121,667,484,379,88,7,3,4,0,105
55081004116,0,0,0,0,0,0,0,0,0
55081004092,343,267,241,13,3,5,5,3,26
55133006712,909,712,652,17,5,19,8,0,60
55081004071,193,152,146,0,0,1,0,0,6
55081004079,316,248,242,1,2,1,2,0,6
55133006696,810,644,541,61,15,10,10,0,103
55133006851,678,558,511,13,6,4,19,0,47
55133006892,0,0,0,0,0,0,0,0,0
55133006847,812,579,531,22,7,17,1,0,48
55133006881,916,660,587,36,4,6,15,1,73
55133006532,529,406,371,15,0,16,3,1,35
55133006846,678,538,517,9,6,4,2,0,21
55081004101,1234,959,841,13,9,99,4,2,118
55081004063,707,577,528,27,9,7,4,2,49
55071003089,987,737,611,104,1,8,11,0,126
55139007071,322,217,149,0,44,5,19,0,68
55063002923,1409,1044,997,14,4,4,20,0,47
55063002917,429,314,297,9,2,1,6,0,17
55063002936,0,0,0,0,0,0,0,0,0
55063002838,761,624,499,21,48,7,50,0,125
55071003104,346,288,279,1,0,0,8,0,9
55071003160,1784,1445,1314,37,15,16,51,0,131
55133006755,461,394,275,25,24,2,66,1,119
55073003242,1656,1311,1187,29,18,27,38,2,124
55073003337,885,602,583,3,0,4,4,0,19
55073003267,962,733,676,8,4,9,36,2,57
55073003347,680,540,510,10,1,8,9,1,30
55073003202,583,452,423,3,6,10,6,0,29
55073003243,590,471,428,4,0,2,31,0,43
55073003295,767,597,566,4,7,13,4,1,31
55073003306,728,575,555,7,2,5,5,0,20
55073003298,787,596,575,12,6,2,3,0,21
55073003254,1503,1155,990,24,15,16,102,1,165
55073003318,412,340,333,4,1,2,0,1,7
55073003317,740,599,578,7,0,3,8,0,21
55021000763,596,459,386,38,11,7,7,0,73
55021000807,422,313,287,13,2,6,1,0,26
55021000724,650,562,551,2,0,0,0,0,11
55021000805,673,489,472,7,0,6,2,0,17
55021000785,524,417,393,13,1,3,3,0,24
55097004813,499,405,390,4,2,4,2,0,15
55097004799,586,497,469,18,3,3,3,1,28
55097004824,375,305,291,5,0,8,1,0,14
55097004758,565,471,423,4,7,2,36,0,48
55139007220,1862,1303,1199,19,13,15,42,0,104
55139007206,1343,913,859,20,5,8,18,0,54
55139007183,782,609,575,10,4,8,11,2,34
55139007217,1185,970,899,25,20,8,18,0,71
55139007104,8,2,0,0,0,1,1,0,2
55097004794,767,602,544,19,9,7,20,0,58
55097004787,355,291,273,3,4,0,8,1,18
55097004785,1002,747,629,20,18,9,64,0,118
55131006358,819,636,597,19,0,10,0,0,39
55139007085,920,667,614,6,4,2,36,0,53
55139007130,675,524,502,3,2,7,12,0,22
55139007161,790,622,607,3,2,9,0,1,15
55071003092,894,758,738,8,2,8,1,0,20
55071003182,1018,802,778,14,5,6,3,0,24
55071003148,707,547,521,14,2,7,1,0,26
55061002797,403,330,311,14,0,7,0,0,19
55061002790,303,246,223,11,4,3,1,1,23
55061002786,834,682,639,18,10,5,6,2,43
55051002376,351,305,289,2,2,6,0,0,16
55133006677,1925,1413,1321,33,4,20,10,0,92
55133006720,1407,1108,1033,18,8,18,17,1,75
55133006728,1969,1603,1408,26,66,26,70,0,195
55133006725,1358,1118,1046,14,20,14,20,1,72
55133006788,2482,2001,1604,241,59,57,33,3,397
55053002407,536,377,367,3,1,4,1,0,10
55053002409,156,100,91,1,0,5,2,0,9
55053002408,161,108,103,0,0,3,0,0,5
55061002817,367,290,282,4,0,1,0,0,8
55061002809,565,429,383,29,0,12,1,0,46
55061002821,797,636,618,7,1,10,2,0,18
55097004802,1331,1027,843,82,18,21,62,0,184
55005000103,640,476,463,2,3,2,2,0,13
55005000130,777,637,614,3,2,5,7,0,23
55013000443,399,323,288,1,6,27,0,0,35
55013000446,480,356,319,7,6,17,3,1,37
55095004666,856,711,672,8,1,26,0,0,39
55095004726,669,521,505,6,1,6,1,0,16
55095004716,577,444,411,8,3,11,5,0,33
55095004732,516,442,408,16,8,5,3,0,34
55097004742,711,573,550,9,0,0,3,0,23
55087004289,1498,1332,1116,45,19,10,139,1,216
55087004300,1179,987,864,33,39,7,31,1,123
55087004312,1402,1065,938,35,26,14,55,0,127
55087004336,1692,1307,1056,63,20,32,133,2,251
55087004437,893,636,580,23,4,19,11,0,56
55087004349,963,756,725,15,6,13,3,0,31
55087004385,903,676,619,27,6,13,6,1,57
55087004481,0,0,0,0,0,0,0,0,0
55121006013,462,361,344,5,3,6,4,1,17
55121006001,610,462,437,5,1,7,3,0,25
55121006011,999,786,770,3,3,5,0,0,16
55121006000,247,185,177,5,1,0,0,0,8
55121006012,540,438,402,8,7,6,8,0,36
55035001838,263,205,188,12,1,2,0,0,17
55081004122,917,679,610,29,9,10,10,5,69
55081004124,0,0,0,0,0,0,0,0,0
55107005404,249,208,195,2,1,1,6,1,13
55107005442,124,104,96,1,0,2,1,0,8
55107005438,269,215,204,1,0,3,4,0,11
55107005433,22,18,18,0,0,0,0,0,0
55107005445,57,44,39,0,0,5,0,0,5
55107005408,525,417,407,5,0,2,1,0,10
55087004372,734,592,548,16,3,26,2,0,44
55087004445,459,345,334,2,6,1,0,1,11
55087004419,414,319,309,3,0,8,0,0,10
55087004464,1687,1434,1302,37,27,8,59,0,132
55057002569,656,470,438,9,5,9,8,2,32
55057002538,307,251,244,4,1,2,0,0,7
55057002539,323,240,223,7,3,5,2,0,17
55035001858,1365,1060,956,14,19,16,34,0,104
55035001852,2444,1905,1658,62,59,52,66,3,247
55035001891,742,583,526,5,3,10,35,0,57
55035001855,2754,2109,1927,32,7,23,99,2,182
55035001860,555,413,370,8,6,14,16,0,43
55035001845,505,378,328,20,5,5,15,0,50
55035001850,966,688,619,15,18,13,18,0,69
55047002268,387,351,314,19,10,4,11,0,37
55047002285,343,216,208,6,2,1,0,0,8
55035001803,631,479,456,1,4,7,5,1,23
55035001800,0,0,0,0,0,0,0,0,0
55035001806,317,228,194,20,0,7,3,0,34
55035001832,1078,599,578,11,1,6,1,0,21
55047002277,381,302,281,6,5,7,3,0,21
55047002276,452,370,348,5,2,7,0,0,22
55063002862,874,717,644,14,6,11,33,2,73
55071003181,0,0,0,0,0,0,0,0,0
55071003146,581,410,393,10,2,2,2,0,17
55071003088,650,524,490,19,3,8,3,0,34
55071003150,611,468,446,10,2,3,4,0,22
55071003147,127,117,115,0,0,2,0,0,2
55021000778,502,396,377,5,1,12,1,0,19
55021000780,436,348,334,6,0,3,3,0,14
55021000779,836,605,540,16,15,18,10,0,65
55021000753,965,716,645,38,4,14,5,0,71
55053002428,788,634,539,16,7,60,1,0,95
55011000404,451,359,345,4,2,1,4,0,14
55011000419,946,735,695,11,6,14,4,0,40
55011000400,167,149,144,2,1,2,2,1,5
55007000186,230,178,155,2,1,15,4,0,23
55087004395,1009,781,419,20,26,324,6,2,362
55087004344,941,695,492,18,10,181,6,2,203
55087004331,892,614,236,40,6,352,0,0,378
55057002593,758,572,541,7,8,7,9,0,31
55121006019,593,444,377,48,7,12,1,0,67
55051002365,212,170,164,2,1,3,0,0,6
55055002440,1443,1067,866,139,19,30,15,0,201
55055002532,663,496,449,33,8,5,4,0,47
55055002492,929,738,721,7,0,6,5,0,17
55055002531,1006,788,716,44,12,8,9,0,72
55055002491,969,755,702,22,4,9,10,1,53
55055002490,616,486,458,12,6,7,6,2,28
55063002887,853,628,589,5,5,2,22,0,39
55063002885,822,680,659,6,2,5,1,3,21
55063002882,1133,937,821,14,11,14,79,1,116
55063002888,1291,886,790,11,13,7,62,0,96
55063002886,601,401,338,5,3,4,52,0,63
55063002878,987,743,698,16,9,15,6,0,45
55063002841,733,635,563,7,16,14,26,1,72
55071003153,473,379,364,10,0,3,2,0,15
55071003152,110,94,92,1,1,0,0,0,2
55117005861,726,600,565,15,1,4,12,0,35
55117005854,498,398,362,18,1,8,4,0,36
55117005860,728,593,544,26,4,10,3,1,49
55117005844,937,737,655,25,10,6,36,2,82
55101004981,649,497,474,13,0,3,4,0,23
55101004932,2028,1348,138,556,650,21,8,3,1210
55117005871,726,609,585,17,1,2,2,0,24
55117005906,833,665,623,23,3,5,4,0,42
55131006477,830,641,613,12,0,8,5,1,28
55131006522,130,91,80,7,1,0,3,0,11
55131006354,531,417,390,12,0,6,6,1,27
55131006468,360,282,266,10,2,0,2,0,16
55131006448,1211,958,865,50,7,14,15,0,93
55113005715,779,674,468,6,2,196,1,0,206
55113005733,626,545,520,4,2,17,4,1,25
55113005701,336,274,234,11,1,24,1,0,40
55113005704,187,169,163,1,0,4,1,0,6
55113005709,120,105,100,0,1,3,1,0,5
55103005070,541,416,384,11,4,8,1,5,32
55103005101,436,315,294,8,0,7,4,3,21
55103005105,457,332,303,8,3,10,3,1,29
55095004706,948,756,705,12,5,15,1,1,51
55013000433,333,300,275,2,3,20,0,0,25
55111005617,641,487,465,12,4,0,2,0,22
55043002134,460,367,359,6,0,0,1,0,8
55043002164,608,438,420,1,3,5,6,0,18
55113005736,835,710,670,4,1,15,7,0,40
55055002529,1192,957,895,50,2,3,2,1,62
55055002462,957,758,668,73,2,13,1,1,90
55055002495,28,18,14,4,0,0,0,0,4
55055002474,1559,1000,866,65,40,19,12,1,134
55081004107,715,527,465,28,7,17,7,5,62
55081004125,106,86,83,2,0,0,1,0,3
55081004131,532,388,359,21,2,3,2,0,29
55081004130,482,330,321,0,1,3,1,0,9
55081004082,232,173,165,5,1,1,0,0,8
55081004087,645,468,385,29,21,17,12,0,83
55025001187,998,779,534,123,66,18,44,3,245
55025001145,1362,993,369,234,244,32,136,4,624
55081004089,458,347,297,13,9,14,9,3,50
55081004135,0,0,0,0,0,0,0,0,0
55081004133,729,537,501,10,2,8,5,1,36
55081004129,0,0,0,0,0,0,0,0,0
55081008055,8,5,3,0,1,0,0,0,2
55081004144,625,488,474,3,2,5,2,0,14
55081008054,0,0,0,0,0,0,0,0,0
55081004080,63,43,39,2,0,0,2,0,4
55081004143,402,317,297,9,1,4,2,0,20
55081004142,3,3,3,0,0,0,0,0,0
55081004148,971,718,675,10,9,7,11,0,43
55081004105,964,761,730,8,6,6,10,0,31
55081004106,840,635,478,103,13,18,22,2,157
55081004109,649,441,424,3,1,5,2,0,17
55081008057,0,0,0,0,0,0,0,0,0
55081004053,562,431,414,6,2,4,2,0,17
55081004069,329,247,243,2,2,0,0,0,4
55117005895,1076,862,745,64,5,27,9,1,117
55117005850,735,584,535,26,7,5,10,0,49
55055002431,1209,923,726,122,29,12,20,0,197
55055002510,546,448,429,8,0,3,4,1,19
55055002483,534,419,396,4,0,14,2,1,23
55083004166,586,416,389,14,2,10,2,0,27
55083004167,332,279,274,0,0,4,1,0,5
55117005824,1907,1506,1190,106,23,18,164,5,316
55117005815,258,205,132,33,13,9,24,0,73
55117005817,1060,785,615,64,18,17,66,1,170
55117005862,718,557,521,21,2,9,5,0,36
55025001133,1114,830,760,9,5,8,43,0,70
55025001136,3650,2998,2653,94,74,38,128,2,345
55025001204,632,510,486,9,1,6,5,0,24
55025001202,470,367,340,8,4,10,0,0,27
55111005691,413,360,333,16,1,1,1,0,27
55025001034,3052,2648,1805,237,161,40,393,10,843
55025001325,913,765,714,5,3,7,21,0,51
55025001324,646,549,504,7,9,11,11,4,45
55025001327,1062,878,833,13,3,10,13,1,45
55025001357,1511,1134,1081,12,11,7,23,0,53
55025001380,2206,1690,1334,111,120,23,93,0,356
55025001379,1900,1292,1125,39,53,10,42,1,167
55087004306,809,593,502,51,13,11,14,0,91
55087004447,929,704,563,65,19,16,38,0,141
55087004410,841,644,590,24,15,9,4,0,54
55087004409,967,771,711,19,10,17,21,0,60
55087004458,0,0,0,0,0,0,0,0,0
55087004314,752,562,509,11,2,29,10,0,53
55123006034,444,347,328,5,3,6,4,0,19
55123006078,155,113,93,1,5,9,1,2,20
55123006098,623,412,394,1,4,4,0,1,18
55131006476,515,415,402,8,1,4,0,0,13
55131006463,860,654,639,7,0,7,0,0,15
55131006365,807,637,617,15,1,2,2,0,20
55111005620,756,600,559,5,9,7,6,0,41
55111005592,406,320,310,2,0,6,0,0,10
55101004907,584,462,407,30,3,8,6,0,55
55101004949,3026,2298,1429,459,362,54,23,3,869
55113005735,487,455,422,6,7,16,0,0,33
55121005997,512,399,366,10,2,6,11,1,33
55121006026,685,517,491,12,5,1,2,1,26
55121005979,258,203,190,9,2,1,1,0,13
55087004320,12,4,2,0,0,0,0,0,2
55087004337,142,114,105,0,1,5,4,0,9
55087004293,999,774,743,4,1,13,3,0,31
55087004335,11,11,5,0,0,6,0,0,6
55087004376,886,695,650,18,6,10,5,1,45
55087004460,971,732,689,7,10,3,17,0,43
55087004401,2199,1621,1442,31,24,21,91,1,179
55087004319,1485,1190,970,67,23,34,99,5,220
55111005632,20,16,14,0,0,2,0,0,2
55111005629,662,498,478,12,0,3,1,0,20
55111005689,418,325,291,19,3,5,2,0,34
55111005633,301,231,226,2,3,0,0,0,5
55111005588,582,412,403,4,0,1,0,0,9
55111005589,694,549,516,7,6,10,4,0,33
55101005055,1489,1226,1081,75,14,14,40,2,145
55101005054,786,627,558,30,14,2,14,0,69
55101004906,870,665,574,46,20,8,10,0,91
55101004921,653,559,507,12,28,3,5,1,52
55101005006,654,508,364,49,51,7,38,2,144
55101005025,748,545,444,46,28,13,16,2,101
55101005005,919,738,536,77,50,14,49,0,202
55101004952,2649,1921,892,248,713,31,46,5,1029
55101004919,910,813,633,49,95,9,14,0,180
55101004955,2400,1862,1329,210,249,42,43,5,533
55101004958,1334,1147,762,151,201,30,18,1,385
55111005642,796,628,544,18,17,18,16,1,84
55111005692,958,769,689,29,12,22,16,0,80
55111005618,507,358,341,6,0,7,1,1,17
55111005605,514,352,348,2,0,0,1,0,4
55101004916,1524,1354,1184,46,44,10,62,3,170
55101004917,1260,995,773,65,121,24,26,1,222
55101004910,1132,914,739,65,49,13,37,2,175
55101005049,600,507,434,41,10,4,12,1,73
55101004893,1844,1442,1225,84,37,41,34,2,217
55101004972,505,412,375,11,4,8,11,0,37
55101004971,649,518,453,35,11,12,2,0,65
55101005009,458,381,355,14,4,3,3,0,26
55111005631,527,397,378,8,0,8,1,1,19
55077003454,403,320,297,16,1,5,0,0,23
55117005920,946,748,736,3,4,6,0,0,12
55117005930,0,0,0,0,0,0,0,0,0
55117005888,671,485,431,12,0,5,27,3,54
55117005839,463,400,381,4,5,4,4,0,19
55131006406,680,560,541,8,0,3,6,0,19
55131006370,921,777,747,10,10,5,3,0,30
55131006423,675,539,513,13,2,5,4,0,26
55131006495,0,0,0,0,0,0,0,0,0
55117005853,945,725,692,19,3,8,7,0,33
55117005882,924,667,632,12,5,8,7,0,35
55131006417,1131,907,819,17,38,12,26,1,88
55117005877,719,598,582,4,4,2,2,0,16
55117005889,1166,870,811,14,11,5,21,0,59
55117005934,735,603,565,15,4,9,12,0,38
55077003453,123,91,75,7,2,5,1,0,16
55101004915,1143,919,788,48,45,12,24,0,131
55101004914,727,622,536,30,37,4,7,0,86
55111005606,788,635,616,10,0,3,0,0,19
55123006040,493,387,380,1,0,4,0,0,7
55101004911,927,732,540,60,102,13,13,0,192
55101004900,870,678,550,54,29,13,24,3,128
55111005593,286,235,230,2,1,2,0,0,5
55111005627,163,135,130,3,0,3,1,0,5
55111005609,603,468,442,7,2,15,0,0,26
55123006085,732,548,532,9,0,0,0,0,16
55123006101,241,201,198,1,0,0,2,0,3
55123006071,333,223,210,2,3,4,0,0,13
55123006072,488,327,315,4,1,2,2,0,12
55123006095,945,775,738,10,7,8,4,0,37
55123006046,97,67,63,0,0,2,0,0,4
55123006070,1055,570,554,9,0,5,2,0,16
55123006069,319,207,192,8,1,3,2,0,15
55101005004,1060,799,550,83,138,16,19,0,249
55101004980,744,624,537,43,15,14,7,1,87
55101005008,589,460,404,25,10,15,4,1,56
55101005001,410,340,314,19,6,1,0,0,26
55111005650,669,535,489,18,1,9,9,0,46
55111005679,832,611,583,10,2,12,5,0,28
55111005643,621,519,476,14,9,9,8,2,43
55111005636,958,744,673,19,13,16,14,0,71
55111005640,688,563,500,29,9,14,6,0,63
55111005613,826,664,631,7,6,7,6,0,33
55111005665,225,198,185,10,0,2,1,0,13
55111005664,810,661,624,13,3,9,4,0,37
55043002195,658,503,488,2,0,7,1,0,15
55101004909,1595,1357,746,142,356,22,88,0,611
55077003464,811,623,599,4,6,9,5,2,24
55043002167,480,395,372,9,4,7,0,0,23
55025001159,2179,1823,1562,60,66,22,99,0,261
55025001226,78,68,51,6,7,1,5,0,17
55025001116,3263,3179,2452,189,100,37,399,9,727
55025001104,2127,1807,1386,65,234,33,83,4,421
55025001110,3555,3153,2659,137,127,52,137,1,494
55025001111,3462,3191,2736,122,162,53,114,3,455
55025001107,2427,1953,1406,141,273,36,92,1,547
55025001113,2523,2264,1698,139,229,56,117,0,566
55025008077,0,0,0,0,0,0,0,0,0
55025008076,0,0,0,0,0,0,0,0,0
55025001350,0,0,0,0,0,0,0,0,0
55025001349,0,0,0,0,0,0,0,0,0
55025001203,483,361,343,6,5,1,5,0,18
55025001021,844,690,572,41,40,14,20,1,118
55117005894,783,633,605,12,0,5,10,0,28
55117005899,754,580,536,16,6,5,13,0,44
55117005912,723,585,564,8,2,3,4,0,21
55131006377,1006,812,767,27,9,4,1,0,45
55131006451,121,91,91,0,0,0,0,0,0
55131006475,0,0,0,0,0,0,0,0,0
55131006437,664,533,503,21,2,3,2,0,30
55131006420,824,647,598,22,6,12,10,1,49
55117005866,924,717,684,13,0,2,10,0,33
55117005921,380,320,299,8,0,4,0,0,21
55117005831,384,289,266,16,1,3,1,0,23
55117005832,365,304,295,3,1,0,3,0,9
55077003465,616,512,496,8,2,3,3,1,16
55073003252,741,613,562,5,9,13,22,1,51
55073003319,553,436,386,33,4,10,2,0,50
55073003281,865,714,656,9,4,11,28,2,58
55099004888,518,451,442,3,0,4,1,0,9
55099004885,440,365,356,3,0,5,1,0,9
55099004869,311,259,253,0,1,4,1,0,6
55099004854,247,205,203,1,0,1,0,0,2
55135006975,373,316,310,0,0,5,1,0,6
55127006280,797,661,629,16,2,8,3,0,32
55127006290,729,558,544,6,3,2,3,0,14
55127006168,577,466,425,31,0,6,1,0,41
55135006951,715,596,551,18,5,13,4,1,45
55135006950,311,245,214,11,5,6,5,3,31
55135006907,841,631,580,18,2,22,2,2,51
55135006920,406,312,287,16,2,3,3,0,25
55135006938,724,605,600,3,0,1,1,0,5
55033001748,698,561,537,3,1,7,10,0,24
55067002998,132,86,77,4,0,2,0,2,9
55067003000,89,70,61,6,0,3,0,0,9
55067003004,903,716,674,21,3,9,4,0,42
55135006922,693,533,450,56,7,17,2,0,83
55125006104,743,599,581,6,1,10,0,0,18
55125006139,1091,909,865,10,5,22,1,1,44
55135006905,60,48,44,1,0,0,0,0,4
55135006961,600,469,451,9,2,5,1,0,18
55135006980,295,232,220,5,1,1,0,0,12
55135006983,693,600,570,3,2,7,7,0,30
55135006976,233,189,184,1,0,2,3,0,5
55135006928,804,633,600,8,2,14,3,0,33
55135006955,336,246,230,6,6,5,0,0,16
55135006957,344,265,241,3,2,13,2,0,24
55009000329,3165,2282,1035,992,93,152,75,3,1247
55009000231,2412,1699,862,602,135,67,62,1,837
55009000294,2307,1632,866,531,85,91,77,4,766
55027001507,458,381,362,12,0,0,0,0,19
55067003021,518,411,397,2,0,10,2,0,14
55125006144,245,205,198,1,0,2,1,0,7
55125006120,300,248,235,4,1,6,0,0,13
55141007292,400,322,292,7,4,6,5,0,30
55141007270,83,78,78,0,0,0,0,0,0
55141007299,139,119,108,0,0,0,11,0,11
55141007336,711,615,590,6,2,6,4,0,25
55141007337,464,363,353,3,0,6,1,0,10
55141007323,574,463,363,39,6,58,0,0,100
55141007322,1,0,0,0,0,0,0,0,0
55141007320,476,399,362,23,1,3,9,0,37
55009000356,1007,758,724,6,1,11,3,0,34
55009000222,1029,710,673,6,2,14,4,1,37
55099004868,365,274,266,0,0,1,0,0,8
55027001561,483,357,351,0,0,5,0,0,6
55027001567,0,0,0,0,0,0,0,0,0
55027001566,0,0,0,0,0,0,0,0,0
55085004227,241,201,192,2,1,6,0,0,9
55085004224,202,164,153,2,0,6,1,0,11
55085004268,255,187,155,10,0,14,3,0,32
55085004244,631,507,453,10,1,32,7,0,54
55027001583,2276,2120,1267,119,633,82,29,1,853
55127006282,775,642,614,15,2,5,4,0,28
55127006281,900,725,675,16,1,12,2,1,50
55127006149,556,493,482,4,0,0,7,0,11
55085004262,74,67,64,2,0,0,1,0,3
55085004265,873,678,617,17,8,26,10,0,61
55085004236,104,85,71,3,0,9,2,0,14
55085004283,353,318,310,0,0,1,1,1,8
55033001740,922,723,689,7,5,11,8,1,34
55009000388,1738,1424,978,268,55,32,86,0,446
55009000384,1476,1134,982,46,15,29,54,0,152
55019000698,410,340,330,4,0,3,0,0,10
55037001947,337,254,234,5,0,13,0,0,20
55037001936,209,162,156,1,0,1,0,0,6
55019000651,433,333,326,3,0,0,0,1,7
55015000476,424,293,275,8,1,10,0,0,18
55015000477,664,525,505,11,4,3,0,0,20
55027001532,295,235,226,6,0,4,1,0,9
55027001595,810,637,602,14,5,13,6,0,35
55027001533,4,3,0,2,0,0,1,0,3
55027001579,676,578,547,14,3,2,10,0,31
55027001511,533,408,380,11,3,7,3,0,28
55027001596,0,0,0,0,0,0,0,0,0
55009000245,1775,1344,955,246,21,43,81,8,389
55009000290,1038,777,704,17,11,23,26,0,73
55009000369,994,800,667,30,34,25,48,1,133
55009000303,2767,2036,1920,26,17,35,32,0,116
55009000221,1691,1275,1164,45,17,25,22,0,111
55009000219,1939,1529,1433,11,20,20,32,0,96
55009000211,1258,1027,901,28,10,39,45,0,126
55015000488,2168,1697,1321,158,83,36,109,3,376
55015000530,829,546,525,7,0,8,4,0,21
55015000479,606,429,398,11,1,10,8,0,31
55015000528,435,341,319,12,1,5,4,0,22
55015000529,557,403,379,6,1,4,6,1,24
55015000511,0,0,0,0,0,0,0,0,0
55015000535,921,683,630,18,1,9,25,0,53
55015000469,652,537,496,30,0,6,1,0,41
55045002229,245,197,189,3,0,0,2,0,8
55045002221,793,609,587,12,2,5,2,1,22
55045002234,690,528,506,4,1,4,4,0,22
55045002236,499,405,386,4,2,8,0,0,19
55045002212,540,429,410,4,0,4,5,0,19
55075003375,700,523,504,2,0,0,6,0,19
55075003376,531,378,353,2,3,9,8,0,25
55019000664,210,185,175,2,0,3,2,0,10
55019000645,436,294,271,17,1,4,2,0,23
55019000696,250,185,178,2,0,1,0,0,7
55115005801,415,311,277,4,1,24,3,0,34
55115005802,817,688,629,16,2,44,3,0,59
55115005781,723,560,469,16,3,67,1,0,91
55033001747,1065,841,802,15,10,7,7,1,39
55033001763,408,325,303,9,3,3,4,2,22
55089004514,1821,1404,1310,30,20,14,20,6,94
55089004511,1507,1176,1117,17,6,7,25,6,59
55089004497,600,513,480,12,4,1,11,0,33
55089004526,961,706,633,43,6,12,9,0,73
55089004557,359,282,265,7,0,0,9,0,17
55089004554,631,502,450,37,2,5,5,0,52
55089004546,491,406,360,19,5,10,10,0,46
55089004504,829,647,595,26,10,15,1,0,52
55115005747,600,490,456,13,5,16,0,0,34
55115005787,679,561,509,9,7,34,3,0,52
55093004619,602,465,447,6,0,7,1,1,18
55045002244,1170,916,855,38,4,13,3,0,61
55045002220,523,429,409,12,1,5,2,0,20
55049002334,488,384,366,7,2,2,4,0,18
55079003806,2041,1638,802,109,613,16,96,0,836
55079003807,2186,1705,912,59,609,16,101,2,793
55079003788,2523,1974,1113,107,567,42,151,6,861
55119005951,460,347,338,6,1,3,0,0,9
55119005975,445,366,343,14,0,7,1,0,23
55119005971,525,390,373,4,3,1,0,0,17
55119005946,378,296,280,5,0,4,3,1,16
55079003576,2524,2006,1428,198,175,29,175,8,578
55079003940,1481,1221,1010,110,42,42,18,1,211
55079003759,2276,1623,150,65,1261,14,154,2,1473
55075003402,390,315,305,2,1,3,0,0,10
55133006652,657,525,460,15,23,3,24,1,65
55133006690,777,599,571,12,0,8,6,0,28
55133006809,874,691,628,27,3,13,13,0,63
55133006717,702,482,456,8,3,6,5,0,26
55133006718,1743,1320,1238,34,13,16,16,1,82
55133006714,1705,1320,1211,56,10,20,17,0,109
55133006716,1391,999,932,24,11,4,12,0,67
55125006105,199,161,154,2,0,7,0,0,7
55115005796,861,681,640,11,5,21,4,0,41
55091004605,542,463,434,8,5,15,1,0,29
55129006324,461,334,317,8,0,7,1,0,17
55079003760,1396,922,60,49,796,23,13,0,862
55079003907,2447,1923,1458,230,151,59,38,2,465
55079003909,2073,1639,1186,219,136,65,39,3,453
55079003903,2039,1627,1197,225,105,47,64,3,430
55079003910,2692,2066,1383,425,147,76,71,0,683
55079003953,1180,914,798,56,21,7,29,1,116
55079003636,1875,1246,217,31,790,19,199,8,1029
55105005359,780,611,519,42,9,20,13,0,92
55105005197,573,419,329,47,8,19,7,0,90
55041002096,413,334,305,3,1,22,1,7,29
55079003660,2547,1677,158,1302,177,80,77,1,1519
55079003649,2713,1833,301,1311,202,88,53,2,1532
55079003661,2932,1972,247,1430,253,83,65,0,1725
55079003601,889,647,21,19,595,11,9,0,626
55079003606,2814,2406,1318,254,608,37,204,8,1088
55079003957,1955,1560,1318,76,42,30,102,3,242
55137007044,619,521,513,1,1,3,2,0,8
55115005789,981,846,760,10,3,68,2,0,86
55115005748,774,662,602,17,3,39,1,0,60
55085004281,388,354,336,1,2,11,2,2,18
55085004229,467,363,347,1,1,9,1,0,16
55079003849,1882,1674,1253,91,136,28,166,2,421
55079003850,2675,2024,1848,55,58,21,39,1,176
55079003709,3749,2755,870,147,1499,37,222,3,1885
55079003588,818,708,663,24,10,7,3,1,45
55079003599,1477,1006,19,56,931,23,7,0,987
55079003597,2252,1449,62,24,1349,26,9,0,1387
55079003499,1187,829,717,41,21,6,36,2,112
55079003891,2679,2238,1685,249,165,57,80,0,553
55079004029,698,544,307,154,71,13,16,1,237
55079003676,3059,2710,2072,237,278,57,62,12,638
55079003678,2482,1981,916,351,673,46,41,4,1065
55079003536,1293,981,785,103,41,38,25,0,196
55079003517,1558,1245,1059,100,49,11,18,0,186
55079003989,1879,1507,933,282,158,29,107,2,574
55079003583,2093,1722,1081,133,93,36,401,0,641
55079003584,2179,1739,1253,204,115,21,149,5,486
55043002177,771,561,538,3,7,3,0,0,23
55105005278,643,484,440,33,3,3,0,1,44
55105005280,610,464,416,22,9,8,7,1,48
55105005279,731,521,471,21,5,8,10,2,50
55119005958,433,320,310,8,0,2,0,0,10
55079003828,1008,733,630,33,28,9,27,0,103
55079003823,717,549,454,24,33,3,28,3,95
55079003804,2094,1655,721,67,684,29,168,3,934
55063002851,2490,2072,1803,46,60,42,112,1,269
55063002827,924,761,678,11,25,15,24,0,83
55133006581,839,591,547,17,4,2,18,0,44
55133006694,1623,1232,1060,78,26,23,38,3,172
55109005465,580,446,414,8,2,10,4,0,32
55109005548,866,619,572,8,3,14,4,0,47
55109005463,546,421,377,6,10,11,16,0,44
55045002223,639,486,460,12,1,8,3,1,26
55071003154,106,90,87,0,2,0,0,0,3
55071003091,751,570,543,7,3,6,4,0,27
55133006836,305,265,224,15,3,3,18,0,41
55133006833,2118,1646,1411,64,6,30,118,3,235
55133006566,2504,2011,1735,58,27,20,163,1,276
55133006837,1901,1494,1371,55,7,18,47,1,123
55133006839,27,15,10,3,1,2,0,0,5
55079003563,893,702,621,47,15,11,8,0,81
55079003564,846,646,500,34,54,10,39,1,146
55079003716,3535,2683,1439,133,958,41,129,3,1244
55079003863,2931,1914,327,1418,108,121,72,4,1587
55079003558,1913,1537,1344,90,20,16,60,0,193
55049002346,237,182,174,4,1,1,1,0,8
55049002343,82,76,73,1,0,2,0,0,3
55079004023,2112,1611,1361,66,136,16,40,0,250
55079003674,1860,1236,135,133,976,16,17,5,1101
55119005937,408,295,286,2,2,5,0,0,9
55079003987,2336,1873,1446,245,40,46,101,7,427
55079003717,1486,986,104,54,769,25,52,5,882
55031001724,463,384,342,7,6,27,1,0,42
55031001723,116,87,70,4,4,6,3,0,17
55031001722,238,191,158,6,9,15,1,1,33
55031001709,1067,806,712,20,25,44,7,0,94
55079004003,1548,1157,772,242,72,37,52,0,385
55079003990,2213,1638,1033,423,93,44,64,2,605
55079003929,1589,1125,536,477,47,28,59,0,589
55079003579,2235,1709,1476,92,43,34,59,2,233
55079003905,2677,2101,1605,260,122,64,54,2,496
55079003826,1024,778,704,31,22,4,18,0,74
55091004604,189,160,149,3,0,7,1,0,11
55137007019,406,369,344,3,1,9,9,0,25
55039002048,742,550,488,33,9,14,2,0,62
55039002047,721,577,565,5,2,2,4,0,12
55029001606,509,457,425,16,2,6,3,1,32
55029001607,714,606,585,11,1,4,2,0,21
55029001648,733,651,612,7,8,12,5,0,39
55075003374,537,458,447,2,0,0,0,0,11
55075003419,786,671,630,11,1,17,1,0,41
55075003409,651,526,508,3,3,7,3,1,18
55075003406,535,434,414,7,0,10,1,0,20
55075003434,970,795,747,15,3,20,3,1,48
55011000402,541,456,436,11,4,3,1,1,20
55031001725,1980,1632,1539,5,16,42,10,2,93
55137007049,551,479,463,3,3,4,2,0,16
55079003958,2186,1802,1475,114,71,20,131,5,327
55079003695,1512,1046,34,46,957,8,13,2,1012
55105005354,2415,1848,1722,38,46,25,17,1,126
55105005168,2562,2000,1762,98,59,35,40,2,238
55105005284,316,256,242,2,2,9,0,0,14
55105005290,730,597,574,5,5,6,4,0,23
55105005111,1928,1338,807,292,196,56,14,0,531
55105005112,1591,1220,866,153,162,36,4,1,354
55139007163,852,647,629,8,0,4,0,0,18
55069003070,187,165,161,0,1,1,1,0,4
55069003077,124,107,103,4,0,0,0,0,4
55053002392,825,662,606,5,5,37,2,1,56
55081004062,972,739,696,11,6,13,11,0,43
55015000517,740,567,527,16,2,17,3,0,40
55079003553,857,735,592,61,30,27,27,0,143
55079003542,745,647,551,61,7,11,11,0,96
55079003486,1047,865,659,51,55,23,83,1,206
55049002359,292,242,227,5,0,4,3,1,15
55015000475,446,331,324,0,1,3,0,0,7
55015000500,346,271,248,11,0,9,3,0,23
55015003000,1,0,0,0,0,0,0,0,0
55015000491,351,301,294,2,0,2,0,1,7
55093004631,866,680,648,6,3,13,6,0,32
55093004640,255,194,191,2,0,1,0,0,3
55097004782,202,154,138,10,3,0,0,0,16
55097004738,478,358,338,7,0,6,1,0,20
55097004832,622,492,482,4,2,4,0,0,10
55139007153,1281,957,847,42,9,23,32,5,110
55139007093,1171,827,681,59,47,20,15,6,146
55065002966,789,572,536,20,3,6,10,0,36
55065002972,358,267,254,6,0,5,2,0,13
55023000833,519,385,371,2,3,6,1,0,14
55023000826,1280,1137,839,52,210,32,6,0,298
55023000827,866,686,637,14,15,9,8,2,49
55055002432,821,644,552,49,7,11,18,2,92
55093004652,996,837,713,27,32,14,36,3,124
55017000607,330,265,243,4,2,6,0,1,22
55069003060,693,555,540,2,0,6,4,0,15
55097004835,695,548,532,6,1,2,3,0,16
55097004761,532,441,426,2,2,6,0,0,15
55139007213,49,33,22,3,5,2,1,0,11
55139007255,531,400,366,4,0,1,28,1,34
55083004174,866,677,631,22,1,17,4,0,46
55055002444,239,155,87,63,3,2,2,0,68
55055002439,1676,1258,1082,89,9,27,14,0,176
55055002506,846,710,677,11,3,5,2,0,33
55083004160,275,241,232,2,1,3,1,0,9
55049002309,137,112,107,1,0,0,0,0,5
55049002310,306,222,214,3,1,2,1,0,8
55049002327,657,513,482,4,5,6,14,0,31
55049002329,631,517,480,10,5,12,5,0,37
55049002326,9,5,4,1,0,0,0,0,1
55049002328,172,139,124,7,1,2,7,0,15
55049002305,191,153,148,3,2,2,1,0,5
55049002303,874,645,603,9,11,19,1,0,42
55073003269,1719,1314,1216,13,7,11,60,2,98
55073003284,786,622,595,5,4,5,7,0,27
55073003258,1259,1006,846,17,24,25,86,0,160
55021000769,953,798,725,29,15,11,11,0,73
55015000515,524,409,394,3,1,2,1,0,15
55015000516,226,193,186,0,0,6,0,1,7
55015000467,678,541,520,4,0,13,2,0,21
55131006369,1027,777,704,33,14,10,13,1,73
55131006438,883,715,686,12,3,7,9,2,29
55131006481,1503,1233,1096,31,61,4,37,1,137
55131006422,2104,1610,1291,84,80,30,111,4,319
55131006497,902,679,651,9,9,6,1,0,28
55131006425,757,532,472,20,11,18,11,0,60
55131006414,1030,802,763,14,7,4,9,1,39
55131003019,0,0,0,0,0,0,0,0,0
55073003320,557,446,436,3,4,0,0,0,10
55073003313,506,369,360,2,2,2,1,0,9
55013000435,367,299,285,4,0,8,0,1,14
55095004670,1112,907,857,7,7,18,2,6,50
55095004707,107,84,77,3,0,0,2,0,7
55017000560,917,727,650,13,2,11,40,0,77
55017000597,2247,1728,1617,31,26,18,25,2,111
55017000636,0,0,0,0,0,0,0,0,0
55059002740,2132,1516,553,444,482,48,17,6,963
55059002748,752,533,168,178,182,9,10,0,365
55059002741,990,686,321,207,141,14,10,3,365
55059002650,1274,901,513,189,183,26,12,0,388
55059002747,1058,702,503,70,66,9,59,0,199
55059080029,0,0,0,0,0,0,0,0,0
55059002780,14,10,5,3,0,0,0,0,5
55059002761,13,4,0,2,0,0,1,0,4
55059002669,1851,1248,804,127,98,15,180,2,444
55059003053,0,0,0,0,0,0,0,0,0
55059002781,0,0,0,0,0,0,0,0,0
55059003048,0,0,0,0,0,0,0,0,0
55059002775,10,1,0,0,0,0,1,0,1
55059003054,12,7,5,0,0,2,0,0,2
55059002783,0,0,0,0,0,0,0,0,0
55059003046,0,0,0,0,0,0,0,0,0
55059002706,754,633,563,18,18,12,23,1,70
55059002655,1406,1007,555,265,157,25,15,1,452
55059002656,1073,808,562,129,88,32,4,2,246
55017008003,4,3,3,0,0,0,0,0,0
55017008002,5,5,5,0,0,0,0,0,0
55017000567,289,204,188,0,2,12,0,0,16
55017000628,0,0,0,0,0,0,0,0,0
55017000541,465,339,332,0,0,2,1,0,7
55021000750,458,331,304,18,4,0,1,0,27
55107005414,70,61,60,0,0,1,0,0,1
55083004189,335,277,262,5,1,3,1,0,15
55083004187,583,458,425,6,4,17,3,0,33
55059002619,1052,814,727,49,12,16,10,2,87
55059002693,1034,799,692,37,13,20,24,0,107
55059003055,8,4,2,1,0,0,0,0,2
55059002700,1294,938,761,58,42,8,64,0,177
55059002760,0,0,0,0,0,0,0,0,0
55059002774,0,0,0,0,0,0,0,0,0
55059002605,870,682,602,43,6,16,7,3,80
55059002604,918,706,627,37,5,19,7,0,79
55089004509,1760,1329,1212,39,44,12,19,0,117
55089004561,1241,1067,976,14,28,8,32,3,91
55089004494,1337,1111,1002,27,31,4,37,0,109
55065002975,109,88,85,1,0,0,1,0,3
55107005388,115,100,93,4,0,2,1,0,7
55107005407,51,45,41,0,1,1,1,0,4
55107005403,479,395,362,7,1,11,2,0,33
55107005432,44,38,37,0,0,1,0,0,1
55087004414,1292,991,924,29,4,15,15,2,67
55057002587,578,479,463,1,1,9,2,0,16
55087004404,260,213,181,7,7,9,4,2,32
55079003573,2158,1722,1209,195,86,37,198,2,513
55079003554,1933,1543,1259,82,33,22,134,0,284
55079003507,2446,2385,2011,74,120,9,145,0,374
55079003878,1300,909,173,595,66,37,65,3,736
55095004693,283,212,190,9,0,3,6,0,22
55095004691,529,420,386,11,1,13,2,1,34
55095004690,523,431,413,2,5,8,3,0,18
55013000432,856,693,667,1,1,12,3,0,26
55013000428,337,286,266,5,2,16,0,0,20
55107005401,115,105,101,0,0,4,0,0,4
55021000772,639,507,480,5,6,11,0,0,27
55021000727,842,735,724,0,3,4,4,0,11
55039001983,661,490,467,9,2,9,2,0,23
55039001987,1091,813,761,25,4,10,12,3,52
55039001988,947,759,728,10,1,17,5,0,31
55065002987,166,120,115,2,0,3,0,0,5
55065002986,399,291,253,20,3,9,1,1,38
55065002953,613,492,469,8,2,9,2,0,23
55065002964,300,224,218,1,1,3,0,0,6
55075003408,633,524,498,6,7,7,1,1,26
55075003428,626,481,443,10,4,14,5,0,38
55075003427,754,619,579,13,2,11,1,0,40
55029001646,457,368,338,13,5,3,2,0,30
55029001661,8,2,2,0,0,0,0,0,0
55073003262,1137,859,711,59,14,18,61,0,148
55109005534,871,634,595,8,9,11,4,0,39
55065002973,486,380,371,1,1,1,5,2,9
55059002630,1757,1246,858,144,79,16,138,0,388
55059002668,1566,1097,687,154,111,26,135,2,410
55059002751,1391,1125,766,138,134,11,82,0,359
55059002729,1969,1386,555,428,385,39,7,0,831
55059002714,1523,1089,390,423,242,28,10,1,699
55059002675,642,505,364,102,25,7,2,1,141
55059002643,1209,884,458,297,99,37,7,0,426
55059002725,1647,1372,913,209,178,17,74,0,459
55059002726,1025,869,729,45,42,12,39,3,140
55059002763,742,735,370,112,169,14,76,1,365
55059002685,598,473,434,22,1,14,2,0,39
55059002686,74,55,44,5,0,7,0,0,11
55059002609,87,77,75,0,0,2,0,0,2
55059002682,720,578,553,9,4,11,1,0,25
55079003995,2299,1815,1324,247,85,35,136,2,491
55079003792,1208,1045,661,32,312,8,25,0,384
55079003815,150,136,115,3,9,5,0,0,21
55043002132,842,650,639,6,0,5,0,0,11
55043002148,202,182,181,0,0,0,0,0,1
55039002004,544,415,391,10,2,9,1,0,24
55039001995,1007,776,748,15,4,9,3,0,28
55071003129,1529,1221,1152,19,10,17,15,0,69
55071003149,567,426,407,9,2,4,2,1,19
55133006546,610,504,479,9,2,4,5,0,25
55133006614,717,599,568,10,6,7,3,0,31
55133006668,791,661,633,9,1,3,10,1,28
55005000092,699,530,507,4,1,5,6,2,23
55041002100,490,326,163,5,2,155,2,2,163
55051002367,160,145,142,0,0,1,0,0,3
55083004197,271,222,215,2,1,4,0,0,7
55083004198,714,577,551,7,2,13,2,0,26
55133006815,739,526,500,15,2,5,2,2,26
55133006692,814,604,558,15,6,9,11,1,46
55021000745,558,462,444,7,3,5,3,1,18
55021000800,805,638,604,8,4,13,5,0,34
55021000802,0,0,0,0,0,0,0,0,0
55021000739,280,214,210,0,2,1,3,0,4
55025001166,2295,1758,1195,180,240,39,112,4,563
55025001033,1018,738,348,96,202,20,90,1,390
55025001168,615,462,270,76,70,11,38,1,192
55025001339,1105,840,800,12,5,14,6,1,40
55025001297,1135,814,757,21,6,5,17,0,57
55025001163,2962,2640,2139,137,137,44,204,3,501
55025001158,3718,3429,1863,164,168,26,1201,5,1566
55025000953,881,637,548,30,30,9,23,4,89
55025000952,901,676,569,49,29,16,17,0,107
55003000069,368,304,293,3,1,8,1,0,11
55025000990,961,795,750,11,6,10,11,2,45
55025001422,1639,1193,1082,35,19,14,33,1,111
55025001074,4,3,2,0,0,0,1,0,1
55133006658,848,672,644,14,6,5,5,0,28
55051002378,290,262,252,2,1,7,0,0,10
55079003904,2640,2079,1593,255,159,35,38,2,486
55079003991,2927,2316,1538,534,127,77,82,3,778
55079003994,3022,2302,1511,385,204,71,149,6,791
55079003889,1304,972,698,200,27,22,27,0,274
55079003773,1634,1125,133,33,796,19,147,3,992
55079003638,1898,1343,180,48,1005,22,100,1,1163
55079003997,3783,2914,1962,468,202,62,259,4,952
55079003923,2195,1633,1042,315,45,31,223,0,591
55079004021,1208,943,648,67,174,29,28,3,295
55079003827,591,492,415,22,31,3,20,0,77
55079003824,45,31,28,0,0,0,3,0,3
55079003960,1588,1316,1068,108,43,32,67,0,248
55079003604,1410,933,16,100,734,18,85,6,917
55023000824,507,382,369,2,1,4,3,0,13
55133006562,809,644,550,27,19,16,32,0,94
55133006733,1687,1301,1131,47,66,24,44,0,170
55133006808,806,584,527,23,5,15,8,0,57
55133006660,828,692,590,53,8,19,14,3,102
55133006797,1580,1188,811,292,26,29,22,5,377
55133006685,490,378,237,108,11,17,6,0,141
55133006761,1868,1323,845,304,116,30,39,3,478
55133006805,1673,1204,817,223,114,22,29,0,387
55061002822,334,243,235,2,0,3,1,0,8
55061002810,327,245,230,5,1,7,3,0,15
55097004741,679,543,517,13,1,4,9,0,26
55097004736,1063,801,766,13,1,2,12,1,35
55097004760,0,0,0,0,0,0,0,0,0
55097004739,420,313,285,17,1,7,2,0,28
55097004762,1076,959,878,23,14,15,25,0,81
55133006745,1379,1046,936,30,16,10,55,1,110
55069003045,528,425,395,6,12,6,1,0,30
55069003036,644,484,446,7,10,14,2,0,38
55097004821,568,432,324,87,3,8,0,1,108
55097004753,305,232,205,13,1,6,2,0,27
55031001691,629,452,422,1,4,18,8,0,30
55133006841,76,51,37,7,0,3,0,3,14
55133006740,1508,1054,838,20,38,3,148,0,216
55133006563,2070,1462,1120,34,102,20,172,0,342
55063002916,519,403,393,1,1,2,4,0,10
55133006768,1940,1606,1371,49,34,20,132,0,235
55133006767,1244,1025,927,24,11,8,58,1,98
55133006539,448,368,343,5,2,7,6,0,25
55133006535,726,584,533,21,2,9,11,0,51
55133006544,863,703,678,8,0,3,12,0,25
55043002161,240,199,192,1,0,2,1,0,7
55043002112,336,260,243,11,0,5,2,0,17
55025001368,0,0,0,0,0,0,0,0,0
55025001075,17,8,0,3,3,0,2,0,8
55025000920,374,299,295,1,0,1,2,0,4
55025000914,0,0,0,0,0,0,0,0,0
55025001134,2662,2354,1895,92,57,17,275,0,459
55089004549,2055,1639,1502,32,24,10,65,1,137
55089004560,844,636,603,15,1,6,11,0,33
55089004523,665,548,508,19,6,3,0,1,40
55089004558,760,567,511,22,14,9,1,0,56
55061002788,453,341,324,0,4,10,1,0,17
55031001672,585,484,411,7,23,27,17,0,73
55107005413,331,249,244,0,0,2,1,0,5
55107005394,122,100,95,2,0,2,0,0,5
55087004330,1526,1206,856,191,74,32,53,2,350
55087004484,976,738,620,36,34,14,36,0,118
55087004476,0,0,0,0,0,0,0,0,0
55087004449,366,292,282,2,0,5,2,0,10
55087004453,1810,1265,1201,10,13,11,22,2,64
55087004326,943,695,619,45,8,18,8,0,76
55087004343,2005,1527,1415,48,15,30,22,2,112
55087004355,1233,984,908,45,6,21,5,2,76
55029001629,308,269,257,5,0,2,0,0,12
55029001668,0,0,0,0,0,0,0,0,0
55029001631,353,286,269,5,1,3,3,0,17
55029001657,0,0,0,0,0,0,0,0,0
55029008007,4,4,0,2,0,2,0,0,4
55039001969,675,520,497,14,2,3,1,0,23
55039001980,908,731,696,12,6,7,9,0,35
55029001651,732,604,546,25,8,11,3,0,58
55029001650,446,388,364,6,4,3,6,0,24
55029001649,673,570,515,18,14,9,6,1,55
55039001963,700,672,463,94,88,12,16,4,209
55039001958,1014,790,668,78,17,16,6,0,122
55039001959,822,650,576,37,12,14,7,1,74
55039001964,425,316,291,9,3,5,6,0,25
55025001341,1030,778,698,57,4,3,9,0,80
55025001342,1032,795,732,33,12,8,12,0,63
55025001343,867,678,653,10,4,2,11,0,25
55025000939,934,746,700,29,0,7,9,1,46
55089004571,584,460,366,18,15,4,52,0,94
55089004520,773,605,553,19,10,7,16,1,52
55007000182,495,398,368,1,3,23,3,1,30
55007000180,373,301,281,3,0,11,0,0,20
55007000159,0,0,0,0,0,0,0,0,0
55071003167,1806,1344,1027,142,55,51,80,2,317
55071003121,501,371,352,10,3,9,1,0,19
55131006439,672,516,441,19,18,10,24,1,75
55025001429,3172,2052,1816,38,31,13,106,0,236
55025001201,815,615,562,19,20,10,3,0,53
55121005987,708,552,518,15,0,7,9,0,34
55121005982,220,182,173,6,1,2,1,1,9
55121005988,306,239,211,24,1,2,2,0,28
55121006029,177,143,126,15,0,2,0,0,17
55087004480,826,626,586,16,10,12,4,2,40
55087004339,630,487,447,17,5,12,2,0,40
55001000001,528,427,378,19,12,12,1,1,49
55133006729,1869,1469,1307,28,47,14,68,0,162
55029001645,986,828,762,34,6,13,11,1,66
55107005396,249,185,175,3,2,4,1,0,10
55107005428,52,41,38,2,0,1,0,0,3
55005000122,627,482,392,14,50,9,15,1,90
55005000147,607,468,434,12,4,11,5,0,34
55083004208,1003,758,716,4,0,21,2,0,42
55083004211,386,311,286,4,0,3,6,0,25
55139007166,2279,1751,1507,97,44,36,66,0,244
55139007250,35,22,12,1,2,5,0,1,10
55069003061,570,383,359,5,2,5,7,0,24
55069003053,165,146,144,1,0,0,0,0,2
55069003048,109,93,91,0,0,1,0,0,2
55069003057,263,205,203,2,0,0,0,0,2
55097004827,543,423,397,4,4,3,13,0,26
55097004843,20,16,16,0,0,0,0,0,0
55097004837,0,0,0,0,0,0,0,0,0
55097004841,0,0,0,0,0,0,0,0,0
55097004797,1007,820,785,2,2,2,27,0,35
55097004825,528,403,367,6,4,6,17,0,36
55097004826,487,378,363,7,1,5,3,0,15
55097004743,621,487,464,5,3,11,4,0,23
55025001419,558,425,398,18,2,9,1,1,27
55025001420,1103,821,740,56,0,8,13,1,81
55025000968,18,16,15,1,0,1,0,0,1
55025000966,0,0,0,0,0,0,0,0,0
55025000971,0,0,0,0,0,0,0,0,0
55025000962,1118,826,760,22,24,3,13,3,66
55025001169,1308,1002,681,101,152,15,55,0,321
55025001167,2396,1802,1066,273,309,45,137,4,736
55025001109,3317,2793,2439,132,97,46,65,2,354
55025000846,1084,842,809,16,2,5,5,4,33
55025000994,146,93,85,2,2,2,2,1,8
55025001371,1852,1313,1007,54,46,9,197,1,306
55025001372,1449,1107,882,67,30,17,109,3,225
55025001319,625,479,447,6,12,6,3,1,32
55035001843,944,755,670,39,20,10,16,0,85
55035001875,2154,1664,1462,43,38,28,90,1,202
55017000591,836,630,602,8,2,13,2,0,28
55017000565,384,276,263,1,0,4,2,2,13
55061002820,390,293,257,31,1,0,1,0,36
55061002819,888,718,677,23,0,8,4,0,41
55011000408,746,587,575,3,0,8,0,1,12
55007000172,216,179,175,0,0,3,1,0,4
55105005130,728,589,570,6,2,7,1,0,19
55105005353,31,23,20,1,2,1,0,0,3
55105005352,54,54,53,0,1,0,0,0,1
55073003277,620,434,397,29,1,3,1,1,37
55073003251,789,588,538,9,6,6,23,0,50
55073003191,691,528,505,11,1,8,3,1,23
55073003197,258,189,183,2,1,0,0,0,6
55061002813,333,250,238,10,0,2,0,0,12
55061002811,616,473,452,17,2,2,1,0,21
55047002284,736,484,455,10,1,6,2,0,29
55035001873,1611,1257,1146,34,19,18,24,3,111
55035001853,0,0,0,0,0,0,0,0,0
55047002278,824,656,608,17,1,14,14,1,48
55047002265,912,685,607,52,6,18,4,0,78
55047002280,104,84,84,0,0,0,0,0,0
55035001839,337,251,238,1,3,7,2,0,13
55035001842,730,534,495,5,7,7,6,0,39
55087004301,246,195,187,5,1,1,1,0,8
55087004441,957,712,668,14,9,11,1,0,44
55063002849,865,718,687,13,3,3,10,1,31
55103005110,440,350,308,18,3,10,9,0,42
55103005075,215,149,146,3,0,0,0,0,3
55011000422,535,436,407,3,6,13,0,0,29
55011000421,271,235,218,8,3,6,2,0,17
55081004110,454,345,328,4,3,4,3,0,17
55081004045,223,170,157,0,1,4,5,0,13
55081004127,754,549,531,2,2,8,6,1,18
55081004094,574,428,352,32,12,19,4,5,76
55081004100,663,507,489,3,1,6,6,1,18
55081004065,764,579,559,9,2,6,2,1,20
55081004048,380,263,243,10,2,7,3,1,20
55131006499,475,359,342,7,0,4,4,0,17
55131006407,15,8,4,1,1,0,2,0,4
55131006441,325,261,257,3,0,1,0,0,4
55131006457,1155,784,730,14,13,18,13,0,54
55131006426,895,728,699,5,2,10,9,1,29
55131006400,425,345,324,9,3,3,6,0,21
55131006471,818,568,477,26,12,16,28,0,91
55025000849,951,740,709,16,5,0,13,1,31
55025000848,958,741,659,27,11,16,9,0,82
55025001296,555,463,440,16,1,5,5,1,23
55065002949,244,179,175,2,0,3,1,0,4
55065002950,69,47,47,0,0,0,0,0,0
55025000950,935,666,608,14,13,6,24,0,58
55025000951,1218,855,746,30,25,15,33,4,109
55025000965,974,724,663,29,5,11,7,0,61
55025000967,0,0,0,0,0,0,0,0,0
55025001224,941,743,616,27,13,14,69,1,127
55025001184,673,435,119,157,101,10,57,0,316
55025001005,1630,1402,1201,44,61,10,77,0,201
55107005406,360,306,301,0,1,2,1,0,5
55131006474,841,672,635,11,4,8,8,1,37
55139007170,1600,1276,1088,78,24,23,58,0,188
55139007137,412,332,285,33,5,8,5,1,47
55139007197,398,324,302,6,0,12,2,0,22
55005000141,665,467,418,19,5,7,15,0,49
55005000091,237,199,190,2,2,1,1,0,9
55005000090,253,196,188,0,0,2,0,0,8
55091004602,325,258,242,2,3,3,3,1,16
55031001682,677,559,526,4,2,14,0,0,33
55073003266,485,391,379,3,0,2,7,1,12
55073003288,1468,1010,902,19,6,19,62,2,108
55073003289,596,395,355,4,5,2,23,0,40
55073003287,644,525,501,16,0,7,0,1,24
55087004295,2005,1651,1551,24,10,41,13,1,100
55121005984,595,459,434,15,0,4,3,0,25
55005000100,268,193,184,1,1,0,1,0,9
55005000099,298,238,229,2,0,3,0,0,9
55057002575,347,276,246,9,2,10,4,1,30
55121006020,456,340,246,85,6,4,2,0,94
55073003223,0,0,0,0,0,0,0,0,0
55069003059,460,381,359,6,2,0,4,1,22
55097004789,530,417,395,8,5,1,11,0,22
55139007205,2077,2070,1515,87,196,63,193,25,555
55139007199,2023,1803,1377,103,153,52,109,17,426
55097004818,672,539,513,6,4,6,3,0,26
55097004747,383,294,280,9,1,4,0,0,14
55097004798,1499,1214,1070,47,17,18,61,3,144
55097004801,1431,1124,1051,19,9,15,34,0,73
55139007195,435,342,323,4,0,8,0,0,19
55139007164,513,427,409,7,1,2,4,0,18
55021000721,400,333,317,6,0,9,1,0,16
55021000742,355,283,260,12,5,0,1,0,23
55053002402,467,352,334,10,1,1,1,1,18
55053002401,0,0,0,0,0,0,0,0,0
55053002424,59,40,0,0,0,40,0,0,40
55069003027,735,611,584,7,8,9,8,0,27
55121006006,582,439,394,33,1,6,1,0,45
55057002562,874,684,573,24,8,56,3,0,111
55057002563,100,78,72,2,3,1,0,0,6
55097004775,887,718,633,35,15,8,24,1,85
55097004776,238,193,155,11,9,9,5,3,38
55097004737,863,678,635,20,2,9,2,0,43
55095004663,957,709,664,20,4,10,3,1,45
55095004723,388,337,319,1,0,5,8,1,18
55095004733,468,366,346,9,1,2,1,0,20
55095004704,612,444,380,37,6,16,0,0,64
55095004701,744,606,585,5,6,6,3,1,21
55095004684,841,694,677,5,0,4,8,0,17
55095004689,1036,818,779,4,1,17,5,0,39
55095004688,547,420,391,9,2,3,4,0,29
55095004674,766,600,572,8,1,2,4,0,28
55095004730,850,676,647,7,4,10,1,1,29
55095004682,495,383,367,6,1,4,2,0,16
55095004668,396,324,311,5,2,2,2,0,13
55063002927,946,732,703,7,3,12,3,0,29
55133006620,2679,2155,1878,113,34,23,89,2,277
55133006790,1124,978,658,177,37,15,98,0,320
55095004685,809,597,585,0,1,3,4,0,12
55013000431,432,408,393,1,2,10,0,0,15
55013000459,119,102,89,2,2,6,1,0,13
55013000434,687,554,513,8,3,17,5,3,41
55095004698,340,286,272,2,0,9,3,3,14
55095004728,958,753,733,2,1,10,2,1,20
55013000453,206,174,166,1,3,5,0,0,8
55005000129,488,386,377,0,1,3,1,0,9
55101004927,835,648,617,17,4,6,6,1,31
55111005630,749,599,572,12,2,5,4,0,27
55111005683,1193,940,776,110,15,27,8,2,164
55111005663,496,398,358,15,3,6,11,0,40
55101005033,680,603,545,29,5,10,8,0,58
55097004849,0,0,0,0,0,0,0,0,0
55097004842,0,0,0,0,0,0,0,0,0
55097004848,0,0,0,0,0,0,0,0,0
55025001332,1032,837,805,19,1,5,7,0,32
55025001360,53,52,44,5,1,2,0,0,8
55025001102,1473,1149,783,91,200,22,45,1,366
55025001020,953,704,651,17,20,4,10,0,53
55113005714,241,230,223,2,1,1,2,0,7
55025000963,801,601,472,50,22,20,36,1,129
55101005015,701,582,536,22,7,9,7,0,46
55117005838,746,578,543,9,3,4,18,0,35
55117005836,562,451,428,4,8,1,5,0,23
55117005891,645,565,530,18,6,8,1,1,35
55117005933,604,469,444,6,3,4,10,0,25
55077003455,441,391,370,5,3,9,5,1,21
55131006350,1567,1131,951,26,53,14,82,5,180
55131006467,941,715,637,16,27,0,34,0,78
55077003457,460,367,351,8,1,4,3,1,16
55123006058,758,583,569,2,0,5,3,0,14
55025000909,855,644,563,20,24,10,27,0,81
55025001272,820,603,540,9,12,5,34,1,63
55025001273,767,549,493,12,2,1,36,0,56
55025001364,1746,1339,998,65,200,27,52,0,341
55073003190,827,671,639,19,4,3,4,0,32
55073003339,811,619,589,15,0,8,1,0,30
55025000853,553,445,417,2,5,15,4,0,28
55025000869,782,638,494,88,36,9,13,2,144
55025001008,1583,1079,618,161,183,45,87,3,461
55025001007,1708,1309,591,324,282,24,91,5,718
55101004973,667,533,502,15,3,6,5,0,31
55101005007,4,2,0,0,0,0,1,0,2
55101004983,650,457,399,22,17,5,10,0,58
55101005010,715,559,515,15,6,7,9,0,44
55111005634,307,237,225,6,0,4,2,0,12
55111005616,666,552,533,4,0,2,10,0,19
55101004963,1817,1236,649,135,409,34,30,4,587
55101005045,574,447,415,9,7,8,8,0,32
55073003312,610,435,421,2,1,4,6,0,14
55073003325,839,639,595,4,2,6,32,0,44
55123006093,588,495,472,4,0,7,3,0,23
55123006089,226,184,178,0,1,4,0,0,6
55123006068,534,392,355,19,1,6,10,0,37
55017000566,708,562,541,3,2,8,4,0,21
55017000576,381,304,290,1,1,6,4,0,14
55017000583,61,37,33,2,0,2,2,0,4
55025001394,1235,893,790,38,20,15,32,1,103
55087004386,316,218,174,6,4,4,31,1,44
55087004405,715,566,548,2,1,3,1,1,18
55087004473,9,8,8,0,0,0,0,0,0
55087004470,718,539,523,6,3,4,3,0,16
55087004471,37,23,22,0,0,0,1,0,1
55087004472,17,7,6,0,1,0,0,0,1
55087004474,0,0,0,0,0,0,0,0,0
55117005822,910,838,534,185,75,4,28,11,304
55131006387,1856,1553,1473,38,14,8,18,0,80
55131006433,1716,1422,1313,71,23,4,7,0,109
55131006361,885,694,666,4,1,9,5,1,28
55087004485,0,0,0,0,0,0,0,0,0
55087004431,823,546,516,7,6,5,5,0,30
55101005022,408,337,321,8,1,7,1,0,16
55101005023,314,235,227,3,2,3,0,0,8
55101005020,950,728,663,23,3,12,10,0,65
55111005625,959,781,607,94,32,20,25,2,174
55025001190,296,197,66,100,17,10,15,0,131
55025001191,714,679,347,114,129,7,68,2,332
55025000847,985,756,711,18,9,16,2,4,45
55025000884,0,0,0,0,0,0,0,0,0
55129006332,171,139,129,1,1,5,0,0,10
55129006334,164,134,129,2,1,0,2,1,5
55111005690,891,715,678,29,1,3,3,1,37
55135006915,427,337,317,16,1,1,0,0,20
55135006992,518,408,390,5,1,2,6,0,18
55135006997,481,424,394,10,4,8,3,2,30
55101005048,853,621,580,35,1,3,3,0,41
55101004898,1822,1505,1108,144,160,28,50,2,397
55101004897,1117,892,751,62,30,28,15,0,141
55101005039,1895,1844,830,158,812,42,23,1,1014
55111005688,9,6,1,2,0,3,0,0,5
55111005659,5,2,0,0,0,2,0,0,2
55111005658,10,9,5,3,0,0,1,0,4
55111005656,14,10,7,0,0,3,0,0,3
55111005667,1,1,1,0,0,0,0,0,0
55111005681,400,305,290,6,0,1,2,1,15
55111005661,669,525,458,27,9,11,4,1,67
55111005644,771,562,514,23,5,21,0,0,48
55111005586,274,189,179,1,0,3,2,1,10
55101004935,1512,1056,251,315,490,20,4,2,805
55099004879,37,30,29,0,0,0,0,0,1
55101004989,867,695,647,29,1,6,10,1,48
55101005035,943,744,721,5,4,5,9,1,23
55101004975,428,349,332,6,0,5,1,0,17
55101004908,510,415,345,26,22,8,11,0,70
55101004993,501,385,362,11,0,10,2,0,23
55135006986,617,466,445,12,1,6,2,0,21
55019000650,868,578,539,17,0,10,5,1,39
55019000641,477,377,361,8,3,3,1,0,16
55019000694,698,543,513,13,2,9,5,0,30
55019000663,433,334,310,7,5,6,4,0,24
55019000704,457,326,305,10,5,3,2,0,21
55135006972,748,602,573,10,1,8,11,1,29
55125006131,511,415,401,2,1,10,1,0,14
55125006106,807,693,661,9,3,12,4,2,32
55127006206,450,367,302,43,8,8,5,0,65
55127006232,773,609,433,120,19,17,17,0,176
55127006226,649,480,312,159,4,5,4,0,168
55127006245,839,698,636,27,7,3,15,0,62
55127006248,905,782,706,36,11,3,18,1,76
55127006247,216,166,119,30,7,4,4,0,47
55127006243,939,764,633,79,17,5,22,0,131
55127006244,0,0,0,0,0,0,0,0,0
55127006229,548,420,277,131,2,14,6,0,143
55127006177,517,408,385,19,0,5,0,0,23
55127006256,964,758,652,58,7,22,11,3,106
55127006249,547,421,409,7,1,0,2,0,12
55127006170,561,449,430,6,0,6,2,0,19
55127006171,514,435,420,5,2,2,2,0,15
55127006286,938,778,762,6,3,6,1,0,16
55019000709,230,189,185,0,1,1,1,0,4
55017000599,662,530,498,6,1,18,6,0,32
55067002996,273,221,209,7,2,1,0,0,12
55067002993,196,172,169,0,0,2,0,0,3
55009000229,1035,778,711,16,3,21,11,0,67
55009000307,2107,1695,1487,49,38,57,64,2,208
55017000598,2053,1647,1526,22,16,37,21,0,121
55019000644,564,450,420,10,7,4,1,0,30
55019000640,463,329,196,122,5,7,0,0,133
55019000669,572,383,380,1,1,0,0,0,3
55019000676,146,82,81,0,0,0,0,0,1
55009000195,890,703,630,27,17,17,9,1,73
55009000230,21,19,14,4,1,2,1,0,5
55027001521,1039,896,857,21,2,16,3,0,39
55027001522,721,620,422,119,65,4,3,0,198
55009000266,920,751,712,6,11,14,8,1,39
55027001542,443,342,321,8,4,6,0,1,21
55027001540,826,653,623,19,0,7,1,0,30
55027001488,187,157,152,3,1,1,0,0,5
55027001598,0,0,0,0,0,0,0,0,0
55027001468,1372,1044,872,112,18,17,14,1,172
55019000639,680,425,402,14,4,4,4,1,23
55027001541,708,536,476,24,8,10,7,0,60
55009000242,1715,1333,1033,108,57,53,65,3,300
55009000368,3014,2293,1793,178,119,110,88,3,500
55009000286,798,625,550,13,18,24,15,0,75
55009000279,1921,1582,1447,23,27,37,31,1,135
55027001513,630,486,462,7,0,11,5,0,24
55027001531,767,562,536,10,2,6,7,0,26
55009000302,2534,1904,1500,207,59,107,35,4,404
55027001496,982,799,759,21,1,7,15,0,40
55027001605,328,244,235,4,4,2,0,0,9
55027001590,18,16,14,2,0,0,0,0,2
55017000584,2360,1981,1672,68,167,42,27,0,309
55017000590,963,691,630,21,8,10,21,0,61
55017000610,311,262,247,3,4,3,3,0,15
55019000648,560,426,406,13,2,2,2,0,20
55009000257,2028,1538,1371,66,23,17,58,1,167
55009000276,1381,1070,929,65,17,18,44,1,141
55141007298,136,101,90,8,1,1,0,0,11
55141007294,607,493,464,9,10,6,4,2,29
55141007295,441,352,318,18,9,4,6,0,34
55141007286,881,751,654,28,15,16,29,2,97
55141007358,430,363,330,22,3,7,2,1,33
55141007357,1364,1186,1084,20,15,20,44,1,102
55141007366,6,6,2,3,0,1,0,0,4
55141007263,702,537,495,29,3,5,0,0,42
55067002990,477,433,412,4,1,15,2,0,21
55067003013,859,669,603,12,10,35,3,1,66
55067003003,462,362,345,4,3,7,6,0,17
55127006225,321,240,156,72,4,3,2,1,84
55127006221,476,337,245,79,5,8,6,1,92
55009000313,2259,1661,910,451,123,51,133,0,751
55009000312,1089,820,612,121,13,21,55,0,208
55033008008,0,0,0,0,0,0,0,0,0
55009000370,1197,947,793,67,37,42,19,1,154
55033001772,453,352,317,4,3,4,19,0,35
55033001745,778,539,489,22,3,4,16,1,50
55033001765,896,653,599,14,3,13,17,2,54
55033001754,223,168,141,0,1,2,23,0,27
55037001939,383,325,316,4,1,3,1,0,9
55037001949,189,164,158,1,2,3,0,0,6
55009000272,705,497,421,32,13,25,7,1,76
55009000237,2248,1757,1024,475,93,54,114,1,733
55009000202,800,662,542,11,5,104,0,1,120
55009000332,789,572,271,16,7,280,3,4,301
55009000317,830,587,457,18,3,91,19,0,130
55009000299,1046,853,740,45,14,33,26,1,113
55009000364,1654,1198,951,39,9,104,93,3,247
55009000278,1456,1079,971,15,6,3,80,2,108
55027001523,898,686,616,46,2,10,4,0,70
55027001553,540,425,393,22,4,6,0,0,32
55093004628,591,481,468,1,1,4,1,0,13
55093004624,261,212,203,2,6,1,1,0,9
55093004621,441,368,350,3,5,7,1,0,18
55045002215,177,144,139,0,0,0,2,0,5
55045002211,165,133,126,0,3,2,2,0,7
55045002255,169,144,138,1,2,1,2,0,6
55045002213,176,135,126,3,5,1,0,0,9
55079003512,1133,869,663,124,36,25,27,0,206
55079003895,3685,2839,1433,876,332,78,169,3,1406
55079003982,2098,1550,1127,270,53,58,70,1,423
55079003866,1912,1354,309,800,178,35,86,1,1045
55079003983,1158,997,781,122,46,27,33,4,216
55079003537,1231,942,788,86,24,20,18,1,154
55079003541,2047,1655,1379,132,57,20,40,0,276
55079003966,2223,1728,1491,69,12,20,121,0,237
55079003967,2218,1869,1668,73,25,27,84,2,201
55079003843,1109,987,866,26,37,3,46,2,121
55079003840,1259,1025,812,34,125,25,35,0,213
55085004235,667,567,537,4,4,11,5,1,30
55079003797,1977,1422,198,86,1125,26,29,2,1224
55079003984,1886,1496,1052,254,76,36,79,3,444
55079003836,1361,1105,859,48,148,14,28,0,246
55141007267,406,318,307,4,0,4,1,0,11
55141007309,763,606,588,9,3,3,1,1,18
55141007282,796,618,600,4,2,4,4,0,18
55141007301,0,0,0,0,0,0,0,0,0
55141007287,1669,1404,1287,32,15,20,47,0,117
55141007272,316,260,252,2,0,4,0,0,8
55105005144,601,464,401,27,12,15,7,0,63
55055002468,507,399,367,14,1,17,0,1,32
55083004177,353,260,227,10,0,16,0,1,33
55083004178,916,728,687,8,4,19,5,0,41
55083004172,311,246,217,6,1,16,2,0,29
55133006597,845,596,554,21,3,5,8,0,42
55133006595,1142,856,799,16,3,6,30,1,57
55133006783,809,632,597,9,3,5,8,0,35
55133006586,832,652,632,4,3,8,3,1,20
55105005230,922,730,537,112,66,8,10,0,193
55105005344,912,673,417,96,147,17,4,0,256
55105005192,851,691,639,15,4,8,16,1,52
55105005191,668,511,480,15,1,2,10,1,31
55115005778,823,677,579,6,3,77,8,0,98
55089004506,1647,1250,1179,13,13,25,18,0,71
55041002081,454,350,335,1,0,11,4,0,15
55041002082,72,55,53,0,1,0,1,0,2
55041002080,20,14,10,2,0,0,0,0,4
55137007017,600,521,493,19,2,8,3,2,28
55049002318,624,501,451,18,10,5,3,0,50
55091004608,218,182,168,4,0,8,1,0,14
55091004607,78,75,70,0,1,2,2,1,5
55079003523,1136,918,685,164,42,15,19,1,233
55079003509,869,736,601,82,23,10,20,2,135
55079003727,1790,1255,428,101,619,43,80,1,827
55137007046,712,602,570,14,5,10,1,1,32
55115005765,724,633,522,14,6,88,3,0,111
55115005783,773,572,499,9,3,53,7,0,73
55115005784,757,579,445,15,2,111,9,0,134
55041002109,438,324,179,2,3,137,0,1,145
55041002094,359,322,311,2,2,4,3,1,11
55079003844,2227,1780,1493,78,101,33,61,4,287
55079003519,1378,1079,874,105,50,41,17,1,205
55079004001,1740,1344,992,94,58,20,179,0,352
55119005962,750,559,542,3,2,6,1,0,17
55079003887,2030,1524,975,403,74,39,48,1,549
55079003900,1073,822,464,229,58,27,57,0,358
55079003521,1498,1240,1042,113,45,27,22,1,198
55115005741,682,521,448,3,5,56,9,0,73
55115005791,570,397,371,18,0,10,0,0,26
55115005790,900,807,759,18,3,28,5,0,48
55115005751,495,385,356,16,0,8,1,0,29
55079003935,1135,924,771,94,26,15,15,1,153
55079003928,1781,1515,1269,133,21,49,32,1,246
55089004500,1520,1201,1107,41,18,11,24,0,94
55089004589,638,492,458,9,4,1,15,1,34
55089004513,672,484,470,4,2,2,6,1,14
55089004566,748,537,496,16,5,10,6,0,41
55089004576,556,420,405,6,4,4,0,0,15
55039001955,373,292,273,0,3,9,1,4,19
55039001961,670,515,442,44,10,13,2,1,73
55039001993,762,591,568,9,6,0,7,0,23
55039001992,816,652,625,6,5,7,7,0,27
55079003998,2542,1974,1377,379,76,41,108,2,597
55079003733,1202,848,21,15,805,16,6,3,827
55079003594,1704,1141,22,23,1076,17,12,2,1119
55079003744,1070,806,149,102,464,20,100,1,657
55079003747,2172,1775,341,235,1138,55,36,11,1434
55079003719,1728,1237,183,33,937,28,81,2,1054
55043002187,754,567,544,1,3,8,3,1,23
55063002914,765,525,504,12,1,5,1,1,21
55133006688,1803,1425,1224,53,46,9,85,1,201
55133006613,1944,1739,1641,20,48,5,16,1,98
55133006862,925,720,683,16,5,11,1,4,37
55133006824,1743,1257,1187,29,8,15,15,0,70
55133006527,631,476,449,14,1,7,1,0,27
55133006531,930,656,623,9,0,4,8,0,33
55133006621,1847,1490,1097,31,41,10,307,1,393
55059002746,832,745,555,63,93,24,25,0,190
55059002762,1258,991,707,142,96,29,24,1,284
55059002677,754,577,425,81,28,14,24,1,152
55059002755,738,542,478,31,16,7,11,0,64
55059002673,392,306,249,34,7,4,10,0,57
55109005498,764,591,551,18,17,1,0,1,40
55059002768,615,493,463,21,3,5,0,0,30
55059002704,722,587,517,30,15,6,7,3,70
55059002635,1590,1298,1055,144,42,33,29,2,243
55003000067,286,145,143,1,0,1,1,1,2
55003000066,174,120,119,1,0,1,0,0,1
55003000076,131,109,105,1,0,3,0,0,4
55131008066,0,0,0,0,0,0,0,0,0
55131006524,654,532,506,9,4,4,4,2,26
55131006491,2,2,1,0,0,0,0,0,1
55131008065,0,0,0,0,0,0,0,0,0
55131006513,13,6,4,2,2,0,0,0,2
55131006518,0,0,0,0,0,0,0,0,0
55131006512,148,129,125,0,3,0,0,0,4
55131006485,0,0,0,0,0,0,0,0,0
55131008068,6,5,1,3,0,0,0,0,4
55131006509,238,215,181,13,1,8,13,0,34
55131006502,4,2,0,0,0,0,1,1,2
55131006489,5,1,0,1,0,0,0,0,1
55131006374,996,783,749,12,4,2,8,0,34
55131006492,0,0,0,0,0,0,0,0,0
55131003018,8,5,0,3,0,0,2,0,5
55131008064,0,0,0,0,0,0,0,0,0
55131006368,967,743,684,9,19,12,5,1,59
55077003460,574,456,423,15,5,8,6,1,33
55077003436,362,294,271,9,1,8,3,0,23
55077003435,349,297,270,6,2,15,5,0,27
55077003451,140,119,113,1,1,2,0,0,6
55123006100,722,487,462,2,2,10,0,0,25
55103005072,718,570,541,9,1,3,8,0,29
55103005076,72,64,59,1,0,3,1,0,5
55105005215,3,3,1,2,0,0,0,0,2
55105005349,32,22,19,2,1,1,0,0,3
55065002965,235,177,175,2,0,0,0,0,2
55065002952,146,105,101,0,0,2,0,0,4
55083004216,517,386,377,0,0,1,0,0,9
55083004213,816,619,601,5,1,3,3,0,18
55083004212,0,0,0,0,0,0,0,0,0
55109005495,681,524,499,1,0,2,20,0,25
55105005302,1071,853,792,33,7,19,1,1,61
55133006882,751,620,565,24,3,21,5,0,55
55133006821,919,717,669,17,4,5,19,0,48
55133006888,410,332,287,25,5,7,1,4,45
55133006880,855,582,539,20,2,17,2,0,43
55133006705,1015,816,781,8,7,13,6,0,35
55133006602,931,740,693,13,4,2,16,1,47
55133006776,958,784,742,15,3,9,4,0,42
55133006782,1933,1549,1451,46,6,13,22,1,98
55119005944,459,310,296,6,2,4,0,0,14
55079003883,1406,1216,1072,77,12,22,22,1,144
55079003539,1330,1026,782,105,54,58,27,4,244
55079003524,654,563,490,29,14,13,10,0,73
55079003540,1062,883,790,47,14,16,15,0,93
55079003872,1207,1020,858,87,31,13,26,1,162
55079003805,2092,1707,768,44,788,14,94,2,939
55079003874,1977,1371,350,916,46,82,57,1,1021
55035001829,278,204,173,17,3,6,6,1,31
55103005088,303,235,225,2,1,1,3,0,10
55103005091,224,186,178,5,0,2,0,0,8
55031001684,249,186,162,3,6,12,1,1,24
55059002702,522,421,339,37,20,11,13,1,82
55059002707,810,689,510,64,78,20,22,0,179
55059002612,750,612,582,12,2,9,2,1,30
55079003897,2584,2202,1840,162,79,40,78,1,362
55079003961,2007,1767,1407,143,119,27,72,1,360
55079003518,1205,969,853,71,15,16,16,1,116
55079003619,2096,1469,61,78,1327,25,21,2,1408
55079004043,3050,2379,1115,88,1058,26,104,0,1264
55047002263,896,655,589,34,10,9,5,1,66
55047002300,923,797,761,18,5,10,2,0,36
55035001892,1481,1155,1007,29,25,27,55,0,148
55035001879,2015,1537,1422,25,7,24,57,0,115
55035001881,670,483,401,28,5,12,31,1,82
55035001824,1050,812,728,22,6,18,31,0,84
55035001826,94,73,64,0,1,0,7,0,9
55035001919,17,10,8,0,1,0,2,0,2
55035001798,427,324,318,4,0,0,0,0,6
55055002433,1655,1649,1287,182,98,12,71,3,362
55001000025,978,807,767,15,5,14,4,0,40
55001000026,399,327,302,7,4,7,0,2,25
55007000187,382,291,239,10,3,31,1,0,52
55103005107,349,288,269,9,2,2,0,0,19
55097004812,687,513,498,3,3,3,2,1,15
55139007064,2047,1638,1318,68,122,45,73,1,320
55139007128,1855,1462,1310,50,38,24,45,1,152
55139007142,1217,986,847,84,16,14,28,0,139
55105005340,753,588,542,19,6,10,3,0,46
55105005143,921,754,676,26,10,19,13,2,78
55105005116,421,339,306,15,11,4,2,0,33
55059002694,259,206,189,4,0,11,0,0,17
55059002603,0,0,0,0,0,0,0,0,0
55059002666,1089,833,626,122,45,23,16,0,207
55059002614,574,459,419,18,7,3,6,1,40
55059002743,1970,1455,977,282,139,32,22,0,478
55059002661,743,550,462,44,11,9,19,0,88
55059002736,106,63,41,12,9,1,0,0,22
55059003051,6,5,0,4,0,0,1,0,5
55059002676,0,0,0,0,0,0,0,0,0
55139007167,0,0,0,0,0,0,0,0,0
55139007227,0,0,0,0,0,0,0,0,0
55001000004,352,297,280,12,0,5,0,0,17
55035001847,376,293,258,8,14,5,8,0,35
55035001857,1762,1373,1265,15,13,17,59,5,108
55035001856,546,435,392,3,0,4,28,0,43
55035001797,0,0,0,0,0,0,0,0,0
55035001809,167,128,110,4,0,9,1,0,18
55035001817,14,4,1,1,0,0,1,0,3
55035001929,1504,1199,962,33,24,20,147,0,237
55035001931,15,13,7,2,0,1,3,0,6
55035001915,0,0,0,0,0,0,0,0,0
55035001933,16,9,2,5,1,0,0,0,7
55035001815,877,619,550,15,3,7,37,0,69
55035001918,19,7,4,0,0,2,0,0,3
55035001816,5,5,3,0,0,2,0,0,2
55103005095,147,117,110,3,0,0,0,0,7
55103005078,233,185,177,2,2,0,1,0,8
55103005089,317,259,256,1,0,1,0,0,3
55071003120,690,546,532,3,3,3,4,1,14
55021000760,1115,813,708,48,27,18,5,2,105
55011000401,321,245,237,2,0,6,1,0,8
55103005084,129,105,102,0,0,0,0,0,3
55103005094,170,147,144,0,0,1,0,0,3
55103003014,0,0,0,0,0,0,0,0,0
55103005083,391,292,285,2,1,1,2,1,7
55071003145,526,437,419,9,0,3,3,0,18
55071003109,307,260,249,4,1,5,0,0,11
55063002867,0,0,0,0,0,0,0,0,0
55063080031,15,12,7,1,0,0,3,0,5
55053002391,168,145,132,3,4,6,3,1,13
55053002422,267,206,174,6,1,20,7,0,32
55021000743,474,393,371,4,0,5,0,0,22
55097004735,502,384,378,3,0,1,2,0,6
55097004750,283,216,211,2,0,1,1,0,5
55097004823,862,661,622,13,4,5,10,1,39
55059002705,511,447,402,21,13,6,3,0,45
55059002703,554,437,378,34,12,7,4,0,59
55059002659,1219,867,497,199,124,25,19,6,370
55059002660,950,748,591,80,39,15,22,4,157
55059002610,44,32,26,6,0,0,0,0,6
55059003047,9,2,2,0,0,0,0,0,0
55087004354,891,671,596,28,12,16,17,0,75
55087004436,2008,1538,1273,100,43,28,88,0,265
55139007193,331,290,288,2,0,0,0,0,2
55139007115,9,9,4,0,0,0,0,0,5
55081004059,733,449,434,1,0,8,3,1,15
55057002544,267,208,189,3,2,8,0,0,19
55001000037,911,778,725,21,9,5,5,0,53
55057002557,744,586,559,0,1,21,0,0,27
55063002889,727,564,517,7,2,6,31,0,47
55063002902,555,391,353,4,0,2,32,0,38
55063002909,21,10,10,0,0,0,0,0,0
55063003006,8,6,5,0,0,0,1,0,1
55063003005,5,2,2,0,0,0,0,0,0
55063002898,228,184,174,1,2,0,3,0,10
55087004412,1805,1428,1170,88,31,18,116,2,258
55057002545,88,72,67,1,1,2,0,0,5
55057002554,341,292,279,1,0,4,1,0,13
55057002556,268,211,202,3,0,0,0,0,9
55109005529,859,666,605,12,9,19,7,0,61
55109005535,769,585,536,18,4,16,6,2,49
55005000097,359,277,249,5,3,13,7,0,28
55123006060,176,119,117,0,1,1,0,0,2
55133006792,1944,1558,1148,284,63,34,36,1,410
55081004113,733,600,568,12,2,8,3,1,32
55081004112,451,273,209,23,31,1,7,1,64
55073003204,683,527,502,4,0,6,3,0,25
55073003203,565,433,415,3,2,9,2,0,18
55073003369,1037,795,668,20,5,10,91,0,127
55073003253,1851,1461,1198,34,38,13,168,2,263
55021000729,96,73,70,0,1,1,1,0,3
55021000758,508,397,367,4,2,11,10,0,30
55021000757,478,377,337,14,10,11,0,0,40
55097004781,582,452,414,10,4,7,9,1,38
55139007143,1114,852,721,60,29,15,20,1,131
55139007248,989,774,607,92,19,25,36,1,167
55063002932,1029,763,708,21,8,14,7,0,55
55063002933,655,489,447,12,5,10,12,0,42
55005000114,959,730,645,14,9,44,15,0,85
55133006840,792,689,654,9,2,10,1,1,35
55133006647,720,582,556,8,2,5,12,1,26
55005000098,570,453,415,16,6,9,6,0,38
55013000450,345,306,285,4,1,12,1,1,21
55013000454,321,248,230,7,1,9,1,0,18
55057002541,125,97,94,1,0,2,0,0,3
55107005405,237,204,195,0,0,3,0,0,9
55107005398,247,199,187,2,0,6,1,0,12
55035001880,2396,1835,1640,47,33,36,78,1,195
55035001828,278,200,180,0,0,5,7,0,20
55035001889,3055,3028,2616,89,60,31,210,8,412
55035001864,1917,1786,1625,56,40,18,59,3,161
55035001867,1720,1609,1382,56,68,26,72,1,227
55071003151,342,252,234,8,1,1,3,0,18
55053002418,98,61,59,0,0,0,2,0,2
55053002429,142,105,93,2,0,5,2,0,12
55035001925,728,498,446,9,1,4,34,0,52
55123006051,273,215,196,4,3,1,1,0,19
55013000455,935,827,790,3,3,23,1,0,37
55087004457,36,22,15,3,1,1,3,0,7
55087004468,13,3,3,0,0,0,0,0,0
55133003024,0,0,0,0,0,0,0,0,0
55129006323,857,679,655,2,3,6,2,0,24
55129006340,126,110,107,2,0,2,0,0,3
55131006465,1961,1528,1327,89,24,37,51,6,201
55131006484,1764,1418,1289,47,20,35,11,3,129
55131006490,880,730,690,18,2,7,12,1,40
55131006386,640,526,501,13,2,8,4,0,25
55131006466,271,233,220,5,1,5,1,0,13
55131006494,2,2,2,0,0,0,0,0,0
55131006480,438,268,251,8,0,5,2,3,17
55131006501,5,1,0,0,1,0,0,0,1
55131006520,272,226,215,7,0,3,1,0,11
55131006402,1537,1072,991,29,21,3,14,0,81
55131006486,0,0,0,0,0,0,0,0,0
55131003021,0,0,0,0,0,0,0,0,0
55131006517,0,0,0,0,0,0,0,0,0
55131006516,0,0,0,0,0,0,0,0,0
55131008067,0,0,0,0,0,0,0,0,0
55113005724,593,497,406,19,6,63,5,0,91
55103005096,487,369,359,3,0,3,3,0,10
55103005079,53,40,38,0,0,2,0,0,2
55103005099,425,331,315,4,3,3,4,0,16
55103003013,0,0,0,0,0,0,0,0,0
55095004664,314,259,251,1,3,1,0,0,8
55095004676,279,217,203,7,0,5,2,0,14
55095004679,891,708,667,8,11,12,5,0,41
55025001048,0,0,0,0,0,0,0,0,0
55081004081,537,433,421,0,0,5,1,0,12
55117005856,598,494,484,0,0,2,2,0,10
55025001142,2334,1848,1163,298,249,43,84,4,685
55025001285,0,0,0,0,0,0,0,0,0
55025001125,4850,4409,2781,175,222,55,1178,3,1628
55025001076,683,595,510,32,21,13,15,3,85
55025001077,1513,1291,1125,69,50,19,18,4,166
55025001144,0,0,0,0,0,0,0,0,0
55087004292,976,767,684,30,21,15,18,0,83
55087004325,944,682,660,0,5,7,7,0,22
55101004965,866,683,558,72,35,16,7,1,125
55111005623,1247,986,950,19,3,7,0,1,36
55121006016,255,210,204,6,1,1,0,0,6
55087004467,0,0,0,0,0,0,0,0,0
55087004413,732,581,532,16,2,20,8,0,49
55087004430,554,412,385,3,4,17,3,0,27
55101004999,1470,1124,998,78,8,23,3,0,126
55101004978,1155,868,718,97,9,17,20,6,150
55101004931,2720,2113,1152,354,560,47,26,6,961
55101005059,664,524,456,36,6,12,8,0,68
55101005064,1427,1182,1069,66,11,14,14,0,113
55111005612,663,524,485,16,2,7,2,2,39
55111005666,870,703,650,30,3,11,2,0,53
55111005621,608,485,460,7,4,6,1,0,25
55101005038,896,712,661,23,0,12,2,2,51
55117005875,616,485,453,9,4,3,14,0,32
55117005878,927,757,718,5,4,6,20,1,39
55117005911,950,749,700,16,6,5,19,0,49
55117005890,975,769,699,31,10,13,13,0,70
55117005892,855,687,639,24,7,14,10,0,48
55123006036,469,373,356,5,5,4,4,0,17
55131006384,1002,830,785,11,7,9,5,0,45
55123006094,840,657,628,9,3,6,6,4,29
55123006052,323,226,219,2,0,2,1,0,7
55111005608,749,580,548,13,5,5,2,1,32
55101004930,2495,1643,352,495,780,40,9,1,1291
55111005686,872,676,608,40,6,11,3,1,68
55111005646,662,530,470,29,22,5,5,0,60
55111005583,371,295,276,11,2,2,3,0,19
55111005652,331,280,245,17,11,2,2,0,35
55043002145,319,262,251,4,5,1,1,0,11
55101004920,2059,1728,1440,97,112,32,44,2,288
55131006450,334,272,263,5,0,3,1,0,9
55025001176,654,556,349,45,52,17,104,1,207
55025001295,509,431,410,18,0,3,2,0,21
55117005842,824,699,670,4,1,6,5,0,29
55117005816,353,246,157,19,17,11,49,1,89
55117005876,672,485,455,12,9,3,4,0,30
55117005849,453,325,300,7,0,3,13,1,25
55117005893,1299,1101,1027,25,17,9,22,0,74
55117005932,12,6,5,0,0,0,1,0,1
55117005931,84,77,71,6,0,0,0,0,6
55073003206,1,1,0,1,0,1,0,0,1
55073003207,0,0,0,0,0,0,0,0,0
55073003231,0,0,0,0,0,0,0,0,0
55073003308,590,434,407,19,0,6,1,1,27
55073003275,141,110,105,1,0,1,0,0,5
55073003290,860,669,613,4,1,7,46,0,56
55099004883,502,400,372,5,2,5,8,0,28
55019000688,188,143,138,3,1,0,1,0,5
55135006914,908,720,691,9,8,6,4,0,29
55033001746,1351,990,802,7,2,19,158,0,188
55135006909,600,472,426,31,3,2,5,0,46
55135006926,732,580,543,9,3,9,5,0,37
55135006913,316,252,238,5,2,3,5,2,14
55135006937,644,501,475,6,3,5,3,1,26
55135006944,341,254,246,1,0,6,0,0,8
55135006993,554,446,421,21,1,3,0,0,25
55009000386,1932,1484,1342,62,25,19,32,1,142
55009000240,579,442,423,8,2,1,1,0,19
55141007377,236,182,170,8,0,0,1,0,12
55141007335,75,61,58,0,0,3,0,0,3
55085004254,393,356,344,4,2,4,2,0,12
55085004231,591,526,468,8,0,28,16,0,58
55127006213,906,729,605,102,5,5,13,0,124
55127006172,501,405,384,6,2,6,3,0,21
55127006269,1644,1361,1168,118,22,9,34,1,193
55085004256,617,508,467,6,7,16,11,1,41
55033001789,294,234,208,5,8,12,2,0,26
55033001767,888,699,656,8,7,16,5,1,43
55009000375,1618,1222,1086,41,24,21,53,3,136
55009000224,3197,2426,1879,130,93,217,125,1,547
55017000548,776,559,528,7,6,14,2,0,31
55017000549,757,541,522,4,2,4,5,1,19
55037001940,178,156,152,0,1,1,0,0,4
55009000339,709,533,525,4,0,3,1,0,8
55009000285,850,692,630,23,4,29,9,0,62
55015008000,0,0,0,0,0,0,0,0,0
55015000523,1131,851,794,7,1,14,25,3,57
55015000536,0,0,0,0,0,0,0,0,0
55015000512,0,0,0,0,0,0,0,0,0
55009000275,632,496,466,13,3,6,2,0,30
55009000321,970,705,667,11,6,21,3,0,38
55009000300,946,744,680,25,4,35,0,0,64
55009000199,1338,1022,942,14,10,18,28,0,80
55015000487,2205,1673,1395,92,35,26,131,0,278
55015000482,1760,1263,1179,23,8,7,37,0,84
55075003433,384,323,307,1,0,9,1,0,16
55045002250,408,342,325,3,3,1,3,0,17
55045002249,469,352,326,13,2,5,1,0,26
55093004618,475,399,362,18,6,3,5,0,37
55093004657,846,622,582,21,1,8,3,0,40
55019000659,329,224,218,3,0,1,0,0,6
55019000703,263,202,188,12,1,1,0,0,14
55019000661,700,451,399,38,3,8,3,0,52
55115005756,556,396,375,6,2,10,0,0,21
55115005798,558,469,452,0,1,11,3,0,17
55093004620,596,482,450,21,3,7,5,1,32
55045002238,613,465,439,17,0,10,1,1,26
55045002240,590,451,412,12,8,5,3,0,39
55045002248,508,406,369,18,3,10,1,2,37
55079003808,791,584,505,19,15,2,34,1,79
55079003620,1233,927,53,22,839,13,17,2,874
55079003575,1997,1591,1246,106,81,24,142,3,345
55075003378,379,281,270,3,0,1,1,0,11
55063002880,1024,789,698,21,11,6,46,1,91
55063002874,916,682,607,6,4,17,41,0,75
55115005760,939,748,714,9,1,8,8,1,34
55115005759,220,135,125,0,1,6,3,0,10
55015000486,2311,1724,1364,135,52,22,137,1,360
55079003683,3384,2958,2054,267,525,64,86,0,904
55079003693,1383,1314,1048,78,82,17,32,2,266
55079003697,1131,804,669,34,20,8,67,0,135
55105005178,828,652,636,5,2,2,5,0,16
55105005179,577,463,442,2,0,1,12,0,21
55105005177,681,533,503,12,3,5,3,0,30
55137007061,636,532,504,7,2,13,0,0,28
55079003570,1075,814,762,20,10,13,6,0,52
55079003835,1513,1372,1101,94,81,27,66,5,271
55043002151,741,543,527,5,4,4,2,0,16
55133006704,919,679,634,19,7,6,6,0,45
55133006814,696,422,390,6,8,6,13,1,32
55133006813,836,599,552,8,9,8,15,2,47
55133006721,798,615,595,1,3,3,6,0,20
55133003023,4,2,0,0,0,0,2,0,2
55133006822,872,711,644,32,11,8,16,0,67
55109005500,760,591,531,16,11,10,13,1,60
55119005938,275,223,213,4,1,4,0,0,10
55083004192,500,370,313,18,2,27,1,0,57
55083004207,532,416,407,0,0,7,0,0,9
55079003988,1703,1312,840,204,86,18,163,1,472
55079003510,870,695,561,75,22,20,14,0,134
55079004012,2360,1841,1395,123,254,35,45,1,446
55079003495,1138,899,724,55,45,8,64,1,175
55119005953,621,492,471,8,1,10,0,0,21
55079003978,1691,1323,1109,103,36,41,51,1,214
55079003977,1439,1094,948,80,17,12,34,1,146
55079003767,3077,2234,388,103,1583,26,174,0,1846
55079004010,1478,1111,510,463,102,24,41,0,601
55079004005,1792,1454,1048,235,68,33,76,2,406
55079004006,692,532,416,52,26,16,30,0,116
55119005955,930,625,614,6,0,4,0,0,11
55119005972,548,446,399,19,10,8,7,0,47
55079003901,2821,2280,1400,482,285,83,80,1,880
55031001717,470,374,343,0,8,8,7,0,31
55075003414,653,561,545,1,3,5,2,0,16
55129006335,722,571,520,17,1,19,8,2,51
55079003705,1590,1097,195,46,706,10,158,0,902
55079003737,1862,1130,31,40,809,15,245,1,1099
55105005193,606,496,467,10,4,8,4,0,29
55105005132,591,447,397,34,4,7,4,0,50
55105005186,680,538,422,110,1,6,2,0,116
55017000539,892,660,630,11,0,10,6,1,30
55079003725,1767,1382,567,81,626,11,100,7,815
55139007152,599,461,403,33,4,12,3,0,58
55139007202,568,446,424,9,1,12,2,0,22
55139007218,614,480,451,1,4,16,4,1,29
55139007110,847,637,498,71,23,23,12,0,139
55083004162,312,256,239,2,2,12,2,1,17
55053002411,484,372,346,14,0,6,2,0,26
55021000773,987,807,724,39,16,18,12,0,83
55021000774,1108,836,748,40,17,11,12,0,88
55015000509,854,655,589,45,6,3,3,3,66
55023000810,108,79,77,0,0,2,0,0,2
55109005503,354,259,233,12,3,4,3,1,26
55109005506,549,400,378,2,1,11,1,0,22
55113005700,273,178,154,0,0,20,1,0,24
55021000759,882,733,642,37,22,5,20,1,91
55021000797,1658,1516,929,111,416,47,12,1,587
55107005435,299,239,210,8,3,14,0,0,29
55107005446,308,236,222,3,1,6,0,0,14
55059002625,637,496,449,16,1,12,8,0,47
55003000048,729,567,481,15,5,65,9,2,86
55057002592,4,4,2,0,0,1,0,0,2
55121006014,574,438,425,10,0,1,0,0,13
55079003731,1228,793,4,74,702,12,29,3,789
55095004724,251,192,174,10,1,5,0,0,18
55095004673,701,610,576,15,4,14,1,0,34
55095004695,888,681,644,8,3,12,6,0,37
55039002068,738,583,526,38,6,10,2,1,57
55039002067,594,453,434,5,0,6,1,1,19
55039001996,305,232,230,0,0,2,0,0,2
55039001997,695,562,528,19,2,11,3,1,34
55039001998,884,674,594,51,2,17,5,0,80
55029001656,70,61,57,3,0,0,0,0,4
55029001652,644,534,481,25,10,18,0,0,53
55029001620,447,381,366,7,1,1,1,0,15
55029001621,431,376,355,10,0,7,3,1,21
55095004700,499,429,343,10,6,66,0,0,86
55095004719,435,331,324,0,0,0,2,2,7
55059002688,1900,1451,1320,75,6,32,9,1,131
55059002692,453,339,295,25,4,9,4,0,44
55059002728,142,89,36,25,25,6,3,0,53
55079003796,1954,1296,103,32,1134,26,29,1,1193
55079003946,2191,1497,452,669,149,50,222,0,1045
55079003915,2583,1896,897,795,69,81,120,2,999
55079003833,1103,870,696,41,75,6,51,3,174
55079003832,1358,1096,754,45,201,19,81,0,342
55051002375,405,331,310,1,0,16,0,1,21
55133006736,1284,1035,948,23,23,18,29,0,87
55133006730,1037,835,739,19,25,10,30,0,96
55025001338,1074,824,605,38,30,4,141,1,219
55025001456,1068,773,706,18,11,8,31,1,67
55079003671,1179,817,102,597,62,35,52,0,715
55079003651,890,604,102,456,25,22,24,2,502
55079003666,1368,882,120,655,71,55,28,0,762
55079003865,2132,1438,270,941,134,55,96,10,1168
55079003884,741,454,77,315,39,20,16,2,377
55079003488,1218,978,766,44,68,7,109,0,212
55079003715,2136,1321,170,75,948,19,137,0,1151
55003000052,690,635,513,29,41,43,10,2,122
55133006622,789,653,506,22,79,8,35,0,147
55133006678,389,312,302,4,1,2,2,0,10
55061002803,229,198,188,6,1,1,0,0,10
55061002800,740,570,527,10,3,16,8,3,43
55139007147,1007,827,818,4,0,1,4,0,9
55139007108,56,46,44,1,0,0,0,0,2
55139007066,969,738,715,6,3,3,2,1,23
55139007171,562,427,410,6,1,0,3,1,17
55139007090,1063,808,724,18,19,30,15,1,84
55139007230,815,585,531,16,2,6,19,1,54
55133006625,1241,1111,933,53,20,11,92,0,178
55063002866,734,580,557,6,2,3,11,2,23
55063002865,0,0,0,0,0,0,0,0,0
55063002856,965,742,685,16,7,10,17,0,57
55133006656,723,585,525,21,3,12,17,0,60
55133006777,1592,1284,1205,32,7,16,18,3,79
55043002200,378,273,248,19,0,3,1,0,25
55025001080,1793,1432,849,179,282,30,97,0,583
55025001160,2911,2512,1988,151,111,42,219,0,524
55025001129,2928,2891,1906,164,70,40,679,3,985
55089004519,1103,816,736,31,8,0,22,1,80
55039002044,0,0,0,0,0,0,0,0,0
55087004408,1072,831,770,11,10,23,8,0,61
55133006773,2458,1918,1667,59,6,20,148,1,251
55039001978,871,659,620,24,3,7,3,0,39
55039002038,835,674,648,6,0,11,1,2,26
55029001633,444,364,335,4,2,11,7,4,29
55029001664,12,9,6,0,2,0,0,0,3
55029001662,0,0,0,0,0,0,0,0,0
55039002009,894,710,638,44,10,6,7,0,72
55039001954,0,0,0,0,0,0,0,0,0
55089004567,466,356,343,7,2,2,2,0,13
55011000399,425,331,318,7,0,3,0,0,13
55071008081,0,0,0,0,0,0,0,0,0
55025001040,3427,2694,1542,218,312,32,608,2,1152
55025003042,0,0,0,0,0,0,0,0,0
55025000961,779,570,530,16,3,9,8,1,40
55025000960,1172,814,772,13,8,4,11,1,42
55025001155,2377,1912,1644,81,48,37,96,0,268
55025001154,232,183,160,3,3,6,8,0,23
55025001127,1699,1576,1086,116,35,6,330,1,490
55025001117,1403,1335,1004,94,89,73,130,3,331
55133006567,494,392,358,12,11,7,4,1,34
55133006642,581,515,485,11,2,10,6,0,30
55005000137,561,443,427,7,2,2,0,0,16
55107005418,42,33,18,6,1,6,2,0,15
55133006574,744,662,625,3,3,2,25,1,37
55133006578,821,561,480,30,14,4,28,0,81
55075003398,357,274,236,21,5,10,3,1,38
55005000136,685,539,513,8,3,5,11,2,26
55005000089,767,615,589,10,1,10,0,0,26
55005000142,492,390,346,14,6,9,10,1,44
55055002523,1130,944,775,58,0,4,9,0,169
55055002527,295,246,237,8,0,0,1,0,9
55139007150,2193,1994,1664,128,103,40,53,1,330
55139007236,2543,1934,1739,61,43,29,53,0,195
55025001328,750,606,572,17,4,13,3,1,34
55025000881,1421,1004,912,7,25,18,29,6,92
55025001105,2123,1700,1345,78,173,29,66,0,355
55025001316,859,636,584,16,18,16,6,1,52
55025001318,32,15,13,0,0,2,0,0,2
55025001306,991,721,675,21,6,1,9,0,46
55025001220,1229,952,835,57,18,27,11,2,117
55025001218,1407,1140,845,145,90,25,46,2,295
55025001215,1742,1256,1057,34,29,12,115,2,199
55025001214,974,833,721,34,20,2,46,2,112
55055002450,2051,1583,1454,69,11,12,15,2,129
55025001458,697,545,513,15,2,7,4,0,32
55011000409,368,275,269,6,0,1,0,0,6
55105005139,0,0,0,0,0,0,0,0,0
55105005345,937,739,466,118,139,15,2,2,273
55073003299,656,528,511,3,2,8,2,2,17
55035001869,2233,1838,1567,45,44,56,101,7,271
55035001870,843,663,565,16,13,10,48,11,98
55047002273,493,395,367,21,1,0,0,0,28
55035001868,1274,996,823,39,37,32,54,7,173
55035001872,1987,1765,1567,37,45,45,63,1,198
55035001877,2724,2379,2146,47,49,31,98,15,233
55087004455,1129,840,800,11,2,11,8,0,40
55087004448,207,152,135,10,0,2,6,0,17
55087004342,663,493,473,4,0,9,4,0,20
55103005080,496,382,373,3,1,4,0,0,9
55081004076,184,139,134,1,0,3,1,0,5
55011000406,508,399,377,18,1,3,0,0,22
55081004136,93,72,70,0,1,0,0,0,2
55081004077,611,421,310,95,2,5,4,0,111
55081004058,605,457,410,26,4,4,3,1,47
55081004066,453,335,315,5,8,2,6,2,20
55081004047,412,277,244,14,3,11,5,0,33
55029001639,482,384,341,23,2,11,2,2,43
55023000823,132,114,110,2,0,0,0,0,4
55023000822,317,258,241,9,1,5,2,1,17
55025001100,1185,945,598,68,189,36,57,0,347
55091004597,599,482,461,8,2,10,1,1,21
55029001653,718,572,512,31,8,13,11,1,60
55131006357,2324,1896,1725,56,33,10,52,3,171
55131006373,719,486,453,13,4,9,7,0,33
55131006462,1896,1469,1373,36,13,25,19,0,96
55139007237,5,5,5,0,0,0,0,0,0
55107005420,133,100,89,3,1,4,1,0,11
55029001609,775,572,543,9,2,12,3,0,29
55029001608,350,276,264,2,0,4,0,0,12
55087004389,728,571,533,6,0,14,18,0,38
55087004390,1935,1439,1315,31,15,14,55,2,124
55087004417,439,409,370,17,4,9,7,0,39
55057002550,139,108,99,0,0,7,0,0,9
55057002548,659,580,563,2,7,4,3,0,17
55139007208,876,699,661,5,1,8,14,0,38
55139080017,15,9,9,0,0,0,0,0,0
55139007200,2501,1982,1576,100,177,43,75,1,406
55021000751,720,523,477,22,6,14,1,0,46
55097004756,424,302,258,39,3,3,1,0,44
55097004757,0,0,0,0,0,0,0,0,0
55087004296,483,385,361,1,0,8,14,0,24
55139007182,2305,1848,1650,47,54,36,58,3,198
55139007131,0,0,0,0,0,0,0,0,0
55139080019,0,0,0,0,0,0,0,0,0
55139007174,0,0,0,0,0,0,0,0,0
55139007091,0,0,0,0,0,0,0,0,0
55139080022,0,0,0,0,0,0,0,0,0
55139007207,0,0,0,0,0,0,0,0,0
55095004687,542,422,393,12,4,6,5,0,29
55133006646,812,658,611,14,6,7,18,2,47
55133006641,315,253,237,3,0,6,3,1,16
55133006611,519,407,352,9,12,21,18,1,55
55133006802,1118,835,670,114,26,15,10,1,165
55133006548,809,600,549,19,2,7,12,0,51
55133006537,815,656,617,7,1,4,11,0,39
55095004686,537,405,377,7,0,7,5,1,28
55095004694,562,433,404,8,7,7,2,1,29
55095004683,468,372,355,1,0,10,2,0,17
55005000123,279,197,178,6,3,6,3,0,19
55111005584,384,316,303,3,1,5,3,0,13
55111005594,263,200,153,40,1,4,0,0,47
55111005626,256,192,157,31,1,3,0,1,35
55111005596,536,402,258,118,10,5,1,1,144
55111005602,427,346,342,1,1,1,0,0,4
55101004905,1372,1121,969,63,38,25,21,3,152
55029001655,37,21,19,0,1,1,0,0,2
55113005696,156,136,124,1,0,9,2,1,12
55025001011,1644,1078,259,380,405,33,29,0,819
55101005011,940,701,662,14,4,4,11,1,39
55101004987,865,669,621,23,10,12,2,1,48
55111005599,909,758,703,10,9,10,8,4,55
55123006050,289,224,214,4,3,5,0,0,10
55077003442,1004,748,665,50,5,19,10,4,83
55101004984,670,507,470,11,4,3,7,0,37
55101004977,621,490,472,15,2,1,2,0,18
55043002131,871,662,652,8,0,0,1,0,10
55123006067,167,140,129,5,0,3,2,0,11
55117005905,907,650,614,6,4,1,23,0,36
55051002370,342,309,290,6,1,6,2,0,19
55025001300,1058,703,647,21,8,10,10,0,56
55101005000,1404,1096,972,84,9,21,10,1,124
55025001348,0,0,0,0,0,0,0,0,0
55025003038,0,0,0,0,0,0,0,0,0
55025000987,410,326,307,12,0,1,6,0,19
55025000992,832,705,635,44,3,7,5,3,70
55025001189,773,608,292,106,181,21,22,5,316
55135006953,0,0,0,0,0,0,0,0,0
55111005622,811,651,615,13,1,5,7,0,36
55111005604,485,391,379,3,0,3,1,0,12
55111005607,486,363,356,0,0,5,2,0,7
55019000700,377,230,216,4,0,7,0,0,14
55017000601,393,278,262,2,2,6,3,1,16
55017000602,375,296,277,3,3,10,4,0,19
55019000691,586,397,386,2,3,5,2,0,11
55019000654,49,38,38,0,0,0,0,0,0
55019000695,227,169,149,4,2,13,3,0,20
55127006257,381,299,260,33,3,2,1,0,39
55127006259,0,0,0,0,0,0,0,0,0
55127006169,1037,773,707,32,2,8,8,0,66
55019000637,80,64,61,0,1,2,0,0,3
55009000357,1150,1029,967,12,15,15,19,1,62
55009000225,626,451,415,10,10,4,7,0,36
55009000283,1229,967,918,12,4,18,10,0,49
55027001564,429,329,320,4,1,0,2,0,9
55009000232,1226,962,852,34,24,14,30,1,110
55019000679,505,320,310,6,1,1,3,0,10
55019000719,681,448,419,22,2,1,3,0,29
55019000702,483,360,294,57,6,8,1,0,66
55019000714,61,57,56,1,0,0,0,0,1
55019000655,180,126,118,3,2,3,1,0,8
55027001512,574,441,411,15,3,3,1,0,30
55027001580,1168,867,798,30,7,27,4,0,69
55027001526,795,654,616,19,5,3,5,0,38
55017000606,631,485,449,2,5,16,7,0,36
55019000689,643,474,459,5,0,6,3,0,15
55019000708,444,287,273,9,1,1,0,0,14
55141007307,1165,941,892,15,1,5,25,0,49
55141007321,305,234,205,14,1,5,0,0,29
55141007311,668,514,506,3,0,3,0,0,8
55127006165,892,700,630,36,10,9,4,0,70
55127006201,139,105,87,9,0,9,0,0,18
55127006198,747,633,531,81,10,7,9,0,102
55127006197,503,409,371,18,4,7,4,1,38
55127006202,565,470,409,48,5,5,4,0,61
55127006200,38,30,26,4,0,0,0,0,4
55033001761,260,203,197,0,1,1,1,0,6
55033001749,765,610,577,21,6,3,0,1,33
55027001573,1344,1091,994,65,13,5,13,3,97
55027001574,1219,1041,976,40,6,15,6,2,65
55027001576,1228,974,877,54,8,11,20,0,97
55079003880,613,404,100,272,16,25,18,1,304
55093004613,458,364,349,0,0,6,3,0,15
55037001945,228,185,181,0,0,4,0,0,4
55079003768,2123,1372,187,41,796,15,354,0,1185
55079004025,1920,1457,1188,58,128,21,77,3,269
55141007378,757,594,579,7,1,4,3,1,15
55141007275,1068,827,767,14,16,9,21,1,60
55105005115,1773,1207,647,320,200,51,10,0,560
55045002210,726,551,537,6,0,3,0,0,14
55133006817,961,758,703,14,6,10,16,2,55
55133006832,326,257,226,21,2,10,0,0,31
55089004521,114,90,68,12,4,4,1,0,22
55089004578,942,765,737,14,5,6,0,0,28
55089004529,719,566,533,18,7,1,2,0,33
55089004579,863,646,565,30,23,12,6,0,81
55105005120,368,312,303,9,0,2,0,0,9
55105005156,615,435,411,13,0,8,1,0,24
55089004536,631,496,466,9,2,11,7,0,30
55089004550,434,348,318,3,6,3,2,0,30
55031001716,1531,1219,1108,21,16,43,11,1,111
55031001714,278,204,181,9,2,8,1,0,23
55041002085,72,62,59,2,1,2,0,0,3
55079003687,1352,938,36,55,847,7,8,0,902
55079003591,785,638,540,43,25,22,10,0,98
55137007038,631,508,490,9,0,2,0,2,18
55089004498,857,632,577,14,6,8,26,0,55
55089004568,766,675,612,19,23,4,16,0,63
55089004532,828,604,578,8,3,3,12,0,26
55077003467,137,100,96,0,0,1,2,0,4
55091004594,133,92,88,1,0,2,1,0,4
55091004598,577,439,414,1,1,13,1,0,25
55039002049,445,339,327,5,5,2,0,0,12
55079003640,1935,1444,219,55,1021,28,152,0,1225
55079003976,1314,973,837,38,25,12,56,0,136
55079003951,1597,1260,1105,62,26,21,51,1,155
55079003718,2220,1456,218,38,1102,9,93,0,1238
55043002188,536,393,375,14,0,2,1,0,18
55043002178,314,215,210,3,0,0,1,0,5
55043002189,45,39,33,2,2,2,0,1,6
55133006793,594,503,443,28,13,7,11,0,60
55011000411,402,318,289,25,0,5,0,1,29
55133006785,1652,1272,1187,40,5,22,12,2,85
55133006874,188,120,99,8,1,2,10,0,21
55133006861,550,453,436,5,1,7,1,1,17
55133006616,395,348,342,1,2,1,0,0,6
55133006529,920,723,673,20,3,15,6,0,50
55133006741,2050,1595,1376,32,50,18,101,0,219
55133006759,580,493,454,15,13,4,8,0,39
55133006628,332,256,234,8,3,3,4,0,22
55041002104,43,34,33,1,0,0,0,0,1
55109005574,551,400,383,1,1,3,7,0,17
55043002170,534,406,394,3,1,4,2,0,12
55043002171,571,426,405,4,5,4,1,0,21
55043002172,442,319,299,5,1,9,6,0,20
55043002174,388,290,282,0,1,3,2,0,8
55055002472,870,674,593,44,22,5,9,0,81
55059002684,164,129,125,3,0,0,1,0,4
55133006667,941,763,719,7,4,17,6,0,44
55017000575,578,485,474,0,0,5,5,0,11
55131006505,0,0,0,0,0,0,0,0,0
55131003020,0,0,0,0,0,0,0,0,0
55131006507,0,0,0,0,0,0,0,0,0
55131003015,0,0,0,0,0,0,0,0,0
55035001888,246,171,149,5,0,9,6,0,22
55035001836,837,666,647,5,2,7,3,2,19
55035003002,0,0,0,0,0,0,0,0,0
55035003001,0,0,0,0,0,0,0,0,0
55035001837,57,44,43,1,1,0,0,0,1
55077003462,175,147,139,4,0,0,1,0,8
55103005103,390,282,256,13,3,4,1,0,26
55115005740,357,286,221,55,1,11,0,0,65
55055002488,968,675,631,27,2,0,4,0,44
55055002489,673,546,518,15,2,10,2,1,28
55133006854,187,153,150,0,0,3,0,0,3
55079003615,1308,813,26,76,586,20,127,2,787
55079003605,2010,1348,198,123,790,40,251,3,1150
55079004019,1098,849,591,51,154,14,34,2,258
55105005202,39,33,13,11,5,0,6,0,20
55079003548,666,564,409,83,36,18,15,0,155
55079003941,1369,1087,804,170,55,42,26,2,283
55079003515,1260,1032,897,80,34,13,8,0,135
55079003596,1060,690,11,32,648,5,8,3,679
55035001914,792,650,622,6,4,8,13,1,28
55035001813,764,624,594,4,3,9,14,1,30
55007000175,358,306,282,3,0,15,0,0,24
55129006343,578,452,426,4,1,12,2,1,26
55129006345,230,171,157,3,0,3,4,0,14
55129006342,1,1,1,0,0,0,0,0,0
55129006300,19,19,15,3,0,1,0,0,4
55129006320,0,0,0,0,0,0,0,0,0
55105005128,429,317,299,8,1,2,1,0,18
55059002613,725,618,574,21,6,9,7,1,44
55059002600,62,58,49,4,0,5,1,0,9
55055002441,1012,853,821,16,5,3,2,0,32
55007000190,177,163,135,6,0,22,2,0,28
55035001866,1411,1273,1100,48,25,35,63,0,173
55047002301,10,5,5,0,0,0,0,0,0
55047002281,136,106,97,2,0,0,2,1,9
55047002269,314,270,267,1,1,1,0,0,3
55111005638,694,535,481,18,14,9,7,0,54
55095004696,308,254,240,9,0,6,0,0,14
55013000456,381,331,300,9,1,21,1,0,31
55013000462,178,124,46,0,2,77,1,0,78
55103005071,53,40,38,2,0,0,0,0,2
55103005093,343,255,245,1,0,3,0,0,10
55133006709,3446,2580,2403,59,19,23,59,3,177
55001000034,546,502,478,8,0,12,4,1,24
55133006891,0,0,0,0,0,0,0,0,0
55097004783,1150,968,844,36,48,12,22,0,124
55059002636,1254,1003,839,68,23,34,24,4,164
55015000490,1589,1250,1087,58,35,34,49,1,163
55015000478,949,636,600,13,3,12,6,0,36
55015000531,774,470,436,14,2,4,13,0,34
55015000481,944,634,593,12,2,2,24,0,41
55015000492,820,638,589,18,5,12,0,0,49
55081004084,1335,919,708,127,34,27,34,4,211
55081004051,94,69,64,0,0,0,5,0,5
55081004147,374,271,231,27,6,4,3,0,40
55081004086,0,0,0,0,0,0,0,0,0
55081004114,0,0,0,0,0,0,0,0,0
55081004085,0,0,0,0,0,0,0,0,0
55081008053,0,0,0,0,0,0,0,0,0
55081004083,414,270,225,28,7,5,7,0,45
55081004061,560,395,306,66,7,12,6,0,89
55081004149,0,0,0,0,0,0,0,0,0
55081004128,833,590,565,15,0,5,2,1,25
55081004120,491,374,347,20,1,1,0,0,27
55133006538,723,570,525,29,3,0,12,0,45
55043002140,719,542,503,20,1,3,8,1,39
55063002842,759,645,597,12,2,5,19,0,48
55109005549,470,362,350,0,4,6,0,0,12
55087004353,1744,1405,1108,107,69,33,87,0,297
55109005557,475,387,367,3,1,6,1,0,20
55005000102,689,518,490,4,2,13,4,0,28
55139007224,590,454,395,34,10,7,4,0,59
55139007086,857,675,567,67,12,21,12,1,108
55139007180,1659,1256,1053,81,48,34,32,3,203
55139007203,893,666,612,13,4,13,25,0,54
55139007140,829,614,581,5,2,9,17,0,33
55123006064,463,283,270,0,0,3,2,0,13
55123006062,154,90,89,0,0,0,0,0,1
55133006575,900,652,617,13,1,4,12,0,35
55073003322,706,572,549,13,0,6,1,0,23
55073003272,1187,880,772,9,9,14,73,1,108
55097004754,625,519,490,23,3,8,0,0,29
55133006820,937,782,734,16,0,2,17,0,48
55087004361,800,616,604,4,4,7,1,0,12
55107005443,465,342,323,1,5,2,7,0,19
55107005449,120,89,88,0,0,1,0,0,1
55107005448,24,24,23,0,0,0,0,0,1
55035008012,0,0,0,0,0,0,0,0,0
55035001899,10,6,4,2,0,0,0,0,2
55035001887,928,665,609,12,8,5,30,1,56
55133006579,726,521,477,10,8,0,26,0,44
55133006556,888,739,711,13,3,4,3,0,28
55133006900,865,685,638,32,1,1,10,0,47
55133006553,801,676,648,9,5,9,1,0,28
55133006772,381,344,307,14,0,0,22,0,37
55133006593,1802,1530,1304,34,56,16,123,0,226
55133006812,704,607,492,38,22,6,45,2,115
55087004332,1053,776,647,38,25,20,47,0,129
55121006007,470,392,368,14,0,8,1,0,24
55043002127,201,154,134,10,2,7,1,0,20
55055002453,1273,1026,946,40,13,10,11,1,80
55063002875,928,707,664,6,4,12,21,2,43
55133006583,699,507,482,7,3,1,10,0,25
55013000439,79,63,61,2,0,0,0,0,2
55095004672,532,448,441,2,2,0,2,0,7
55005000101,494,382,353,7,4,10,2,1,29
55083004173,267,225,192,5,13,16,0,0,33
55055002528,526,439,397,26,0,9,7,1,42
55025001225,644,501,441,25,17,2,11,0,60
55087004304,902,663,612,9,5,22,4,0,51
55087004290,160,138,99,11,9,7,10,0,39
55111005615,45,39,38,0,1,0,0,1,1
55101005057,1704,1332,1144,63,51,13,38,0,188
55101004894,2,2,1,1,0,1,0,0,1
55087004322,1697,1289,1153,31,28,46,21,0,136
55111005591,158,114,111,0,1,2,0,0,3
55101005012,670,548,493,18,10,12,5,0,55
55043002192,1412,1119,1022,22,20,18,26,0,97
55131006413,628,468,442,19,2,4,5,0,26
55089004537,818,632,590,21,4,11,6,0,42
55117005910,758,593,556,16,2,7,8,0,37
55073003336,874,674,636,13,4,9,4,0,38
55073003199,392,321,298,12,3,4,0,0,23
55127006275,769,694,599,49,14,15,11,6,95
55127006267,1252,1205,1008,85,47,5,48,1,197
55127006210,866,724,673,34,2,13,6,1,51
55135006949,4,2,1,1,0,0,0,0,1
55135006917,366,293,290,0,0,0,1,0,3
55135006921,778,649,543,75,4,16,8,0,106
55135006995,644,513,460,32,0,14,2,0,53
55009000392,687,543,516,14,1,6,4,0,27
55009000316,358,283,279,4,0,0,0,0,4
55009000345,0,0,0,0,0,0,0,0,0
55085004264,1095,903,780,25,57,27,11,0,123
55127006284,776,656,627,7,6,6,7,1,29
55009000246,1323,1090,1027,16,3,31,11,0,63
55015000466,244,186,182,2,1,1,0,0,4
55045002233,443,336,319,0,1,6,0,0,17
55033001775,258,214,208,2,0,5,0,0,6
55079004008,1857,1497,942,279,139,34,94,1,555
55079003916,27,14,1,11,5,0,0,0,13
55079003944,0,0,0,0,0,0,0,0,0
55079003587,870,680,595,46,11,16,13,2,85
55079003561,916,734,674,36,2,8,10,0,60
55105005217,0,0,0,0,0,0,0,0,0
55105005200,0,0,0,0,0,0,0,0,0
55105005310,793,612,586,4,4,3,8,0,26
55105005332,0,0,0,0,0,0,0,0,0
55079003658,1739,1073,96,821,136,41,47,1,977
55079003770,1731,1014,32,20,653,5,312,0,982
55079003772,2050,1323,131,67,957,26,148,1,1192
55079003663,1442,928,142,611,155,44,35,1,786
55079003698,1301,941,756,47,63,18,44,2,185
55043002135,587,448,432,9,0,2,2,0,16
55079003775,900,558,49,14,324,2,169,0,509
55079003785,1046,686,84,24,542,7,42,6,602
55079003845,2067,1658,1207,260,116,49,38,3,451
55133006592,915,677,624,12,3,9,20,0,53
55133006582,1037,742,672,26,7,10,14,2,70
55109005517,683,449,429,6,1,2,6,0,20
55109005511,469,364,317,7,3,5,16,0,47
55109005543,524,397,371,18,1,6,2,0,26
55109005455,567,416,390,15,5,3,4,0,26
55109005507,410,326,307,9,5,3,2,1,19
55109005579,471,379,359,6,2,5,4,0,20
55109005581,488,350,308,25,3,0,8,0,42
55071003176,0,0,0,0,0,0,0,0,0
55079003550,914,736,581,79,28,28,15,2,155
55079003547,813,671,468,103,68,22,13,0,203
55079003655,1601,1063,103,809,111,46,42,2,960
55079003618,1215,794,22,29,749,20,2,0,772
55079003476,2859,2657,2137,166,118,34,138,10,520
55079003505,2862,2664,2141,172,151,46,147,6,523
55119005939,201,136,125,7,2,0,0,0,11
55079003641,1156,888,98,24,709,3,63,0,790
55031001701,677,566,543,8,3,7,5,0,23
55079003568,1876,1590,1157,233,78,44,90,0,433
55137007047,191,154,148,1,2,5,0,0,6
55105005214,694,531,466,35,13,11,1,0,65
55023000840,132,98,96,1,0,0,0,0,2
55069003050,501,414,405,5,0,2,0,0,9
55097004836,195,160,159,0,1,0,0,0,1
55073003276,233,172,145,17,0,4,1,1,27
55117005887,1162,822,765,22,12,4,9,0,57
55131006393,850,677,653,11,3,2,8,0,24
55131003017,0,0,0,0,0,0,0,0,0
55131006429,715,462,415,8,33,6,0,0,47
55073003309,717,540,519,9,3,5,2,0,21
55001000010,215,195,185,6,2,0,0,3,10
55059002631,1139,911,835,27,12,22,15,3,76
55109005486,1225,977,857,59,17,24,25,4,120
55059002698,775,570,503,29,15,10,8,0,67
55089004538,1612,1320,1232,33,17,17,16,1,88
55121006004,990,762,726,6,1,13,8,0,36
55121005977,394,312,301,5,3,2,1,1,11
55079004002,847,592,446,46,21,4,77,3,146
55079003950,2044,1638,1444,54,50,21,68,2,194
55079004039,1395,1193,967,96,73,9,41,7,226
55013000438,197,154,145,3,0,4,0,0,9
55107005395,178,153,142,1,0,1,2,0,11
55039008013,10,7,0,4,0,1,1,0,7
55133006896,0,0,0,0,0,0,0,0,0
55095004699,686,567,528,9,4,12,3,0,39
55059002697,490,411,368,25,2,4,7,0,43
55059002696,544,423,387,24,1,4,1,0,36
55089004543,1057,887,815,20,27,7,16,0,72
55089004574,812,631,576,9,17,4,28,0,55
55083004215,375,294,287,3,0,3,0,0,7
55083004214,426,292,280,4,0,2,1,0,12
55083004217,1044,740,704,7,4,16,7,3,36
55005000140,599,410,394,8,0,3,2,0,16
55083004191,382,324,301,10,0,8,3,1,23
55083004193,407,317,261,29,2,18,3,0,56
55053002388,519,348,343,0,0,3,2,0,5
55003000045,370,318,307,1,0,7,1,0,11
55133006557,802,627,576,21,3,15,8,0,51
55069003079,721,633,623,6,0,0,2,0,10
55071003093,714,558,515,26,2,11,0,0,43
55133006830,755,583,431,46,16,16,61,3,152
55133006722,2001,1547,1353,58,70,17,47,2,194
55025000898,633,516,475,17,3,10,7,0,41
55025000903,566,450,425,7,7,7,1,1,25
55025000896,906,690,645,15,8,3,16,0,45
55091004603,419,347,330,2,1,5,3,0,17
55029001667,62,55,53,0,0,2,0,0,2
55025001131,2416,1837,585,159,110,42,914,3,1252
55025001128,1409,1409,1082,73,25,10,204,1,327
55071003099,159,148,139,5,0,0,2,1,9
55025001310,691,469,415,14,13,4,7,0,54
55005000079,844,680,565,7,9,105,1,1,115
55005000082,266,213,201,5,1,5,1,0,12
55025001309,854,683,604,32,13,17,10,0,79
55097004744,538,443,431,2,0,1,5,0,12
55007000189,109,94,83,0,0,10,1,1,11
55073003328,96,89,89,0,0,0,0,0,0
55073003330,34,31,27,1,0,0,3,0,4
55035001865,587,408,383,8,1,1,15,0,25
55035001913,0,0,0,0,0,0,0,0,0
55035001897,5,4,2,2,0,0,0,0,2
55081004067,734,599,528,27,17,24,5,3,71
55091004591,716,498,471,7,2,5,8,0,27
55097004807,135,133,126,1,1,6,0,0,7
55021000726,888,693,667,6,2,5,5,1,26
55139007168,26,18,4,5,3,7,2,0,14
55069003047,442,350,344,3,1,1,1,0,6
55069003037,608,480,446,13,5,7,6,0,34
55069003042,181,148,137,4,1,1,2,0,11
55097004822,718,573,561,3,0,4,3,1,12
55013000448,48,35,30,2,0,2,2,0,5
55025001392,845,592,535,10,9,8,33,0,57
55113005711,136,103,8,2,0,95,0,1,95
55131006515,8,7,7,0,0,0,0,0,0
55077003458,69,58,56,1,0,0,1,0,2
55073003198,667,527,487,30,5,2,2,1,40
55025001151,3359,2598,2259,116,75,44,88,1,339
55123006054,673,467,431,15,0,7,5,1,36
55025001292,786,592,546,10,6,12,18,3,46
55025001314,866,655,580,26,20,6,15,0,75
55057002540,223,163,155,6,1,1,1,0,8
55123006073,240,178,164,0,2,7,1,0,14
55131006381,1019,827,789,18,2,7,6,1,38
55087004340,706,527,457,17,7,35,0,0,70
55101005030,669,546,522,4,2,6,5,1,24
55101005029,437,341,322,6,0,2,5,0,19
55025001287,910,790,703,32,34,13,8,0,87
55101005058,1268,1036,888,78,16,23,23,4,148
55101004902,1039,825,694,45,38,13,26,0,131
55101004904,1440,1092,949,87,18,22,15,1,143
55019000667,332,280,264,5,5,2,1,0,16
55127006279,756,658,631,18,3,4,2,0,27
55127006253,729,529,372,111,3,15,26,0,157
55127008060,0,0,0,0,0,0,0,0,0
55127008061,0,0,0,0,0,0,0,0,0
55127006260,794,636,556,48,2,13,5,0,80
55009000280,1077,831,798,14,0,9,5,1,33
55009000255,991,626,601,12,1,2,8,0,25
55009000296,719,546,486,22,2,7,24,0,60
55009000304,1231,903,860,8,4,11,10,0,43
55019000682,392,296,253,33,0,3,3,0,43
55019000646,400,310,273,23,3,5,5,0,37
55027001551,11,10,10,0,0,0,0,0,0
55027001502,17,7,7,0,0,0,0,0,0
55141007328,787,638,609,6,6,6,1,1,29
55141007310,268,196,192,2,1,1,0,0,4
55141007285,774,586,553,15,5,7,3,1,33
55125006129,710,424,42,6,2,376,0,0,382
55125006117,140,87,37,1,2,48,0,1,50
55125006128,315,210,27,3,0,182,0,1,183
55045002225,608,477,459,1,6,2,5,1,18
55037001951,115,100,96,1,1,0,0,0,4
55009000260,1471,1147,1043,44,21,11,15,3,104
55079003491,1248,937,830,33,20,10,42,6,107
55079003925,1633,1253,823,262,49,23,115,1,430
55079003894,1238,948,670,173,61,37,30,0,278
55079003585,1038,888,691,63,85,8,40,1,197
55105005190,577,439,409,8,4,6,3,0,30
55133006676,1097,770,687,25,16,5,32,0,83
55115005742,716,555,508,22,7,18,0,0,47
55137007010,456,366,312,22,3,21,8,0,54
55079003566,762,583,490,19,16,12,39,0,93
55079003686,1330,978,25,24,906,11,14,1,953
55079003489,1514,1286,981,64,75,15,167,3,305
55089004582,829,669,615,21,8,13,18,0,54
55123006053,503,370,348,6,2,8,5,0,22
55133006697,903,628,558,12,2,2,48,0,70
55079003533,1522,1260,962,175,85,14,41,1,298
55133006893,55,35,34,0,0,1,0,0,1
55133006751,2017,1493,1174,30,46,13,208,0,319
55133006770,1225,961,876,37,13,6,22,0,85
55039002001,400,314,299,6,0,4,2,1,15
55131006444,754,568,538,8,3,7,10,0,30
55017000572,630,529,502,6,7,7,1,0,27
55077003463,334,278,256,6,0,10,2,0,22
55123006039,98,72,70,0,0,0,2,0,2
55109005499,611,479,430,15,3,9,16,0,49
55109005502,473,318,306,1,4,11,0,0,12
55109005484,679,495,458,8,1,3,12,0,37
55109005468,838,673,620,17,4,11,18,0,53
55109005469,694,554,524,6,8,9,6,0,30
55115005767,0,0,0,0,0,0,0,0,0
55079003892,1883,1501,1164,183,92,36,42,0,337
55083004195,281,240,225,4,1,6,0,0,15
55059002715,1261,969,791,111,40,10,15,0,178
55059002722,917,777,679,30,38,14,8,0,98
55059002744,52,39,36,2,0,0,1,0,3
55047002283,18,13,10,3,0,0,0,0,3
55003000057,589,440,399,7,1,25,4,0,41
55059002683,514,439,407,17,3,2,11,0,32
55059002599,131,111,97,6,2,5,3,1,14
55057002565,498,390,369,9,3,10,1,0,21
55057002595,294,218,212,1,0,2,0,0,6
55057002591,225,187,166,5,0,7,3,0,21
55109005515,443,352,326,9,0,4,10,0,26
55109005561,551,418,402,1,1,4,6,0,16
55087004305,718,563,539,2,0,9,6,0,24
55077003440,412,338,320,2,6,7,0,0,18
55117005935,720,573,520,32,1,14,0,0,53
55097004808,533,424,386,8,6,8,15,0,38
55069003071,570,453,443,4,0,1,2,0,10
55073003188,614,403,388,9,1,3,1,1,15
55073003261,676,489,457,4,3,2,25,1,32
55073003246,621,498,433,19,4,6,35,0,65
55069003038,522,407,393,6,2,5,1,0,14
55035001841,349,281,272,5,2,1,0,0,9
55047002264,864,605,461,96,15,27,11,7,144
55021000737,898,739,701,16,2,11,4,2,38
55035001876,277,277,219,12,8,1,34,0,58
55133006639,637,495,471,10,3,1,11,0,24
55131006367,1058,741,668,21,16,11,23,1,73
55113005723,481,370,321,0,0,45,1,0,49
55095004718,891,660,616,16,4,15,6,2,44
55095004667,615,517,508,3,0,6,2,1,9
55081004099,484,381,350,11,10,12,2,1,31
55081004078,479,366,345,10,5,2,1,0,21
55087004370,386,298,272,11,3,12,0,0,26
55077003452,459,377,356,6,1,7,2,0,21
55123006075,924,703,690,5,0,2,5,0,13
55131006360,668,541,497,15,12,3,11,1,44
55101004985,654,535,474,27,8,19,5,0,61
55111005680,776,605,535,40,15,8,8,0,70
55111005685,220,180,173,3,2,2,0,0,7
55101005027,403,344,333,3,0,4,1,0,11
55131006488,5,3,3,0,0,0,0,0,0
55131006487,2,0,0,0,0,0,0,0,0
55101004924,851,610,175,281,142,25,7,1,435
55077003466,173,139,125,9,4,1,1,0,14
55131006430,337,274,257,4,0,4,2,0,17
55025001222,1500,1179,1043,26,31,13,65,1,136
55025001162,2758,2345,1933,82,54,26,225,0,412
55025001307,755,587,556,12,5,4,9,0,31
55117005826,546,390,287,19,5,6,74,2,103
55073003233,2108,1768,1618,22,28,24,64,2,150
55127006155,929,678,633,12,5,8,21,0,45
55141007319,505,396,380,6,0,2,9,0,16
55027001546,591,470,433,14,2,6,7,0,37
55125006107,1028,892,865,15,2,8,5,0,27
55085004279,797,658,634,1,1,5,6,0,24
55085004234,519,388,365,5,0,12,0,0,23
55033001744,749,579,542,19,0,10,2,1,37
55033001788,159,99,93,2,0,2,2,0,6
55009000250,1177,834,781,10,2,16,12,0,53
55027001520,904,698,653,11,0,21,2,0,45
55027001494,0,0,0,0,0,0,0,0,0
55015000507,681,519,465,42,0,7,1,1,54
55089004510,697,537,505,21,3,4,3,0,32
55049002304,707,518,495,9,3,5,4,0,23
55079003612,1373,1169,357,117,621,19,91,1,812
55079003490,1614,1276,1065,42,43,18,104,3,211
55105005160,8,5,4,0,0,0,1,1,1
55079003675,1766,1525,1138,158,156,54,44,0,387
55079003692,1220,1109,690,64,307,14,28,0,419
55079003734,1106,722,11,29,681,6,3,0,711
55079003630,1568,1141,32,16,1088,12,5,0,1109
55079003593,1369,974,8,34,922,7,10,0,966
55079003504,1406,997,910,21,20,8,34,2,87
55079003780,1288,862,45,46,746,18,31,1,817
55079003766,1249,928,259,60,551,28,49,1,669
55133006540,389,327,289,17,6,7,4,0,38
55133006541,630,473,434,16,0,5,9,0,39
55109005475,1056,800,758,12,3,10,5,0,42
55109005578,509,354,334,1,3,3,4,0,20
55071003138,693,499,439,41,2,15,0,0,60
55079004007,1537,1217,857,173,55,34,97,3,360
55079003626,1095,786,94,33,637,16,27,0,692
55079003936,974,832,725,56,27,14,16,1,107
55079003938,1248,1070,910,72,24,29,26,1,160
55079003793,1137,883,675,36,124,9,27,0,208
55079003926,1679,1243,759,321,49,27,93,0,484
55079003735,1137,829,44,34,741,6,14,1,785
55011000398,423,329,308,4,9,5,0,0,21
55049002324,107,91,90,0,0,0,0,0,1
55053002426,986,978,508,69,323,69,12,0,470
55079003956,1697,1506,1186,106,88,22,99,1,320
55109005555,703,536,516,4,3,3,9,0,20
55139007154,1072,831,761,20,11,10,22,1,70
55015000495,902,722,679,23,6,12,2,0,43
55139007221,626,471,457,7,0,0,3,0,14
55131006442,559,471,451,11,1,2,0,0,20
55131006375,595,449,414,16,3,3,9,1,35
55001000024,680,537,493,15,0,15,3,0,44
55079003557,2009,1505,1241,78,37,35,122,2,264
55079004038,685,500,145,186,129,29,24,1,355
55079003622,1589,1139,31,31,1064,22,6,2,1108
55003000070,81,62,62,0,0,0,0,0,0
55003000071,50,38,36,1,0,1,1,0,2
55133006571,406,315,292,9,2,6,5,0,23
55083004196,864,704,602,18,1,73,3,0,102
55025001294,921,677,618,18,15,6,14,1,59
55023000835,557,458,430,9,3,2,6,2,28
55133006779,1531,1172,1075,43,5,7,29,0,97
55133006781,1723,1369,1298,21,9,18,10,1,71
55131006431,575,465,433,11,4,5,2,0,32
55131006396,604,444,430,6,1,1,8,0,14
55133006708,638,510,485,10,0,3,4,0,25
55025001455,730,568,535,12,1,2,10,0,33
55133006834,505,428,384,20,1,6,20,0,44
55089004496,1368,1018,886,42,29,6,40,0,132
55001000019,320,263,247,6,3,3,2,2,16
55055002463,762,616,566,31,6,8,3,1,50
55025000851,459,382,362,6,0,2,7,0,20
55129006309,198,170,160,4,0,6,0,0,10
55073003323,625,460,439,8,5,1,3,0,21
55035001851,791,554,522,8,1,15,4,0,32
55087004411,1657,1307,1019,88,42,31,122,2,288
55087004357,708,519,501,4,1,7,1,1,18
55081004072,881,676,607,40,7,12,5,0,69
55081004049,436,319,299,6,3,3,5,0,20
55081004108,545,411,393,10,1,3,2,0,18
55025001192,738,562,525,14,3,1,10,0,37
55025001099,1834,1521,1077,91,282,20,41,2,444
55107005417,231,192,171,0,2,8,0,0,21
55107005434,1,0,0,0,0,0,0,0,0
55005000110,389,303,276,11,6,7,1,0,27
55073003264,1084,861,731,13,17,31,65,0,130
55133006757,891,845,795,16,12,4,8,0,50
55123006056,238,193,181,7,0,1,2,0,12
55123006074,69,53,51,0,0,0,1,0,2
55123006055,755,561,547,3,2,4,3,0,14
55101005044,664,496,466,10,0,15,5,2,30
55017000558,368,325,310,3,1,5,3,0,15
55107005419,137,110,105,2,1,1,1,0,5
55107005421,142,118,110,1,4,1,0,0,8
55025001303,906,681,658,2,1,8,11,0,23
55025001302,894,646,597,19,11,14,5,0,49
55135006932,459,387,362,10,1,6,2,0,25
55019000647,110,74,67,5,0,2,0,0,7
55127006274,1999,1982,1620,123,146,22,64,0,362
55019000665,506,395,362,22,3,8,1,0,33
55019000716,151,114,101,10,1,1,1,3,13
55009000322,0,0,0,0,0,0,0,0,0
55009000376,946,784,468,19,8,282,5,0,316
55009000305,1421,1155,1012,43,15,47,40,1,143
55009000252,1733,1416,843,173,238,98,61,0,573
55009000319,847,617,578,7,10,5,10,0,39
55079003930,1484,1082,388,560,60,34,71,5,694
55079003703,1627,1112,53,46,1004,24,5,2,1059
55079003959,1858,1490,1084,209,131,33,57,0,406
55079003933,1240,1027,761,183,44,35,19,0,266
55079003968,1670,1369,1159,37,16,13,149,1,210
55049002344,60,34,33,0,0,0,0,0,1
55141007259,305,242,215,10,0,8,3,0,27
55105005301,897,710,653,21,9,12,6,0,57
55091004606,322,256,252,0,0,2,1,0,4
55041002086,442,345,323,0,0,21,0,1,22
55041002087,126,96,89,2,0,5,0,0,7
55079003628,1475,1039,28,32,969,11,8,1,1011
55079003862,3615,2562,655,1622,205,160,84,3,1907
55133006636,331,240,217,0,2,4,2,3,23
55133006637,371,264,250,3,2,3,4,0,14
55133006632,646,537,496,19,1,5,12,1,41
55043002136,564,435,420,6,1,7,2,0,15
55059002690,178,145,122,5,0,10,0,0,23
55023000821,523,391,369,7,8,8,0,0,22
55117005886,598,480,459,8,3,3,3,0,21
55131006372,789,614,584,14,5,5,6,0,30
55123006032,376,303,283,5,4,5,3,0,20
55079004000,638,486,386,27,7,8,58,0,100
55035001846,605,468,420,17,6,5,14,1,48
55035001863,997,774,627,31,35,29,54,7,147
55031001686,700,539,500,9,4,20,1,1,39
55079003494,990,789,666,44,29,10,37,0,123
55079003917,1759,1267,695,377,88,43,95,0,572
55079003562,831,665,584,51,12,5,11,1,81
55139007133,25,21,21,0,0,0,0,0,0
55139007256,774,614,576,8,3,3,24,0,38
55059002716,544,498,370,45,61,12,7,0,128
55059003056,0,0,0,0,0,0,0,0,0
55095004731,310,235,220,2,0,5,1,0,15
55013000444,340,256,243,1,1,6,1,0,13
55095004669,663,539,513,5,6,6,4,0,26
55071003132,596,500,480,2,3,6,2,0,20
55059002701,530,414,372,12,4,5,14,0,42
55121006028,502,389,303,83,3,3,2,1,86
55073003194,312,267,254,1,0,4,0,3,13
55139080016,0,0,0,0,0,0,0,0,0
55071003161,1459,1201,1128,25,3,21,25,0,73
55133006901,0,0,0,0,0,0,0,0,0
55133006879,171,97,91,1,0,0,0,0,6
55035001844,338,233,223,0,2,1,8,0,10
55131006453,566,462,425,21,3,6,2,0,37
55131006362,817,686,657,9,1,6,6,1,29
55095004708,560,473,450,4,0,17,1,1,23
55081004052,403,239,236,1,1,0,1,0,3
55081004055,32,11,10,0,0,0,1,0,1
55111005603,254,210,204,4,0,2,0,0,6
55087004416,0,0,0,0,0,0,0,0,0
55101005026,566,431,411,7,5,9,1,0,20
55101005024,1050,1015,793,35,134,44,9,0,222
55101004967,631,526,479,17,7,2,16,0,47
55101004964,784,616,580,12,2,12,4,0,36
55101004903,1178,921,804,60,21,19,16,1,117
55111005585,816,625,496,26,15,83,3,0,129
55101005003,731,585,471,50,41,21,3,0,114
55101004982,778,613,581,9,3,8,4,0,32
55043002124,1278,1114,1017,20,34,13,26,1,97
55025001044,9,4,0,0,1,3,0,0,4
55099004876,38,31,25,2,0,0,4,0,6
55127006196,969,815,728,47,5,19,20,2,87
55067003010,877,677,616,26,15,14,3,1,61
55067002999,324,268,259,2,0,5,1,0,9
55009000390,830,618,590,12,2,5,4,0,28
55009000337,0,0,0,0,0,0,0,0,0
55085004223,655,487,456,10,8,9,1,0,31
55009000248,568,429,407,10,3,1,4,0,22
55009000241,593,445,394,9,5,22,13,1,51
55089004573,587,448,418,2,7,6,12,0,30
55089004588,7,7,4,0,0,3,0,0,3
55079003791,799,637,522,17,41,3,53,2,115
55115005739,243,190,176,2,1,7,0,1,14
55079003556,1713,1267,1071,72,22,12,92,2,196
55079004028,731,559,326,151,55,12,17,0,233
55079003498,756,524,459,14,11,5,33,0,65
55079003834,1539,1247,864,130,155,34,52,0,383
55109005459,11,8,6,0,0,0,0,0,2
55133006870,399,313,304,1,0,1,7,0,9
55079003501,1156,845,712,38,15,5,61,1,133
55079003787,1571,1267,549,52,542,17,120,0,718
55079003934,1182,987,801,110,35,17,22,1,186
55023000814,79,68,67,1,0,0,1,0,1
55109005519,692,560,517,17,1,17,4,0,43
55109005513,634,529,492,8,5,9,7,0,37
55109005518,608,466,448,6,4,5,0,0,18
55093004643,806,577,532,17,4,20,1,1,45
55055002519,675,522,451,58,5,4,0,0,71
55013000457,92,75,71,0,0,2,1,0,4
55105005159,377,293,270,11,1,3,3,1,23
55105005157,481,352,341,5,0,1,2,1,11
55121005983,525,407,394,3,2,1,2,0,13
55087004345,589,475,456,11,1,1,4,0,19
55109005523,506,380,361,4,4,5,7,0,19
55079003574,936,778,715,25,10,12,18,0,63
55079003969,1082,922,792,38,32,9,57,2,130
55079003484,2618,2560,1920,167,247,40,180,1,640
55079003607,2754,2718,1968,278,157,19,285,3,750
55021000806,484,373,369,2,0,0,2,0,4
55133006572,747,589,534,18,8,5,14,4,55
55059002699,576,437,399,14,6,3,6,0,38
55079003653,1908,1375,150,988,226,65,27,4,1225
55079003679,1301,942,101,43,782,15,9,2,841
55133006623,562,467,357,10,25,3,71,3,110
55051002362,145,116,111,0,0,2,0,0,5
55053002414,69,65,61,0,0,2,0,0,4
55133006665,628,535,515,6,1,4,3,0,20
55089004587,393,312,275,1,5,0,28,0,37
55139007160,0,0,0,0,0,0,0,0,0
55069003063,105,85,78,3,1,2,0,0,7
55097004816,719,556,531,11,3,5,1,0,25
55061002791,306,249,231,5,0,6,5,0,18
55131006412,922,834,777,18,13,16,5,0,57
55133006600,0,0,0,0,0,0,0,0,0
55133006573,738,608,582,9,10,1,2,0,26
55133006570,706,557,531,16,0,0,10,0,26
55087004303,115,94,82,6,1,1,3,0,12
55087004444,646,502,489,7,2,2,1,0,13
55133006643,842,671,641,22,1,1,8,0,30
55133006580,485,390,352,10,0,4,20,0,38
55039002025,0,0,0,0,0,0,0,0,0
55025001427,1049,824,762,29,9,12,11,0,62
55131006385,2,1,0,0,0,1,0,0,1
55025001337,1183,943,747,44,24,10,121,3,196
55071003137,542,397,385,6,0,2,4,0,12
55071003107,500,381,347,19,0,7,1,0,34
55071008080,2,1,1,0,0,0,0,0,0
55025001286,875,645,591,14,8,10,15,2,54
55035001840,301,237,227,0,0,1,1,0,10
55047002272,477,344,310,14,8,3,1,0,34
55087004454,1229,892,839,18,9,14,7,0,53
55139080027,0,0,0,0,0,0,0,0,0
55133006887,0,0,0,0,0,0,0,0,0
55133006857,0,0,0,0,0,0,0,0,0
55077003443,298,220,196,3,0,14,1,2,24
55087004380,1840,1386,1093,90,61,48,88,1,293
55099004867,143,109,102,2,0,2,2,0,7
55017000614,349,280,274,0,1,2,3,0,6
55017000622,6,6,6,0,0,0,0,0,0
55009000287,1607,1266,853,288,26,37,53,1,413
55027001556,763,584,513,49,3,10,0,0,71
55037001946,160,144,134,0,0,8,0,0,10
55049002325,484,375,357,8,1,1,4,0,18
55079003802,697,523,373,17,61,7,67,0,150
55079003825,948,791,599,14,84,3,86,0,192
55079004024,2262,1749,1475,70,137,23,34,0,274
55045002247,766,621,594,7,6,0,3,1,27
55049002330,582,408,389,3,1,6,10,0,19
55049002331,569,462,419,5,15,14,5,0,43
55133006726,1045,785,660,38,35,18,26,4,125
55133006648,286,238,225,5,1,5,1,0,13
55079003595,1422,1054,7,22,1027,10,7,1,1047
55079003684,1241,925,204,67,633,18,23,0,721
55079003592,1243,831,24,35,784,9,0,0,807
55079003810,800,614,544,15,13,5,31,0,70
55011000418,952,724,682,4,12,11,10,6,42
55133006744,1142,862,712,15,35,3,89,0,150
55043002173,929,703,671,10,5,8,6,0,32
55039002006,855,697,684,1,0,9,2,0,13
55039002051,351,274,239,28,5,2,0,0,35
55131006424,704,522,474,17,14,7,9,0,48
55077003444,727,551,517,7,1,11,8,1,34
55105005209,96,64,59,1,0,4,0,0,5
55079003985,1802,1552,1124,139,77,32,187,1,428
55079004004,1689,1369,1067,136,79,35,61,3,302
55079003487,843,652,558,18,30,14,33,1,94
55109005508,874,648,582,4,8,15,16,1,66
55017000596,1060,832,787,8,4,7,17,0,45
55105005195,493,388,384,4,0,0,0,0,4
55059002681,57,44,44,0,0,0,0,0,0
55023000815,83,66,59,3,5,1,0,0,7
55059002618,981,780,711,32,7,13,13,1,69
55109005494,1172,887,825,21,4,10,18,2,62
55087004358,597,456,408,15,7,2,21,0,48
55025001299,865,692,642,16,17,11,7,0,50
55111005611,949,718,680,16,2,20,2,0,38
55101004925,209,178,154,8,3,5,4,0,24
55111005601,137,114,112,1,1,1,0,0,2
55043002123,1418,1346,1236,53,19,3,31,2,110
55067003015,115,84,73,0,0,3,1,0,11
55135006978,356,284,279,0,2,0,0,0,5
55085004222,432,328,304,6,2,12,3,0,24
55045002245,610,479,459,7,3,6,0,0,20
55019000678,289,238,218,15,1,2,0,0,20
55079003829,827,710,559,26,40,7,76,1,151
55079003790,806,621,546,23,23,6,16,1,75
55079003624,1166,873,75,24,743,9,28,1,798
55079003571,1255,1030,898,36,14,10,62,0,132
55079003643,1513,1033,68,46,907,24,11,0,965
55079003665,1640,1082,191,642,171,69,69,3,891
55079003635,1635,1097,138,36,596,6,321,2,959
55105005368,134,102,97,0,0,3,2,0,5
55079003799,883,636,45,26,562,14,7,0,591
55079003757,1511,922,38,30,473,12,377,1,884
55079003664,1178,776,86,575,85,39,41,1,690
55039001984,548,449,438,5,0,5,1,0,11
55005000126,85,66,59,2,2,1,0,0,7
55025000989,769,630,575,22,10,9,3,0,55
55025000988,591,509,481,10,4,6,11,0,28
55133006559,1006,771,720,37,3,6,8,0,51
55133006899,394,304,276,6,2,6,12,0,28
55079003650,1894,1285,156,1001,87,66,38,2,1129
55079003708,1393,981,363,68,474,13,83,3,618
55133006587,1809,1368,1273,16,8,7,54,0,95
55133006883,56,35,31,0,0,0,4,0,4
55087004418,1535,1131,932,100,24,37,35,1,199
55025001428,1288,989,887,55,16,9,18,1,102
55025001029,2029,1648,1430,48,50,20,82,4,218
55073003193,497,372,332,9,14,2,13,0,40
55139007201,2046,1673,1419,59,47,30,122,1,254
55089004515,54,44,39,2,0,0,3,0,5
55097004746,158,114,114,0,0,0,0,0,0
55043002122,1305,1278,1167,49,23,10,29,1,111
55131006353,369,295,284,0,2,3,1,0,11
55025001293,904,729,612,52,29,15,29,4,117
55025001217,1059,829,561,98,109,13,46,0,268
55111005649,654,524,449,33,11,15,14,1,75
55111005587,327,244,228,0,3,10,0,0,16
55101005032,667,486,461,4,4,2,4,1,25
55101005037,592,429,409,9,4,1,5,0,20
55127006273,548,461,326,42,69,9,16,0,135
55009000209,1062,1061,294,79,658,45,2,0,767
55027001562,431,377,365,7,2,1,4,0,12
55027001568,0,0,0,0,0,0,0,0,0
55033001766,322,257,227,13,0,2,2,0,30
55079003954,1587,1241,1014,91,37,14,91,6,227
55079003634,1628,1145,165,60,848,3,69,4,980
55105005187,832,621,611,7,0,2,0,0,10
55079003761,1421,860,35,8,798,2,13,2,825
55133006766,951,861,772,17,9,2,56,0,89
55109005516,638,492,436,22,2,12,5,1,56
55109005524,707,493,463,3,2,2,12,0,30
55043002166,288,231,218,7,0,7,0,0,13
55059002695,984,857,802,30,5,3,4,1,55
55039002008,729,578,550,15,8,4,0,0,28
55131006478,981,752,718,8,0,10,5,0,34
55079003992,1736,1398,990,223,112,33,54,0,408
55109005521,685,546,515,13,3,7,3,2,31
55083004204,1040,763,742,9,0,7,2,0,21
55083004206,554,422,414,0,0,0,5,0,8
55081004075,281,167,164,0,1,3,0,0,3
55081004046,15,12,11,0,0,0,0,0,1
55123006061,559,412,395,4,0,8,1,0,17
55123006059,52,42,38,1,0,3,0,0,4
55123006049,332,261,247,8,2,2,2,0,14
55057002581,378,303,291,4,0,0,6,0,12
55021000787,522,427,395,11,0,6,8,3,32
55081004050,0,0,0,0,0,0,0,0,0
55133006702,1028,792,762,14,6,5,4,1,30
55055002493,503,389,292,66,16,10,7,2,97
55101004901,1561,1231,1046,62,49,22,51,0,185
55131006378,578,442,425,8,2,6,0,1,17
55101005013,496,402,378,11,2,0,3,0,24
55117005841,451,365,364,0,0,1,1,0,1
55073003259,798,616,567,4,1,6,35,0,49
55027001482,17,12,3,2,0,0,1,0,9
55027001483,0,0,0,0,0,0,0,0,0
55027001484,2,2,2,0,0,0,0,0,0
55027001485,0,0,0,0,0,0,0,0,0
55093004659,696,555,527,10,1,8,5,2,28
55049002308,194,142,137,1,0,4,0,0,5
55079003756,911,663,100,103,391,16,68,0,563
55079003644,1476,1028,139,63,765,16,78,0,889
55079004035,1332,1114,869,72,125,25,30,1,245
55113005702,81,67,41,1,1,22,2,0,26
55021000734,320,217,207,7,1,2,0,0,10
55017000630,0,0,0,0,0,0,0,0,0
55039002002,477,401,389,4,0,6,1,1,12
55133006898,0,0,0,0,0,0,0,0,0
55133006742,1642,1173,1041,33,13,11,72,1,132
55131006410,1121,946,769,38,35,12,92,3,177
55133006884,660,504,473,11,0,1,13,0,31
55133006558,526,419,401,2,1,4,11,0,18
55073003270,705,554,499,9,1,7,32,1,55
55081004145,704,560,481,49,3,14,5,4,79
55025000964,621,469,409,24,10,3,21,0,60
55073003332,520,439,421,0,0,4,12,0,18
55139080020,0,0,0,0,0,0,0,0,0
55139007162,0,0,0,0,0,0,0,0,0
55139007127,1069,873,622,125,39,8,75,0,251
55071003095,730,606,572,8,3,5,13,0,34
55071003172,2117,1594,1303,99,29,29,134,1,291
55029001614,582,435,402,13,5,10,3,0,33
55077003445,662,428,416,5,0,0,1,0,12
55089004517,508,337,310,12,3,5,8,0,27
55101004994,449,370,354,7,1,9,1,0,16
55043002130,468,356,347,6,0,1,2,0,9
55025001289,852,749,647,32,32,13,10,3,102
55127006180,53,37,32,0,0,0,4,0,5
55009000291,707,575,564,2,1,4,0,1,11
55019000643,85,52,51,0,0,0,0,0,1
55049002354,480,366,349,8,1,2,3,0,17
55079003743,1686,1058,54,86,770,20,148,1,1004
55043002185,643,526,495,13,3,10,2,0,31
55109005525,372,281,271,5,1,0,0,0,10
55109005514,823,580,531,7,4,9,18,0,49
55035001834,506,378,356,2,2,6,3,3,22
55063002859,813,633,583,16,6,6,17,2,50
55063002855,595,481,454,6,2,5,13,0,27
55073003321,522,390,376,10,0,4,0,0,14
55057002543,70,54,46,3,0,5,0,0,8
55057002542,41,37,37,0,0,0,0,0,0
55073003245,1166,895,824,17,12,4,34,0,71
55125006110,412,361,339,1,3,6,4,0,22
55133006569,445,334,309,8,5,4,3,2,25
55079003493,857,590,497,34,11,13,28,0,93
55079003508,1290,1050,819,63,75,13,80,0,231
55109005470,593,431,391,11,1,9,9,2,40
55079003771,1355,945,85,49,800,10,12,2,860
55079003614,1171,939,193,45,691,13,7,3,746
55079003549,643,548,448,48,17,12,24,0,100
55079003932,2090,1434,428,829,54,56,126,0,1006
55023000831,14,14,5,2,7,1,0,0,9
55075003425,222,170,162,4,1,3,0,0,8
55079004040,1891,1421,885,360,116,61,27,1,536
55039001956,346,265,252,8,3,0,0,0,13
55039001974,634,490,477,4,3,4,2,0,13
55039001973,418,334,305,8,0,9,12,1,29
55079003560,911,740,650,31,12,14,35,0,90
55047002271,407,321,278,28,2,7,4,0,43
55047002290,53,46,41,1,2,2,1,0,5
55117005873,635,566,515,20,13,6,14,0,51
55139080021,0,0,0,0,0,0,0,0,0
55071003114,336,268,243,3,4,4,1,0,25
55123006057,60,47,47,0,0,0,0,0,0
55101004976,290,229,215,9,1,0,1,2,14
55025000905,573,404,341,16,24,4,12,2,63
55025001365,1967,1439,794,166,353,33,83,4,645
55009000227,2435,1776,998,516,133,93,68,3,778
55045002239,458,356,337,3,2,8,2,1,19
55079003979,1240,1095,1010,30,3,3,45,0,85
55079003753,4078,3981,3062,220,198,34,439,5,919
55079003479,1717,1642,1186,149,137,12,147,0,456
55039001999,486,375,361,4,1,4,2,0,14
55079004026,1757,1464,1007,58,322,12,52,3,457
55035001819,1186,823,777,11,1,9,21,1,46
55139003029,10,5,4,0,0,1,0,0,1
55109005560,709,544,499,14,1,13,13,0,45
55087004428,0,0,0,0,0,0,0,0,0
55133006842,799,652,619,15,5,5,4,0,33
55133006866,0,0,0,0,0,0,0,0,0
55133006864,0,0,0,0,0,0,0,0,0
55101004895,1716,1368,1156,84,86,31,11,2,212
55101004922,1154,896,742,81,42,9,22,0,154
55099004853,141,112,97,3,3,4,1,0,15
55045002246,498,362,322,17,7,6,9,1,40
55079003659,2611,1826,215,1286,302,98,37,4,1611
55133006811,1077,952,871,21,9,6,45,0,81
55079003876,1948,1372,216,1020,67,74,66,1,1156
55107005423,39,33,31,0,0,0,0,0,2
55025001126,3283,3257,2223,135,89,36,755,1,1034
55087004323,1164,852,821,14,0,9,2,0,31
55133006693,716,536,486,12,10,13,13,1,50
55131006392,615,487,460,6,1,11,2,1,27
55029001615,481,394,356,10,1,8,5,0,38
55097004828,883,694,662,6,0,9,12,1,32
55025001290,914,810,725,37,25,9,13,1,85
55009000338,2293,1798,1116,269,219,128,86,1,682
55141007280,809,672,643,10,7,4,3,0,29
55037001937,392,324,319,0,0,3,0,0,5
55079003952,1450,1025,857,82,23,16,46,0,168
55089004535,753,649,587,16,20,8,19,0,62
55057002598,3,2,2,0,0,0,0,0,0
55073003257,945,808,659,19,10,8,102,2,149
55133006756,1491,1176,1049,70,15,23,21,1,127
55101004968,630,498,431,19,8,4,32,1,67
55101004918,1018,819,590,81,59,32,58,1,229
55131006418,675,508,466,20,0,7,10,1,42
55009000366,939,778,637,35,55,27,18,0,141
55109005509,891,657,616,19,12,6,5,0,41
55133006653,614,505,457,4,5,5,34,0,48
55025001321,914,719,696,7,3,6,5,0,23
55087004377,204,157,141,6,0,2,7,0,16
55139007178,1052,759,694,11,11,6,27,2,65
55123006047,246,193,185,6,1,2,0,0,8
55043002116,128,100,99,0,0,1,0,0,1
55023000819,191,177,173,0,1,1,1,0,4
55071003158,4,2,0,2,1,1,0,0,2
55087004307,1397,1134,964,32,20,23,94,0,170
55101004966,656,477,423,31,10,2,10,0,54
55085004277,740,561,517,11,3,19,3,0,44
55109005501,667,505,460,27,3,11,4,1,45
55079003949,698,605,427,56,40,17,63,0,178
55089004570,710,581,571,1,1,6,0,0,10
55081004102,121,95,85,7,3,0,0,1,10
55089004577,980,772,705,21,20,7,10,3,67
55101004892,941,782,729,28,5,15,7,0,53
55027001543,902,679,636,28,0,13,0,0,43
55133006801,1154,856,720,86,6,9,25,0,136
55079003613,1426,1154,160,105,857,15,29,3,994
55057002551,162,132,123,2,2,0,3,0,9
55101004913,1474,1163,939,88,95,11,20,0,224
55127008063,2,2,0,1,0,2,0,0,2
55107005389,36,28,28,0,0,0,0,0,0
55043002114,348,276,262,3,2,5,6,0,14
55119005949,117,92,89,0,3,0,0,0,3
55073003244,591,489,450,5,0,5,25,0,39
55023000816,350,265,255,2,2,2,1,1,10
55139007209,318,235,168,41,8,7,18,0,67
55019000657,292,193,62,123,1,5,3,0,131
55079003528,1047,795,556,115,65,34,36,4,239
55099004881,109,85,77,0,2,4,1,1,8
55079003704,1083,778,207,19,417,11,131,0,571
55041002110,87,58,51,1,0,6,0,1,7
55079003559,1485,1162,955,77,22,22,79,1,207
55061002802,407,315,303,2,1,7,0,0,12
55097004777,1030,1016,738,40,96,31,103,7,278
55079003707,3634,2499,423,342,1643,45,110,7,2076
55031001727,308,248,227,1,3,10,7,1,21
55041002088,38,37,32,0,0,5,0,0,5
55073003370,485,392,336,14,2,12,26,4,56
55079003478,1404,1323,1047,96,98,28,72,5,276
55079003662,1500,1007,179,696,84,33,57,3,828
55139007082,0,0,0,0,0,0,0,0,0
55139007251,20,12,4,3,2,0,2,1,8
55073003304,161,139,120,13,0,4,2,2,19
55095004681,603,505,467,10,1,19,9,0,38
55039001985,489,394,387,4,0,3,0,0,7
55089004501,93,68,67,0,0,0,1,0,1
55025001112,578,562,419,55,20,15,43,0,143
55079003668,116,93,23,19,48,4,1,0,70
55007000162,307,247,70,2,0,175,0,0,177
55131006364,471,384,362,6,0,8,2,1,22
55079003809,643,494,448,13,9,2,17,1,46
55079003633,628,452,74,23,316,3,41,0,378
55079003475,2188,2159,1756,125,9,0,40,17,403
55073003329,232,209,196,0,5,0,2,0,13
55101004912,1361,1118,906,102,67,36,14,2,212
55013000465,2,0,0,0,0,0,0,0,0
55123006048,420,295,283,5,2,1,2,0,12
55079003931,1061,808,333,400,57,34,19,0,475
55087004482,11,6,1,4,0,1,1,0,5
55097004774,820,819,617,14,74,21,83,10,202
55097004772,884,876,651,25,71,29,93,9,225
55009000214,795,659,632,4,7,8,7,0,27
55089004564,104,87,77,3,1,1,2,1,10
55079003551,949,827,661,75,22,22,43,4,166
55029001658,23,16,15,0,0,1,0,0,1
55027001545,986,842,800,16,1,15,4,0,42
55071003184,6,2,2,0,0,0,0,0,0
55049002348,12,7,5,2,0,0,0,0,2
55073003205,2,2,2,0,0,0,0,0,0
55059002632,1442,1090,911,102,30,21,25,2,179
55025001291,808,641,567,32,23,10,9,1,74
55079003965,0,0,0,0,0,0,0,0,0
55035001820,662,519,483,3,5,1,18,1,36
55133006601,279,228,226,1,1,0,0,0,2
55021000752,456,357,337,2,3,5,0,0,20
55131006440,303,247,221,13,3,2,2,1,26
55059002602,0,0,0,0,0,0,0,0,0
55073003249,14,13,12,1,0,0,0,0,1
55079003485,947,907,719,40,100,3,33,0,188
55079004030,592,502,258,116,109,7,12,0,244
55079004027,451,342,190,94,47,6,11,0,152
55041002107,64,64,64,0,0,0,0,0,0
55079003706,1638,899,71,134,689,4,4,0,828
55131006461,0,0,0,0,0,0,0,0,0
55027001582,6,4,2,0,0,0,2,0,2
55087004299,0,0,0,0,0,0,0,0,0
55065002948,22,17,15,1,0,0,0,0,2
55131006408,0,0,0,0,0,0,0,0,0
55029001663,16,14,11,3,0,0,0,0,3
55079003980,1662,1623,273,165,1195,2,4,0,1350
55085004225,50,35,34,0,1,0,0,0,1
55127008062,0,0,0,0,0,0,0,0,0
