GEOID,TOTAL_POP,TOTAL_VAP,WHITE_VAP,HISPANIC_VAP,BLACK_VAP,NATIVE_VAP,ASIAN_VAP,PACIFIC_VAP,MINORITY_VAP
48355000039,1257,1063,374,614,47,26,24,0,689
48355000107,6814,4933,2452,2224,79,94,96,7,2481
48355000019,3149,2772,2411,195,10,79,47,2,361
48355000001,2495,2313,1231,866,115,60,62,12,1082
48101000101,405,318,232,61,24,5,7,5,86
48101000301,299,246,132,67,41,5,3,4,114
48101000401,327,267,179,68,14,10,3,2,88
48355000037,2212,1657,168,1419,55,35,6,3,1489
48355000108,2317,1953,695,1226,22,20,11,9,1258
48355000085,1010,753,50,686,17,9,5,1,703
48355000041,864,643,24,601,12,13,1,1,619
48355000071,2870,2204,222,1886,79,40,13,0,1982
48355000026,6851,4972,2040,2066,221,75,581,13,2932
48355000127,1949,1409,742,561,36,27,60,4,667
48355000011,989,718,190,518,6,5,3,1,528
48355000036,1200,915,171,716,12,19,7,2,744
48355000040,5254,4260,3347,612,41,110,137,5,913
48355000081,4996,4156,3312,567,59,88,112,4,844
48355000067,7594,5787,2254,2651,378,109,452,12,3533
48355000032,4148,3310,1176,1687,216,104,169,4,2134
48061000037,3296,2349,57,2280,8,22,7,2,2292
48061000017,12415,8127,209,7861,21,118,24,1,7918
48061000044,4731,3642,1202,2139,122,80,164,15,2440
48061000079,6723,4972,911,3806,77,87,167,3,4061
48307000202,122,105,93,8,1,6,0,0,12
48257000017,2246,1821,1544,193,24,44,7,1,277
48257000028,3183,2499,1664,528,249,48,23,2,835
48257000030,4112,2765,1637,965,74,104,8,4,1128
48257000018,3873,2785,2182,368,142,80,21,2,603
48051000114,3118,2328,1328,662,278,59,18,0,1000
48051000204,979,805,627,100,62,7,8,5,178
48051000301,2103,1636,1108,354,129,50,6,0,528
48051000410,2804,2370,1813,249,175,97,18,1,557
48307000401,1167,881,590,256,17,19,8,0,291
48307000201,1772,1356,567,698,55,33,20,2,789
48055000108,253,180,46,129,4,3,0,0,134
48055000118,160,125,69,49,2,3,1,0,56
48055000405,2561,1830,704,945,124,71,7,4,1126
48055000404,6118,4031,897,2987,82,130,22,22,3134
48055000410,0,0,0,0,0,0,0,0,0
48055000409,57,33,25,6,0,0,1,0,8
48055000401,1940,1460,294,975,171,24,13,2,1166
48165000007,1212,849,121,670,55,11,2,1,728
48165000008,1837,1207,669,501,34,12,4,1,538
48027000307,7247,5303,1429,1981,1793,137,31,24,3874
48063004004,3070,2299,1410,450,351,59,35,9,889
48099000415,299,237,205,15,2,9,2,0,32
48457000003,1931,1571,1219,126,143,51,10,0,352
48457000001,825,665,576,29,41,17,1,0,89
48247000002,1171,873,103,736,1,11,7,4,770
48247000001,1181,856,64,773,5,6,4,5,792
48247000003,1193,870,100,746,0,14,1,1,770
48247000004,1290,915,68,820,2,11,17,3,847
48247000005,3,2,0,2,0,0,0,0,2
48173000003,233,192,139,48,4,1,0,2,53
48173000002,292,220,136,83,4,6,1,1,84
48173000004,298,203,117,81,9,5,1,2,86
48061000078,6571,4738,685,3919,53,104,26,1,4053
48061000028,3081,2133,252,1846,23,25,9,2,1881
48061000042,2535,1857,119,1701,20,26,3,4,1738
48061000087,3714,2839,755,2030,17,41,19,3,2084
48061000035,2268,1711,367,1316,26,58,8,1,1344
48061000032,5491,4031,753,3142,59,80,67,3,3278
48453000443,10228,7335,1013,5694,533,316,123,14,6322
48453000365,4571,3821,2524,852,155,82,222,7,1297
48453000361,2113,1713,1280,273,30,66,66,3,433
48453000352,5128,4413,2715,1160,210,144,240,4,1698
48453000358,6849,5600,3462,1441,305,167,241,14,2138
48453000351,4117,3378,1541,731,135,58,939,8,1837
48453000301,2430,2177,1224,546,99,45,298,3,953
48453000113,21623,16517,4375,6747,2631,447,2651,47,12142
48453000227,5523,3812,579,2238,502,119,479,4,3233
48453000160,5915,4301,1272,1902,584,165,502,8,3029
48453000146,4380,3472,1692,864,459,88,375,7,1780
48453000438,2607,2426,1348,754,125,69,173,9,1078
48453000428,2501,2451,1802,301,111,22,191,0,649
48453000434,0,0,0,0,0,0,0,0,0
48453000432,20,19,6,8,1,2,4,0,13
48453000200,7783,7129,4932,1087,311,139,675,9,2197
48453000202,4720,4265,2822,723,138,110,493,14,1443
48453000259,3836,2997,2025,479,180,93,245,14,972
48029002082,3443,2557,346,2050,128,95,35,7,2211
48123000401,3611,2730,1855,624,181,65,16,1,875
48123000102,2178,1598,335,839,396,26,11,0,1263
48123000302,1888,1411,858,472,60,14,1,1,553
48123000402,1372,1079,935,112,17,13,4,0,144
48123000301,1990,1575,1035,487,45,24,6,2,540
48123000101,3505,2986,1425,1102,418,43,9,4,1561
48355000103,4640,3272,1215,1884,89,91,27,9,2057
48355000100,2165,1605,388,1156,41,26,15,0,1217
48355000101,5449,4042,1452,2414,78,88,42,6,2590
48355000082,1253,1001,148,773,58,27,14,1,853
48355000021,607,531,287,168,16,31,29,0,244
48355000051,4659,3363,736,2357,201,84,31,3,2627
48355000117,4699,3617,2463,821,91,114,145,13,1154
48355000065,5241,4558,2001,1689,732,72,134,7,2557
48355000008,8900,6699,2586,3164,373,174,503,12,4113
48355000091,6687,5686,2393,2320,585,121,317,20,3293
48355000124,4836,3822,1443,1979,142,81,207,18,2379
48371000007,2894,2120,459,1609,21,52,17,0,1661
48453000266,628,505,446,25,1,6,12,0,59
48453000256,2652,1910,1693,116,10,21,48,2,217
48453000212,5848,4226,3449,273,37,42,387,8,777
48453000364,4613,3463,2875,258,38,53,222,4,588
48453000221,1533,1158,859,122,27,13,132,4,299
48453000233,5762,4723,3372,536,159,80,532,6,1351
48453000338,7311,5215,4039,524,67,117,462,28,1176
48453000330,4072,2897,2187,222,41,59,375,5,710
48453000357,769,558,463,28,0,11,54,1,95
48453000232,12185,8030,5587,747,159,134,1333,16,2443
48453000244,7000,5229,3580,702,231,114,559,9,1649
48453000128,0,0,0,0,0,0,0,0,0
48453000154,8655,6629,2063,2115,1208,143,1183,20,4566
48453000153,10727,8550,3014,2370,1475,246,1668,19,5536
48453000268,2404,1902,806,652,220,55,216,0,1096
48453000328,6131,5109,3311,862,322,128,497,6,1798
48453000327,4001,3126,2235,377,90,68,381,10,891
48453000331,3678,2758,1806,248,62,52,602,2,952
48453000242,8495,7007,4842,1114,224,146,651,13,2165
48453000273,3989,3384,2731,335,54,56,176,10,653
48453000214,3611,2707,2334,209,40,37,80,1,373
48453000106,9944,7003,2345,3549,888,308,166,16,4658
48061000006,3005,2194,63,2101,19,35,5,3,2131
48061000027,4696,3324,164,3131,15,38,5,3,3160
48061000022,4561,3321,157,3148,13,29,11,0,3164
48061000040,4754,3448,546,2868,7,36,17,2,2902
48307000301,1659,1260,896,320,18,22,3,0,364
48055000103,2726,2076,1210,718,67,63,32,2,866
48055000412,503,410,225,149,22,12,5,0,185
48419000008,1830,1330,700,290,315,20,5,1,630
48419000005,3156,2419,1977,234,121,63,19,3,442
4841900001W,959,663,358,271,19,12,2,1,305
48165000006,961,679,232,435,5,18,1,3,447
48165000002,4559,3029,1832,1085,39,52,26,8,1197
48165000003,5919,3760,2625,1056,32,49,17,7,1135
48165000009,3173,1911,1310,558,6,31,9,0,601
48165000004,3597,2456,1191,1155,45,59,29,3,1265
48027000201,8170,6056,2597,1389,1645,259,261,98,3459
48027000208,11440,8247,2461,1836,3242,262,651,180,5786
48027000101,13067,10676,7167,1727,1242,286,385,49,3509
48027000103,12946,9507,4990,3267,873,397,189,11,4517
48027000102,5916,4433,2947,1072,235,172,96,14,1486
48027000203,9942,7582,6187,904,155,217,113,20,1395
48027000405,13960,9120,2481,2211,3764,301,554,274,6639
48027000413,19135,12527,3070,3256,5323,381,873,370,9457
48027000412,12797,8705,1902,2027,4270,214,512,222,6803
48027000404,9551,7138,2029,1954,2648,252,472,147,5109
48027000401,2244,1795,1161,259,204,71,87,16,634
48027000209,13207,9154,3778,1664,2762,322,812,147,5376
48027000111,10868,8002,4378,1709,1368,298,369,94,3624
48027000210,12662,8570,2701,1919,3346,264,539,189,5869
48027000402,3611,2861,1884,447,368,111,99,12,977
48027000313,4219,3514,2473,495,360,107,109,25,1041
48027000317,11810,8984,5801,1337,1094,260,529,38,3183
48027000107,1067,804,439,271,55,22,12,7,365
48027000108,2482,1870,1469,282,45,63,8,1,401
48417000303,426,334,305,19,3,10,1,0,29
48027000113,471,377,300,41,12,17,13,1,77
48027000304,1255,1002,655,237,83,42,17,1,347
48133000003,2686,2140,1605,364,108,60,22,1,535
48133000009,657,583,535,34,3,3,0,0,48
48133000002,522,426,363,50,3,14,0,0,63
48061000050,7569,5640,633,4924,24,80,37,5,5007
48061000019,4132,2657,151,2480,13,32,14,2,2506
48061000021,5388,3770,233,3451,26,50,36,3,3537
48061000109,0,0,0,0,0,0,0,0,0
48061000012,4506,3493,284,3155,23,45,32,0,3209
48061000080,8893,6522,1681,4598,92,124,89,16,4841
48061000082,6413,4264,254,3983,10,44,8,1,4010
48061000060,2090,1500,133,1353,10,25,4,1,1367
48061000088,6214,3950,144,3745,25,51,35,0,3806
48061000054,6965,5271,261,4895,32,70,62,4,5010
48061000100,7120,5137,268,4739,29,81,97,12,4869
48061000074,10708,7218,161,7013,25,92,25,6,7057
48061000004,5927,4385,720,3525,32,79,87,3,3665
48061000105,169,112,1,110,0,2,1,0,111
48061000009,5961,4419,209,4167,26,98,4,1,4210
48061000007,1014,806,39,743,5,12,17,0,767
48355000004,4327,3263,553,2349,257,70,88,8,2710
48355000118,4492,3546,772,2469,240,81,41,11,2774
48355000078,2490,1908,95,1547,267,21,6,3,1813
48355000015,2084,1428,325,1022,42,44,12,2,1103
48061000001,2579,2075,752,1277,21,42,17,2,1323
48061000014,6184,4235,146,4044,8,60,16,6,4089
48061000058,7345,5113,686,4317,38,77,25,4,4427
48061000026,5123,3826,779,2963,36,63,21,6,3047
48061000055,4824,3737,611,3100,18,26,18,4,3126
48061000095,1885,1286,59,1220,13,12,4,1,1227
48257000009,2814,2197,1494,378,208,90,12,2,703
48257000006,3375,2654,2039,426,69,124,18,0,615
48257000005,4425,3365,1027,748,1545,69,30,3,2338
48257000015,5052,3840,2933,571,127,142,34,5,907
48257000016,5165,3984,3296,395,117,120,53,4,688
48257000024,2124,1669,1092,361,159,54,11,0,577
48257000014,9403,6247,2972,1215,1510,206,359,25,3275
48257000011,3514,2493,1689,397,284,95,40,6,804
48257000025,2032,1480,869,356,199,56,8,3,611
48257000027,7206,4810,2859,979,773,108,128,9,1951
48257000003,7873,5554,3420,967,803,191,178,5,2134
48257000029,8954,5713,2070,1292,2151,154,133,11,3643
48257000004,7135,5158,3456,989,494,152,76,1,1702
48029003007,5175,3736,1455,1202,291,76,774,26,2281
48029003072,6720,4637,2190,1634,365,146,402,28,2447
48029004003,3002,2216,183,1628,396,73,26,7,2033
48029002018,1764,1369,57,1279,18,74,10,2,1312
48029002118,105,76,1,72,1,7,0,0,75
48029004011,3292,2334,168,1491,672,77,19,1,2166
48029001089,2999,2061,360,1613,60,60,24,5,1701
48029001115,375,284,96,179,0,9,0,0,188
48029001124,1794,1258,121,1092,25,70,6,5,1137
48029001138,3243,2578,645,1346,389,66,178,29,1933
48029001080,11533,8523,1653,5088,1288,285,484,63,6870
48029001139,1767,1236,214,854,123,39,46,7,1022
48029004088,6702,4980,1180,2099,1495,168,263,14,3800
48029002115,11323,7469,2534,3528,923,193,434,40,4935
48029003209,945,743,388,278,22,15,35,1,355
48029002063,2469,1894,1017,698,73,47,73,9,877
48029002120,4021,2745,862,1406,280,63,202,5,1883
48029002160,463,310,100,138,49,13,26,2,210
48029002095,3179,2377,1208,867,94,57,186,4,1169
48029002158,0,0,0,0,0,0,0,0,0
48029003174,5994,4270,2393,1301,174,70,363,12,1877
48029003203,595,491,239,208,13,22,22,2,252
48029003151,4762,3369,1625,1265,154,114,276,8,1744
48029003202,1735,1247,578,482,82,51,94,13,669
48029001046,4164,2996,220,2714,41,65,13,2,2776
48029001151,4508,3024,940,1306,431,97,306,19,2084
48029001122,7614,5356,1736,2436,765,131,427,9,3620
48029001121,6074,4000,1245,1824,614,112,347,13,2755
48029001143,6234,4456,1544,1983,591,101,322,24,2912
48029001073,6070,4065,1187,2092,489,152,268,21,2878
48029001144,2643,2454,1851,396,105,54,75,17,603
48029001145,992,727,330,302,74,32,30,3,397
48029001129,3503,2491,755,1105,415,76,207,16,1736
48029001108,7074,5048,1616,2577,598,133,260,26,3432
48029001069,1044,859,295,453,79,17,41,7,564
48029001137,0,0,0,0,0,0,0,0,0
48029003097,24,11,10,1,0,1,0,0,1
48029003094,7017,5884,2762,2176,395,115,517,13,3122
48029003145,5442,4052,1921,1395,208,85,497,20,2131
48029004095,2606,2030,768,1059,153,62,36,9,1262
48061000066,9339,6479,847,5543,25,127,42,1,5632
48061000099,1089,748,54,686,4,10,5,0,694
48061000003,5238,3645,209,3409,26,85,12,4,3436
48061000085,1669,1185,239,924,7,18,6,0,946
48369000101,2576,1873,651,1175,33,52,7,3,1222
48375000327,8247,7442,2845,2444,1991,94,93,2,4597
48375000222,5840,3945,535,1080,378,87,1927,17,3410
48375000421,4660,3233,605,2148,339,163,107,4,2628
48375000123,5878,4650,3120,863,303,186,151,3,1530
48501000202,2053,1420,539,837,15,31,8,0,881
48369000202,396,272,127,140,3,2,3,0,145
48375000325,4499,3604,2458,740,193,133,108,4,1146
48375000121,3396,2604,1796,459,204,83,88,0,808
48375000122,5624,4539,2811,910,519,138,178,9,1728
48375000324,6233,4936,3781,541,227,153,246,1,1155
48375000321,3512,2623,2242,224,27,92,12,1,381
48371000002,3417,2513,531,1899,29,71,26,2,1982
48371000001,4618,3686,1036,2293,271,88,61,5,2650
48371000010,2177,1747,336,1201,188,40,16,1,1411
4831700004A,307,215,153,57,4,1,0,1,62
48335000004,800,639,342,244,37,19,5,2,297
48335000025,3535,3174,1021,1384,746,31,12,1,2153
48335000003,1707,1286,863,340,39,50,9,2,423
48335000002,302,227,178,42,4,6,1,0,49
4831700003A,318,223,180,38,1,4,0,0,43
48299000205,958,819,732,39,1,24,8,0,87
48307000101,1832,1456,1176,233,19,22,14,5,280
48355000018,6027,4703,2603,1450,283,206,179,48,2100
48355000006,5194,3991,2192,1246,178,131,274,9,1799
48355000102,2200,1623,543,1013,19,36,17,0,1080
48355000062,1754,1341,141,1138,53,30,7,5,1200
48355000017,5664,4562,1308,2661,278,141,260,18,3254
48371000005,97,77,38,35,1,8,2,0,39
48423000030,6995,5087,4161,397,277,104,122,12,926
48423000044,6429,4784,2586,878,1159,138,71,7,2198
48423000026,3961,3096,2481,211,285,97,18,5,615
48355000076,1759,1313,75,1207,29,22,1,4,1238
48355000047,968,685,103,529,35,22,2,2,582
48355000033,2579,2233,831,1206,127,62,23,5,1402
48355000024,1657,1256,163,989,97,15,9,2,1093
48355000012,2023,1425,186,1211,19,28,0,2,1239
48355000105,2081,1493,59,1420,9,30,4,1,1434
48355000038,355,273,19,130,126,7,6,5,254
48355000079,2018,1451,158,1153,131,11,3,0,1293
48355000086,790,644,359,242,11,24,17,0,285
48453000334,4352,3143,1954,213,61,56,868,10,1189
48491000275,5471,4243,2192,859,315,123,784,17,2051
48479000341,2287,1795,120,1634,8,22,34,1,1675
48479000308,1711,1275,58,1193,5,8,17,0,1217
48479000124,4009,2852,46,2787,22,14,11,2,2806
48453000310,11497,9302,4810,3185,665,276,463,30,4492
48453000406,6178,5023,2316,2045,426,154,189,8,2707
48299000410,5109,4212,3589,373,21,135,40,4,623
48299000101,374,301,255,31,1,10,3,0,46
48061000086,3978,2853,107,2686,24,31,32,0,2746
48061000068,6177,4126,79,4020,6,71,13,1,4047
48061000102,3794,2724,239,2450,21,40,11,3,2485
48061000041,8438,6025,259,5679,68,74,34,6,5766
48061000031,679,489,92,395,3,15,2,0,397
48061000051,3820,2590,101,2478,10,37,5,1,2489
48061000023,566,399,55,336,2,10,1,0,344
48061000067,4526,3840,1601,2015,43,71,118,1,2239
48061000059,2251,1523,152,1339,6,50,17,0,1371
48375000323,6133,4786,3723,720,81,234,33,2,1063
48375000326,5180,3930,2684,920,96,176,69,8,1246
48375000422,8931,6645,1944,2588,1871,272,103,8,4701
48165000005,340,244,156,84,0,5,1,0,88
48351000005,551,511,447,21,30,10,4,0,64
48351000001,1601,1203,942,33,189,35,6,1,261
48351000012,279,212,188,2,10,8,1,0,24
48351000004,197,149,121,3,20,3,1,0,28
48457000004,1735,1355,1207,34,44,42,9,0,148
48221000011,3205,2434,1894,392,37,80,23,4,540
48221000003,4383,3509,2922,388,26,114,43,6,587
48221000001,1954,1639,1438,118,32,37,14,1,201
48099000101,11562,7986,4235,1400,1765,301,323,170,3751
48457000002,1506,1167,653,79,394,10,26,0,514
48307000402,403,324,283,21,4,15,1,1,41
48307000302,313,276,224,44,1,18,2,2,52
48051000203,562,444,329,73,38,5,3,1,115
48051000211,1457,1154,797,210,119,41,1,4,357
48133000007,2933,2314,2022,177,19,70,28,8,292
48133000008,4563,3558,2891,367,147,130,29,6,667
48061000106,4596,3559,759,2716,23,31,61,5,2800
48061000072,6271,4219,218,3858,38,88,104,1,4001
48061000073,6388,4889,541,4192,36,56,129,3,4348
48249000011,1238,910,99,797,7,20,8,0,811
48249000006,1809,1348,141,1061,6,14,0,0,1207
48355000126,7016,5005,2174,2212,263,111,346,6,2831
48355000125,9512,6794,2351,3483,398,140,521,13,4443
48355000009,3220,2469,1024,1364,47,57,13,3,1445
48355000061,1744,1272,44,1042,181,29,3,2,1228
48355000048,2265,1731,459,1182,48,59,18,3,1272
48453000324,12149,8826,6145,971,311,137,1237,16,2681
48453000368,601,376,316,27,4,7,18,1,60
48453000359,9848,7512,5080,1662,139,274,397,11,2432
48453000316,9524,6442,4438,699,178,136,982,26,2004
48453000308,10848,8160,6755,760,113,207,283,16,1405
48463000005,2822,2271,978,1159,62,32,40,6,1293
48463000008,2702,2006,449,1535,6,36,5,2,1557
48463000012,3358,2469,850,1543,25,39,40,3,1619
48453000342,6157,5184,3917,723,158,135,245,20,1267
48453000402,11948,8245,1121,6289,551,307,257,9,7124
48371000003,238,187,102,67,15,9,1,0,85
48257000026,4203,2937,804,834,1231,71,29,1,2133
48257000020,3034,2229,1255,715,101,93,100,1,974
48257000001,6376,4558,2243,1694,462,165,56,6,2315
48271000001,814,672,364,272,6,21,10,1,308
48271000002,581,416,134,267,6,17,7,3,282
48271000003,647,505,116,355,19,14,3,4,389
4821300004W,1462,1159,937,125,39,46,17,4,222
482130001CR,3955,3000,2432,323,116,108,13,4,568
48213000002,1448,1057,625,315,70,37,14,1,432
4821300002E,3608,2797,2463,185,40,88,16,5,334
48213000003,3724,2750,811,1043,832,64,30,3,1939
48235000100,378,275,171,102,1,4,1,2,104
48235000200,358,292,232,49,8,6,4,3,60
48235000300,398,308,228,74,3,7,2,1,80
48423000047,652,518,278,49,158,27,3,2,240
48041000031,9165,7031,4009,1356,915,229,569,18,3022
48041000035,19816,18288,10468,3940,1728,326,2089,30,7820
48041000037,179,134,103,13,13,2,1,0,31
48041000005,2591,1955,1419,398,70,42,10,4,536
48501000406,1093,776,227,515,12,14,16,0,549
48369000302,462,315,237,74,2,4,0,1,78
48369000301,1891,1435,813,600,10,24,5,0,622
48375000224,6793,4657,1504,2803,198,136,82,3,3153
48375000125,5729,4596,3117,931,295,158,77,1,1479
48375000221,5326,3700,787,2547,230,129,144,10,2913
48369000401,559,409,275,129,4,8,1,2,134
48369000201,1737,1196,222,954,18,22,3,2,974
48375000322,279,215,162,29,9,16,0,1,53
48061000033,1897,1292,102,1159,25,44,13,5,1190
48061000043,2796,1968,149,1777,7,33,24,1,1819
48061000039,2824,1953,95,1845,13,17,3,2,1858
48061000030,2767,1871,455,1368,32,33,16,1,1416
48061000104,456,325,31,293,0,3,0,0,294
48061000081,2837,2003,189,1793,4,30,5,0,1814
48457000018,1854,1475,1224,66,126,42,17,2,251
48457000017,2532,2375,905,598,851,12,18,0,1470
48457000008,240,190,172,2,8,6,0,0,18
48453000152,4415,3841,2750,567,249,98,227,14,1091
48453000126,7443,6527,3510,1400,1153,163,381,14,3017
48453000444,1110,674,74,378,224,15,6,1,600
48453000275,4394,3996,2939,531,113,81,349,7,1057
48453000208,9007,8903,3113,2199,723,63,2938,10,5790
48453000277,11238,9941,4999,1576,411,86,2869,11,4942
48479000237,570,416,28,383,3,1,1,1,388
48479000457,87,70,13,55,5,2,1,0,57
48479000448,871,606,26,574,7,10,3,1,580
48479000215,3370,2417,65,2334,13,27,3,0,2352
48215000049,5452,4095,177,3810,25,77,87,0,3918
48215000230,1724,1218,178,947,23,15,64,1,1040
48215000167,811,639,121,500,3,11,14,0,518
48215000129,258,184,29,152,2,3,1,0,155
48215000112,2662,1884,53,1796,12,46,18,4,1831
48215000132,1473,1125,30,1090,6,16,0,0,1095
48215000022,1496,1073,33,1031,7,29,5,0,1040
48215000191,902,595,18,569,4,14,8,0,577
48215000118,3675,2543,127,2382,8,40,26,1,2416
48215000172,72,52,0,52,0,0,0,0,52
48215000177,2114,1431,86,1334,6,17,1,1,1345
48215000229,3459,2323,27,2269,8,33,13,3,2296
48215000091,2053,1443,62,1375,1,6,2,0,1381
48215000178,44,36,11,24,0,1,0,1,25
48215000173,4177,2822,522,2271,6,34,4,0,2300
48215000104,9209,5780,186,5535,25,98,27,2,5594
48215000123,1677,1215,142,1062,7,12,3,1,1073
48215000176,3758,2432,187,2224,10,53,4,1,2245
48215000051,3908,2731,26,2689,8,50,2,0,2705
48215000080,2628,1704,12,1688,1,14,2,0,1692
48215000257,829,651,13,632,2,11,3,0,638
48215000054,3449,2397,334,1875,50,43,113,5,2063
48215000199,4323,3080,290,2501,54,55,236,4,2790
48215000201,1963,1370,143,1024,19,39,190,0,1227
48215000200,3303,2510,325,1982,50,29,133,5,2185
48215000083,5912,4241,659,3411,37,63,126,3,3582
48351000009,357,293,222,0,64,5,2,0,71
48099000416,5791,4212,2119,771,976,142,222,131,2093
48099000207,7300,5498,2941,884,1142,164,301,149,2557
48221000002,5823,4637,3825,541,37,169,43,5,812
48221000005,3289,2459,2170,166,22,74,16,3,289
48221000014,5123,3997,3243,557,38,108,26,18,754
48221000013,4823,4164,3615,332,33,124,54,6,549
48221000008,4195,3375,2751,368,42,126,40,6,624
48479000266,4904,3287,115,3125,34,20,17,0,3172
48479000226,2005,1507,47,1443,8,17,6,0,1460
48479000309,4766,3630,145,3458,22,58,13,2,3485
48479000268,1094,642,13,621,5,7,4,0,629
48479000154,10891,6642,135,6472,29,101,9,1,6507
48479000227,12446,7909,212,7625,42,116,53,1,7697
48453000373,8460,6993,5728,770,122,203,139,15,1265
48453000105,25582,17981,4399,8542,4270,542,747,28,13582
48453000120,490,393,199,88,69,19,33,0,194
48453000125,0,0,0,0,0,0,0,0,0
48453000117,14271,9558,1054,6692,1648,294,140,11,8504
48453000121,3791,2526,374,1149,948,77,63,2,2152
48453000122,5344,4254,1025,1286,1808,99,102,9,3229
48453000151,3484,2839,1395,757,581,67,78,3,1444
48453000127,0,0,0,0,0,0,0,0,0
48215000058,7133,5025,193,4781,27,92,34,5,4832
48215000171,40,34,1,33,2,0,0,0,33
48215000003,1860,1256,36,1214,3,8,1,0,1220
48215000174,2320,1523,18,1497,3,19,2,0,1505
48215000232,4412,2758,55,2697,4,22,9,0,2703
48215000023,4324,3056,517,2512,15,40,5,2,2539
48215000120,4503,3046,168,2865,3,38,0,0,2878
48215000056,4444,3112,99,2988,13,34,6,1,3013
48215000202,1831,1406,657,728,6,18,4,4,749
48215000165,1372,1024,88,921,4,18,2,0,936
48215000244,1724,1244,72,1152,17,14,5,0,1172
48215000166,1496,1004,97,864,12,14,19,0,907
48215000041,10189,6707,111,6573,12,101,14,1,6596
48215000213,511,368,37,330,0,3,0,0,331
48215000190,1025,721,175,528,2,13,8,1,546
48215000038,5406,4044,508,3442,25,58,64,2,3536
48215000188,4998,3764,1018,2663,16,53,39,3,2746
48215000036,5827,4305,128,4139,21,51,17,2,4177
48215000187,5722,4279,773,3466,16,59,7,5,3506
48215000100,5449,3867,224,3621,16,50,11,1,3643
48215000078,4443,3245,95,3138,8,29,3,0,3150
48215000210,1064,685,12,673,2,4,0,0,673
48215000128,4932,3448,55,3370,10,70,11,1,3393
48215000066,2209,1723,99,1603,11,42,5,2,1624
48215000045,1772,1442,432,992,8,32,7,0,1010
48215000157,2605,1829,38,1789,1,17,0,0,1791
48215000175,2390,1705,78,1619,1,30,4,0,1627
48215000016,3111,2165,56,2101,15,18,6,0,2109
48215000079,4289,2720,51,2658,12,38,1,2,2669
48135000101,13200,9192,2740,6127,158,191,38,9,6452
48135000402,5413,4032,591,2457,925,83,38,12,3441
48135000209,2433,1952,869,714,248,47,91,1,1083
48135000201,11547,8607,4905,2646,452,184,424,26,3702
48135000202,4398,3242,1852,1085,182,114,63,7,1390
48135000102,10705,7333,1449,5711,63,163,25,21,5884
48135000407,3338,2416,682,1689,22,32,7,1,1734
48135000404,4315,3005,623,2340,14,64,4,0,2382
48135000311,2242,1622,510,971,67,34,41,5,1112
48099000311,11302,8372,4321,1874,1493,189,515,127,4051
48099000205,3784,2845,2208,414,88,115,33,3,637
48125000006,329,261,219,37,0,8,0,0,42
48125000003,455,367,227,120,15,7,2,3,140
48125000005,256,206,156,43,7,9,4,2,50
48041000015,4670,3934,2733,634,308,98,155,11,1201
48041000026,5164,4013,2723,681,404,102,109,9,1290
48041000081,95,81,50,21,8,4,0,1,31
48041000017,6878,5293,2013,2273,870,141,58,10,3280
48041000045,180,141,93,38,3,1,2,2,48
48041000046,830,627,261,300,51,15,6,1,366
48041000047,967,682,285,331,58,16,4,0,397
48257000022,1803,1366,1098,162,42,38,17,2,268
48257000008,4388,3113,1474,1054,443,138,62,9,1639
48257000010,3923,2946,2311,358,126,143,25,5,635
48257000007,13091,8473,3789,1788,2440,232,335,21,4684
48257000013,8112,5695,2917,1073,1315,232,206,20,2778
48257000023,2606,1864,1042,677,93,58,5,0,822
4841900009N,1703,1261,855,115,230,45,11,3,406
4803300002B,66,54,50,3,1,0,3,3,4
48363000030,1386,990,488,357,103,38,16,1,502
48363000017,1492,1097,567,422,68,42,6,1,530
48363000023,2914,2202,1590,392,69,82,72,3,612
48237000006,1948,1443,1166,204,19,53,11,0,277
48237000001,2845,2395,1505,580,275,37,16,3,890
48237000003,296,204,149,43,5,9,4,1,55
48237000004,1022,753,654,67,4,30,2,0,99
48191000302,567,436,274,113,40,13,2,1,162
48191000402,319,241,157,71,12,2,1,0,84
48191000202,597,500,328,140,25,12,3,0,172
48221000004,4088,3146,2340,662,31,149,20,1,806
48221000012,3127,2470,1921,366,36,119,12,1,549
48501000404,746,556,295,242,1,19,2,0,261
48501000101,1822,1333,496,805,14,16,5,0,837
48501000303,974,673,228,434,3,14,1,0,445
48375000424,3350,2155,527,649,869,61,94,1,1628
48375000126,5704,4187,2274,868,440,138,388,7,1913
48419000004,1031,837,650,25,151,11,0,0,187
48453000312,3324,2760,1949,511,59,99,169,5,811
48453000251,4862,4022,2831,401,75,66,642,9,1191
48453000320,2784,2344,1980,152,49,43,83,4,364
48453000238,4187,3457,2276,463,90,65,587,5,1181
48355000121,2838,2199,521,1449,173,45,44,9,1678
48355000098,2620,1993,73,1694,193,26,35,6,1920
48355000056,2610,1695,196,1378,88,51,20,1,1499
48453000423,11065,8088,1514,5498,857,265,235,23,6574
48453000101,17992,12709,2698,7192,2409,481,382,36,10011
48453000114,355,295,111,93,88,22,3,2,184
48453000115,0,0,0,0,0,0,0,0,0
48453000116,8,4,0,3,0,0,0,0,4
48453000119,0,0,0,0,0,0,0,0,0
48453000107,1063,748,287,427,18,24,19,2,461
48453000458,5230,4550,2848,1195,234,131,178,8,1702
4821300001T,2317,1897,1587,119,105,55,19,5,310
4821300003M,2452,1900,1543,231,48,75,12,1,357
4821300003N,2522,1978,1556,276,80,54,16,0,422
482130001TC,4589,3797,3263,299,30,153,34,7,534
4821300003C,5553,4412,3583,264,396,123,58,5,829
48257000021,4850,3570,2331,1010,107,131,14,1,1239
48371000004,1123,795,321,449,5,28,10,0,474
48041000061,58,41,33,0,4,4,0,0,8
48041000048,404,296,189,95,9,5,1,0,107
48041000060,146,110,85,9,9,4,2,0,25
48201000019,2175,1998,952,420,387,46,214,3,1046
48201000892,2530,2286,873,539,640,75,184,1,1413
48201000618,8845,6528,1632,3034,1294,219,523,9,4896
48201000731,11012,8179,2005,4174,1430,292,523,12,6174
48201000876,8178,5769,2919,1149,754,131,853,5,2850
48201000662,5501,4344,2886,1113,60,117,180,13,1458
48201000352,8771,6590,3434,2412,385,178,242,20,3156
48201000804,11792,8781,2741,3126,1498,210,1348,13,6040
48201000955,16429,10729,6250,2558,459,166,1172,21,4479
48201000690,6714,4915,3023,1068,243,164,477,14,1892
48201000878,2818,2075,1317,369,181,36,179,2,758
48201000503,4303,3010,1878,526,232,64,324,6,1132
48201000114,8997,6394,3914,1328,648,204,383,18,2480
48201000453,5807,4197,527,2698,669,145,295,9,3670
48029003091,979,801,605,167,6,12,17,3,196
48029003092,3167,2557,1906,509,30,63,56,2,651
48029003154,2056,1689,1109,476,54,42,41,0,580
48029001067,6224,4572,1147,3253,78,168,54,6,3425
48029001008,2587,2167,685,1306,100,73,51,3,1482
48029001126,0,0,0,0,0,0,0,0,0
48029001107,6767,4840,866,3824,61,172,33,3,3974
48029001102,2115,1594,407,1101,50,40,9,0,1187
48029002016,2526,1889,55,1807,22,29,9,3,1834
48029001105,2673,1775,212,1458,71,31,27,3,1563
48029001059,1820,1267,140,975,131,11,13,4,1127
48029004020,3339,2596,615,1667,179,93,123,7,1981
48351000010,513,409,383,12,8,4,2,0,26
48351000008,747,582,417,11,139,17,2,0,165
48351000002,430,367,299,3,49,11,0,0,68
48351000007,315,255,184,1,62,4,2,0,71
48351000020,203,160,32,0,125,3,0,0,128
48099000413,11899,10871,5734,2538,2409,141,86,17,5137
48457000007,711,560,506,30,9,15,0,0,54
48457000010,1570,1221,1090,44,46,24,2,0,131
48453000332,3529,2855,2213,363,44,68,148,4,642
48453000371,4888,4074,3049,603,117,170,132,23,1025
48479000423,2254,1514,26,1482,9,23,4,0,1488
48215000073,4570,3361,623,2384,65,69,274,2,2738
48215000106,8529,6217,656,5017,102,87,449,9,5561
48215000055,4225,2925,142,2753,16,40,13,6,2783
48215000238,324,192,6,186,1,10,0,0,186
48215000113,7840,5617,434,5034,44,126,101,2,5183
48215000137,58,47,13,33,1,2,1,0,34
48215000005,3700,2538,33,2501,4,35,4,0,2505
48215000085,6984,4723,137,4554,23,60,14,5,4586
48215000046,791,537,37,491,3,8,2,5,500
48215000110,3441,2112,49,2042,14,28,16,3,2063
48215000249,806,605,44,552,3,23,2,0,561
48215000209,4784,2878,62,2808,4,32,10,1,2816
48215000256,3136,1844,20,1822,6,31,2,0,1824
48215000241,3886,2299,43,2255,7,44,0,0,2256
48215000125,2841,1953,69,1867,10,16,15,3,1884
48215000075,194,135,5,128,2,6,0,0,130
48215000182,6482,3645,68,3562,6,72,8,7,3577
48215000090,5706,3924,95,3781,13,57,11,1,3829
48215000237,1702,1207,22,1177,0,5,3,0,1185
48215000153,912,597,7,588,1,1,1,0,590
48215000015,1599,1151,89,1050,3,9,3,0,1062
48257000019,4159,3233,2145,664,320,83,32,2,1088
48191000401,385,314,226,73,7,7,1,1,88
48277001A5A,3278,2414,1400,264,621,106,43,10,1014
48277002B2A,3138,2224,918,252,945,120,11,7,1306
48277002C3A,3203,2408,1382,322,567,115,20,4,1026
48277001E7C,1652,1355,1135,62,97,38,26,1,220
48277001A3B,1714,1272,821,158,242,63,11,2,451
4827700001H,764,599,532,31,10,24,0,0,67
48029004077,8541,5803,1030,3823,858,178,106,19,4773
48029004070,5366,3877,604,2160,1006,143,99,17,3273
48041000011,7455,6070,2826,1580,633,129,943,7,3244
48041000022,1140,812,233,450,110,25,9,2,579
48041000014,9374,6205,840,4269,1009,225,48,9,5365
482130003WS,2771,2261,1931,153,54,98,12,2,330
48213002GBS,3505,2827,2416,239,51,89,19,4,411
48191000101,675,494,254,166,62,14,3,0,240
48041000001,3047,2179,1626,334,100,85,27,6,553
48041000074,1228,1219,546,398,130,1,174,1,673
48041000040,7216,5689,3885,870,354,174,424,3,1804
48041000027,4341,3367,2607,542,75,98,52,5,760
48041000041,6146,4556,3674,250,75,66,468,6,882
48041000080,5856,4130,2899,557,224,101,334,2,1231
48041000042,0,0,0,0,0,0,0,0,0
4827700004E,1057,808,740,23,11,27,5,1,68
48277003H3C,1694,1357,965,94,238,47,15,0,392
4827700002E,796,620,558,26,10,24,0,0,62
4827700001F,1052,834,762,19,7,27,2,0,72
48507000003,2626,1914,35,1851,24,18,6,3,1879
48507000004,1487,1075,149,915,9,6,4,2,926
48375000223,4749,3510,717,2568,132,128,32,3,2793
48133000006,504,397,327,54,3,11,1,1,70
48453000404,10589,7780,2639,4045,693,258,365,21,5141
48453000403,4161,3001,737,2112,97,107,17,4,2264
48463000003,550,463,398,52,1,14,0,0,65
48463000002,1761,1361,544,793,3,36,0,0,817
48463000001,3309,2411,712,1624,16,38,39,0,1699
48453000156,15553,12299,3876,6162,1544,477,664,50,8423
48453000248,5312,4072,1921,1735,255,95,145,5,2151
48453000401,7881,5424,1115,3610,561,243,110,11,4309
48453000138,0,0,0,0,0,0,0,0,0
48453000210,2242,1697,1440,135,25,19,59,5,257
48173000001,293,229,172,55,1,4,0,1,57
48061000053,9135,6258,120,6113,29,70,2,1,6138
48061000075,6763,4705,90,4600,17,35,4,2,4615
48061000098,9346,6175,232,5819,55,96,79,8,5943
48061000048,7960,5448,401,4909,37,99,104,9,5047
48061000016,2397,1742,288,1435,3,11,7,0,1454
48061000057,1477,1072,115,933,4,22,17,4,957
48061000002,900,732,299,416,4,11,12,1,433
48489000012,154,123,12,109,1,5,0,0,111
48061000046,7171,5110,312,4741,21,71,30,4,4798
48061000025,1819,1307,89,1214,2,8,0,4,1218
48133000004,395,337,279,46,5,7,1,1,58
48351000021,536,432,382,29,9,7,2,1,50
48351000013,1294,1054,966,25,17,32,7,0,88
4841900001N,2478,1830,1051,544,190,34,23,2,779
484190001SE,3119,2302,589,496,1046,49,154,15,1713
48201000961,6570,4553,130,2574,1423,98,453,2,4423
48201000884,1723,1257,69,547,580,20,60,1,1188
48201000868,6030,4350,347,3216,599,188,178,4,4003
48201000241,8179,5590,635,4559,249,161,138,16,4955
48201000936,368,258,32,162,57,20,8,2,226
48201000353,9423,6777,358,3848,2378,197,229,11,6419
48201000716,4556,3433,2058,1004,198,111,67,8,1375
48201000707,1354,1120,567,341,76,32,132,2,553
48201000476,4036,2989,814,1646,344,75,164,4,2175
48201000394,3064,2235,346,1766,94,75,23,9,1889
48201000463,10382,7780,1714,2907,2175,213,941,19,6066
48201000640,7366,5332,1954,1817,949,151,527,27,3378
48201000480,5083,3920,1896,1077,438,109,426,2,2024
48201000481,6990,5288,2974,1256,612,143,315,11,2314
48201000669,5758,4621,2388,772,1028,75,372,3,2233
48201000219,3885,3267,476,414,1984,43,394,7,2791
48201000510,8083,6554,2124,1674,2261,132,503,15,4430
48355000066,2759,2169,542,1424,119,66,57,0,1627
48355000094,3103,2415,735,1539,92,54,16,1,1680
48355000059,2355,1867,751,979,70,61,47,0,1116
48355000063,3147,2539,1476,910,67,37,61,6,1063
48355000013,1497,1147,33,1104,15,15,4,0,1114
48355000097,2014,1529,154,1325,43,48,7,2,1375
48355000074,2850,2096,107,1951,28,17,13,2,1989
48453000374,10569,7249,5053,865,297,166,905,18,2196
48491000277,7620,5434,3861,731,201,154,508,8,1573
48453000225,8586,6632,2781,1536,1099,165,1163,26,3851
48453000375,1369,1134,894,138,19,24,70,4,240
48029003063,2662,2131,975,1030,80,77,52,11,1156
48029003131,13,6,3,0,2,0,1,1,3
48211000402,129,90,81,4,0,5,0,0,9
48099000102,2053,1624,1384,145,16,60,13,2,240
48201000529,6850,5324,3855,959,288,133,102,19,1469
4821300001M,3275,2548,1714,355,391,62,26,9,834
4827700001C,412,311,283,11,6,9,4,0,28
48237000002,1579,1235,1099,99,2,20,4,4,136
48249000015,2609,1877,271,1588,12,27,11,0,1606
48249000008,5421,3987,1671,2180,31,110,4,5,2316
48125000001,170,124,92,27,4,5,2,1,32
48125000002,134,96,76,15,2,5,2,1,20
48221000010,6592,5359,4690,395,40,166,48,11,669
48221000007,1257,941,847,47,7,30,3,4,94
48221000009,6512,4899,4101,463,64,159,113,11,798
48419000006,762,610,527,21,51,18,1,1,83
48355000075,3578,2758,130,2574,40,49,12,3,2628
48355000045,1275,972,88,845,36,21,4,1,884
48355000031,1309,1035,153,811,42,40,13,3,882
48215000124,2496,2015,407,1480,38,35,76,1,1608
48215000134,4235,3207,712,2383,38,54,54,2,2495
48215000135,3672,2890,365,2326,54,67,114,6,2525
48215000141,185,136,21,100,7,3,9,0,115
48355000114,1312,984,111,795,31,19,32,1,873
48275000201,244,179,157,16,2,3,1,0,22
48201000009,4044,3280,872,1312,890,95,171,6,2408
48201000889,355,326,148,87,70,9,23,0,178
48201000924,0,0,0,0,0,0,0,0,0
48201000649,10702,7893,606,3548,2138,169,1644,18,7287
48201000358,10507,7083,242,4024,2663,158,199,7,6841
48201000958,2837,1941,106,1132,466,59,237,8,1835
48201000959,10,10,5,4,2,1,0,0,5
48201000957,1061,794,56,310,364,16,75,2,738
48201000101,3625,2509,166,1610,739,75,24,2,2343
48201000462,5722,4606,1182,1416,1423,117,563,7,3424
48201000255,3557,2863,1606,436,528,65,225,3,1257
48201000877,13175,9063,1706,4104,2239,254,967,10,7357
48201000796,6400,4563,1133,2126,930,142,337,2,3430
48201000813,9086,6432,1415,3200,1193,222,592,11,5017
48201000771,5568,3954,680,2312,731,136,247,3,3274
48201000523,7797,5747,2055,2649,700,240,286,12,3692
48201000751,17911,13589,5378,4987,1952,322,1125,24,8211
48201000133,3885,2661,1881,267,45,32,422,2,780
48201000071,9660,8479,4821,1849,520,193,1166,7,3658
48201000070,5689,5119,3622,702,215,65,475,11,1497
48201000851,7450,5766,2760,1587,859,172,491,9,3006
48201000539,3439,2449,826,786,418,56,401,11,1623
48201000041,2770,1990,579,627,635,78,109,6,1411
48201000734,8176,5782,2768,1390,797,171,682,16,3014
48201000817,8456,6210,3457,1163,662,112,802,12,2753
48201000111,10473,7295,4086,1462,975,164,669,35,3209
48201000806,5838,3896,1693,1006,574,123,588,1,2203
48041000020,12137,11872,6517,3427,784,47,1393,13,5355
48215000197,6620,3734,42,3672,12,67,8,2,3692
48215000011,3259,2287,46,2224,6,39,6,1,2241
48215000050,4774,3317,73,3224,14,44,8,2,3244
48215000131,39,32,2,30,0,0,0,0,30
48215000198,1056,719,16,700,3,8,0,0,703
48215000127,1952,1378,28,1339,4,11,5,0,1350
48215000255,498,345,85,259,1,1,0,0,260
48215000126,2983,2224,533,1668,6,52,5,1,1691
48215000181,1003,917,598,306,2,10,0,0,319
48215000203,8173,5629,500,4647,98,95,383,2,5129
48215000063,1659,1367,111,1209,12,26,29,0,1256
48215000204,1673,1187,166,1001,5,14,12,1,1021
48215000082,17,10,1,9,0,1,0,0,9
48215000087,19940,11731,267,11401,23,153,18,1,11464
48215000070,5212,3505,73,3411,8,83,4,3,3432
48215000119,2150,1551,25,1518,8,17,1,1,1526
48215000061,6235,4325,148,4122,25,48,43,0,4177
48215000240,2161,1518,158,1330,3,21,20,1,1360
48215000133,353,238,10,221,5,16,7,0,228
48215000069,18071,12305,675,11051,575,122,13,3,11630
48215000068,7764,5214,304,4849,39,64,18,1,4910
48215000154,6207,4279,194,4050,20,77,13,4,4085
48215000109,8856,6779,551,5751,224,102,260,7,6228
48201000083,9797,6987,1527,2965,2087,264,331,74,5460
48201000118,7644,5215,1827,1014,1592,99,686,13,3388
48201000517,9577,6952,1438,4277,696,275,476,25,5514
48201000650,6430,5062,2476,1307,511,112,728,12,2586
48201000983,563,444,182,99,92,12,61,0,262
48201000668,8291,6477,2870,1689,955,184,881,10,3607
48201000684,8509,5690,2175,1567,693,185,1153,24,3515
48201000788,32,19,2,7,8,0,1,0,17
48201000112,4750,3604,1914,821,354,89,472,8,1690
48201000018,1895,1481,821,194,116,31,327,5,660
48201000014,2597,2012,1399,260,127,43,187,2,613
48041000013,3863,3048,1820,722,365,68,60,9,1228
48041000016,3296,2331,299,1581,399,60,34,0,2032
48191000201,95,76,58,17,1,1,1,0,18
48249000022,2886,2098,154,1897,18,21,6,0,1944
48249000012,3458,2543,415,2071,15,44,16,3,2128
48249000007,4001,3002,780,2118,18,37,56,4,2222
48453000346,7780,6067,4924,503,146,137,337,8,1143
48209000445,2999,2279,1910,188,28,37,99,3,369
48209000444,3453,2635,2194,269,33,60,52,7,441
48453000218,12301,11300,5807,2517,958,256,1831,42,5493
48453000267,2581,2138,1326,451,171,50,158,4,812
48453000369,10484,7517,4695,847,326,153,1453,16,2822
48453000372,3226,2623,2018,412,43,92,47,4,605
48453000229,2891,2277,1346,548,185,71,173,9,931
48183000021,7025,4985,1027,2016,1878,131,30,12,3958
48183000020,6983,5026,989,1621,2323,104,48,9,4037
48183000003,6298,5135,3402,646,878,131,88,6,1733
48183000019,7189,5500,1237,1339,2795,83,102,7,4263
48183000001,3189,2525,1554,333,544,67,25,3,971
48109000002,596,466,109,350,6,8,3,0,357
481090003-5,445,351,106,225,5,8,12,1,245
48109000004,632,474,101,342,19,21,11,0,373
48507000002,2737,1929,76,1820,20,26,11,3,1853
4850700004A,956,681,46,628,5,7,1,1,635
48055000301,2729,2178,769,1027,352,55,12,8,1409
48055000305,891,678,393,247,10,31,5,0,285
48055000206,2160,1607,567,768,216,82,12,2,1040
48055000302,3183,2390,740,1519,67,92,20,2,1650
48355000028,315,257,180,66,5,7,2,1,77
48355000034,1111,749,166,561,15,8,4,2,583
48355000123,3282,2403,1028,1265,49,66,17,6,1375
48041000004,4399,3073,277,1433,1366,46,5,0,2796
48041000030,5460,3731,945,2088,608,143,43,7,2786
48041000069,8792,5917,4090,627,250,111,828,8,1827
48041000010,6483,4572,2859,657,367,117,546,23,1713
48041000002,7618,5672,4172,886,224,128,248,3,1500
48041000070,1947,1492,892,328,188,41,67,3,600
48041000101,115,82,32,35,9,7,1,0,50
48041000067,759,491,230,230,21,15,5,0,261
48041000090,27,18,9,2,3,2,0,0,9
48041000094,0,0,0,0,0,0,0,0,0
48041000091,28,23,19,3,2,1,0,0,4
48041000077,1375,946,301,569,31,64,2,0,645
48041000093,0,0,0,0,0,0,0,0,0
48041000092,0,0,0,0,0,0,0,0,0
48041000006,1446,1120,859,161,30,53,9,0,261
48041000007,2523,1888,1532,240,37,55,18,2,356
48041000039,7298,5571,3676,752,469,138,540,14,1895
48453000211,4209,3380,1353,1209,433,99,352,13,2027
48453000216,6203,5234,1853,1567,1345,140,447,19,3381
48453000111,7917,6467,2765,1568,846,158,1251,12,3702
48453000205,5751,4859,2093,1361,619,167,745,13,2766
48453000215,4991,3766,1589,1156,598,127,390,4,2177
48453000226,5902,4761,1342,1524,920,93,984,7,3419
48453000112,5067,3926,1107,1167,857,85,813,12,2819
48453000343,5562,4527,2331,1131,599,107,416,18,2196
48463000013,4635,3352,448,2843,26,50,14,1,2904
48453000304,5969,4104,2944,509,80,72,481,8,1160
48453000450,10021,7586,1950,4559,734,402,303,8,5636
48453000407,11644,9254,2515,5052,1290,264,358,15,6739
48453000426,4595,4022,1738,1765,278,97,187,4,2284
48453000164,8765,6375,919,4488,689,226,327,10,5456
48453000317,4187,2934,2135,322,34,41,390,5,799
48453000356,2948,2679,1827,394,78,59,309,9,852
48453000239,3187,2341,1951,221,40,33,93,4,390
48453000250,7415,6667,5125,718,160,121,530,5,1542
48453000148,10286,7983,2832,2619,1729,248,713,23,5151
48453000315,5759,4206,2770,874,157,86,349,11,1436
48453000302,5642,4199,2944,637,100,105,414,2,1255
48209000230,2040,1577,1170,282,27,54,36,0,407
48453000104,2074,1814,669,742,255,95,119,3,1145
48453000347,3757,2760,2162,234,37,39,268,0,598
48453000307,1924,1305,1066,119,14,19,76,3,239
48453000129,6106,5081,1657,1521,1765,98,140,9,3424
48453000436,735,598,184,332,54,22,22,1,414
48453000219,5634,4443,1860,1381,628,126,528,16,2583
48453000203,6169,4300,1081,2096,595,139,539,5,3219
48453000460,4679,3975,2522,1097,120,154,128,19,1453
48479000218,4304,3059,83,2944,14,29,17,1,2976
48479000130,8472,5636,78,5549,11,42,1,1,5558
48453000339,2740,2179,1456,388,137,79,124,13,723
48453000141,1224,1042,315,417,160,31,124,6,727
48453000131,30,19,6,4,1,1,10,0,13
48453000139,14656,10577,1991,6689,1424,464,487,15,8586
48453000134,0,0,0,0,0,0,0,0,0
48225000003,2468,1843,618,200,1009,16,5,1,1225
48225000002,2021,1637,1079,152,374,26,8,0,558
48225000014,337,257,220,28,4,6,0,0,37
48225000001,1931,1461,690,265,450,38,15,3,771
48007000002,5697,4461,2391,1731,51,173,109,10,2070
48007000001,3109,2587,2035,426,27,79,10,4,552
48007000003,5817,4961,3729,814,101,137,157,14,1232
48007000004,4876,4188,3307,514,24,140,185,4,881
4800700004A,1295,1188,954,157,9,59,14,7,234
48055000104,847,557,296,231,14,12,6,1,261
48055000111,1910,1429,641,616,151,23,16,3,788
48055000117,0,0,0,0,0,0,0,0,0
48055000101,1182,896,372,435,73,21,9,0,524
48055000113,0,0,0,0,0,0,0,0,0
48055000112,0,0,0,0,0,0,0,0,0
48055000202,2093,1571,811,621,83,47,17,0,760
48035000002,1788,1332,865,406,13,61,1,0,467
48035000007,829,683,595,54,7,20,6,0,88
48455000008,564,455,416,13,3,22,1,2,39
48363000015,1143,912,784,68,11,36,9,1,128
48123000202,2195,1728,1008,553,115,50,24,1,720
48363000006,1135,968,871,49,3,35,12,0,97
48363000001,771,643,535,66,10,20,6,1,108
48363000009,394,360,343,12,1,3,2,0,17
48483000009,1186,877,677,123,32,33,22,0,200
48483000007,185,146,134,9,0,2,0,0,12
48201000492,5873,4311,1457,1193,1408,88,297,7,2854
48201000207,1649,1367,440,877,22,52,30,0,927
48201000440,3867,2820,2076,193,14,26,494,2,744
48201000265,6363,4874,3051,489,186,60,1093,5,1823
48201000391,3559,3130,2017,421,266,80,373,3,1113
48201000827,4906,3358,261,2990,84,116,21,3,3097
48201000954,0,0,0,0,0,0,0,0,0
48201000527,1627,1175,161,963,38,29,17,1,1014
48201000784,1368,1050,26,297,725,19,2,0,1024
48201000198,931,719,49,130,516,11,30,0,670
48201000411,6917,4796,427,4006,320,165,51,1,4369
48183000017,1898,1346,583,249,468,54,6,1,763
48183000014,6923,5121,3913,617,414,141,42,5,1208
48183000016,7103,5314,3785,802,542,141,66,1,1529
48183000010,9775,7146,3589,1679,1630,184,100,6,3557
48183000013,5398,4081,2937,318,682,128,43,4,1144
48183000012,7174,5188,4275,407,244,194,25,6,913
48479000349,6439,4125,260,3726,44,42,100,11,3865
48479000356,8754,6046,326,5597,45,75,76,3,5720
48479000345,2910,2199,106,2054,11,41,19,1,2093
48453000110,14418,10939,4546,2901,2099,304,1256,51,6393
48453000161,4899,3455,1208,1142,830,117,255,25,2247
48491000463,11734,8762,3473,2496,1568,224,1101,35,5289
48237000005,782,619,562,36,1,18,3,0,57
48029004039,2551,1790,71,818,903,88,13,6,1719
48029003017,3316,2450,1817,437,59,49,70,1,633
48029001110,6439,4073,949,2293,624,132,233,39,3124
48029001150,4615,3235,816,1838,385,114,203,21,2419
48029001141,4827,3289,803,1804,528,99,166,25,2486
48029001140,2342,1572,355,913,228,72,63,7,1217
48029001106,0,0,0,0,0,0,0,0,0
48029001101,1,1,0,1,0,0,1,1,1
48029002136,6589,4486,1565,2344,313,131,255,28,2921
48029002101,2239,1669,639,856,81,38,92,1,1030
48029002034,3012,2630,919,1410,294,28,7,2,1711
48029003205,0,0,0,0,0,0,0,0,0
48029004017,3099,2810,939,1579,204,104,70,7,1871
48029002031,3888,2520,74,2380,62,89,7,6,2446
48029002117,1647,1080,59,990,30,32,2,2,1021
48029003084,5175,4087,1874,1752,264,133,152,13,2213
48423000052,3016,2279,1758,175,233,83,20,1,521
482130004PF,677,504,398,21,52,21,3,1,106
48271000004,1087,981,718,203,11,32,11,2,263
48213002PSN,5414,4411,3823,332,53,168,14,4,588
48213002PSS,2085,1738,1523,95,28,76,8,5,215
48183000015,3860,2794,1326,847,549,89,9,1,1468
48061000096,3360,2360,69,2277,7,36,8,1,2291
48061000005,1379,906,23,879,4,10,0,0,883
48061000063,2346,1805,163,1616,4,23,19,4,1642
48061000070,2293,1694,66,1604,8,11,9,1,1628
48201000902,4752,4114,2614,812,255,88,383,2,1500
48201000054,2554,2151,1448,401,88,53,186,4,703
48201000621,2995,2414,680,1085,363,78,280,3,1734
48453000303,4333,3266,2351,489,64,80,268,11,915
48453000241,2722,2240,1693,346,41,45,115,5,547
48465000032,283,244,140,85,0,7,6,3,104
48423000042,5607,4440,3399,372,422,159,72,1,1041
48423000079,5649,4099,3000,339,567,103,73,2,1099
48423000075,4034,3313,3021,136,62,48,31,1,292
48423000055,9727,7432,4097,780,1862,208,524,6,3335
48423000028,6943,4947,3783,450,460,150,89,11,1164
48423000017,1676,1293,1077,89,42,68,13,2,216
48423000005,6850,4984,4000,413,354,163,56,5,984
48423000080,34,32,22,1,6,0,0,0,10
48423000036,6781,5299,1369,1616,2211,115,41,6,3930
48423000003,3538,2785,2147,256,258,57,67,7,638
48423000007,3434,2536,1662,429,350,76,30,6,874
48423000082,127,71,30,32,5,1,0,0,41
48423000081,503,358,89,159,108,12,2,0,269
48423000012,3384,2229,213,969,1036,40,14,0,2016
48423000059,4769,3770,2829,290,332,101,241,14,941
48423000025,2941,2372,1846,210,193,68,55,6,526
48201000722,10266,7139,159,3970,2981,199,47,8,6980
48201000333,5741,4512,3198,765,195,133,204,8,1314
48201000757,15753,10917,779,4370,4811,379,968,26,10138
48201000894,7224,5009,423,1497,2904,142,230,17,4586
48201000466,7183,5729,1725,1752,1540,113,687,7,4004
48201000465,7146,5385,1451,1622,2016,156,276,20,3934
482130004SE,4390,3560,2922,350,135,110,23,2,638
4821300004A,2443,1965,1052,444,384,50,48,7,913
48201000196,680,507,47,348,112,15,9,1,460
48201000928,9,7,0,0,7,0,0,0,7
48201000226,6689,4940,175,4481,157,121,143,10,4765
48201000065,5238,3957,172,3706,65,87,23,3,3785
48201000066,2823,2117,94,1850,153,62,5,3,2023
48201000047,3058,2261,104,1096,1052,67,12,4,2157
48201000900,30,21,6,15,0,0,0,0,15
48201000537,4594,3783,2238,720,263,75,505,1,1545
48201000545,7856,5836,1135,1726,830,78,2161,12,4701
48201000762,5854,4280,837,1799,631,64,1004,5,3443
48201000247,3591,2723,364,298,1702,21,359,15,2359
48201000200,5683,5183,3629,740,214,92,492,4,1554
48201000376,6010,4226,699,2938,504,153,81,3,3527
48201000963,2365,1561,249,1033,212,59,58,4,1312
48201000212,3097,2207,90,1882,234,53,16,6,2117
48201000930,1395,1006,17,715,260,25,10,0,989
48201000094,1978,1358,71,1173,40,21,65,0,1287
48201000301,6246,4461,646,3739,78,106,13,0,3815
48201000304,3359,2650,1479,528,129,66,472,2,1171
48201000148,3717,2877,1786,274,139,48,624,0,1091
48201000789,5405,4294,1730,1159,1027,65,381,8,2564
48201000642,2465,2048,1406,326,134,67,139,4,642
48201000630,10359,7331,424,1471,5176,132,323,5,6907
48231000325,3563,2887,2397,181,152,90,47,5,490
48231000108,3340,2454,1371,621,373,78,21,10,1083
48129000102,420,357,312,20,5,18,1,1,45
48027000312,3358,2451,1758,523,62,71,17,1,693
48109000001,461,382,59,310,6,11,5,2,323
48201000100,4246,3056,705,1969,351,91,25,4,2351
48201000102,4267,3246,427,2320,435,112,28,5,2819
48201000249,6363,4749,2017,1802,757,141,84,14,2732
48201000370,7778,5786,3440,1205,572,127,460,12,2346
48201000297,7293,5375,596,3252,791,210,808,15,4779
48201000561,5919,4523,2089,1756,532,139,62,5,2434
48201000680,262,253,171,30,24,0,21,0,82
48201000918,38,38,14,4,21,0,0,0,24
48201000044,3799,2980,472,2253,187,86,50,5,2508
48201000046,5033,3810,425,2767,542,96,62,4,3385
48201000037,3626,3295,2233,499,171,65,335,6,1062
48201000033,5836,5396,3447,970,231,101,605,14,1949
48041000089,0,0,0,0,0,0,0,0,0
48041000072,50,36,29,5,2,0,1,1,7
48061000097,795,645,65,568,3,17,2,0,580
48061000038,779,650,137,509,1,8,0,1,513
48061000008,1137,788,22,761,5,4,1,0,766
48167000311,4883,3948,1567,818,1494,67,57,3,2381
48167000283,5975,4357,2460,922,612,109,277,10,1897
48167000220,10887,7900,4400,1791,1028,179,562,18,3500
48167000228,4592,3606,2924,483,25,119,39,2,682
48167000159,9683,7120,3778,2540,393,277,225,5,3342
48167000105,687,676,392,166,99,5,23,0,284
48453000422,3230,2724,1925,428,88,67,226,4,799
48041000034,12195,10107,5348,2007,1376,211,1220,20,4759
48041000024,3762,3017,1818,621,251,93,255,10,1199
48423000071,5755,4450,3390,306,381,86,282,3,1060
48423000037,2295,1684,1303,126,175,39,34,3,381
48423000038,4001,3417,2336,319,534,91,153,4,1081
48423000058,4819,3834,2739,279,464,106,245,5,1095
48423000035,4170,3238,1394,384,1331,56,92,1,1844
48423000029,3044,2247,1618,223,334,57,27,3,629
48225000005,1881,1513,1267,66,130,28,16,2,246
48225000006,1698,1340,908,41,337,23,16,0,432
48231000433,6510,4479,1107,2093,1153,185,33,16,3372
48231000104,1489,1155,798,256,48,50,10,6,357
48299000203,3093,2635,2226,273,14,99,20,5,409
48455000021,652,519,439,43,7,31,3,0,80
48455000017,716,522,134,37,338,12,8,2,388
48455000019,1675,1290,972,189,95,38,9,2,318
48227000208,233,158,121,29,1,12,1,0,37
48227000304,1047,748,484,216,13,26,12,3,264
48227000209,0,0,0,0,0,0,0,0,0
48227000034,2707,2114,1326,596,131,38,39,4,788
48227000033,2810,2076,1187,710,112,37,28,3,889
48227000014,460,364,115,220,21,7,3,1,249
48227000024,557,436,352,42,5,5,30,0,84
48035000006,1690,1474,1301,74,20,53,6,2,173
48035000010,2218,1658,1241,290,51,56,13,0,417
48455000003,656,569,527,11,10,18,2,2,42
48455000001,909,717,605,53,35,23,1,1,112
48455000002,1205,1029,909,53,11,39,4,1,120
48455000016,817,612,433,52,120,12,0,2,179
48061000065,7460,4932,401,4491,24,87,7,2,4531
48483000002,891,653,439,204,4,16,1,0,214
48483000008,884,666,468,126,34,36,7,4,198
48483000003,995,755,505,234,4,12,2,0,250
48417000202,795,596,523,52,0,11,4,0,73
48417000406,412,304,255,38,6,6,6,1,49
48261000006,26,16,2,11,0,3,2,2,14
48063002002,3126,2475,1764,438,163,79,31,5,711
48041000009,3130,2730,1641,422,185,56,453,7,1089
48423000040,7019,5355,4326,353,421,130,106,3,1029
48423000074,961,798,627,31,67,7,66,1,171
48423000014,3189,2275,1075,689,429,54,37,3,1200
48423000066,1600,1164,422,523,210,15,1,0,742
48423000002,2193,1493,80,1108,291,63,4,3,1413
48423000041,6170,4356,3506,288,353,124,62,5,850
48029002011,3686,2661,199,2380,80,85,11,3,2462
48029002103,563,395,2,387,5,5,0,0,393
48029002072,4950,3667,1039,2245,242,96,121,18,2628
48029004059,3602,2781,1120,1124,380,71,128,18,1661
48029002137,1983,1600,465,971,101,66,62,4,1135
48029002121,913,710,152,498,30,30,18,0,558
48029002132,0,0,0,0,0,0,0,0,0
48029004041,3580,2625,213,1199,1211,66,17,8,2412
48029004113,1995,1476,177,745,544,26,21,6,1299
48029004082,4418,2908,260,1309,1298,89,91,10,2648
48133000001,4305,3352,2572,578,77,109,40,5,780
48113002941,8372,6189,2969,1148,690,195,1198,16,3220
48113001719,6294,4508,1104,2404,791,192,139,6,3404
48113003038,1221,956,45,255,645,26,12,2,911
48113003037,771,547,21,241,287,9,1,0,526
48113004041,1670,1258,42,815,394,44,8,3,1216
48113002604,5928,4643,1440,487,896,74,1791,11,3203
48113002303,4278,3355,1404,1747,80,130,73,1,1951
482130004BV,1255,987,851,49,50,29,11,0,136
4821300001A,3287,2572,2016,393,46,100,11,1,556
48041000025,1883,1250,104,340,788,28,14,4,1146
48453000206,2731,2630,1578,445,112,45,447,6,1052
48479000402,3303,2301,53,2239,7,24,10,1,2248
48135000403,5997,4346,196,3685,448,99,7,5,4150
48135000109,397,294,202,80,5,10,0,0,92
48135000405,2483,1824,118,1615,94,40,5,1,1706
48135000303,4262,3296,844,2195,187,77,48,13,2452
48135000301,4465,3345,941,2232,108,73,27,4,2404
48275000301,703,544,304,189,33,12,1,0,240
48275000401,923,664,374,212,55,13,5,0,290
48275000302,102,93,78,11,2,1,0,0,15
48191000301,187,138,82,37,13,10,0,0,56
48113002002,1965,1553,926,431,79,54,72,2,627
48113002079,5562,4472,1118,1350,1478,124,449,9,3354
48113002053,5935,5046,1582,1604,1208,108,620,10,3464
48113002078,145,117,22,35,44,6,9,3,95
48113002305,6579,5658,2575,1454,913,135,647,18,3083
48113002056,1572,1341,1101,83,30,8,108,2,240
48113002924,3579,2749,1309,584,574,107,198,1,1440
48113002921,7075,5592,2632,1067,1030,151,769,12,2960
48113003009,3031,2850,1678,429,444,43,264,12,1172
48113003801,1289,922,93,688,132,33,3,0,829
48113003068,6302,4467,132,916,3384,135,37,4,4335
48113001084,4615,3688,868,1259,1478,115,70,0,2820
481090003-3,54,48,21,25,2,0,0,0,27
48423000021,2159,1597,1282,147,84,35,40,1,315
48423000063,320,202,39,63,82,7,13,0,163
48423000032,4728,3567,2484,552,387,105,62,1,1083
48423000064,414,333,158,75,75,14,18,0,175
48423000013,2676,1940,33,572,1328,37,2,2,1907
48213000004,4810,3738,2676,610,327,93,53,6,1062
48029002107,6399,4286,1215,2398,408,103,267,28,3071
48029002065,10040,6797,1536,4238,627,231,406,28,5261
48029002125,5046,3329,1053,1607,405,101,280,25,2276
48029002154,7349,4838,1570,2548,432,145,296,19,3268
48029002093,4101,2975,799,1562,401,90,219,26,2176
48029004002,1901,1446,103,1215,121,43,2,1,1343
48029001130,7,2,0,0,1,0,0,0,2
48029003065,156,132,32,74,17,5,9,7,100
48029003152,4742,3836,1095,1255,322,60,1137,12,2741
48029003019,1495,1213,440,452,115,36,196,5,773
48029002146,255,177,25,132,12,6,5,1,152
48029002111,2491,1956,367,1257,265,69,56,4,1589
48029004026,6892,5124,591,4346,139,162,30,13,4533
48029003173,5264,3855,1588,1574,227,82,435,16,2267
48029004005,2826,2157,333,1552,215,97,46,7,1824
48029002070,4060,2841,88,2682,50,101,6,3,2753
48029001094,6156,3932,583,2786,396,109,170,22,3349
4827700002G,959,738,570,64,72,19,4,0,168
4827700002D,929,722,554,43,89,34,8,0,168
4827700004D,2129,1609,1416,71,51,73,8,2,193
48277002A1A,2012,1544,597,189,714,55,6,1,947
4827700003I,1960,1540,1358,73,29,83,5,0,182
4827700003E,1592,1238,1100,49,11,57,6,5,138
4827700003D,1309,1076,954,29,19,63,1,1,122
48423000019,8102,5849,4635,601,344,153,99,10,1214
48423000076,2657,1888,323,1177,364,56,20,2,1565
48423000046,1990,1502,873,334,224,50,30,3,629
48113003104,7179,5414,905,1366,2975,141,168,9,4509
48113004074,4079,3260,1276,1564,305,149,55,2,1984
48113004521,7016,5359,1622,2180,1045,188,419,28,3737
48113004519,4487,3401,1051,874,897,87,532,4,2350
48113004502,5973,4441,1062,1284,1432,114,630,7,3379
48113004049,0,0,0,0,0,0,0,0,0
48113004505,3782,2836,878,1402,442,83,70,18,1958
48113004113,4604,3330,153,3046,107,170,40,1,3177
48113004061,5707,4175,222,3846,85,191,17,2,3953
48113002073,1257,1004,860,72,20,17,29,5,144
48113001115,3049,2294,584,1510,148,106,17,3,1710
48113001058,3466,2733,1216,1331,101,94,49,1,1517
48113004608,8600,6588,1590,2296,1844,199,832,28,4998
48113004627,10004,9062,3764,1999,1579,164,1596,19,5298
48113004626,4702,3647,1559,1399,203,163,402,15,2088
48113004634,7709,6528,2489,970,1221,111,1779,16,4039
48113004663,0,0,0,0,0,0,0,0,0
48113004000,1998,1455,179,927,237,22,106,0,1276
48113002508,6795,5593,2380,1352,879,135,895,13,3213
48029002156,2825,2551,826,961,267,64,487,10,1725
48029001091,4267,3023,241,2652,78,102,44,1,2782
48029001117,638,497,35,430,18,11,9,0,462
48029004179,4111,3252,1415,1405,232,96,171,4,1837
48029004166,737,514,91,286,120,17,40,0,423
48029004076,7911,5474,961,3201,955,192,377,27,4513
48029004049,5128,3875,773,1613,1082,106,386,25,3102
48029004010,3743,2518,135,1582,815,88,14,0,2383
48029001047,3189,2383,162,2187,33,46,16,2,2221
48363000027,2716,2083,1667,290,53,66,23,9,416
48363000018,273,210,179,17,1,9,2,1,31
48363000003,1126,1006,895,57,3,42,4,0,111
48363000013,958,757,620,79,13,39,8,0,137
48123000303,718,551,386,141,14,15,1,1,165
48423000008,2158,1692,1284,157,213,20,7,3,408
48113002922,8835,6449,3306,1079,1334,200,611,3,3143
48113002927,9371,6810,3076,1448,1446,217,695,17,3734
48029004037,3584,2613,128,1519,962,80,25,9,2485
48029001040,5427,3979,170,3769,34,130,24,3,3809
48029004126,3263,2311,1058,722,389,87,111,12,1253
48029004187,0,0,0,0,0,0,0,0,0
48029002080,2705,2004,306,1602,78,63,7,3,1698
48029004136,1962,1408,524,606,230,46,34,3,884
48029004159,92,54,18,30,5,7,4,0,36
48029004101,1962,1535,564,778,157,49,5,4,971
48029004069,1142,991,514,367,78,35,7,2,477
48029003112,2868,2306,747,1231,221,91,109,14,1559
48029003135,1422,1211,540,519,89,29,53,3,671
48029002053,1972,1576,207,1320,32,49,18,3,1369
48029002045,2653,2199,557,1576,40,66,31,5,1642
48029002006,80,71,9,60,2,0,0,0,62
48029002039,2194,1756,234,1448,53,54,16,3,1522
48029003025,2165,1653,1221,295,38,29,77,2,432
48029001058,5275,3869,791,2927,43,98,80,4,3078
48029001123,1340,960,251,670,15,37,14,3,709
48029002015,3683,2652,75,2546,26,63,7,3,2577
48029001019,2775,1646,189,1366,67,40,25,8,1457
48029004028,3682,2926,412,2386,104,95,42,12,2514
48453000409,2883,2572,1626,684,102,78,118,5,946
48453000442,2897,2473,1273,933,155,106,81,9,1200
48453000433,4794,4306,2212,1361,297,141,395,25,2094
48453000405,2712,2160,939,978,84,89,124,9,1221
48453000427,4313,3414,1232,1538,458,114,125,14,2182
48277003C7G,4677,3570,2347,258,720,177,68,8,1223
48277004A6E,2275,1907,1396,110,247,59,104,5,511
4827700001G,804,616,536,30,10,35,0,0,80
48029004053,3931,2976,949,1366,467,90,185,14,2027
48029004107,1473,1212,476,332,291,46,119,7,736
48029002144,2874,2352,690,1545,58,79,52,2,1662
48029003022,2134,1593,1131,340,49,37,57,6,462
48029003177,0,0,0,0,0,0,0,0,0
4827700002F,314,243,201,24,3,16,3,0,42
4827700001B,235,183,148,12,3,16,1,0,35
48201000271,3599,2737,18,246,2480,25,7,1,2719
48201000786,4029,2863,317,2470,57,66,19,11,2546
48201000331,13247,9000,2882,3237,1896,235,901,27,6118
48201000119,10550,7603,3886,2763,547,262,273,10,3717
48201000919,0,0,0,0,0,0,0,0,0
48473000419,1344,913,576,156,87,14,82,0,337
48201000638,4762,3531,99,1381,1953,131,99,6,3432
48201000754,5145,3414,112,1185,2052,41,107,1,3302
48201000893,27,12,6,6,3,0,0,1,6
48201000706,6392,5156,1426,810,1612,40,1268,12,3730
48201000620,7185,5972,2165,1041,1697,55,1012,4,3807
48201000487,12011,8570,448,4127,1773,216,2157,10,8122
48201000508,11162,8627,492,4271,1202,240,2648,15,8135
48113001720,4897,3786,1452,1621,515,159,135,4,2334
48113004518,6613,4646,960,3051,391,142,180,15,3686
48113004527,4876,3440,563,2745,71,158,34,7,2877
48113001022,4330,4094,2757,599,290,81,347,3,1337
48113001117,2841,2730,2336,169,52,54,104,2,394
48113003609,4670,3572,537,578,2398,63,57,6,3035
4803700002A,1910,1401,349,54,969,27,2,0,1052
4803700001B,2301,1609,467,116,971,62,7,0,1142
4803700008A,1267,955,369,109,454,20,8,0,586
48037000010,2419,1911,1528,63,204,58,53,8,383
4803700005C,6379,4990,3730,254,590,140,281,3,1260
4803700006A,3351,2641,1989,143,363,72,70,3,652
48037000027,1045,841,775,22,4,34,1,0,66
4803700003B,3451,2738,1090,303,1280,64,26,5,1648
48029002046,2709,2248,401,1774,39,126,24,1,1847
48029003082,3779,2939,1309,1225,209,107,134,18,1630
48029003180,1546,1290,642,529,54,22,47,7,648
48029002043,4270,3160,106,2925,113,108,15,3,3054
48275000101,836,667,473,155,22,11,4,0,194
48275000202,545,379,208,126,28,12,1,0,171
48201000195,2680,2145,349,716,1050,23,42,6,1796
48201000993,0,0,0,0,0,0,0,0,0
48201000279,5417,3932,1237,2379,173,136,72,8,2695
48201000302,7384,5274,1328,3756,119,188,43,8,3946
48201000170,5904,4176,1050,2767,297,92,31,3,3126
48201000673,4248,3423,2421,826,49,86,53,3,1002
48371000009,349,229,102,113,1,12,5,2,127
48113002308,1722,1508,556,251,293,27,377,0,952
48113002302,4043,3129,664,2129,143,145,122,0,2465
48113002310,3186,2588,1425,818,80,121,194,2,1163
48113002055,5351,4004,852,2019,948,101,158,15,3152
48113001503,5206,4013,1084,446,1229,66,1210,5,2929
48113001026,910,754,349,108,222,22,61,2,405
48113001705,4233,3136,790,1213,471,89,626,5,2346
48309000058,6844,5020,2448,1274,1139,153,53,4,2572
48309000009,2481,1748,393,913,413,84,14,1,1355
48231000215,11597,8109,5757,1513,400,346,138,14,2352
48123000201,725,555,361,157,30,11,3,2,194
48113001040,6766,5140,1282,1292,2366,97,168,7,3858
48113001128,773,622,542,35,14,20,9,0,80
48113001039,860,587,40,178,360,10,11,0,547
48029003067,1788,1453,800,557,32,27,44,0,653
48029001030,485,290,34,206,43,9,10,2,256
48029001035,9990,9174,5171,1519,2166,67,436,22,4003
48029003150,55,35,4,29,0,6,5,0,31
48029001016,1976,1514,59,1443,11,24,9,1,1455
48029001097,1488,1137,59,1072,15,38,3,0,1078
48029001112,10270,6963,1048,4843,869,176,253,32,5915
48029001148,2211,1453,266,1019,160,67,23,3,1187
48029001142,4503,2954,418,2202,257,84,104,14,2536
48029001136,493,334,66,228,37,17,14,2,268
48029001082,8529,6183,1132,4362,485,216,214,29,5051
48029001071,3394,2480,477,1719,194,82,78,7,2003
48029001033,4788,3375,504,2662,142,102,50,13,2871
48029001132,0,0,0,0,0,0,0,0,0
48029001131,0,0,0,0,0,0,0,0,0
48029003099,5237,3709,1425,1464,166,62,641,14,2284
48029003189,1549,1116,451,355,81,35,213,5,665
48029003188,0,0,0,0,0,0,0,0,0
48029003168,795,603,222,208,38,6,135,1,381
48029003198,1112,788,278,273,18,11,209,0,510
48029003169,233,189,96,78,7,8,8,0,93
48029003158,151,101,30,46,12,7,10,0,71
48029003185,409,305,107,154,28,12,21,0,198
48029003191,310,237,111,84,0,7,38,0,126
48029003186,0,0,0,0,0,0,0,0,0
48029003190,802,641,203,294,59,17,72,0,438
48029003187,0,0,0,0,0,0,0,0,0
48029004050,2368,1969,957,689,210,51,82,5,1012
48029004175,0,0,0,0,0,0,0,0,0
48029001146,402,313,64,226,7,22,10,1,249
48029001092,2744,1736,100,1550,75,43,9,2,1636
48029001062,441,306,54,236,9,11,10,0,252
48029001114,296,183,10,168,5,7,2,0,173
48029001064,2567,1883,302,1546,24,67,14,1,1581
48029001006,4005,3089,153,2894,26,110,13,2,2936
48029004001,4726,4485,2188,1642,294,135,256,14,2297
48029002051,1312,1226,406,619,119,41,68,2,820
48283000006,580,431,76,351,2,7,0,0,355
48283000003,1244,894,79,808,3,14,2,0,815
48335000001,1790,1289,802,416,32,29,16,1,487
48335000046,856,600,357,192,29,16,10,0,243
48317000004,875,614,380,202,21,10,3,1,234
48299000109,3328,3105,2826,154,19,67,28,0,279
48027000202,11755,8699,4251,1659,1924,340,547,196,4448
48417000405,274,218,193,20,0,4,4,0,25
48027000315,13596,9330,5715,1953,1075,244,430,38,3615
48027000104,11616,8454,6462,1078,385,258,310,26,1992
48027000311,4461,3546,2771,512,89,142,41,5,775
48027000110,10120,8149,4191,1918,1410,224,451,134,3958
48027000204,6914,5194,1675,1289,1867,179,270,100,3519
48113002711,5587,4408,1699,678,907,54,1045,7,2709
48113004119,3,0,0,0,0,0,0,0,0
48113004087,6747,4564,241,3942,349,109,30,5,4323
48113004120,5397,3766,88,3516,141,105,19,3,3678
48113003066,4744,3159,61,1295,1791,117,7,4,3098
48113002200,2208,1665,1484,65,20,33,55,1,181
48113002810,75,56,30,15,4,4,6,0,26
48113004636,16,9,7,1,1,1,1,0,2
48439003706,4967,4395,2603,739,494,115,464,28,1792
48113002910,321,228,70,142,4,14,7,0,158
48113004633,5358,3900,447,412,637,45,2406,5,3453
48363000025,232,184,127,35,13,9,3,1,57
48363000024,315,239,177,44,8,5,6,1,62
48363000005,633,513,352,143,6,9,3,0,161
48233000031,2291,1722,1416,183,16,107,6,1,306
48085000049,2794,2301,1800,191,93,78,153,9,501
48085000138,1471,1188,982,95,29,20,52,5,206
48085000055,9561,8867,4067,931,629,106,3174,8,4800
48085000218,6414,4483,1897,288,374,65,1835,6,2586
48085000120,4945,3633,2461,285,204,57,616,4,1172
48085000127,5535,4261,2495,594,455,114,648,4,1766
48085000030,6965,5192,3136,1037,483,155,384,17,2056
48085000229,2415,1746,883,282,289,49,232,8,863
48085000092,6619,5244,2669,1332,750,143,379,9,2575
48085000018,1478,1121,803,221,19,76,20,4,318
48085000183,108,80,70,4,0,5,0,0,10
48085000188,240,183,104,44,13,18,8,0,79
48085000184,0,0,0,0,0,0,0,0,0
48085000181,4165,2846,1685,630,365,114,74,8,1161
48085000102,2942,2314,1900,143,75,73,107,0,414
48085000204,468,355,236,46,33,10,34,2,119
48085000149,6307,4416,2730,532,550,94,522,12,1686
48085000236,3900,2841,1985,256,218,81,301,6,856
48085000189,1372,1042,719,222,19,56,22,0,323
48085000010,1061,781,583,142,8,28,13,1,198
48085000228,9245,6148,2720,1846,1117,183,362,13,3428
48085000215,4145,2942,1789,844,164,126,52,6,1153
48085000009,5686,4006,2144,976,634,123,157,15,1862
48085000198,186,140,98,35,2,4,1,0,42
48085000191,1136,826,440,333,7,39,13,1,386
48085000028,3727,3068,1790,317,333,67,555,3,1278
48437000011,500,392,216,146,18,10,6,2,176
48437000001,1514,1247,497,579,155,18,2,1,750
48437000004,894,629,189,351,80,21,6,2,440
48299000307,5585,4443,3473,691,77,203,32,6,970
48299000108,998,944,861,28,8,31,5,2,83
48201000005,1848,1594,1170,317,28,49,57,0,424
48201000026,3563,2894,642,1919,181,94,136,3,2252
48201000010,3587,2902,332,2379,127,121,55,2,2570
48201000710,3392,2958,2040,412,120,36,323,1,918
48201000217,3673,2871,2116,350,101,49,272,0,755
48201000748,4479,3478,1367,1117,644,105,329,6,2111
48201000840,3372,2466,466,1156,776,53,63,17,2000
48201000767,268,204,40,136,17,14,8,1,164
48201000520,13344,9328,787,2555,5829,213,190,26,8541
48201000883,13817,9657,614,5386,3432,383,281,11,9043
48201000496,4960,3591,451,2411,430,139,294,1,3140
48201000601,5547,4158,2750,585,392,113,346,6,1408
48201000349,3177,2496,1157,720,435,86,143,6,1339
48201000845,837,750,392,159,157,13,40,0,358
48201000742,5652,4332,2242,620,426,61,982,4,2090
48027000105,2732,1958,1501,318,24,82,35,9,457
48029001022,1643,1231,34,1194,6,22,4,0,1197
48029001023,4531,3381,96,3231,26,56,8,4,3285
48029001127,1082,814,42,766,10,28,4,2,772
48029001147,4408,3128,667,1969,321,96,177,16,2461
48029001079,4942,3603,797,2131,462,102,223,44,2806
48029001052,3632,2641,317,2250,34,82,28,2,2324
48029001026,2489,1821,83,1713,16,56,7,3,1738
48029002017,2364,1731,38,1671,17,33,5,5,1693
48029003148,2062,1361,687,407,80,40,183,8,674
48029004086,1022,775,313,425,15,31,11,2,462
48029003002,3353,2611,905,1522,122,87,66,8,1706
48029002013,2121,1620,94,1477,33,44,21,2,1526
48029001056,7039,4766,442,4094,155,126,67,13,4324
48029001054,4349,3222,384,2757,31,92,26,2,2838
48029003046,1672,1365,886,375,28,21,55,5,479
482130001MN,1943,1622,1366,84,73,65,10,1,256
48041000065,341,255,183,25,17,12,20,2,72
48041000071,172,112,85,11,2,4,3,0,27
48041000051,0,0,0,0,0,0,0,0,0
48041000050,21,11,7,1,0,0,3,0,4
48041000032,12,9,3,2,0,0,6,0,6
48201000746,1781,1462,649,406,182,51,185,0,813
48201000002,2940,2641,1540,592,222,68,241,5,1101
48201000505,9362,7328,2402,3426,1174,202,206,20,4926
48201000448,4462,3441,2388,698,107,93,173,6,1053
48201000270,7966,6009,2112,2955,744,138,162,10,3897
48201000500,6754,5153,2417,1276,924,162,494,7,2736
48201000110,5211,4035,1521,1067,987,109,387,18,2514
48201000246,7505,5699,2278,1393,1151,137,823,12,3421
48201000912,2824,2127,714,722,521,62,136,1,1413
48201000550,7443,5538,1193,1764,2407,166,166,9,4345
48095000306,506,396,232,139,9,16,6,1,164
48095000408,1444,1336,791,467,68,5,14,2,545
48095000205,275,239,153,76,3,6,3,1,86
48113003702,6499,5013,1991,1136,1412,141,391,9,3022
48113001087,7216,5249,373,2402,2332,81,145,8,4876
48113003069,2441,1816,49,284,1467,40,14,2,1767
48113003099,467,356,10,137,205,11,3,1,346
48113001074,3091,2387,265,1994,78,78,25,6,2122
48113001714,5295,3720,978,2468,177,163,55,5,2742
48113002402,5407,4448,1584,907,409,139,1476,6,2864
48117000004,4618,3126,678,2389,42,76,11,1,2448
48013000022,989,742,416,292,5,21,5,0,326
48029001013,4354,3297,123,3143,35,139,7,3,3174
48029001086,4311,3137,508,2278,246,95,94,18,2629
48029001043,2774,2088,252,1705,88,63,49,2,1836
48029004065,8935,6267,933,3795,1370,211,220,41,5334
48029004161,1568,1191,173,460,485,40,87,11,1018
48029001120,409,255,12,222,24,6,4,1,243
48029001003,3399,2888,669,2052,72,89,81,7,2219
48029004081,1280,828,455,140,171,37,47,9,373
48029002004,6181,4438,220,3963,219,94,38,8,4218
48027000314,6726,5321,2767,1561,762,152,162,13,2554
48027000206,3332,2309,714,445,926,84,150,70,1595
48027000408,14429,9962,2565,2342,4166,319,775,248,7397
48129000201,903,668,568,42,26,25,12,1,100
48129000303,398,315,255,34,11,18,3,0,60
48129000101,383,346,263,49,25,8,0,0,83
48029003076,1513,1226,889,271,33,11,32,0,337
48029003130,2165,1686,1120,428,29,35,98,5,566
48029002142,1611,1218,258,819,87,66,32,2,960
48029004007,7421,5904,3005,1205,1158,133,503,67,2899
48029004093,4506,3420,1223,1672,370,103,92,18,2197
48029004148,270,210,62,135,12,4,4,0,148
48029004080,4549,3303,713,1896,599,116,72,14,2590
48029001010,910,765,121,612,23,40,6,3,644
48029001001,1026,891,307,528,22,26,26,2,584
48029001095,881,637,343,119,109,21,54,15,294
48029001135,8,5,0,1,4,1,0,0,5
48029001128,5399,4347,977,2662,630,68,67,2,3370
48029001134,17,5,1,4,2,2,1,0,4
48029001133,74,49,6,33,10,10,4,1,43
48029001038,6295,4499,537,3649,218,104,86,7,3962
48029002041,4356,3354,216,2967,146,114,28,7,3138
48029003078,4001,3183,1720,1158,138,88,126,4,1463
48029004048,3507,2681,247,2336,52,103,49,7,2434
48029002050,3103,2347,417,1788,103,69,31,0,1930
48029002049,5639,4214,455,3393,318,89,72,9,3759
48085000221,7160,5024,3617,512,483,99,323,8,1407
48085000196,3162,2187,1227,263,310,45,357,2,960
48085000175,2771,1949,1177,183,169,56,365,1,772
48085000044,3878,2882,1143,1364,267,129,33,2,1739
48085000001,4198,3270,2074,776,291,81,59,9,1196
48085000224,3525,2438,1861,166,158,53,194,6,577
48085000214,5812,3887,3112,218,254,73,223,9,775
48085000239,6673,4249,2855,442,490,109,375,5,1394
48085000128,6693,4699,3652,376,167,140,339,2,1047
48085000168,2574,1721,1246,103,71,44,253,2,475
48085000041,7273,4986,3245,521,424,126,674,14,1741
48085000003,6624,4774,940,2701,1006,196,75,14,3834
48085000148,0,0,0,0,0,0,0,0,0
48085000179,5328,4314,3721,212,50,95,200,5,593
48085000098,3201,2494,1212,1011,182,55,73,8,1282
48085000220,9252,5856,1702,538,683,88,2849,14,4154
48085000212,9623,5841,1538,207,403,54,3622,3,4303
48085000134,10404,7070,3071,745,1104,145,2012,25,3999
48085000225,6520,4394,1480,350,759,81,1747,9,2914
48309000081,6095,4575,3864,446,66,138,19,11,711
48309000044,8707,6025,4490,750,477,150,164,13,1535
48309000080,3233,2446,2114,180,53,67,13,0,332
48309000051,7850,6068,3902,899,715,174,405,23,2166
48309000011,2718,2122,1611,245,153,59,63,0,511
48309000032,1608,1300,1007,171,106,27,8,0,293
48309000017,1665,1274,632,305,290,26,17,4,642
48309000087,4483,3173,1112,1534,457,123,18,2,2061
48231000216,3476,2594,1938,455,83,91,19,9,656
48231000322,2395,1834,1332,336,21,134,9,3,502
48231000214,5886,4512,3554,650,68,189,42,7,958
48231000427,6594,5408,2885,495,1512,315,220,54,2523
48231000426,966,731,566,108,14,31,3,7,165
48231000434,1846,1466,1219,154,28,55,11,1,247
48231000318,1097,830,683,96,11,40,10,2,147
48231000320,4802,3738,3026,433,47,183,36,2,712
48231000105,1843,1265,648,464,122,53,8,4,617
48231000431,794,613,361,176,53,20,2,2,252
48231000430,1317,940,592,231,70,40,13,3,348
48113001717,6886,4849,1371,2217,993,178,207,10,3478
48113001722,6614,4758,1181,1913,1329,130,295,4,3577
48113002406,5804,4867,2127,1002,999,162,642,5,2740
48085000084,3625,3059,1781,416,566,64,226,1,1278
48029001039,8087,5413,304,4945,156,133,38,5,5109
48029001068,5413,3564,733,2429,271,120,93,18,2831
48029002066,4872,3697,1472,1876,180,106,163,4,2225
48029001044,3117,2420,116,2263,35,60,12,2,2304
48029004057,1950,1613,996,332,137,49,110,5,617
48029004144,703,600,356,172,46,22,14,2,244
48029004105,2852,2158,948,882,210,63,123,9,1210
48029002064,3969,3073,626,2327,70,75,29,11,2447
48029002110,2225,1652,434,1088,92,50,44,1,1218
48029003184,623,478,163,303,8,4,4,0,315
48029004031,3489,2576,212,2225,128,75,21,1,2364
48029004051,2169,1875,1037,546,183,50,80,14,838
48135000406,6898,4922,786,3833,292,101,24,1,4136
48231000217,2156,1764,1471,206,21,53,16,3,293
48309000033,2168,1683,1228,235,134,34,49,3,455
48199000001,2355,1797,1271,92,352,42,25,1,526
48083000001,1965,1621,1308,199,43,56,15,5,313
48469000010,2708,2095,1079,767,172,30,61,1,1016
48469000031,1732,1337,521,629,162,32,23,2,816
48469000002,1588,1352,561,664,104,39,9,1,791
48469000014,2148,1641,909,651,67,31,3,2,732
48469000034,2266,1649,176,1222,253,29,3,3,1473
48469000004,3389,2365,351,1750,237,51,22,2,2014
48199000005,875,697,653,16,11,14,4,0,44
48199000008,1072,862,790,31,2,27,3,2,72
48239000006,1385,1002,463,444,59,26,19,2,539
48239000003,3113,2433,1665,519,148,50,32,0,768
48225000007,1276,977,762,71,104,39,10,2,215
48225000019,890,729,572,19,119,13,1,1,157
4800700001A,3036,2431,1519,755,41,103,20,1,912
48169000006,169,153,137,15,0,2,0,0,16
48169000005,166,131,104,23,0,2,2,0,27
48169000004,839,584,173,351,50,11,1,1,411
48169000002,1072,813,554,226,26,10,4,1,259
48169000003,2772,2489,416,1912,154,13,23,3,2073
48225000004,2938,2275,1340,386,495,55,33,8,935
48225000021,465,370,274,23,63,15,1,2,96
48113001716,3116,2525,1632,489,243,76,101,3,893
48113002003,3329,2690,1920,394,157,32,177,4,770
48113002007,3820,2819,2371,164,73,45,149,1,448
48113001032,2149,1438,525,626,221,24,49,0,913
48113002052,1684,1287,1065,76,26,30,74,1,222
48113002408,5635,4202,896,2598,331,183,357,4,3306
48113002411,2573,1902,187,1595,72,64,60,0,1715
48085000075,2709,2302,1555,233,135,27,350,10,747
48085000105,1911,1546,964,152,155,30,249,4,582
48085000143,2902,2487,1576,253,220,30,379,2,911
48085000050,7933,5723,1489,1761,929,126,1495,15,4234
48085000051,3696,2840,876,1447,302,127,190,2,1964
48085000158,4587,3337,1230,225,410,40,1423,4,2107
48085000045,4414,3594,2322,380,471,68,360,6,1272
48085000147,3629,2711,1358,357,497,49,468,4,1353
48085000238,7051,4900,2102,592,1022,103,1142,14,2798
48085000038,9778,7734,3612,803,1125,188,2054,29,4122
48085000230,8997,6483,2865,697,1174,92,1641,11,3618
48085000206,3014,2061,1365,192,195,34,261,9,696
48085000211,5209,3554,2224,349,444,85,440,11,1330
48085000169,5933,3950,1822,408,510,67,1149,6,2128
48085000157,6227,4265,1905,283,291,76,1730,5,2360
48085000192,3887,2753,1922,536,132,106,44,4,831
48085000035,2577,1920,1306,472,43,78,27,3,614
48085000193,1903,1425,1026,265,27,80,30,3,399
48085000200,0,0,0,0,0,0,0,0,0
48085000069,5071,4024,2542,329,259,85,800,11,1482
48135000306,3805,2758,534,1893,215,62,81,19,2224
48117000002,4598,3185,607,2490,40,103,12,5,2578
48029001098,1543,1195,75,1077,18,41,19,4,1120
48029001074,52,37,3,34,0,2,0,0,34
48029003020,3332,2725,2052,522,45,34,84,3,673
48029003178,1,1,0,1,0,0,0,0,1
48029002097,4187,3118,836,1990,229,104,52,7,2282
48029002088,5949,4575,1183,2907,310,156,171,9,3392
48469000013,2384,1676,376,1183,90,42,6,0,1300
48469000027,2384,1733,1402,249,19,40,7,3,331
48469000003,1815,1469,718,660,64,29,10,2,751
48199000015,2973,2264,1886,137,104,69,30,5,378
48199000016,3680,2774,2427,173,30,93,18,7,347
4808300002E,507,399,332,52,2,12,0,0,67
48083000003,1877,1452,1119,236,36,68,13,3,333
48469000026,1680,1230,745,414,37,18,7,0,485
48469000015,173,140,82,50,4,7,0,0,58
48469000018,5893,4587,2889,1424,154,163,17,1,1698
48469000019,4993,3678,1460,1750,278,68,164,5,2218
48113003900,11473,8042,1121,2024,4790,203,77,10,6921
48113001305,4116,2831,663,1847,274,115,26,0,2168
48113001141,0,0,0,0,0,0,0,0,0
48113001065,7996,5342,593,2608,1962,270,161,0,4749
48113004040,1358,1004,24,521,455,26,4,0,980
48113003008,10316,9590,5115,1435,2145,282,769,22,4475
48113002704,6954,5455,1751,1086,1089,138,1460,8,3704
48113002805,5792,4207,2248,445,236,59,1219,5,1959
48113002911,988,673,163,92,69,12,341,2,510
48113002808,5458,3730,1662,347,122,45,1544,7,2068
48113002806,4463,3211,1670,400,208,72,875,4,1541
48309000078,5531,4164,2842,909,258,124,45,6,1322
48309000063,5802,4197,3449,318,186,86,149,3,748
48309000073,1614,1199,1000,121,20,37,4,0,199
48309000023,4177,3039,2557,201,85,76,118,10,482
48309000082,3793,2975,2433,349,56,89,36,4,542
48309000003,10963,10060,5976,1569,1020,237,1383,37,4084
48309000021,2334,2071,1206,295,223,32,191,3,865
48113004624,4356,3192,961,1925,189,162,92,9,2231
48113004516,654,563,149,248,169,4,1,0,414
48113004091,23,14,4,7,3,5,2,0,10
48113004637,9207,7099,1871,646,785,86,3725,19,5228
48113004647,6105,4767,1658,496,453,77,2078,7,3109
48113004635,6088,4428,676,439,487,50,2782,7,3752
48113003110,4545,3315,367,555,2320,74,60,5,2948
48113003103,4901,3517,444,656,2357,54,58,8,3073
48113003607,5049,3876,304,355,3150,46,68,6,3572
48113001102,6127,4109,331,3400,355,174,13,8,3778
48113004014,2394,1872,1524,174,43,44,85,4,348
48113004099,1555,1360,962,187,92,17,89,0,398
48113001011,4095,2933,361,1616,700,107,258,2,2572
48351000003,761,579,539,8,12,21,2,0,40
48351000006,1017,784,419,21,326,13,4,0,365
48201000768,3719,2776,1949,470,172,75,124,1,827
48201000691,7183,5043,2972,1176,416,144,400,8,2071
48097000011,4356,3215,2330,681,41,137,22,4,885
48097000020,492,415,343,43,9,20,3,0,72
48309000014,3555,3058,747,637,1625,57,48,4,2311
48309000089,182,147,16,94,30,9,4,0,131
48309000086,3981,2882,1199,796,816,76,26,6,1683
48309000060,8002,5864,3867,982,606,156,251,8,1997
48309000075,4530,3391,2825,368,38,101,47,4,566
48309000059,5472,4124,3144,606,177,116,62,6,980
48309000019,4318,3307,2423,427,264,49,133,5,884
48037000021,407,330,249,13,50,17,0,0,81
4803700004B,2834,2233,1394,96,650,52,55,4,839
4803700003A,2382,1767,1148,115,413,70,20,4,619
4803700006B,2741,2119,1620,87,233,71,99,0,499
48037000011,3579,2712,2272,97,177,121,35,8,440
48201000015,4111,2941,2216,251,29,34,395,5,725
48201000144,1616,1217,27,336,832,26,19,4,1190
48201000013,7296,5348,1979,2268,878,152,119,13,3369
48201000740,2952,2017,495,1122,359,44,21,2,1522
48201000028,8793,6748,2662,2118,1444,155,423,9,4086
48201000021,1685,1481,531,269,511,33,162,2,950
48201000067,10537,7582,387,6447,731,238,64,13,7195
48201000221,6235,4612,542,3934,69,148,54,1,4070
48201000231,6632,4818,368,4092,292,143,69,4,4450
48201000109,5554,3705,98,844,2729,69,41,7,3607
48201000739,7205,5067,1240,2348,1373,130,102,11,3827
48201000348,4420,3555,1462,1623,269,103,137,7,2093
48201000368,2143,1496,176,805,498,28,27,1,1320
48201000598,12910,8835,1522,4197,2226,313,843,10,7313
48201000149,18854,12661,5029,3128,2279,245,2068,26,7632
48201000624,2313,1570,828,418,215,51,82,1,742
48201000923,6634,4449,2614,675,392,115,681,5,1835
48201000790,6322,4317,713,2135,1087,106,425,32,3604
48201000242,5959,4191,716,3167,230,180,36,5,3475
48201000451,3690,3099,2239,373,310,56,126,7,860
48201000513,4118,3305,2049,472,491,84,214,2,1256
48309000062,10011,7759,5179,1222,869,170,331,18,2580
48309000055,1898,1356,1109,127,48,39,21,2,247
48309000027,2762,1802,389,617,747,58,37,3,1413
48309000057,2806,2238,1104,698,299,73,80,2,1134
48309000076,3857,2999,2278,497,64,79,31,2,721
48309000079,3102,2211,1257,738,138,113,14,4,954
48097000034,1460,1074,343,563,115,42,18,2,731
48097000035,2526,1782,959,579,189,59,10,1,823
48013000014,608,473,199,258,1,9,4,0,274
48013000006,162,124,93,27,0,0,0,0,31
48013000013,4248,3080,1394,1576,23,64,17,4,1686
48013000019,692,517,238,246,9,21,2,0,279
48029002033,4272,4034,678,2792,585,36,10,2,3356
48029003108,1889,1506,916,432,92,60,40,1,590
48029003157,3313,2697,1611,819,134,82,82,7,1086
48015000415,2324,1763,1004,528,200,43,9,2,759
48503000005,4361,3317,2703,469,37,90,25,0,614
48503000024,3524,2634,1780,741,25,87,12,3,854
48503000022,4626,3602,3074,362,37,130,19,1,528
48015000209,801,662,546,69,27,16,0,0,116
48293000202,1439,1026,208,309,509,15,3,1,818
48503000010,650,481,405,46,4,19,2,0,76
48503000007,220,158,130,10,1,13,2,0,28
48015000416,2438,1766,916,672,104,76,25,6,850
48437000002,1637,1173,584,510,54,32,2,1,589
48299000204,1019,930,839,46,5,25,10,0,91
48033000004,184,142,124,18,1,0,1,2,18
4803300002A,110,74,57,17,0,0,0,0,17
48363000028,2090,1530,1014,436,39,51,1,2,516
48029004061,5726,4027,758,2289,899,131,102,13,3269
48029001034,7595,4875,1716,2027,780,176,291,29,3159
48029001116,2298,1675,573,859,177,63,59,3,1102
48029001125,3469,2417,778,1232,294,62,133,18,1639
48029001103,1909,1352,453,724,84,55,60,11,899
48029001118,7950,5157,1581,2489,787,168,281,35,3576
48029001081,4025,3252,1870,924,349,72,130,12,1382
48029004044,2821,2207,637,1131,360,56,71,9,1570
48029004120,599,525,158,178,100,14,80,4,367
48029004117,700,554,287,225,29,12,8,4,267
48029004046,3955,3346,1752,940,450,98,178,20,1594
48029004210,36,23,8,11,3,5,0,0,15
48029004029,4311,3219,248,2536,445,131,35,9,2971
48029004018,1233,1082,605,422,24,32,23,4,477
48029004192,2,1,1,0,0,0,0,0,0
48029004142,1560,1215,172,432,577,16,34,1,1043
48029004154,1185,915,225,539,75,41,67,8,690
48029004047,5755,4115,919,2503,553,132,135,27,3196
48029001063,4227,3002,624,2268,45,85,24,1,2378
48029001072,3382,2611,471,1654,392,82,104,11,2140
48029003096,4450,3288,1843,1022,137,74,230,11,1445
48029003210,4881,4217,1816,1698,336,86,326,15,2401
48387000027,530,437,393,14,12,9,10,0,44
48387000024,220,195,168,14,7,5,0,0,27
48327000002,485,383,246,122,5,11,2,2,137
48327000004,339,256,162,84,6,4,0,1,94
48327000001,424,350,142,192,7,9,2,4,208
48437000006,568,412,173,212,17,18,2,2,239
48037000013,217,182,149,10,11,7,1,0,33
48037000014,4921,3786,2531,179,865,153,53,7,1255
48037000030,2475,1843,1336,138,282,61,14,2,507
48037000016,1985,1507,1351,30,74,39,6,0,156
48037000018,6300,5440,2717,1032,1514,132,37,13,2723
48067000001,4393,3574,2700,167,557,120,20,7,874
48029003115,2107,1761,1075,560,34,39,76,5,686
48029003070,3044,2527,1391,882,127,55,112,17,1136
48029003075,3430,2804,1903,681,34,50,156,2,901
48029003086,2227,1790,1041,597,61,40,72,0,749
48029003196,18,15,7,7,1,1,0,0,8
48029003165,5752,4152,2049,1378,229,112,442,29,2103
48029001007,2078,1616,76,1512,10,54,8,1,1540
48029004074,4059,3024,966,1939,49,111,29,3,2058
48029004180,8,4,0,3,0,0,1,0,4
48029004165,177,147,87,58,2,3,0,0,60
48029004129,206,174,66,99,3,15,2,0,108
48029004202,5,5,3,2,2,0,0,0,2
48029001057,5964,4155,873,3123,101,123,37,5,3282
48029001049,5228,3916,318,3526,56,116,18,4,3598
48029001050,2411,1805,241,1509,24,31,28,5,1564
48029004141,1156,688,41,437,216,21,3,2,647
48029004030,1008,677,21,435,222,12,2,0,656
48029003125,5807,4022,1827,1237,328,119,622,14,2195
48029003199,5392,3883,1772,1329,315,100,395,7,2111
48029004064,3831,2938,935,1500,415,77,93,21,2003
48029003088,5893,4575,2267,1406,368,108,496,19,2308
48029003124,6704,5282,2355,1793,694,110,413,32,2927
48029003181,3498,2575,1321,804,143,68,254,13,1254
48029003197,0,0,0,0,0,0,0,0,0
48309000077,2806,2103,1564,367,97,59,11,5,539
48309000010,5334,3614,461,1498,1661,104,13,2,3153
48309000008,2649,1966,781,808,340,74,25,2,1185
48309000065,2040,1552,1236,176,74,44,6,0,316
48311000003,159,130,99,27,4,2,3,0,31
4831100004A,62,56,34,20,1,1,1,1,22
48361000006,2242,1783,1506,110,87,69,24,0,277
48361000003,2257,1725,403,154,1124,36,23,0,1322
48361000028,4251,3091,2690,224,26,88,57,1,401
48159000402,1061,868,712,88,9,54,6,1,156
48029003052,7624,5655,2426,2133,433,141,632,9,3229
48029001045,7715,5349,377,4774,124,143,60,10,4972
48029004072,4254,3413,1944,1186,150,98,46,7,1469
48029004212,7,7,1,4,0,0,0,0,6
48029004038,4246,3393,1892,1057,242,111,135,3,1501
48029002105,1166,852,33,797,22,20,5,5,819
48029002075,2372,1700,48,1581,71,65,10,4,1652
48029004104,3739,2740,955,1364,258,100,152,15,1785
48229000001,1366,1271,729,517,8,17,19,1,542
48017000001,1650,1155,508,622,9,23,0,2,647
48017000004,1747,1180,202,951,13,20,3,0,978
48017000003,1753,1196,341,831,10,37,1,0,855
48293000205,934,656,282,230,131,21,3,0,374
48503000023,3549,2709,2017,506,81,76,22,8,692
48503000020,338,265,235,16,2,8,2,0,30
48387000003,1574,1272,659,77,488,29,14,3,613
48387000001,130,93,64,3,23,2,0,0,29
48159000102,720,556,463,57,9,24,2,1,93
48387000021,189,164,124,3,31,5,0,0,40
48387000005,1555,1204,1066,43,27,61,6,1,138
48309000066,1980,1563,1324,151,27,40,3,2,239
48309000042,2623,1887,478,969,419,53,5,1,1409
48309000038,1477,1056,415,407,204,29,11,1,641
48309000088,1477,1046,440,394,191,63,4,3,606
48309000012,6024,4163,445,521,3178,73,13,4,3718
48309000030,3654,2721,1359,814,477,93,33,2,1362
48309000026,1851,1437,554,613,242,40,27,1,883
48309000025,4433,3177,776,1995,338,91,44,7,2401
48309000072,1415,1100,828,140,106,30,2,1,272
48309000053,1891,1642,996,318,269,32,21,20,646
48129000401,839,651,486,68,75,24,10,7,165
48129000301,315,254,205,19,13,18,3,0,49
48333000009,870,674,509,129,8,22,4,0,165
48333000001,1139,924,743,150,7,27,4,0,181
48333000002,809,647,495,117,7,25,5,1,152
48013000004,203,160,66,85,4,6,3,0,94
48013000012,2271,1679,499,1136,25,35,15,0,1180
48201000657,3255,2502,471,1142,756,60,126,18,2031
48201000783,2518,1638,47,909,658,40,42,4,1591
48201000399,10254,7170,1130,2956,2934,203,135,47,6040
48201000283,21999,14658,698,8127,5446,572,469,50,13960
48029002069,6117,4761,801,3236,491,169,219,18,3960
48029002008,2202,1712,95,1570,44,25,5,3,1617
48229000002,920,650,41,605,2,19,0,0,609
48017000002,1754,1307,731,542,9,24,6,0,576
48341000201,3017,2134,1055,872,63,62,105,0,1079
48341000401,1879,1312,717,542,14,71,8,0,595
48341000301,4826,3459,839,2308,90,210,147,2,2620
48395000006,2469,1844,1405,157,237,41,15,2,439
48395000002,2498,1805,839,558,387,43,4,2,966
48395000007,184,144,60,50,28,12,0,0,84
48395000022,1812,1330,227,290,795,43,7,4,1103
48395000011,1804,1398,921,330,97,40,2,0,477
48469000005,5041,3880,1013,2372,389,83,51,1,2867
48043000003,488,414,245,159,0,7,3,0,169
48043000001,2698,2125,1350,617,40,82,50,4,775
4822300003A,2945,2332,1718,356,177,55,32,7,614
48253000303,1614,1242,1133,53,2,48,3,3,109
48253000301,373,300,254,29,8,9,0,0,46
48253000401,2153,1627,1414,131,16,46,15,0,213
48253000302,6341,6045,2401,2035,1561,32,37,1,3644
48253000103,1005,732,415,280,17,15,5,1,317
48253000203,572,495,219,234,20,2,20,0,276
48253000402,1901,1426,997,344,38,49,7,3,429
48253000101,2102,1596,1031,436,97,52,7,1,565
48253000201,2657,2031,1277,570,139,34,11,1,754
48137000001,341,276,78,190,1,6,2,1,198
48137000004,315,250,90,154,1,8,3,0,160
48137000003,397,302,188,99,3,15,4,5,114
48137000002,369,312,214,85,9,10,5,2,98
48031000302,1504,1262,999,195,5,39,18,0,263
48031000303,671,602,503,73,6,13,3,1,99
48363000022,1382,1080,905,115,6,39,8,3,175
4832300001A,1389,994,25,957,0,12,3,0,969
4832300002A,1222,887,21,863,1,7,3,0,866
4832300001B,3634,2757,115,2592,13,40,34,0,2642
4832300004B,4840,3404,155,3201,18,50,33,1,3249
48461000004,759,553,232,283,18,19,1,0,321
48461000006,572,428,154,251,19,7,4,2,274
4803300001B,77,51,51,0,0,0,0,0,0
4803300001A,84,65,61,4,0,0,0,0,4
4803300003B,56,43,33,7,3,1,1,1,10
48201000097,9697,6869,4409,1501,689,217,103,10,2460
48201001008,2004,1510,1109,247,93,35,20,0,401
48201000382,3246,2174,668,1195,271,90,23,5,1506
48201000976,2547,1752,345,1172,199,66,42,6,1407
48201000460,9564,6869,627,3789,2053,206,401,13,6242
48201000131,7592,5122,430,3610,961,268,129,6,4692
48201000776,5771,4196,1739,1109,1126,98,184,24,2457
48201000888,4729,3245,570,1329,1205,104,123,34,2675
48201000979,0,0,0,0,0,0,0,0,0
48201000666,0,0,0,0,0,0,0,0,0
48201000949,274,221,102,59,19,5,40,0,119
48201000287,2472,1975,1210,434,141,40,159,2,765
48201000947,1102,885,593,167,32,16,80,4,292
48201000994,427,373,102,60,117,15,99,0,271
48201000948,0,0,0,0,0,0,0,0,0
48201000056,2446,1973,982,690,122,79,154,1,991
48201000259,3027,2392,31,700,1671,36,3,0,2361
48201000164,2424,1784,57,707,1010,41,17,4,1727
48201000551,7690,5448,3593,758,363,113,632,3,1855
48201000998,189,124,53,51,18,1,5,0,71
48201000616,5295,4042,2219,990,453,98,311,5,1823
48201000803,6355,4876,2753,963,536,135,519,16,2123
48201000115,4141,2913,131,1984,791,88,10,1,2782
48201000045,22339,14616,1172,8331,4942,393,170,25,13444
48201000362,8134,6071,3576,1473,397,158,496,12,2495
48201000215,3370,2567,1544,296,89,30,601,6,1023
48341000402,3211,2185,91,1590,308,71,192,4,2094
48293000303,312,256,199,27,13,11,7,0,57
48293000402,622,510,472,19,7,9,1,0,38
48293000406,197,184,178,2,0,4,0,0,6
484990001-3,2876,2363,2084,159,19,78,11,2,279
48085000080,5124,3849,2233,507,447,172,529,7,1616
48085000113,5670,4251,2383,855,544,111,383,9,1868
48085000216,10494,7075,4841,998,753,229,248,14,2234
48085000016,6289,4236,2781,518,524,138,291,12,1455
48085000004,3558,2583,1744,268,314,122,150,8,839
48085000116,6402,4936,2872,336,344,71,1285,10,2064
48085000109,6069,4733,2767,416,341,65,1148,3,1966
48085000086,4082,3250,1871,277,393,59,641,1,1379
48085000108,4860,3788,1657,332,357,68,1378,12,2131
48085000067,4208,3710,2259,347,360,68,664,6,1451
48085000164,2055,1807,1262,87,63,25,365,1,545
48085000058,5532,4484,2314,368,715,101,989,7,2170
48085000091,3818,2963,1798,434,292,89,380,18,1165
48085000054,5677,4513,1969,834,722,140,869,9,2544
48085000077,5229,3960,2014,515,528,63,853,4,1946
48085000130,5262,3953,2107,298,279,74,1202,8,1846
48085000062,3472,2817,1749,540,240,123,173,6,1068
48085000021,6089,4895,2794,567,413,130,1006,5,2101
48085000066,3398,2651,1517,653,239,94,180,2,1134
48085000039,4919,3827,1945,854,541,101,399,13,1882
48085000085,4474,3638,1962,504,384,79,709,0,1676
48085000037,3967,2900,2205,517,35,134,20,2,695
48085000187,803,624,482,85,7,39,9,0,142
48085000186,183,139,122,12,1,4,1,0,17
48043000002,1493,1261,762,401,24,47,28,0,499
48043000008,1547,1325,382,817,105,77,15,5,943
48253000202,472,369,313,36,3,14,2,1,56
48253000102,473,324,101,154,62,7,0,0,223
48087000201,543,397,211,126,34,23,3,1,186
48087000401,495,387,222,142,15,7,0,0,165
48087000101,695,519,428,65,9,13,11,4,91
48087000302,111,90,73,15,0,2,1,1,17
48201000192,4010,2951,166,1480,1284,85,34,3,2785
48201000571,5772,3968,256,3622,108,106,12,1,3712
48201000533,2902,2082,587,1069,350,59,42,1,1495
48201000522,4235,3189,2099,570,209,146,218,4,1090
48201000619,7067,5256,3404,747,262,82,757,12,1852
48201000248,5537,3931,440,2871,576,166,22,4,3491
48201000458,4304,3081,134,1678,1229,134,58,0,2947
48201000318,6270,4620,171,1876,2501,118,69,4,4449
48201000292,3262,2340,80,1626,621,59,23,2,2260
48201000337,3284,2358,142,1329,878,69,43,4,2216
48201000875,8374,5860,1781,1819,1183,157,1017,10,4079
48201000839,3876,3102,625,1286,758,113,449,10,2477
48201000944,8,6,2,2,0,2,2,0,4
4831100002A,52,34,21,13,1,0,0,0,13
48429004-19,1144,962,828,81,8,25,6,1,134
48429004-11,1063,784,528,218,17,22,0,3,256
48429003-19,1129,1025,689,189,138,10,3,2,336
48429003-11,1554,1101,641,391,20,35,13,5,460
48429001-11,2014,1536,1093,326,39,73,19,3,443
48345000003,24,21,17,4,0,0,0,0,4
48219000021,3894,2841,1136,1539,105,78,8,3,1705
4803300003A,54,42,38,4,1,0,0,0,4
48233000021,4132,3291,2793,240,26,196,20,0,498
48015000102,1865,1455,965,295,158,27,8,0,490
48015000313,2349,1732,488,876,318,65,25,1,1244
48015000314,4389,3272,2038,841,256,98,63,3,1234
48015000104,1168,938,631,227,42,44,9,1,307
48029002001,2369,1451,139,1191,103,38,32,1,1312
48029004147,484,398,211,132,28,7,31,0,187
48029004091,1621,1337,559,559,102,54,99,10,778
4832300003C,957,716,117,583,4,18,5,2,599
4832300002C,6681,4437,64,3895,13,520,13,7,4373
4832300001C,9323,6460,108,6297,26,63,26,4,6352
48469000023,2299,1744,1198,446,53,44,5,4,546
48469000008,4589,3224,918,1957,288,64,38,3,2306
48469000009,2338,1757,717,841,132,53,47,0,1040
48199000010,3460,2620,1391,132,1045,37,17,4,1229
48199000002,7665,5822,5156,255,201,134,34,7,666
48199000012,1372,1089,970,32,65,18,4,1,119
48217000010,3366,2485,1545,628,208,105,18,3,940
48387000007,383,300,239,18,18,14,4,1,61
48363000016,488,423,380,12,2,15,3,0,43
48363000008,2166,1713,1475,148,15,49,15,5,238
48087000402,124,101,86,11,3,1,1,2,15
48329000203,1546,1141,516,549,34,51,13,8,625
48329000211,8497,5710,3041,2028,379,152,152,4,2669
48363000007,948,711,574,99,4,23,7,3,137
48363000002,16,16,16,0,0,0,0,0,0
48123000203,1642,1205,771,339,77,34,2,1,434
48435000301,987,735,410,309,8,17,4,2,325
48435000201,778,617,296,312,4,3,1,2,321
48435000401,795,604,165,428,3,10,3,2,439
48233000011,2829,1998,1462,374,36,122,14,0,536
48233000033,3083,2323,1411,704,85,131,17,2,912
48223000012,360,280,256,21,2,2,0,0,24
48223000020,883,688,590,53,9,26,1,1,98
48229000004,437,373,153,202,3,23,1,1,220
48201000223,8789,7846,2138,1042,1682,105,2974,17,5708
48201000805,3613,2902,2222,372,164,73,78,1,680
48201000514,7797,5836,2956,1353,906,176,550,10,2880
48201000853,3899,2949,1942,441,250,71,245,11,1007
48489000001,2945,2073,94,1953,14,14,6,5,1979
48013000005,4130,2942,738,2105,61,88,10,2,2204
48461000003,889,650,201,418,21,11,3,2,449
48461000001,618,433,298,112,17,10,8,1,135
48013000021,340,278,193,77,8,7,1,0,85
48353000006,1744,1236,760,422,16,31,7,0,476
48383000002,861,630,281,337,8,7,2,2,349
48383000003,829,569,255,290,11,16,5,3,314
48231000319,2759,2115,1813,148,48,64,14,1,302
48029004079,2602,2103,962,674,304,82,135,11,1141
48029004056,5546,4368,1776,1695,641,147,195,45,2592
48029003014,795,645,265,339,21,9,18,0,380
48029003064,564,444,229,193,5,7,13,2,215
48029003031,50,28,8,18,3,3,0,0,20
48029004067,4089,2845,842,1206,684,113,121,26,2003
48029004025,2624,1909,319,1496,63,65,11,0,1590
48029003056,3724,2915,862,1386,370,76,265,11,2053
48029003010,1734,1414,380,713,159,35,163,3,1034
48029003162,1670,1262,450,552,82,40,154,2,812
48029003127,6304,4854,1576,2256,350,172,655,10,3278
48029002044,5315,3677,157,3330,144,104,48,12,3520
48029002073,2388,1772,268,1417,63,46,17,1,1504
48489000003,1447,1043,103,928,8,13,2,0,940
48029003069,4562,3623,1764,1484,129,87,201,4,1859
48029002058,4294,3268,345,2854,39,125,18,10,2923
48029004204,41,28,0,26,2,2,0,0,28
48029004133,71,60,30,20,9,0,0,0,30
48029001066,1723,1294,168,1102,13,29,8,1,1126
48029004075,1037,791,90,640,53,38,10,8,701
48029004009,2342,1644,118,1114,395,74,39,7,1526
48029004146,80,62,19,27,11,5,2,1,43
48029004156,2037,1510,309,579,514,43,109,4,1201
48029004066,5945,4322,991,1853,1310,117,185,39,3331
48029003062,81,67,20,44,2,4,1,2,47
48029003079,4222,3609,1961,1228,210,115,160,10,1648
48029002020,6861,4614,166,3831,501,123,136,8,4448
48029001042,1667,1277,42,1224,17,33,1,1,1235
48029001060,6077,4147,138,3921,67,104,37,5,4009
48029002089,1015,744,23,708,22,24,4,0,721
48029002012,2990,2230,69,2124,25,83,16,0,2161
48029004194,2092,1597,521,817,178,71,83,6,1076
48029004058,3182,2534,1227,987,163,120,108,18,1307
4806700013T,2505,1904,983,70,792,39,11,3,921
48067000015,668,539,473,9,46,10,3,0,66
48067000009,1391,1150,837,29,225,43,12,2,313
48219000024,1417,985,507,445,10,30,3,1,478
48219000035,386,268,110,140,13,8,2,0,158
48219000016,2736,2125,1393,597,85,54,11,4,732
48219000046,1029,764,472,245,17,32,0,0,292
48489000004,2446,1866,147,1687,11,42,11,8,1719
48489000009,1509,1123,60,1049,12,11,7,0,1063
48305000007,55,41,25,12,0,2,0,0,16
48095000407,185,163,145,8,2,1,4,0,18
48095000101,476,377,330,38,6,5,1,0,47
48217000022,2432,2006,1771,119,14,79,20,6,235
48217000002,1908,1400,762,485,100,75,7,1,638
48217000005,927,724,583,92,16,33,1,0,141
48217000020,1535,1181,982,122,6,56,5,3,199
48217000021,2566,2135,1895,109,38,71,7,1,240
48217000013,4451,3418,2756,362,140,112,25,3,662
48217000012,1131,938,752,143,15,24,3,0,186
48217000004,3534,2714,1765,580,245,101,42,5,949
4832500002C,6620,5015,2465,2327,72,156,57,19,2550
4832500004C,2967,2225,555,1611,27,50,9,3,1670
4832500003C,4533,3418,1359,1927,49,99,24,5,2059
4832500004B,6103,4561,1969,2398,70,130,27,4,2592
4832500002B,4083,3193,1993,1058,36,90,33,11,1200
4832500001C,3961,3115,1814,1097,75,96,48,11,1301
4832500003B,812,648,329,301,6,10,3,1,319
4832500003A,1316,1085,700,352,7,31,7,3,385
4832500004A,2712,2044,1052,929,21,52,1,2,992
4832500001A,1682,1324,1006,287,12,28,3,0,318
4832500003D,5949,4806,1022,3115,614,69,27,4,3784
48065000302,556,428,363,37,9,22,0,0,65
48065000301,928,658,565,51,11,28,3,0,93
48065000103,661,505,376,81,16,27,4,0,129
48095000204,156,130,81,40,0,3,1,0,49
48329000201,5890,4202,1800,2221,69,128,13,2,2402
48269000001,60,50,43,5,0,0,0,2,7
48353000004,3088,2242,860,1131,212,74,20,4,1382
48353000003,2877,2167,1188,780,127,67,41,5,979
48383000004,836,609,187,396,17,14,9,7,422
48269000003,74,57,50,6,1,0,2,3,7
48269000004,64,41,41,0,0,0,0,0,0
48353000001,1998,1508,921,441,79,65,13,1,587
48353000008,190,160,143,11,1,2,0,0,17
48217000024,1889,1435,1043,113,215,49,9,0,392
48217000003,4136,2916,934,1405,530,87,19,3,1982
48217000008,402,325,271,27,14,10,2,0,54
48217000015,648,517,394,90,10,17,6,0,123
48217000027,931,702,641,42,0,15,1,0,61
48217000019,681,498,418,49,12,17,3,0,80
48067000006,747,597,494,38,39,24,3,0,103
48067000019,706,539,449,24,22,32,5,0,90
48217000014,1503,1154,1045,57,15,20,5,0,109
48013000020,5696,4229,2462,1601,57,97,49,6,1767
48347000023,454,384,249,61,61,6,9,0,135
48347000024,2668,2117,864,340,882,17,26,0,1253
48347000025,121,98,68,11,14,0,0,0,30
48347000026,7264,5193,2041,1713,1295,104,70,9,3152
48347000012,2969,2317,1861,213,145,79,23,2,456
48347000014,4769,3472,2587,446,326,91,33,3,885
48397000004,4541,3447,2487,563,162,149,101,7,960
4839700001B,8922,6283,4901,630,321,194,284,8,1382
48397000001,7520,5462,4185,526,296,150,300,6,1277
4839700004C,7457,5166,3448,953,492,181,131,14,1718
4839700004B,2869,2104,1311,550,158,84,41,6,793
4839700003D,10917,7837,5663,1211,461,259,238,16,2174
4839700004A,18112,12185,7307,2802,1249,411,498,27,4878
48347000027,2684,1792,147,327,1312,32,15,1,1645
48353000007,359,289,249,16,6,19,0,0,40
48403000004,318,250,239,4,1,6,0,0,11
48015000418,2303,1752,1204,441,86,31,9,3,548
48015000417,908,721,426,146,128,23,7,3,295
48293000204,769,601,479,85,30,12,2,0,122
48061000036,3624,2732,615,1982,47,49,80,4,2117
48043000005,173,159,127,29,1,2,1,0,32
48279000003,1212,869,347,507,16,11,4,2,522
48279000011,1073,749,426,290,16,16,4,0,323
48279000008,3350,2428,1143,1137,120,53,6,7,1285
48085000022,6397,4514,3211,856,242,177,86,10,1303
48085000154,1699,1246,969,150,58,37,37,2,277
48085000024,4386,3626,1388,546,1326,103,334,4,2238
48085000057,7729,5760,3329,1056,882,193,366,20,2431
48085000167,7404,5460,2199,386,457,49,2352,16,3261
48085000231,5308,4001,2219,608,741,92,376,4,1782
48085000043,5649,3989,1874,845,918,141,254,7,2115
48085000099,497,385,238,59,74,6,11,1,147
48085000172,6905,4854,3029,905,576,197,161,7,1825
48085000017,6552,4425,2656,886,622,140,132,5,1769
48085000182,0,0,0,0,0,0,0,0,0
48085000202,0,0,0,0,0,0,0,0,0
48293000101,2685,2084,1353,352,330,52,16,2,731
48293000301,2684,2060,1183,427,345,42,67,0,877
48293000302,1295,1001,535,226,234,24,6,0,466
48293000401,3587,2637,998,810,779,100,19,6,1639
48503000016,340,269,248,14,3,4,0,0,21
48345000001,291,220,183,26,3,9,2,2,37
48345000004,270,219,203,6,1,8,2,0,16
48159000101,1747,1365,1116,140,66,42,11,0,249
48113001500,6698,4657,1297,2559,518,125,245,17,3360
48113003407,930,661,194,412,45,26,6,0,467
48097000018,2354,1738,1573,89,7,59,6,0,165
48097000017,548,426,406,8,0,11,0,0,20
48331000317,1542,1195,1019,86,50,22,10,0,176
48431000001,334,267,215,40,0,8,2,2,52
48431000002,389,279,130,142,3,8,4,0,149
48431000003,297,220,160,56,2,4,0,0,60
48431000004,352,249,169,71,3,9,2,0,80
48331000419,3287,2488,1533,584,287,86,19,9,955
48331000318,3828,2912,1977,646,211,56,22,8,935
48199000011,1612,1269,1125,35,23,56,5,1,144
48085000153,7798,5530,2980,536,720,114,1189,4,2550
48113002940,2254,1820,1176,243,135,52,200,4,644
48085000177,10320,8764,4547,1049,1242,196,1627,18,4217
48085000190,118,86,58,15,6,4,0,4,28
48085000011,7059,5089,3409,1177,274,185,58,13,1680
48085000201,0,0,0,0,0,0,0,0,0
48085000096,2336,1657,657,520,383,49,70,4,1000
48085000146,7616,5469,2820,678,674,124,1172,8,2649
4832300002B,6691,4914,209,4568,82,59,42,3,4705
48029004114,226,153,24,89,34,4,8,2,129
48029004213,8,4,3,0,0,0,0,1,1
48029003146,5620,4643,1701,2223,306,156,391,9,2942
48029002091,5619,4744,1326,2391,687,162,359,17,3418
48029003103,1447,1013,265,438,167,38,128,11,748
48029003170,1,1,0,0,1,0,0,1,1
48029003183,65,44,15,11,10,7,5,0,29
48029004100,1368,1007,330,391,176,31,95,15,677
48029004143,9172,6264,1228,2721,2037,226,252,59,5036
48029004193,217,155,29,85,34,8,4,5,126
48029003207,415,411,118,213,69,4,12,5,293
48029002147,1220,923,244,517,131,51,50,12,679
48081000003,874,744,561,140,10,31,3,3,183
48495000201,824,579,192,368,17,11,6,0,387
48279000010,841,655,247,365,32,12,1,2,408
48279000004,181,118,50,67,0,1,1,0,68
48495000301,1956,1414,642,703,42,31,18,0,772
48495000401,2141,1584,307,1177,48,60,41,5,1277
48279000009,1375,1057,509,494,47,19,4,3,548
48279000007,305,236,165,62,4,7,3,1,71
48309000067,4346,3355,2860,312,80,77,4,1,495
48309000041,2770,2353,1407,459,410,43,38,9,946
48309000061,4672,3587,2366,601,394,70,164,6,1221
48309000031,4300,3286,1703,710,791,81,39,7,1583
48309000016,1211,961,645,156,89,38,37,1,316
48445000301,2646,1904,528,1235,96,48,26,8,1376
48495000202,943,670,422,226,7,23,5,0,248
48353000009,2802,2136,1510,511,65,39,21,3,626
48305000002,583,433,205,208,3,14,1,0,228
48305000003,747,562,234,318,5,12,0,0,328
48305000004,1022,686,518,154,2,16,1,0,168
48305000005,85,63,35,23,3,5,1,0,28
48223000023,415,330,236,44,23,13,5,2,94
48223000017,1877,1380,1140,159,32,49,8,0,240
48067000021,459,340,298,18,10,8,4,0,42
48067000012,1310,1052,761,24,221,45,4,2,291
48101000201,349,266,221,30,11,6,1,1,45
48061000052,2485,2204,1456,600,42,51,68,2,748
48079000101,720,518,177,309,22,11,5,1,341
48079000404,549,386,86,275,21,3,2,0,300
48079000202,570,397,226,154,9,9,2,0,171
48079000306,617,447,180,254,10,6,4,0,267
48079000303,91,69,40,27,0,1,0,0,29
48301000004,9,2,1,0,1,1,1,1,1
48301000001,28,17,15,0,0,1,0,0,2
48043000006,756,674,471,143,10,37,7,0,203
48043000004,2123,1658,806,765,42,84,18,5,852
4832300003A,5070,3629,153,3444,15,39,20,2,3476
4832300004A,1780,1336,50,1275,3,18,6,0,1286
48041000023,127,95,63,25,5,5,0,0,32
48041000097,0,0,0,0,0,0,0,0,0
48041000098,13,12,8,4,1,1,0,0,4
48223000036,1470,1123,967,101,20,25,11,0,156
48223000004,2292,1698,1239,341,73,48,16,2,459
48223000003,3245,2469,1716,358,310,92,25,5,753
48061000108,8,8,0,8,0,0,0,0,8
48503000006,259,213,168,29,1,13,3,0,45
48081000004,759,594,454,126,1,14,0,3,140
48081000002,799,656,537,85,0,28,1,1,119
48081000001,853,640,484,120,3,23,2,3,156
48073000042,2491,1726,317,633,758,26,8,9,1409
48073000045,1677,1245,552,576,102,27,2,0,693
48073000046,1091,851,669,95,66,19,2,0,182
48073000047,562,406,296,66,37,13,4,1,110
48437000007,688,502,412,77,5,8,3,0,90
484990004-2,3709,2993,2568,254,33,87,42,3,425
484990004-3,5339,4326,3346,525,286,114,36,0,980
484990002-2,6080,4688,3564,759,189,163,24,3,1124
484990001-1,4354,3674,3110,248,157,115,22,3,564
484990003-1,1689,1360,1168,104,32,56,8,0,192
484990004-4,1204,919,767,68,20,45,16,1,152
484990002-3,4600,3698,2892,414,252,110,35,0,806
484990002-1,702,560,471,47,17,27,3,0,89
48031000102,2863,2332,1761,465,30,59,16,3,571
48031000201,2815,2330,1929,285,20,64,19,10,401
48395000005,1975,1518,1132,99,229,33,28,3,386
48085000121,4225,3084,906,146,150,28,1825,9,2178
48085000197,2446,1712,603,98,96,16,895,2,1109
48085000107,4496,3545,2059,303,208,44,914,4,1486
48085000034,6364,4715,1564,236,206,49,2688,10,3151
48085000025,7871,5486,2725,431,555,102,1700,4,2761
48085000210,2464,1671,701,109,139,18,698,4,970
48085000165,1194,875,533,74,58,15,203,0,342
48085000144,3819,2881,1674,233,294,70,611,4,1207
48085000166,6546,4393,1912,337,568,75,1519,13,2481
48085000032,3158,2522,1831,316,123,70,191,4,691
48085000053,2814,2249,1671,263,81,89,150,4,578
48085000065,1940,1532,912,322,125,41,137,2,620
48085000087,11099,7020,1999,296,239,66,4401,17,5021
48085000135,7146,5084,1975,351,504,71,2177,8,3109
48085000234,3409,2222,887,130,106,17,1077,0,1335
48085000139,9115,6404,2529,608,1048,85,2132,9,3875
48085000125,8087,6113,2725,406,761,95,2133,15,3388
48113002702,5893,4838,3165,353,304,89,945,4,1673
48445000101,1261,1000,538,350,106,10,1,1,462
48445000102,2393,1718,984,658,46,45,9,2,734
48445000401,2462,1755,667,1013,65,28,8,4,1088
48015000205,2996,2309,1686,315,223,48,30,0,623
48015000101,2253,1677,1047,405,188,47,17,2,630
48015000103,1960,1577,1250,188,95,34,8,0,327
48445000202,810,595,240,339,0,17,1,0,355
48073000013,1857,1399,1115,189,41,57,7,0,284
48073000028,2210,1944,1026,345,531,35,12,0,918
48039000039,8819,6554,3440,2525,311,231,112,16,3114
48039000016,9591,7209,4093,2440,399,168,145,3,3116
48039000034,8560,6387,3273,2692,144,232,78,4,3114
48039000003,8160,6096,3851,1776,240,169,68,1,2245
48039000008,2029,1658,1202,357,36,42,13,1,456
48039000048,6159,4431,1897,1838,517,150,74,8,2534
48039000019,4802,3508,1060,2071,342,120,20,4,2448
48039000038,929,813,669,74,20,29,12,1,144
48039000010,1483,1142,753,321,20,47,4,3,389
48039000049,2429,1810,1486,208,52,33,15,1,324
48039000068,9825,6964,1530,1959,2298,154,1143,14,5434
48039000050,9709,6897,1497,979,2698,120,1719,21,5400
48039000066,7311,4864,1088,748,1306,68,1717,18,3776
48039000067,6885,5114,1068,872,2269,85,921,9,4046
48039000059,7726,5367,1497,686,1496,88,1667,7,3870
48039000001,7874,5806,2641,2465,499,199,85,9,3165
48039000015,4251,3271,2325,618,199,96,32,3,946
48039000031,2000,1524,993,419,57,54,15,2,531
48039000042,1148,863,462,283,103,22,9,1,401
48039000013,6515,4704,2190,1297,772,140,382,3,2514
48039000037,5899,4046,2018,1176,498,94,277,7,2028
48353000005,145,124,119,2,0,2,0,0,5
48301000003,26,20,19,0,1,1,1,1,1
48027000310,750,574,473,74,4,7,4,2,101
48027000306,6221,4742,1803,1701,1085,180,62,28,2939
48433000004,339,269,210,48,6,3,3,1,59
48239000001,3641,2671,1333,812,431,63,47,4,1338
48215000115,6211,4488,137,4322,11,70,9,1,4351
48215000227,10384,6885,71,6797,11,85,8,0,6814
48215000228,8679,6052,97,5939,12,71,8,6,5955
48215000122,6638,4346,59,4283,2,36,6,4,4287
48215000226,69,40,0,40,0,1,0,0,40
48215000020,1974,1321,21,1297,1,6,0,0,1300
48215000235,511,394,71,315,5,5,7,0,323
48215000040,6100,4083,28,4041,11,37,4,0,4055
48215000155,1116,820,56,760,3,11,4,0,764
48215000121,185,124,9,111,0,4,1,1,115
48215000002,4317,3183,413,2756,8,55,7,2,2770
48215000114,6486,4723,1086,3504,47,72,108,1,3637
48215000111,4022,3221,472,2664,39,41,52,0,2749
48215000007,6407,4929,611,4186,31,66,109,3,4318
48215000148,335,214,7,206,2,2,2,0,207
48215000150,3817,2880,330,2429,24,62,91,0,2550
48215000139,1121,895,63,816,2,35,1,0,832
48215000008,3301,2609,420,2087,26,52,68,1,2189
48215000043,13401,8860,188,8560,28,126,60,2,8672
48215000189,7436,4490,98,4352,7,69,8,1,4392
48215000220,1482,927,44,861,4,18,24,0,883
48215000086,928,749,154,583,1,5,11,0,595
48215000247,346,253,12,240,0,0,0,1,241
48215000248,164,111,0,111,2,3,0,0,111
48215000101,1664,1234,183,1011,10,14,34,0,1051
48215000236,1374,963,122,791,21,14,31,0,841
48215000205,1050,686,9,674,4,11,0,0,677
48201000773,8254,6433,350,2044,1586,120,2514,10,6083
48201000647,13289,9721,364,2288,3310,111,3815,15,9357
48201000428,11489,8706,545,2778,2009,168,3384,10,8161
48201000081,5727,3979,385,3522,39,135,14,2,3594
48201000078,3174,2505,244,2144,84,114,20,3,2261
48201000526,2408,1826,131,1560,110,35,32,0,1695
48201000213,4285,3132,2541,204,34,35,300,0,591
48347000022,207,191,119,23,46,8,5,0,72
48347000013,1861,1415,1162,102,80,48,16,2,253
48347000015,2674,1989,1480,165,243,85,20,6,509
48347000016,3514,2737,2229,220,156,68,67,0,508
48347000033,7108,5780,4110,457,896,129,179,4,1670
48347000045,1168,906,743,94,41,29,6,1,163
48177000008,559,411,249,142,15,14,1,1,162
48425000003,2571,1894,1438,353,19,68,33,5,456
48167000103,1450,1278,1130,85,12,25,18,2,148
48167000104,1320,1168,966,138,16,40,10,2,202
48167000221,2330,2066,1788,173,18,54,36,0,278
48167000274,1078,993,877,76,6,26,12,0,116
48167000471,4599,3616,2003,628,419,65,439,14,1613
48167000399,733,571,91,382,69,38,17,1,480
48167000334,2594,1840,389,352,1073,32,5,2,1451
48167000226,4237,3306,2080,785,294,108,40,6,1226
48167000488,6205,4628,2857,941,327,112,425,12,1771
48167000263,12531,8622,5555,1454,629,225,806,22,3067
48167000314,6204,5022,1979,1427,1434,164,78,16,3043
48167000218,4628,3796,2165,1153,302,95,97,5,1631
48167000316,4869,3650,939,2040,586,150,54,5,2711
48167000232,3231,2569,1201,738,522,66,58,2,1368
48167000331,3715,2921,602,701,1577,54,38,9,2319
48167002323,507,473,388,57,8,19,8,0,85
48167002322,0,0,0,0,0,0,0,0,0
48167000225,3715,3348,2697,439,43,88,74,3,651
48167002321,0,0,0,0,0,0,0,0,0
48167000330,5357,3998,1323,1135,1496,132,21,7,2675
48167000343,5323,3752,1266,1667,741,124,32,18,2486
48167000315,5851,4865,2224,1632,820,143,79,21,2641
484990003-3,5138,4192,3253,175,530,164,37,2,939
48201000623,7955,6193,2546,1586,1407,153,595,17,3647
48201000648,4841,3726,2081,606,475,89,514,8,1645
4832500001D,3884,2974,1599,1279,49,57,28,5,1375
48305000011,136,82,55,26,1,1,1,1,27
48041000029,985,847,577,77,155,18,9,1,270
48347000021,3468,2557,1502,765,219,55,8,1,1055
48347000042,4568,3189,1167,1729,232,79,22,3,2022
4839700003B,5064,3583,1923,690,689,153,194,7,1660
4839700003A,3973,2735,661,1722,241,85,66,7,2074
48413000003,350,273,92,168,7,7,4,1,181
48413000001,717,551,273,264,14,8,4,2,278
48413000004,742,549,366,162,7,15,6,0,183
48413000002,642,494,201,279,5,6,2,0,293
48285000029,1749,1353,1151,116,47,30,6,1,202
4815300024B,469,319,42,256,15,10,2,1,277
48153000024,639,449,123,295,22,10,2,1,326
48085000070,2375,1890,1448,180,68,44,166,4,442
48085000072,2706,2191,1139,374,172,62,461,3,1052
48215000098,6842,5008,222,4746,36,46,20,0,4786
48215000047,3777,2822,73,2712,28,32,14,1,2749
48215000231,981,689,100,554,5,10,28,0,589
48215000048,6645,4972,102,4807,10,53,54,1,4870
48215000193,1135,777,38,699,8,10,27,0,739
48215000029,2447,1652,310,1305,29,28,16,3,1342
48215000093,386,298,100,193,1,11,2,0,198
48215000185,7,5,3,1,0,0,1,0,2
48135000103,5252,3631,1143,2364,64,88,14,0,2488
48135000104,845,593,180,396,4,20,0,0,413
48135000307,5621,3926,1083,2537,228,94,44,18,2843
48135000308,1828,1271,511,645,61,29,33,3,760
4822300002A,2011,1542,783,212,483,47,22,3,759
48113002929,2189,1657,908,393,225,49,98,1,749
48113002920,6149,4547,2029,967,829,129,621,5,2518
48113002068,3451,2853,1915,489,247,70,124,3,938
48113002706,5611,4533,1674,787,630,57,1408,9,2859
48113001703,7234,5248,968,2610,567,135,1070,19,4280
48305000001,540,391,194,164,17,13,3,0,197
48305000012,360,262,96,153,4,7,0,0,166
48215000006,5949,4209,574,3575,23,57,31,0,3635
48215000147,577,352,16,322,6,10,9,0,336
48215000169,771,582,13,565,3,5,2,0,569
48215000033,2759,1959,89,1852,6,27,10,0,1870
48215000184,92,66,25,38,1,2,0,0,41
48215000017,2804,2263,692,1563,3,10,3,0,1571
48215000024,156,121,46,73,1,4,0,0,75
48215000149,107,90,1,89,2,2,1,0,89
48215000252,9,9,6,3,0,0,0,0,3
48073000022,956,737,478,79,136,33,4,0,259
48073000012,2276,1710,1269,222,173,35,13,5,441
48073000048,883,664,568,59,5,22,2,0,96
48167000454,7221,5411,3154,1163,520,143,423,8,2257
48167000148,6353,4786,2530,1536,557,152,51,14,2256
48167000345,1906,1385,300,370,687,42,9,0,1085
48167000146,4589,3555,1989,1042,392,82,62,8,1566
48167000461,5070,3699,2833,455,114,91,207,3,866
48167000482,407,296,191,85,6,9,3,1,105
48167000224,5633,4714,2701,1073,529,108,320,14,2013
48167000223,6093,4653,2262,1285,864,111,169,11,2391
48167000193,4436,3247,2193,501,265,81,210,2,1054
48167000490,7692,5555,3633,974,488,101,357,7,1922
48167000278,4028,3137,2483,486,19,111,21,5,654
48167000258,3634,2819,2231,457,28,84,4,2,588
48085000026,3772,2949,1333,864,361,88,318,8,1616
48085000160,490,363,310,39,1,14,3,0,53
48085000020,1099,884,703,108,29,28,20,0,181
48113001301,5809,4205,1161,2174,738,163,99,13,3044
48113003405,7379,5014,976,2589,1319,148,98,10,4038
48113002016,4455,3720,2896,339,190,74,238,4,824
48113001100,7143,4857,127,3008,1718,153,35,13,4730
48113003012,420,272,11,127,129,5,4,0,261
48113003045,1032,721,24,184,483,19,32,0,697
48113001090,5681,4024,328,2791,859,153,21,1,3696
48113004078,3212,2712,1027,1321,255,100,77,0,1685
48113004115,444,340,238,69,9,14,14,0,102
48113004619,2267,1722,756,795,68,75,43,11,966
48113004660,99,70,24,35,6,0,5,0,46
48113004618,1131,826,183,577,27,41,31,3,643
48073000026,1631,1189,667,181,311,30,8,0,522
48073000038,1855,1266,287,717,227,65,8,0,979
48073000015,6337,4596,2390,1353,696,151,71,3,2206
48073000043,2838,2006,843,777,350,69,6,1,1163
48085000002,8196,6248,2965,1703,1109,217,283,16,3283
48085000207,6258,4187,2625,413,594,111,449,7,1562
48085000208,3687,2631,1715,273,227,62,355,8,916
48085000013,10153,6580,4759,808,450,170,380,26,1821
48085000052,8073,5664,1637,921,719,92,2314,14,4027
48097000033,630,517,468,24,2,22,5,0,49
48217000006,552,457,376,53,5,10,1,0,81
48217000009,940,738,416,258,36,28,1,1,322
48085000115,3993,3294,2182,347,289,46,414,13,1112
48085000142,4917,4187,2079,328,367,72,1323,1,2108
48167000275,413,384,341,24,2,18,3,0,43
48167000336,6082,4650,702,711,3183,95,63,3,3948
48167000169,0,0,0,0,0,0,0,0,0
48359000404,222,160,146,11,1,2,2,1,14
48069000307,438,319,119,193,4,7,2,1,200
48069000206,263,201,133,61,2,9,3,0,68
48201000699,3071,2435,1403,394,98,54,498,0,1032
48201000389,4236,4131,1326,726,694,17,1378,56,2805
48201000016,4819,4642,2401,918,773,80,509,11,2241
48201000890,3511,3206,1967,514,469,56,198,9,1239
48451000106,3369,2401,679,1577,88,66,14,1,1722
48451000146,7641,5944,1787,3705,283,191,57,15,4157
48451000144,3582,2521,889,1366,148,62,87,9,1632
48451000112,1469,1095,748,318,5,23,10,3,347
48451000358,8477,6425,4533,1469,131,246,40,3,1892
48073000032,1436,1080,862,110,65,32,9,2,218
48073000027,1473,1136,724,167,224,14,2,0,412
48097000014,400,316,269,21,1,20,2,0,47
48097000008,1456,1131,934,98,17,59,4,2,197
48097000027,633,422,305,55,29,13,23,0,117
48389000006,307,231,81,140,2,6,3,1,150
48389000011,1429,1008,57,917,21,21,5,2,951
48389000008,929,691,83,585,15,20,4,0,608
48389000004,3120,3068,143,2834,99,6,33,1,2925
4839700002C,7333,5478,4495,400,207,163,175,6,983
48177000010,883,687,341,332,9,6,0,2,346
48177000001,4271,3135,1611,1278,196,80,17,2,1524
48177000015,462,371,247,117,2,5,0,0,124
48177000002,3061,2317,1013,937,340,39,25,4,1304
48285000026,1169,809,230,452,122,29,8,1,579
48285000016,660,532,459,45,13,12,3,0,73
48285000032,546,468,389,60,11,5,1,1,79
48059000003,3312,2530,2142,252,17,93,26,1,388
48011000401,241,191,164,14,5,8,1,1,27
48011000101,468,360,319,23,2,14,1,0,41
48361000005,2354,1855,833,134,840,30,22,2,1022
48361000027,2908,2254,2051,114,6,60,20,2,203
48377000001,404,324,100,209,2,9,4,0,224
48377000007,1780,1481,626,817,11,49,13,4,855
48377000004,1523,1139,39,1061,5,16,31,0,1100
48377000005,1116,811,26,774,0,16,8,1,785
48069000408,792,566,507,48,3,12,5,1,59
48069000401,1142,816,130,642,20,16,10,4,686
48377000003,56,46,3,41,1,0,0,1,43
48377000002,1167,822,43,759,3,16,13,4,779
48445000402,405,260,191,66,0,4,0,0,69
48153000009,142,91,70,18,0,1,1,2,21
48201000498,6464,4881,1050,1939,1623,155,237,12,3831
48201000322,4564,2959,376,1699,873,95,45,5,2583
48201000264,8913,6388,1463,4267,373,273,239,9,4925
48201000658,4853,3466,1580,1105,558,94,138,12,1886
48201000199,5987,4599,3018,897,401,146,159,25,1581
48201000485,7816,5705,3175,1354,637,150,460,10,2530
48201000982,11701,7701,4441,1583,589,174,943,10,3260
48201000903,5249,3692,2017,1121,212,120,272,5,1675
48201000245,9316,6567,2893,2252,799,270,511,13,3674
48285000027,277,224,168,38,12,8,1,1,56
48285000001,1657,1298,1060,99,136,9,6,2,238
48177000007,736,560,377,129,40,10,2,0,183
48153000001,1627,1190,747,407,28,20,1,2,443
48381000421,6879,5421,3724,1109,368,198,55,7,1697
48381000426,3996,3059,2390,460,58,101,35,3,669
48381000415,8672,6137,3902,1539,300,196,220,1,2235
48381000429,5969,4519,3324,773,208,150,81,7,1195
48381000114,6336,4598,2784,1300,226,152,167,1,1814
4847500001E,2731,1931,513,1227,175,36,22,8,1418
48069000301,1588,1142,561,520,40,26,14,2,581
48069000201,1550,1082,183,857,27,17,9,3,899
48069000105,317,193,45,144,2,4,0,0,148
48069000101,1281,958,189,750,7,13,2,2,769
48149000002,292,237,182,36,8,11,2,0,55
48049000202,2544,1947,1275,482,127,65,12,6,672
48049000411,2617,1950,1072,724,100,51,14,1,878
48049000303,2328,1713,1157,391,81,51,22,1,556
48085000151,2815,1976,865,193,314,61,548,2,1111
48085000060,3723,2755,1761,316,171,70,431,0,994
48085000042,3106,2176,1388,557,111,103,50,5,788
48085000159,6396,4409,1728,1332,598,101,691,10,2681
48085000237,3812,2565,1054,378,514,59,564,2,1511
48085000090,4033,3110,2119,162,98,41,679,5,991
48085000123,3273,2477,1407,247,314,38,467,3,1070
48085000106,2864,2158,1308,323,221,87,241,7,850
48085000219,5456,4188,2255,419,338,75,1093,9,1933
48427000010,14867,9919,149,9695,34,69,46,2,9770
48427000002,11093,7579,143,7384,20,78,22,4,7436
48143000031,1777,1437,1177,197,4,54,7,2,260
48143000034,1625,1251,1097,77,6,43,12,1,154
48427000008,6272,4397,69,4308,12,31,5,2,4328
48143000045,5156,4655,2811,906,764,154,74,36,1844
48427000001,4568,3382,147,3211,9,29,11,2,3235
48359000103,191,141,121,13,2,5,3,0,20
48359000403,245,193,148,35,4,4,6,1,45
48359000203,198,168,145,21,0,4,0,1,23
48001000019,3467,2580,1628,402,465,73,30,1,952
48001000021,2772,2169,1717,235,140,43,32,0,452
48149000012,722,558,342,175,33,19,1,0,216
4814900001N,3738,2806,1840,650,257,74,15,1,966
48149000010,818,678,563,88,10,14,1,3,115
48049000306,2769,2144,1756,240,27,78,45,0,388
48113001702,6252,4652,1125,2104,516,174,846,14,3527
48113003409,1803,1329,228,890,178,115,24,0,1101
48113003062,5935,3818,69,687,3041,54,29,9,3749
48093000002,2942,2220,1356,778,18,80,11,3,864
48085000083,6169,4474,3071,680,389,147,211,4,1403
48085000233,3084,2184,1250,354,344,75,187,6,934
48085000056,5895,4049,2283,868,353,120,444,8,1766
48085000005,1645,1247,833,211,100,77,55,4,414
48427000003,3956,2692,26,2660,6,14,3,1,2666
48427000006,13660,9903,158,9719,11,71,10,5,9745
48427000009,9098,6450,86,6342,17,38,4,5,6364
48313000101,5002,4345,1649,1459,1194,30,31,3,2696
48313000303,2869,2092,949,431,655,45,16,2,1143
48143000025,1225,933,674,221,7,29,8,3,259
48113004001,3571,2576,277,2168,89,116,37,6,2299
48113002076,12,11,6,0,5,0,1,0,5
48113002000,53,44,8,34,0,3,0,0,36
48113001044,3077,2392,1642,258,374,31,103,4,750
48113003082,7704,5067,213,2241,2611,98,16,1,4854
48113001101,5201,3520,199,3065,240,194,13,4,3321
48113001124,58,30,4,26,0,0,0,0,26
48113001140,0,0,0,0,0,0,0,0,0
48113004067,4538,3402,366,2878,110,104,26,3,3036
48113002602,6349,4986,1301,490,893,61,2254,5,3685
48113003204,5108,3718,849,1679,1127,195,47,1,2869
48285000030,3254,2406,1371,810,170,72,16,0,1035
48285000011,485,380,336,30,7,8,0,0,44
48177000003,2830,2127,797,1186,119,37,13,6,1330
48153000023,1187,860,213,599,33,20,7,3,647
48153000018,1338,1020,541,448,29,7,5,4,479
48201000879,5957,4308,1018,1969,723,123,586,11,3290
48201000996,1080,831,317,331,126,14,58,0,514
48389000005,552,436,102,320,1,8,6,1,334
48143000032,3473,2570,1865,535,42,73,43,5,705
48143000011,1098,881,608,205,29,33,4,2,273
48143000018,2683,2053,1703,270,8,42,28,2,350
48143000030,856,667,589,32,8,25,2,0,78
48387000028,277,243,172,23,35,9,5,0,71
48387000017,290,241,199,13,12,15,3,0,42
48117000003,5291,3839,1634,2091,59,65,18,1,2205
48117000001,4076,2799,553,2186,27,58,17,1,2246
48417000101,732,540,455,72,2,8,1,0,85
48201000408,5434,3788,347,3302,60,154,67,3,3441
48201000608,2412,1597,97,1388,20,59,90,1,1500
48201000062,4576,3414,97,3239,84,121,17,2,3317
48201000190,5485,3856,364,3386,49,133,40,1,3492
48201000777,3785,2487,165,2164,104,72,34,1,2322
48201000134,3768,2757,454,1970,275,80,57,2,2303
48201000468,10549,7647,487,4529,1412,334,1202,10,7160
48201000613,5687,4206,255,2227,1379,121,364,11,3951
48085000114,1971,1501,1115,277,40,57,33,1,386
48085000111,9490,7145,3815,1294,825,174,1056,9,3330
48067000002,527,416,314,14,64,17,3,3,102
48067000014,3014,2360,1955,61,239,78,20,4,405
48067000016,746,566,470,26,40,29,3,0,96
48093000009,306,246,176,65,2,3,0,0,70
48093000007,596,471,314,148,3,10,1,0,157
48097000037,2653,2013,1443,327,137,51,44,9,570
48097000026,1664,1184,658,344,87,69,30,0,526
48097000010,2293,1842,1627,121,9,61,11,0,215
48483000004,232,179,160,9,0,10,0,0,19
48329000411,5749,4153,3244,586,67,122,141,10,909
48329000409,3853,3047,1714,948,227,57,93,11,1333
48329000304,5782,4090,504,3066,485,75,29,8,3586
48201000736,51,38,0,35,5,0,0,0,38
48201000160,1200,930,42,328,561,28,11,0,888
48201000962,8276,8172,2021,2201,3946,11,48,3,6151
48201000162,4486,3182,205,2867,101,184,24,1,2977
48201000163,7048,5181,550,4482,107,142,35,2,4631
48201000208,5013,3580,346,2734,473,74,3,2,3234
48329000103,4953,3668,1946,1191,297,118,124,11,1722
48167000166,3972,3187,2393,468,126,84,116,6,794
48167000167,8885,7497,5547,929,474,176,349,9,1950
48167000455,3500,2640,1547,717,220,84,93,10,1093
48167000276,3095,2743,1964,417,180,67,125,4,779
48489000010,335,299,223,67,1,2,0,0,76
48219000033,191,125,89,32,2,2,1,1,36
48219000032,3435,2509,923,1416,132,56,15,2,1586
48219000015,826,657,441,187,3,13,3,1,216
48201000275,4578,3422,193,1878,1327,73,87,9,3229
48201000057,4536,3714,2775,600,67,108,147,4,939
48201000269,2987,2612,2002,261,132,28,165,4,610
48201000096,6487,4120,205,2218,1700,84,30,21,3915
48201000913,724,511,29,351,72,16,59,1,482
48201000881,21352,14394,1792,6656,4948,371,1054,27,12602
48167000197,1914,1431,829,421,127,43,24,3,602
48167000394,84,54,18,10,21,0,4,0,36
48167000165,9256,6267,4113,970,493,147,554,4,2154
48167000306,8018,6908,3901,1312,936,203,603,19,3007
48167003061,29,22,11,11,0,0,0,0,11
4839100002B,341,277,174,92,3,16,0,0,103
48143000044,2918,2210,1876,220,19,77,11,0,334
48143000021,2831,2130,1267,773,15,53,12,2,863
48143000012,1929,1482,1249,146,32,41,26,0,233
48143000023,1011,761,486,246,3,21,5,1,275
48143000020,2451,1762,1050,650,24,61,6,4,712
48143000019,2342,1838,1435,315,29,40,10,3,403
48285000019,631,493,400,58,21,4,0,1,93
48177000009,1663,1268,435,677,125,56,7,1,833
48177000005,888,697,525,99,51,14,4,0,172
48451000327,5315,3934,1644,1949,247,104,44,8,2290
48451000308,703,539,177,327,25,6,11,1,362
48451000434,2294,1718,691,886,78,68,28,0,1027
48451000402,5339,4243,2311,1357,300,138,173,39,1932
48451000305,90,76,37,35,0,2,4,0,39
48241000019,2498,1966,1438,89,380,33,17,1,528
48241000011,605,462,410,20,24,6,0,0,52
48241000006,1954,1516,815,235,433,34,8,7,701
48157001054,1078,759,181,498,57,18,22,2,578
48157003150,13209,9358,1844,1986,3183,130,2365,11,7514
48157004117,12682,8402,2009,1593,2576,130,2182,12,6393
48157003083,8709,6079,1524,1223,1801,97,1517,10,4555
48339000001,4368,3075,1419,1141,351,109,61,15,1656
48339000085,6642,4929,3205,1410,136,194,29,5,1724
48339000063,7788,6041,5124,523,118,143,81,17,917
48339000038,8015,6202,5183,503,161,162,161,8,1019
48339000045,3734,2902,2014,515,126,99,176,16,888
48339000084,10209,7886,3579,2182,1012,224,911,56,4307
48483000005,120,94,81,9,1,3,0,0,13
48347000047,1225,1029,973,11,0,27,0,1,56
48347000046,1455,1086,837,116,77,35,9,1,249
4839700002A,6167,4882,3427,638,446,180,233,4,1455
48397000002,6224,5054,3776,566,345,148,223,18,1278
4839700003C,3760,2823,2341,216,79,70,104,6,482
48397000003,1161,970,564,169,209,31,9,4,406
48241000010,2829,2169,1949,86,48,70,2,1,220
48339000076,7761,5832,4472,747,246,142,190,11,1360
48339000054,5263,3491,1393,1856,107,196,26,3,2098
48339000052,9815,6889,3547,2833,232,284,91,14,3342
48339000009,2768,2087,1599,179,190,85,29,7,488
48339000031,6151,4942,3619,643,175,84,407,16,1323
48157003019,1357,1057,658,206,135,22,27,4,399
48157001008,1448,1205,736,349,97,29,9,1,469
48157003144,7661,5306,2615,859,255,75,1484,4,2691
48157003145,5747,4027,1621,953,439,50,957,4,2406
48339000100,7308,4739,2872,780,648,129,307,37,1867
48339000088,7272,4812,2724,900,618,141,466,29,2088
48339000046,10201,6754,3773,1273,950,136,623,23,2981
48339000047,7355,5259,2764,1474,605,167,275,25,2495
48339000014,8970,6437,2890,2956,286,271,144,14,3547
48339000036,6723,4762,2884,1605,119,169,46,10,1878
48339000094,4321,3442,1745,957,473,115,170,17,1697
48339000072,4507,4006,3555,220,70,66,66,4,451
48339000039,7280,5363,4401,585,107,179,73,18,962
48339000090,8589,5927,4797,649,176,170,104,7,1130
48339000041,7011,5063,3592,1166,113,181,32,5,1471
48339000007,3434,2585,1720,667,71,141,19,2,865
48339000043,7772,6016,4648,723,276,163,180,18,1368
48339000024,4983,3755,2308,690,523,118,141,11,1447
48339000035,9130,6850,3768,1896,751,211,310,20,3082
48339000033,4482,3955,2922,484,126,79,321,4,1033
48339000080,8437,5992,3974,1151,421,136,304,15,2018
48339000056,4912,3468,2244,639,222,125,272,12,1224
48339000096,11440,8072,4075,2105,963,270,763,13,3997
48339000015,6811,5393,4024,781,219,143,221,17,1369
48157001010,7055,5153,3188,1475,340,130,52,7,1965
48399000003,2227,1702,1088,514,38,55,17,5,614
48477000205,3852,3012,2322,228,317,39,106,2,690
48477000419,838,637,423,115,56,10,32,3,214
48329000305,4083,2734,230,1667,788,44,37,2,2504
48085000226,6834,4796,2698,592,864,123,551,5,2098
48085000213,7079,4330,1736,506,565,97,1425,24,2594
48085000163,11209,7550,3240,932,979,114,2293,10,4310
48085000209,2043,1275,528,139,135,27,456,7,747
48475000002,2907,2137,1072,926,97,40,26,6,1065
48381000325,6174,4461,3510,668,57,137,68,4,951
48381000324,7056,5503,4364,734,135,200,80,7,1139
48381000110,7112,5615,4350,956,54,201,44,2,1265
48381000305,4185,3147,2425,499,68,102,32,1,722
48381000307,5504,4204,3354,563,65,109,72,9,850
4847500004E,2133,1612,652,877,61,45,8,3,960
4847500004M,420,298,173,106,4,15,2,2,125
48381000112,7394,5378,3247,1573,344,217,54,7,2131
48219000043,460,340,221,96,9,9,3,0,119
48217000018,323,248,174,48,11,11,0,0,74
48167000277,3790,2961,2390,421,26,100,15,8,571
48331000212,3617,2827,1385,797,591,43,17,6,1442
48331000101,4060,3086,1992,758,262,61,22,7,1094
48331000420,3026,2365,1829,356,75,62,16,3,536
48339000018,8849,6418,4184,1684,280,233,75,8,2234
48339000030,3962,2957,2371,344,120,74,60,4,586
48339000091,3179,2357,1791,383,79,68,20,0,566
48339000087,6654,4343,2805,673,410,117,373,21,1538
48339000092,8298,5541,3054,1130,844,117,437,15,2487
48399000001,2355,1795,1086,598,44,48,13,5,709
48399000005,224,186,160,19,1,5,2,1,26
48399000002,168,128,87,35,1,6,0,1,41
48205000401,2078,1803,848,727,189,22,13,2,955
48205000301,1151,866,690,145,12,14,10,4,176
48347000044,2837,2146,1691,302,89,57,12,1,455
48005000029,2177,1665,1450,156,34,21,10,0,215
48347000043,2098,1560,1052,282,163,52,14,2,508
48223000002,2684,2011,1297,424,209,74,11,1,714
48329000306,4300,3115,216,2478,385,67,21,5,2899
48329000308,9539,6929,1056,4106,1645,221,102,12,5873
48481000201,3472,2674,2021,514,91,44,10,0,653
48481000103,3405,2537,1256,1037,197,58,21,0,1281
48481000302,4300,3067,1529,1301,186,55,32,1,1538
48481000401,5605,3928,1104,2194,599,57,21,3,2824
48505000003,3689,2549,350,2173,3,31,8,1,2199
48505000002,2759,1866,129,1727,5,13,7,3,1737
48019000204,2316,1944,1452,380,17,62,20,0,492
48145000105,1348,1004,559,166,260,20,4,0,445
48481000101,4033,3131,1300,1169,605,60,23,2,1831
48447000002,356,288,245,34,1,11,0,0,43
48481000403,1346,1012,386,450,159,11,6,5,626
48505000001,2937,2121,113,1995,3,13,6,3,2008
48481000303,2946,2268,1580,534,103,50,10,3,688
48119000005,1273,986,767,98,57,56,9,4,219
48119000003,893,648,464,39,112,30,7,4,184
48189000110,519,403,261,126,3,7,3,0,142
48189000112,2221,2051,827,874,336,15,9,3,1224
48189000305,1546,1214,740,414,27,18,11,6,474
48189000101,680,517,164,323,24,17,1,0,353
48189000202,954,692,75,522,83,25,1,2,617
48339000006,6212,4292,2681,799,209,44,557,1,1611
48339000003,11094,7800,4392,1887,586,178,767,11,3408
48339000097,4297,3216,2684,336,63,69,67,4,532
48339000089,7286,5178,3866,750,180,157,204,22,1312
48157003038,12075,8055,3030,1983,714,149,2243,21,5025
48157003146,13078,8191,3130,1705,737,100,2499,8,5061
48157003095,8445,5818,1993,1296,1327,81,1162,4,3825
48157001048,5115,3628,517,2196,871,75,53,8,3111
48157003143,13665,8513,3117,1672,701,108,2887,9,5396
48157003159,6676,4183,1251,843,385,49,1650,5,2932
48157003057,8892,6255,2887,1201,1318,130,743,7,3368
48157003142,8001,5262,2153,1043,279,84,1712,10,3109
48157002108,9605,7559,1117,834,3442,93,2183,14,6442
48091000306,5177,4152,2458,1301,197,108,130,11,1694
48091000304,8908,6716,3454,2748,257,199,158,8,3262
48091000305,5794,4148,2362,1420,146,138,107,30,1786
48091000106,6538,5104,3981,817,91,139,70,8,1123
48091000105,5793,4749,3614,834,45,182,53,20,1135
48091000107,4043,3134,2335,521,148,64,70,4,799
48091000405,7195,5556,3985,1181,79,225,67,15,1571
48091000104,2760,2380,1950,269,42,82,26,3,430
48373000019,1879,1784,1636,58,15,41,12,0,148
48085000141,4302,3369,1793,363,367,63,771,5,1576
48085000173,709,523,450,17,21,14,22,1,73
48085000012,2786,2097,1617,184,118,56,103,7,480
48085000203,3914,2968,2373,259,176,64,106,7,595
48085000122,6470,4868,3844,348,257,84,322,13,1024
48085000205,36,24,13,1,1,1,8,0,11
48329000106,7216,5256,2004,2597,396,126,152,19,3252
4832900108A,837,649,329,276,14,30,13,0,320
48329000102,7746,5277,2436,1996,413,140,328,12,2841
48329000101,1916,1392,698,565,52,45,24,1,694
4832900109A,28,19,6,13,0,4,0,0,13
48329000108,1713,1252,590,551,54,24,23,2,662
48329000406,3775,2963,1755,744,137,52,259,3,1208
48329000309,1745,1162,232,776,131,34,8,0,930
48329000109,1867,1290,350,810,73,54,27,4,940
48329000110,4287,3041,2296,465,39,67,178,0,745
48399000010,503,380,301,67,1,6,1,0,79
48219000011,1247,926,611,255,38,27,9,1,315
48219000045,2599,1916,856,971,54,52,6,4,1060
48091000403,7706,6566,5192,944,100,218,101,11,1374
48091000206,8410,6379,4601,1332,161,189,111,12,1778
48273000024,2984,2626,562,1561,280,47,209,0,2064
48273000031,2522,1922,600,1161,78,29,64,2,1322
48297000013,678,557,436,90,2,21,2,0,121
48131000002,1366,1089,45,1029,2,6,3,1,1044
48451000421,5020,3959,2550,957,191,107,174,4,1409
48451000420,953,654,408,183,14,14,35,1,246
48451000423,2023,1585,1243,225,36,43,46,2,342
48451000241,6901,5589,4304,842,183,154,128,19,1285
48451000424,3675,2903,1716,867,129,79,114,1,1187
48373000006,7236,5875,5062,352,130,203,54,4,813
48373000016,6945,5269,4029,726,318,145,30,2,1240
48373000005,7735,6987,3695,1525,1577,109,81,4,3292
48187000113,2018,1566,930,556,16,55,11,2,636
48187000117,7988,5573,3521,1596,218,167,149,21,2052
48187000114,1919,1423,719,632,33,33,12,5,704
48187000208,5996,4520,2925,1296,141,98,69,3,1595
48187000213,5320,3695,2169,1208,156,123,79,13,1526
48187000206,5895,4353,906,3297,74,172,32,8,3447
48187000307,6449,4708,2354,1163,845,162,253,38,2354
48187000303,1911,1530,931,322,169,68,67,3,599
48131000007,239,200,42,145,2,2,0,0,158
48131000008,2526,1817,272,1442,16,34,24,1,1545
48187000106,5108,4031,2350,1320,179,107,100,8,1681
48187000226,617,496,206,267,14,16,0,0,290
48187000120,1693,1369,914,367,36,50,14,4,455
48187000216,76,54,36,18,0,0,0,0,18
48187000115,451,332,230,85,3,22,2,0,102
48187000126,40,26,19,7,0,0,0,0,7
48187000407,2872,2199,1526,503,88,68,12,2,673
48187000119,2507,2044,1355,589,41,55,23,1,689
4832900307A,456,336,169,141,14,15,6,2,167
48329000307,2096,1579,750,696,78,53,15,5,829
48347000041,1888,1342,618,217,439,49,41,2,724
48347000034,179,162,76,11,72,3,0,0,86
48347000017,1063,895,563,69,217,22,34,1,332
48103000001,1105,821,373,433,4,18,2,0,448
48103000002,944,677,257,405,5,9,3,0,420
48197000004,913,720,563,103,29,17,2,0,157
48197000002,889,676,494,115,47,18,5,3,182
48197000001,951,739,543,136,37,20,11,1,196
48487000020,2680,1945,968,763,133,77,32,2,977
48487000001,3421,2557,1636,606,136,93,112,6,921
48111000006,831,586,275,289,13,19,1,0,311
48111000007,1591,1137,416,668,27,38,5,0,721
48111000008,1673,1153,601,523,15,20,1,1,552
48111000001,767,533,352,169,3,15,1,0,181
48025000001,3209,2467,898,1427,66,65,47,6,1569
48359000101,271,90,59,17,14,8,0,2,31
48201000509,11344,8721,3882,2867,1215,225,660,15,4839
48201000715,3549,2658,702,910,692,65,330,10,1956
48201000718,6959,5437,3059,737,233,61,1330,7,2378
48187000403,4711,3734,1897,1267,337,137,163,14,1837
48187000402,3382,2523,1219,962,218,98,81,5,1304
48187000411,5519,3858,1910,1030,599,95,252,36,1948
48187000308,2911,2170,1352,507,173,62,86,6,818
48187000409,9188,6289,2501,1824,1539,181,424,69,3788
48187000305,6675,4917,2488,1358,698,157,297,32,2429
48187000304,5389,4166,2368,1077,452,140,204,18,1798
48273000042,1434,1011,87,889,26,16,13,1,924
48273000041,918,668,52,607,6,10,4,0,616
48143000047,2054,1642,1310,220,45,47,35,0,332
48143000046,1637,1261,872,291,33,45,21,0,389
48143000024,1068,887,776,66,10,15,18,1,111
48313000404,2712,2104,1707,255,60,49,24,1,397
48219000014,1178,896,585,277,11,14,3,2,311
48187000223,479,372,198,154,18,7,2,0,174
48359000303,409,309,229,70,4,8,4,1,80
48161000002,2362,1760,1028,323,364,45,9,2,732
48093000001,2492,1887,1363,445,13,57,21,2,524
48093000012,2975,2347,1737,525,20,61,5,7,610
48093000014,160,130,114,11,0,3,1,0,16
48093000005,1015,806,629,157,3,24,2,0,177
48093000004,134,102,94,6,0,0,0,0,8
48093000013,330,276,242,27,0,5,1,0,34
48115000013,234,168,137,29,3,5,0,0,31
48329000212,2878,2141,1052,867,154,63,30,3,1089
48489000008,1401,1042,72,959,5,6,4,0,970
48489000006,665,494,48,438,10,6,9,3,446
48329000303,864,608,112,444,31,22,9,0,496
48273000035,1746,1310,301,1000,1,14,2,0,1009
48273000045,1156,859,36,817,6,17,4,0,823
48187000408,7786,5553,3360,1691,192,165,164,42,2193
48187000401,3245,2464,1355,856,116,59,69,14,1109
48187000215,1468,1006,630,242,81,15,34,0,376
48187000121,119,106,82,13,7,6,0,0,24
48187000122,57,47,42,2,0,1,0,0,5
48187000116,4156,3309,1991,1144,62,105,21,8,1318
48187000301,6243,4301,2086,1167,807,161,194,30,2215
48187000404,6016,4218,2093,1304,603,117,186,31,2125
48187000109,973,763,556,152,17,29,5,0,207
48055000201,1816,1332,645,586,66,24,14,4,687
48187000302,8057,5538,2571,1760,820,218,292,41,2967
48273000023,2669,1968,301,1434,88,48,132,1,1667
48329000401,2156,1535,993,451,22,37,13,11,542
48135000207,2996,2236,1552,570,34,57,17,4,684
48489000007,1925,1385,139,1215,22,26,6,0,1246
48489000011,3832,3449,475,2443,392,8,139,1,2974
48465000010,4101,2938,274,2610,39,54,23,1,2664
48465000013,2257,1835,1082,518,132,45,85,13,753
48465000021,3617,2515,69,2437,15,33,1,1,2446
48465000024,3120,2164,197,1945,9,31,11,3,1967
48465000040,8144,5989,487,5409,57,92,29,5,5502
48465000031,7364,5285,1518,3417,155,155,144,17,3767
48465000033,3317,2508,942,1502,27,45,13,4,1566
48127000001,2314,1664,214,1377,35,27,26,3,1450
48329000302,8796,6210,1829,4177,82,188,21,9,4381
48439004067,3006,2289,155,2080,45,50,10,1,2134
48439004017,9380,6273,682,4537,880,124,134,21,5591
48439004073,1241,843,357,263,208,11,18,0,486
48439004686,0,0,0,0,0,0,0,0,0
48439003041,6040,4496,2280,1215,601,184,262,49,2216
48439003575,12,10,3,0,5,0,0,0,7
48439003585,31,28,7,8,6,3,2,0,21
48439003665,21,12,10,2,0,0,1,0,2
48439001061,641,444,51,200,174,15,14,0,393
48439001678,76,50,12,29,8,0,2,0,38
48439004410,5506,4363,1879,980,790,123,623,31,2484
48439003671,987,797,627,85,33,25,27,0,170
48439003240,5236,3656,1998,778,413,104,376,7,1658
48439003552,7015,4814,2500,861,722,152,614,22,2314
48439002223,2293,1851,1387,156,156,47,107,6,464
48439004107,2920,2069,168,1745,114,59,51,4,1901
48439001412,0,0,0,0,0,0,0,0,0
48439001477,3863,2599,141,1890,563,68,21,0,2458
48439001104,4887,3589,311,1317,1863,92,82,13,3278
48303000111,3136,2260,1586,442,86,48,86,9,674
48303000154,6161,4200,2642,1018,175,98,278,4,1558
48303000140,6383,4635,3367,853,106,109,199,1,1268
48303000035,872,710,521,159,10,28,2,0,189
48303000038,2938,2135,649,1258,203,45,5,4,1486
48439002426,3468,2588,1685,344,336,109,127,4,903
48439004259,1416,1181,1003,77,22,58,24,2,178
48439001071,5742,4801,1991,918,1656,106,220,11,2810
48439001366,0,0,0,0,0,0,0,0,0
48439003333,8164,6490,4357,964,628,214,302,42,2133
48439002453,4626,3349,938,520,1468,60,382,4,2411
48439004371,3321,2582,2111,238,43,74,90,11,471
48439004395,1240,977,806,104,19,36,14,1,171
48439001244,306,205,115,56,17,17,4,2,90
48439001578,3755,2497,524,762,1149,88,51,3,1973
48439001621,225,150,30,40,76,2,6,1,120
48439001577,3833,2435,217,1555,641,82,21,9,2218
48439001301,3587,2587,293,915,1316,64,49,1,2294
48439001439,600,310,25,86,200,5,0,1,285
48439001084,0,0,0,0,0,0,0,0,0
48439001427,16,13,10,2,1,0,0,0,3
48439002299,3164,2259,341,339,778,39,793,4,1918
48439002379,6345,4489,899,835,1838,113,881,11,3590
48439002302,4720,3099,400,1120,1363,96,214,20,2699
48439002320,4327,3189,571,878,1120,76,626,4,2618
48439003336,6617,5203,1813,780,868,119,1609,48,3390
48439003389,6249,5003,2664,735,729,124,770,42,2339
48439004006,1877,1586,783,283,464,30,43,7,803
48439003325,1763,1372,896,312,51,81,34,9,476
48439003289,5269,3960,2248,1137,229,167,223,3,1712
48439003037,3747,3029,2331,331,153,76,142,12,698
48439003114,4991,4134,2730,965,154,134,155,13,1404
48439003038,8104,6035,2881,2262,508,198,293,17,3154
48439003396,4541,3430,2455,292,162,90,412,8,975
48439003469,1450,1203,1018,71,58,20,45,1,185
48471000401,8769,7719,3595,1942,1876,117,167,22,4124
48471000206,1977,1540,865,230,325,59,57,7,675
48097000002,430,337,226,89,11,4,2,3,111
48187000105,4851,3730,2232,1264,113,78,18,6,1498
48487000019,2981,2341,1306,590,324,59,92,4,1035
48487000021,3805,3078,1983,514,324,95,188,4,1095
48111000009,1973,1404,554,768,38,50,13,3,850
48147000018,5732,4511,3404,519,350,196,54,4,1107
48147000019,3168,2363,1816,228,205,97,18,5,547
48181000308,1968,1467,1112,245,19,75,6,1,355
48181000202,5984,4707,3580,505,278,290,58,2,1127
48181000104,1220,965,803,83,13,53,15,2,162
48439004533,3497,2486,986,1130,123,81,203,1,1500
48439004724,1567,1146,896,155,23,40,24,2,250
48439004044,6698,4613,2843,977,473,133,207,24,1770
48439001278,4178,3176,586,441,2025,63,113,10,2590
48439001279,3740,2778,754,645,1279,66,94,4,2024
48439003696,7181,4808,2918,994,410,129,366,18,1890
48439003372,6546,4447,2681,702,402,139,542,39,1766
48439003422,3754,2474,1628,215,133,59,429,1,846
48439004045,3455,2710,2233,282,53,86,57,6,477
48439004048,2135,1548,121,1329,85,59,12,1,1427
48439004051,23,12,5,2,2,1,0,0,7
48439003570,5565,3969,2270,650,417,95,521,19,1699
48439004588,6437,4648,2654,826,466,117,617,9,1994
48439004234,4583,3363,2275,486,236,131,291,8,1088
48471000103,2590,2016,1264,385,299,53,20,2,752
48471000104,2803,2247,1668,339,168,56,12,0,579
48471000102,9435,8400,4295,1766,1992,158,243,7,4105
48471000304,10971,9684,5013,2138,2337,166,47,10,4671
48471000404,5019,3873,2974,299,455,109,23,2,899
48471000101,2534,2235,797,610,804,16,23,3,1438
48471000301,8614,7099,2468,2303,2098,171,85,9,4631
48439001025,4201,2987,706,1495,734,112,39,3,2281
48439002306,2531,2061,1521,247,175,71,65,5,540
48439001189,3788,2923,1198,996,487,84,192,7,1725
48439001481,1818,1251,137,1074,34,15,3,0,1114
48439001608,1158,894,675,163,21,19,18,0,219
48439001611,36,26,4,22,0,6,0,0,22
48439001062,24,20,18,2,0,0,0,0,2
48439001457,0,0,0,0,0,0,0,0,0
48439001434,0,0,0,0,0,0,0,0,0
48439001108,2676,2193,1733,250,77,35,95,1,460
48439001408,372,311,113,169,12,11,5,4,198
48439001633,75,66,28,38,0,0,0,0,38
48439001081,4168,4040,1656,440,1072,22,853,0,2384
48439001298,4990,4434,3356,537,205,123,202,8,1078
48439001154,6362,4431,848,965,1728,61,869,6,3583
48439001576,998,655,18,410,196,4,34,1,637
48439001603,6553,5497,1442,973,2180,115,809,41,4055
48439001012,3942,2945,1100,913,788,90,115,9,1845
48439001105,2007,1691,1086,282,245,31,56,5,605
48439001238,5300,3868,1154,1399,1140,109,127,9,2714
48439002523,2889,2160,511,689,608,57,331,6,1649
48439002451,495,351,112,84,137,10,11,0,239
48103000004,1357,947,270,645,14,19,6,1,677
48085000061,2121,1781,1207,216,145,47,166,2,574
48085000161,443,353,267,55,11,11,10,1,86
48085000150,2210,1589,1027,194,205,60,128,5,562
48085000162,318,271,213,43,5,10,4,0,58
48085000178,4198,2843,2021,409,167,62,167,8,822
48085000029,4679,2798,1988,294,244,67,213,3,810
48085000199,3775,2373,1790,152,171,52,195,3,583
48197000003,796,605,398,162,21,20,3,2,207
48105000002,858,635,333,287,4,20,8,1,302
48105000001,741,598,151,427,10,14,7,0,447
48105000004,737,559,104,439,10,10,2,3,455
48091000203,6446,5133,3802,802,261,118,140,12,1331
48091000207,2866,2180,1710,258,83,58,55,5,470
48091000103,4904,3832,3096,494,62,73,87,4,736
48439002405,7295,5211,1322,1057,1879,132,892,33,3889
48439002708,2942,2047,797,272,800,56,140,2,1250
48439002697,5935,4254,1694,585,1634,94,263,6,2560
48439002643,5954,3905,1357,665,1457,89,379,5,2548
48439002618,84,47,21,1,24,0,0,0,26
48439003567,7222,4978,3533,695,355,172,228,4,1445
48439003152,71,52,39,7,3,4,2,1,13
48439003363,5047,3522,2298,606,387,107,147,8,1224
48439004694,8262,5785,3208,1269,787,159,447,25,2577
48439003700,4655,2934,1863,524,411,101,61,11,1071
48439003043,5340,3571,2593,547,238,116,96,3,978
48439004115,743,586,531,21,8,7,16,1,55
48439004252,1622,1311,797,398,49,55,26,3,514
48439004178,5816,4733,2828,963,684,101,186,3,1905
48439004250,7477,5942,2962,1141,1207,158,499,21,2980
48439004604,22,15,0,7,3,2,2,3,15
48439004682,1009,720,141,532,7,5,40,2,579
48439004245,530,347,25,265,47,8,7,2,322
48439002228,2895,2340,1704,251,166,57,178,4,636
48091000205,6569,5292,3584,917,465,143,188,28,1708
48091000202,2329,1706,924,493,188,68,72,1,782
48091000108,2473,2127,1673,323,35,69,34,2,454
48091000302,8118,6417,3829,2206,183,186,75,11,2588
48091000301,11002,7936,2788,4599,333,222,109,18,5148
48091000101,5422,4374,3341,788,84,84,64,11,1033
48091000401,3373,2798,2246,417,47,62,25,2,552
48105000003,762,602,314,263,5,17,0,1,288
48373000014,1682,1264,1050,58,24,121,2,3,214
48451000124,3496,2500,503,1605,361,67,16,3,1997
48451000230,10422,8317,5054,2259,613,250,294,28,3263
48451000213,3830,2720,2257,351,19,56,20,5,463
48373000021,2283,1791,1207,325,189,56,21,2,584
48373000007,1402,1050,605,205,182,20,37,1,445
48303000010,2240,1966,872,654,271,79,124,5,1094
48483000001,215,182,169,10,1,2,0,0,13
48449000018,487,319,146,145,11,20,6,0,173
48089000103,965,715,494,156,53,10,2,0,221
48485000303,4217,3035,1013,947,987,147,30,5,2022
48485000412,900,711,636,40,4,28,3,1,75
48485000310,2591,1976,1716,124,28,95,14,4,260
48485000103,8215,5986,4197,748,440,208,415,29,1789
48485000114,18,14,11,1,0,1,1,1,3
48185000003,3776,2667,413,1247,973,68,11,2,2254
48207000009,353,279,257,11,4,6,2,1,22
48207000010,222,182,141,26,2,10,0,0,41
48207000002,1569,1309,788,404,93,23,7,0,521
48479000125,1657,1190,10,1173,7,13,5,0,1180
48161000005,4783,3942,2251,812,824,71,10,2,1691
48373000008,1633,1278,845,143,220,44,2,0,433
48089000402,4352,3261,1006,1567,658,61,3,2,2255
48245000034,1998,1581,92,130,1316,24,27,4,1489
48245000033,5299,4289,2010,1163,957,132,58,3,2279
48245000097,5,3,0,3,0,0,0,0,3
48245000010,1623,1224,252,440,503,33,22,1,972
48245000007,2544,1959,781,378,758,55,23,3,1178
48245000084,1753,1264,52,252,951,26,11,2,1212
48245000068,3537,2720,1494,252,818,46,113,2,1226
48245000001,3444,2393,233,743,1404,46,9,0,2160
484990001-2,3234,2772,2430,233,19,76,12,1,342
48491000413,931,725,497,193,14,21,2,0,228
48491000456,4127,3151,961,1628,508,79,36,1,2190
48491000426,3235,2366,1414,611,205,94,65,4,952
48491000429,3228,2409,923,1166,261,88,33,2,1486
48453000163,905,642,329,256,24,15,12,0,313
48491000415,2863,2253,1558,527,95,66,15,8,695
48491000311,4237,3016,1714,1149,58,99,32,8,1302
48491000425,1255,964,404,431,107,16,4,5,560
48479000344,8743,6507,423,5897,41,72,155,4,6084
48479000136,268,200,10,186,1,3,3,0,190
48181000404,5071,3949,3472,161,37,236,33,3,477
48181000402,4207,3261,2441,352,190,249,27,2,820
48025000006,1619,1250,537,651,13,40,10,0,713
48025000004,506,394,225,154,4,7,2,0,169
48025000002,253,222,134,71,4,6,6,3,88
48433000002,284,225,189,18,12,8,1,1,36
48151000010,769,602,370,180,40,13,6,4,232
48151000004,1075,831,633,172,11,13,1,1,198
48439003035,4674,3643,2899,294,75,122,246,4,744
48439001015,2077,1687,623,900,83,50,60,2,1064
48439004374,3524,2667,1482,641,212,86,280,14,1185
48439003032,2230,1758,1091,435,130,64,46,10,667
48175000031,1145,882,612,213,42,13,12,3,270
48175000011,1226,940,364,504,68,16,7,0,576
48439004634,2428,2363,1716,269,128,29,214,1,647
48439004493,2396,2251,1562,323,123,55,180,6,689
48439001099,2246,1597,331,765,450,30,36,5,1266
48439001414,67,57,20,21,16,0,0,0,37
48439001407,79,73,32,23,9,8,2,0,41
48077000024,459,362,338,4,7,16,1,0,24
48439002235,8615,6107,1178,3234,1152,260,499,26,4929
48439002659,38,26,10,14,0,0,3,0,16
48439002461,5779,4181,628,1728,1388,98,408,12,3553
48439002675,18,15,0,9,1,3,0,0,15
48439002381,2012,1489,235,416,777,21,76,4,1254
48439002181,4176,3288,2139,576,365,93,123,5,1149
48439001441,2078,1603,296,300,897,45,89,3,1307
48439003214,4911,3920,2277,752,378,129,390,19,1643
48341000101,5575,3868,1338,2260,83,185,113,2,2530
48341000202,2701,1878,1033,701,22,99,53,1,845
48187000209,2137,1594,197,1234,146,34,5,4,1397
48187000202,2313,1652,331,1140,179,29,2,3,1321
48187000222,24,16,0,16,0,0,0,0,16
48187000225,39,32,9,22,1,1,0,0,23
48187000207,2462,1741,450,1117,159,45,11,4,1291
48187000224,275,199,23,166,11,7,0,0,176
48131000001,2400,1724,93,1424,13,10,14,4,1631
48131000005,577,441,70,339,2,2,2,0,371
48131000009,1919,1586,231,1004,136,14,0,0,1355
48273000013,2127,1547,290,1197,46,21,15,2,1257
48273000032,1943,1405,309,917,143,32,26,2,1096
48273000043,2432,1842,341,1417,44,54,39,2,1501
48187000218,145,98,19,79,1,1,0,0,79
48187000405,3302,2526,1680,707,63,59,30,8,846
48187000406,2705,2126,1675,311,57,65,17,4,451
48127000004,101,87,13,74,1,1,1,0,74
48127000003,544,395,40,353,3,3,2,2,355
48127000002,2409,1718,178,1488,30,31,21,1,1540
48163000008,2058,1403,212,1169,8,22,0,1,1191
48163000003,1304,971,27,928,8,11,0,1,944
48287000101,3654,2632,1200,1050,318,78,17,0,1432
48287000404,1719,1282,596,446,202,35,11,2,686
48287000202,2673,1950,1231,518,159,26,17,1,719
48127000005,881,676,35,636,2,1,0,2,641
48163000010,3817,2827,532,1798,472,13,17,0,2295
48163000009,1943,1365,141,1201,4,9,1,0,1224
48163000002,2941,2555,130,2121,143,16,146,1,2425
48089000202,744,582,461,91,9,17,4,2,121
48245000029,2748,2052,1640,311,52,54,9,4,412
48245000092,1681,1337,841,149,294,22,36,1,496
48245000108,807,616,481,64,14,21,31,0,135
48245000032,291,260,201,14,16,9,27,0,59
48115000011,339,217,133,79,4,4,4,2,84
48297000009,1435,1090,498,551,10,28,4,0,592
48187000107,1694,1336,999,248,30,50,5,2,337
48187000127,9,9,7,1,0,1,0,0,2
48187000205,2044,1589,899,591,53,51,8,2,690
48447004005,117,94,88,3,1,1,1,0,6
4850500002A,594,436,27,409,2,8,0,0,409
48019000407,2931,2491,1881,453,22,71,17,5,610
48019000305,3253,2711,2069,477,32,97,24,8,642
48019000203,3077,2469,1911,407,29,93,40,7,558
48019000409,1272,1049,683,264,13,71,10,2,366
48019000410,546,471,416,45,1,11,1,2,55
48019000408,261,230,199,20,2,11,3,2,31
48145000304,1864,1440,821,369,196,31,18,0,619
48481000203,5081,3890,1124,1298,1418,58,35,1,2766
48145000204,1746,1287,209,339,733,24,3,0,1078
48287000302,2075,1577,1291,110,89,63,4,1,286
48287000405,890,622,516,45,47,9,3,0,106
48287000103,350,288,257,18,6,5,0,0,31
48465000030,2896,2049,322,1621,65,54,33,8,1727
48187000103,1117,902,555,286,31,23,3,4,347
48187000104,2115,1765,814,731,154,44,41,4,951
48439004338,7020,5057,2597,1338,643,164,387,15,2460
48439001056,1659,1405,557,168,612,68,15,9,848
48439001008,589,421,38,227,147,7,7,5,383
48439001010,1424,1087,242,478,337,46,12,1,845
48439002305,2918,2215,1275,295,426,52,173,1,940
48439002029,3604,2691,1600,389,446,79,192,5,1091
48439004499,8596,6234,2452,1929,989,204,758,10,3782
48439004162,1948,1317,252,903,46,22,113,0,1065
48439002474,1240,925,583,227,73,33,13,2,342
48439002721,3405,2607,1557,378,416,88,171,2,1050
48439002425,5513,4287,1908,737,1371,111,215,9,2379
48439001515,77,58,33,22,1,3,0,0,25
48045000002,333,255,182,62,6,5,1,0,73
48045000004,377,315,270,41,1,3,2,0,45
48065000201,1457,1121,957,99,22,44,15,1,164
48403000002,1711,1539,1435,38,22,43,4,1,104
48255000007,787,575,442,113,2,8,0,0,133
481770004/6,3025,2148,635,1412,66,32,17,2,1513
48177000013,505,390,263,114,3,4,2,5,127
48425000004,2216,1699,1402,226,9,43,7,6,297
4846700001B,5286,3974,3205,594,37,123,9,4,769
4846700001D,2159,1672,1388,163,23,72,9,2,284
4846700001A,2782,2205,1889,201,15,76,13,3,316
4846700003B,3225,2445,1769,292,304,71,10,0,676
4846700002C,3816,2975,2608,207,38,97,22,3,367
4846700002B,2254,1815,1601,111,24,61,8,0,214
48001000004,2306,1821,1605,82,63,64,4,3,216
48493000310,1199,944,651,253,6,31,10,0,293
48493000311,2935,2280,1729,432,44,67,16,3,551
48115000002,2500,1786,492,1200,70,27,11,2,1294
48115000001,3804,3186,901,1588,664,27,10,0,2285
48491000428,4896,3612,2179,1036,279,118,40,5,1433
48491000427,4262,3399,2079,952,237,170,45,4,1320
48491000489,7725,5323,2942,936,530,118,806,10,2381
48491000488,4944,3475,1979,689,273,82,503,8,1496
48491000480,9682,7220,3479,1962,891,187,757,18,3741
48491000314,6205,5264,3259,1293,485,129,131,19,2005
48491000370,10700,7973,4765,2412,402,276,184,26,3208
48491000344,7600,6115,4829,660,232,137,246,21,1286
48491000368,9134,6897,3411,2156,716,156,544,29,3486
48491000197,4772,3170,1479,317,71,34,1264,10,1691
48491000140,2818,2045,1382,299,75,33,240,4,663
48491000392,7818,6106,5014,620,175,131,161,7,1092
48491000379,6057,4814,3857,575,122,111,128,11,957
48491000423,7442,5616,2491,2172,607,207,244,21,3125
48491000150,5638,4374,1889,1764,524,135,124,19,2485
48491000135,7182,5695,2182,2260,749,199,380,17,3513
48491000455,5174,4047,1620,1822,425,146,119,22,2427
48491000119,5802,4286,2472,1259,292,120,201,9,1814
48491000145,6891,4864,1682,2257,669,171,213,25,3182
48075000201,1432,1093,792,222,30,42,6,6,301
48187000102,1603,1278,777,399,74,17,14,0,501
48187000201,1178,869,262,533,60,9,8,1,607
48187000111,209,191,84,96,11,0,0,0,107
48187000110,271,243,143,87,9,2,0,0,100
48187000212,221,182,70,85,21,0,0,1,112
48145000403,1768,1319,820,359,94,48,6,3,499
48145000405,1183,909,549,206,128,28,1,3,360
48505000004,3627,2428,63,2352,12,35,5,1,2365
48019000306,1622,1397,1181,159,9,37,3,0,216
48447003003,383,284,256,21,1,5,2,1,28
48379000306,1743,1376,1064,147,94,49,16,1,312
48379000407,1524,1209,1079,57,17,41,12,0,130
48379000101,1932,1558,1349,110,21,48,11,1,209
48075000401,1438,1064,765,226,28,35,22,5,299
48075000301,2310,1979,905,664,373,29,24,4,1074
48491000204,9128,6300,3873,941,319,137,1026,15,2427
48491000254,6107,4656,2938,1113,210,158,276,18,1718
48491000201,13780,9240,4181,1150,440,125,3307,18,5059
48491000266,8987,6961,4107,1210,590,149,960,12,2854
48491000202,3757,2678,1484,258,115,56,765,6,1194
48491000274,13228,11013,5471,2078,1077,244,2258,27,5542
48491000186,5958,4018,1315,436,129,59,2065,9,2703
48491000147,7531,6266,3230,1139,678,161,1094,12,3036
48491000206,6551,4750,3590,745,134,185,106,9,1160
48491000267,12636,8769,5911,1706,477,289,443,29,2858
48491000207,9185,6583,5060,1011,146,217,153,26,1523
48491000190,7001,5020,3351,647,236,114,675,10,1669
48491000434,5077,3965,2961,763,116,116,29,7,1004
4846700003C,6307,4767,3809,621,165,144,31,11,958
4846700003D,4294,3369,2970,198,61,96,28,6,399
48255000001,2373,1771,604,1080,69,36,19,10,1167
48255000011,878,675,310,330,15,11,20,1,365
48255000012,2043,1726,572,785,250,31,57,1,1154
48255000005,1236,896,328,543,14,20,4,2,568
48329000202,10694,7194,4492,2419,57,208,43,3,2702
48493000102,3277,2379,593,1687,47,79,28,4,1786
48493000104,1842,1431,824,535,30,45,19,4,607
48493000207,3147,2407,1371,928,44,78,14,7,1036
48493000414,3895,2951,1904,918,38,80,15,2,1047
48493000206,3897,2958,1372,1457,67,59,29,6,1586
48493000416,4043,3117,1704,1202,93,91,49,4,1413
48493000415,6247,4530,3119,1050,180,164,58,14,1411
48151000012,863,697,486,168,22,16,6,2,211
48179000007,4788,3549,1987,1201,207,134,29,1,1562
48179000005,4532,3368,2581,556,76,100,57,2,787
48491000263,9959,7071,4194,1657,548,237,503,27,2877
48491000259,9732,7069,4455,1501,523,184,424,21,2614
48453000370,3299,2503,1715,608,35,104,30,6,788
48491000182,6541,4248,2723,407,181,54,858,3,1525
48491000172,4138,2678,1370,275,113,49,882,2,1308
48491000332,8123,5234,3122,532,252,119,1218,2,2112
48491000333,6881,4657,2881,833,312,119,529,10,1776
48491000345,5397,3799,2896,445,128,93,225,13,903
48491000343,7193,5749,4042,896,257,170,420,13,1707
48329000403,5011,3622,2571,711,117,95,129,4,1051
48367000315,5867,4669,3883,383,88,130,132,9,786
48367000445,2733,1892,1685,102,31,40,32,2,207
48491000146,7684,6213,3552,1188,488,171,878,6,2661
48215000010,4712,3467,197,3248,20,33,7,0,3270
48215000053,11127,7689,355,7118,64,123,165,2,7334
48215000158,10673,6953,227,6558,55,102,106,0,6726
48215000194,3953,3106,899,2183,14,41,5,0,2207
48215000195,2126,1618,722,885,2,19,6,0,896
48215000145,2044,1486,27,1453,3,23,2,0,1459
48215000170,1969,1329,13,1308,4,4,1,0,1316
48215000251,29,18,1,17,0,0,0,0,17
48491000287,7095,5424,3692,1018,350,129,260,19,1732
48491000283,9240,6734,3828,1826,470,287,397,29,2906
48491000305,4872,3744,3079,378,112,90,87,8,665
48491000309,2252,1795,1421,288,24,31,26,4,374
48465000011,3456,2530,102,2402,26,40,3,3,2428
48465000020,162,138,97,33,1,8,1,1,41
483930004-2,89,75,69,1,2,1,0,0,6
48393000002,182,142,128,6,2,5,0,0,14
48215000179,1435,894,14,880,1,8,1,0,880
48215000239,6407,4395,398,3955,23,75,15,0,3997
48215000088,12858,8548,195,8326,34,139,6,1,8353
48215000211,4803,3235,108,3079,34,48,19,0,3127
48215000212,1255,841,94,729,7,17,8,1,747
48215000065,2323,1600,89,1299,15,8,203,0,1511
48215000161,3776,2851,154,2492,33,69,173,1,2697
48215000162,455,330,11,304,4,9,10,0,319
48215000163,384,305,24,275,4,1,2,1,281
48215000076,98,61,12,46,1,0,0,2,49
48215000222,10,7,1,6,0,1,0,0,6
48215000105,6659,4669,291,4206,56,63,120,0,4378
48215000221,3139,2240,118,2084,13,39,26,0,2122
48215000223,949,573,69,475,11,6,19,0,504
48349000202,2743,1855,229,1282,296,59,8,27,1626
48349000200,1708,1247,299,360,542,32,10,37,948
48349000201,1449,995,133,124,694,8,6,30,862
48493000103,2738,2078,894,1113,30,62,10,5,1184
48077000008,1080,841,745,36,7,37,13,1,96
48077000001,1355,1040,922,41,13,52,5,1,118
48243000004,274,240,133,74,10,25,11,10,107
48243000001,661,566,406,140,3,19,3,1,160
48491000331,7661,5318,3185,963,275,146,771,15,2133
48491000330,6076,4425,3021,917,228,146,133,22,1404
48491000198,7598,5309,2688,626,287,104,1601,17,2621
48491000138,6734,5414,3224,1083,622,155,381,3,2190
48485000309,6009,4466,3927,241,48,164,50,5,539
48485000307,4371,4258,1493,1274,1462,22,26,0,2765
48485000317,104,97,86,5,0,4,0,0,11
48485000204,1002,809,677,78,3,35,15,4,132
48485000208,226,185,111,30,15,19,9,0,74
48485000201,7494,6280,3809,953,1065,142,360,69,2471
48485000406,4975,3806,2804,512,279,100,136,8,1002
48485000108,5617,4463,3099,527,536,115,176,12,1364
48047000004,1751,1227,103,1110,4,11,8,1,1124
48491000149,5906,4665,2309,1213,829,99,295,17,2356
48491000484,11231,7741,3849,1891,944,260,925,29,3892
48491000339,6320,4776,2249,1271,709,140,452,28,2527
48491000337,8199,5819,3133,959,565,119,1048,21,2686
48491000369,10357,7424,4157,2032,567,212,573,31,3267
48367000425,2044,1575,1254,214,24,80,9,2,321
48367000255,3508,2498,1934,312,91,93,47,15,564
48367000450,3331,2514,2088,269,31,74,26,6,426
48367000405,4472,3486,2982,294,45,108,46,6,504
48039000007,5426,3898,873,2416,553,97,31,0,3025
48039000014,7659,5784,3936,950,704,159,58,2,1848
48039000002,6044,4663,3024,888,580,120,49,3,1639
48039000040,7859,6066,3422,1724,596,175,171,14,2644
48039000058,5473,3753,1267,491,1179,61,800,4,2486
48039000036,3748,2622,889,1477,122,92,85,1,1733
48039000060,7611,5412,2305,1421,766,121,848,13,3107
48039000061,1448,1153,743,326,22,59,39,3,410
48039000057,5453,4078,2384,1372,104,143,73,2,1694
48329000105,4000,2859,923,1619,141,82,98,5,1936
48493000101,3206,2597,1218,1210,81,87,21,3,1379
48357000001,2321,1612,559,1022,5,53,8,1,1053
48357000004,2593,1821,850,909,11,69,7,5,971
48357000003,2612,1851,1170,611,4,69,8,0,681
48357000002,2489,1707,705,948,9,54,12,3,1002
48023000004,965,723,630,58,9,18,1,0,93
48023000003,809,632,522,68,15,12,2,4,110
48161000001,4636,3536,2603,399,401,117,46,8,933
48161000007,1278,980,677,98,178,20,4,5,303
48077000027,648,497,411,27,12,41,3,0,86
48485000211,331,256,181,64,7,3,1,1,75
48485000413,1666,1291,1025,142,70,54,3,1,266
48485000414,992,797,660,71,42,19,7,0,137
48201000543,3984,3018,242,2686,56,115,18,1,2776
48201000153,5556,3973,238,3489,243,175,23,5,3735
48201000495,3870,3104,1466,610,360,69,591,0,1638
48201000172,1543,1160,110,996,27,46,14,0,1050
48201000093,9665,6808,671,5829,226,229,69,6,6137
48201000328,5741,4078,397,3176,453,104,97,4,3681
48201000908,0,0,0,0,0,0,0,0,0
48201000222,3744,3132,2424,251,69,34,348,6,708
48409000115,6462,5060,3062,1681,122,127,82,8,1998
48089000201,4372,3466,2370,705,327,60,14,1,1096
48089000305,2401,1947,1406,342,160,29,12,2,541
48491000189,5885,3962,2018,672,175,80,1009,18,1944
48491000264,10585,7613,4667,1885,389,283,434,25,2946
48183000011,7548,5584,3494,994,865,137,68,6,2090
48183000005,6599,5226,3592,549,762,160,150,7,1634
48183000006,3892,2781,2064,213,272,63,153,1,717
48183000007,5578,3917,2803,404,502,141,72,2,1114
48183000004,4349,3538,2812,174,415,65,74,6,726
48367000210,2834,2209,1836,219,30,82,7,2,373
48367000140,1927,1446,1239,115,15,67,15,3,207
48367000240,2426,1880,1517,224,19,81,18,2,363
48367000230,2345,1777,1448,202,33,95,7,2,329
48039000012,5826,4289,1941,1736,316,107,237,9,2348
48039000017,5324,3873,1117,2300,408,120,22,3,2756
48039000043,8268,6375,3646,1643,543,150,402,13,2729
48039000030,4529,3766,2326,705,478,85,154,0,1440
48039000021,12915,9516,2596,3444,3069,245,333,33,6920
48039000063,6806,4712,785,1282,2169,104,449,5,3927
48039000053,4703,3143,557,688,1497,47,424,11,2586
48039000064,117,69,25,34,3,7,3,1,44
48039000009,5764,5351,2043,1633,1627,58,32,3,3308
48145000101,1571,1165,400,323,405,38,19,4,765
48001000022,1434,1150,944,71,84,27,24,2,206
48001000008,926,735,256,233,243,21,7,0,479
48149000025,3982,3136,2126,634,335,50,23,4,1010
48149000022,249,189,173,14,1,3,0,0,16
48149000017,557,468,409,42,5,12,3,1,59
48001000011,8669,8373,3078,2088,3155,44,38,4,5295
48485000203,4194,3431,2169,492,523,122,144,29,1262
48485000312,263,187,63,37,82,6,7,0,124
48485000306,1892,1369,360,255,684,33,39,4,1009
48485000311,4988,3770,1167,1261,1218,144,45,11,2603
48077000006,625,486,415,30,3,31,7,0,71
48047000002,1883,1541,356,1165,6,16,3,1,1185
48047000003,1299,944,63,855,6,11,13,0,881
4804700003S,379,325,24,290,4,8,1,3,301
48399000008,979,787,578,167,21,20,3,4,209
48399000004,784,606,320,257,24,11,3,6,286
48315000002,1733,1475,1225,55,108,78,13,3,250
48315000003,845,644,490,36,87,25,7,4,154
48315000008,1031,874,706,17,125,25,9,0,168
48193000009,255,201,188,7,1,5,2,1,13
48315000004,658,530,354,7,159,10,1,2,176
48315000007,1082,864,423,21,385,25,13,6,441
48405000001,1844,1454,832,147,479,15,5,1,622
48405000008,892,737,686,23,12,16,3,1,51
48183000002,5715,4657,3364,306,793,84,116,1,1293
48421000302,370,282,199,77,5,9,1,0,83
48009000001,1893,1434,1299,61,11,49,9,3,135
48009000003,528,400,328,53,4,21,1,1,72
48245000081,1139,834,10,107,708,6,8,0,824
48245000026,3896,3131,1718,423,720,78,215,3,1413
48245000017,4153,3216,1268,399,1295,66,210,2,1948
48245000090,73,60,14,11,29,3,7,0,46
48453000149,2524,2232,1417,429,107,97,180,10,815
48479000416,2310,1636,42,1586,10,30,2,0,1594
48479000310,648,488,12,472,4,5,2,0,476
48479000362,957,714,26,685,4,20,0,0,688
48479000363,1889,1337,32,1304,1,13,0,0,1305
48479000413,4316,3115,61,3043,15,22,3,0,3054
48479000453,1131,827,14,812,1,4,0,0,813
48479000405,3733,2578,22,2551,4,43,0,2,2556
48479000465,1696,1233,17,1210,3,27,6,1,1216
48479000403,2386,1640,31,1600,7,22,3,2,1609
48453000123,15897,10959,4902,2604,1825,282,1534,32,6057
48453000137,20780,14250,7232,3071,2074,400,1595,57,7018
48171000013,2598,2151,1726,347,11,52,9,0,425
48171000004,3538,2917,2305,480,24,78,44,2,612
48185000014,3232,2491,1824,489,52,82,15,2,667
48479000129,4432,3114,53,3041,11,48,3,3,3061
48157003130,8417,6063,2889,1460,421,116,1213,7,3174
48157003156,3252,2404,1754,276,106,57,210,5,650
48157003122,5103,3773,2721,455,125,67,390,3,1052
48157004135,10811,7674,1684,504,340,70,5081,14,5990
48157004158,4096,2899,371,159,119,9,2245,3,2528
48157004042,1426,1263,853,122,75,19,183,4,410
48157004026,4068,3154,1368,280,193,34,1269,14,1786
48157002023,5609,4103,100,2647,1306,135,67,2,4003
48421000301,243,167,114,45,3,8,3,1,53
48349000206,1077,799,573,136,39,43,7,1,226
48435000101,812,599,144,446,0,6,5,0,455
48453000133,3555,2827,1457,878,362,72,89,7,1370
48453000130,3447,2788,1236,1101,311,104,112,6,1552
48453000446,1431,1235,657,498,25,35,32,2,578
48453000425,904,803,435,262,45,35,35,0,368
48453000366,7376,5346,3599,829,156,116,641,17,1747
48401000416,1676,1292,835,338,91,27,8,0,457
48401000111,3320,2999,1714,406,834,41,12,0,1285
48401000212,1141,926,698,70,137,10,4,0,228
48401000112,4107,3200,2100,504,472,87,24,2,1100
48401000316,766,603,489,24,74,6,1,1,114
48401000114,2281,1725,1223,156,264,67,12,3,502
48401000417,2726,2006,1179,519,235,73,8,1,827
48049000308,715,572,509,30,1,22,2,0,63
48049000410,3607,2839,2200,426,96,114,20,8,639
48001000006,2173,1588,656,333,580,22,7,6,932
48149000013,1094,861,641,158,35,26,0,1,220
4814900001E,1594,1218,845,237,102,23,11,2,373
48149000016,2379,1825,1053,649,86,50,8,1,772
48049000307,907,731,608,90,5,19,7,0,123
48049000101,3796,2945,2229,523,99,69,39,4,716
48001000018,2845,2249,1840,107,195,77,13,4,409
48149000011,567,455,394,34,11,9,0,0,61
48149000014,301,253,187,52,5,10,0,0,66
48349000101,3960,2852,1330,833,542,87,40,62,1522
48349000308,418,386,346,24,6,7,2,1,40
48405000010,519,404,360,18,19,8,2,0,44
48273000014,815,567,109,437,18,10,17,0,458
48297000012,169,136,102,25,1,5,0,0,34
48131000006,192,147,12,132,1,2,1,1,135
48131000004,157,122,31,90,0,2,0,0,91
48273000033,866,670,219,428,5,11,7,0,451
48273000034,770,663,445,191,4,13,5,0,218
48207000001,515,397,311,60,10,11,4,2,86
48055000102,1162,886,576,274,11,14,7,2,310
48055000205,433,342,284,42,8,3,2,1,58
48055000204,2239,1663,1068,490,31,78,6,2,595
48401000213,2830,2185,1625,203,264,84,13,2,560
48401000318,1522,1160,842,89,200,23,7,0,318
48401000418,3345,2570,1770,418,312,80,1,2,800
48091000404,5641,4147,3038,806,91,121,110,11,1109
48091000406,6882,5825,4463,983,171,127,98,12,1362
48091000407,3721,2792,2267,390,27,71,38,2,525
48039000051,4445,3556,2401,670,176,67,225,6,1155
48039000005,3574,2713,1517,909,213,93,15,8,1196
48039000045,5212,3893,2501,981,222,86,97,3,1392
48401000215,3156,2324,1491,427,317,90,10,2,833
48401000315,1269,988,819,83,51,38,1,1,169
48005000005,3571,2649,1216,643,707,70,42,0,1433
48005000020,5251,3892,532,1487,1797,87,43,4,3360
48005000039,885,758,488,67,175,9,14,0,270
48005000036,21,16,14,2,0,0,0,0,2
48005000025,3599,2720,2020,445,183,71,17,2,700
48005000002,5341,3827,792,1468,1524,77,30,5,3035
48005000001,1303,891,317,369,198,28,7,0,574
48005000003,3842,2942,2070,605,169,83,17,2,872
48157001067,4975,3649,847,745,1149,68,912,14,2802
48157004062,4620,3817,1210,441,1077,64,1073,3,2607
48157002088,4853,3677,517,1375,1325,83,452,11,3160
48157002081,2626,1933,270,695,697,49,280,5,1663
48157001114,6942,5098,249,1578,3282,93,61,12,4849
48157001153,3437,2425,85,304,2014,22,52,4,2340
48157004147,13222,9168,1329,632,1259,47,5923,13,7839
48157004126,6025,4421,1049,661,985,62,1690,1,3372
48157004155,5464,4069,384,960,734,72,1970,1,3685
48157004071,1258,837,106,90,117,4,515,1,731
48339000055,4025,2692,1277,1296,65,134,18,5,1415
48339000025,7687,5610,3352,1872,120,318,78,13,2258
48339000053,7747,5727,3485,1629,357,161,123,19,2242
48339000016,7708,5495,3651,1516,69,227,43,4,1844
48157003006,18190,11773,6369,2302,1106,194,1798,12,5404
48157003148,19438,12547,6081,2753,1487,187,2047,21,6466
48157003149,6613,4991,3986,487,247,89,159,3,1005
48157001109,1777,1312,399,425,376,39,131,3,913
48157001058,3697,2512,325,786,1273,25,146,5,2187
48157001003,7839,5322,251,3806,1234,181,79,20,5071
48157001097,7699,5174,2557,753,994,81,788,3,2617
48157001076,9161,7025,1677,1106,1825,108,2397,15,5348
48157001141,4721,4138,2151,475,503,63,961,5,1987
48001000003,1925,1473,1151,159,97,48,15,2,322
48001000001,3153,2340,1347,284,632,46,40,0,993
48001000023,1689,1395,1236,67,45,40,4,3,159
48001000015,1317,1072,851,103,88,24,6,0,221
48001000013,3109,2276,1399,424,371,66,29,2,877
48001000020,2048,1539,853,414,203,63,22,0,686
48001000007,2928,2048,379,845,773,80,30,3,1669
48349000303,1774,1401,1070,136,132,45,13,5,331
48459000010,3326,2520,2196,124,75,99,14,2,324
48459000007,3836,2856,2187,306,179,140,29,1,669
48115000017,160,119,66,50,0,2,2,0,53
48161000010,515,398,314,43,31,7,1,0,84
48089000302,1276,1059,950,71,16,9,11,0,109
48249000010,3528,2547,149,2362,30,30,4,1,2398
48249000016,1413,1031,80,895,34,21,9,1,951
48249000017,2059,1572,207,1350,8,15,1,0,1365
48089000304,670,563,478,65,5,5,1,0,85
48209000234,3493,2448,595,1751,65,84,17,7,1853
48209000335,4420,3547,2888,496,25,122,30,11,659
48209000339,1460,1228,966,188,7,38,12,1,262
48209000330,2720,2263,1414,625,122,76,61,10,849
48209000334,5153,5093,1312,1470,373,46,1896,1575,3781
48209000318,122,116,79,31,1,6,0,0,37
48209000333,5112,4241,3522,472,39,128,47,4,719
48209000449,6403,4751,3692,734,77,146,87,8,1059
48209000421,92,72,54,4,3,9,3,0,18
48209000420,1557,1202,724,371,62,25,23,6,478
48209000225,1817,1450,1011,378,12,31,12,4,439
48209000419,3191,2279,1201,932,83,41,44,2,1078
48209000221,5040,3855,1973,1492,267,89,80,9,1882
48209000220,4658,3268,2146,817,119,112,105,12,1122
48209000231,7185,4894,1744,2627,362,152,147,11,3150
48209000233,2691,1899,541,1192,86,67,60,1,1358
48091000303,1402,1143,486,578,34,48,12,3,657
48459000015,2824,2107,1776,204,22,88,6,0,331
48459000013,1280,1012,721,84,167,41,9,0,291
48025000014,355,262,90,167,1,7,3,0,172
48025000013,2097,1586,577,984,11,15,7,4,1009
48025000009,1015,768,72,675,16,10,1,1,696
48115000003,2522,1852,1001,777,48,42,19,1,851
48115000004,2518,1851,867,903,52,43,16,1,984
48005000021,2729,2121,1239,607,292,35,0,0,882
48005000034,3295,2722,1901,256,352,46,165,7,821
48005000018,1244,1007,575,171,225,15,25,0,432
48005000040,1456,1102,567,223,265,33,23,4,535
48005000011,3095,2381,2062,163,68,85,9,2,319
4800500011B,2045,1482,1238,95,90,54,2,2,244
48057000025,985,889,748,114,2,12,3,2,141
48057000006,754,619,467,110,6,12,6,3,152
48057000024,1938,1553,1100,340,14,32,62,4,453
48005000037,839,592,422,106,51,9,4,0,170
48005000035,2476,1963,1407,210,259,45,47,1,556
48005000004,1766,1323,551,324,415,26,15,3,772
48367000345,3391,2590,2109,316,41,105,23,3,481
48367000130,6110,4572,3473,755,53,200,44,14,1099
48367000105,3129,2422,2018,265,17,87,28,4,404
48367000125,4278,3293,2667,390,28,166,13,1,626
48367000120,3555,2600,2165,259,30,130,24,3,435
48367000115,4247,3238,2647,353,54,143,29,1,591
48039000004,5774,4708,2718,978,892,88,40,5,1990
48039000032,4095,3191,2243,622,208,93,24,2,948
48405000011,591,435,27,21,383,1,5,0,408
48471000201,10379,9319,4045,2069,2803,140,330,19,5274
48433000001,326,257,200,43,5,10,4,1,57
48249000018,677,489,51,428,10,16,0,0,438
48249000002,882,649,283,340,10,16,0,3,366
48329000210,2621,1984,1080,632,177,47,62,5,904
48479000231,6739,4731,149,4538,10,49,29,0,4582
48479000252,7323,4919,102,4797,16,63,8,0,4817
4814900001W,1091,869,695,98,49,21,12,0,174
48049000105,2427,1875,1479,285,43,50,18,4,396
48049000417,2972,2502,2061,279,51,85,13,4,441
48001000024,1274,987,861,65,25,29,9,1,126
48245000042,3514,2682,2101,412,55,51,67,0,581
48245000060,5944,4319,2864,1044,157,106,151,2,1455
48245000057,1013,811,20,50,739,13,5,2,791
48477000320,2689,2171,1794,230,58,38,25,3,377
48477000307,2876,2199,1291,395,382,38,115,6,908
48245000003,3586,2547,116,400,2027,32,17,4,2431
48001000016,1184,915,718,65,97,27,8,0,197
48149000008,564,442,354,57,20,10,1,2,88
48113001311,4243,3117,1152,1421,423,124,85,4,1965
48113001310,7540,5367,1594,2419,1258,175,57,7,3773
48113001308,5262,3685,827,2229,563,157,66,5,2858
48113001304,3215,2334,662,1315,287,100,47,4,1672
48113003059,1443,1150,31,146,976,6,4,1,1119
48113003016,2856,2490,1018,500,832,72,86,10,1472
48113003095,0,0,0,0,0,0,0,0,0
48113003091,0,0,0,0,0,0,0,0,0
48113004013,416,334,259,36,4,1,25,0,75
48113002012,2137,1714,1405,188,26,41,59,4,309
48113004641,1130,850,271,526,14,27,26,0,579
48039000011,6752,4946,2000,1412,824,138,599,15,2946
48245000041,276,218,162,46,3,6,4,0,56
48245000109,367,252,229,19,1,0,3,0,23
48245000021,6021,5944,2229,1444,2275,5,18,2,3715
48245000064,1085,854,207,160,460,24,19,3,647
48245000107,3737,3717,851,1606,1246,16,32,0,2866
48399000007,1317,1040,698,292,32,22,1,0,342
48349000203,3229,2561,1640,332,481,57,31,5,921
48179000003,169,137,120,9,0,8,2,0,17
48001000010,6985,6772,2529,1842,2347,40,36,1,4243
48049000113,3926,3236,2214,667,278,71,20,1,1022
48349000301,657,491,227,163,53,19,7,32,264
48443000002,181,155,46,102,2,4,3,4,109
48443000001,183,153,66,78,3,3,1,3,87
48443000004,214,166,115,46,3,0,0,0,51
48443000003,182,142,84,52,2,2,0,0,58
48331000316,1020,806,609,77,86,24,14,1,197
48331000105,1876,1424,1034,321,35,33,2,2,390
48249000001,1044,814,138,650,10,21,4,1,676
48249000013,769,595,20,564,3,13,3,1,575
48491000342,2574,1914,896,768,209,40,38,2,1018
48491000310,3448,2571,1584,806,50,113,26,14,987
48491000312,12020,8522,4613,2949,619,304,187,22,3909
48491000491,9623,7072,3587,1923,912,236,485,8,3485
48491000402,12761,8802,3969,2875,1427,326,364,34,4833
48491000490,4398,3464,1890,776,554,116,188,2,1574
48465000022,4906,3928,1084,2734,55,51,50,3,2844
48163000006,860,670,328,315,23,7,1,0,342
48163000001,2074,1523,242,1245,14,48,7,3,1281
4846700004C,2679,2118,1761,218,50,66,22,5,357
4846700004E,1785,1433,1156,168,29,53,10,0,277
4846700004A,1865,1458,1243,133,19,39,18,2,215
48255000004,4005,3574,1039,1740,743,36,40,4,2535
48255000014,1570,1176,257,863,30,34,9,0,919
48255000009,293,235,155,72,1,8,4,2,80
4846700002D,3166,2531,2194,210,24,81,18,3,337
48265000405,1977,1689,1472,153,8,38,11,6,217
48265000404,1213,989,842,114,2,23,6,1,147
4828900005A,113,100,88,3,0,9,0,0,12
48289000009,355,285,252,18,4,8,2,2,33
48339000020,5612,3951,1228,2349,285,185,47,11,2723
48339000075,6728,5681,3780,876,521,130,380,10,1901
48339000098,8846,6449,3909,1137,526,121,716,15,2540
48339000034,3531,2780,2076,434,116,70,102,3,704
48113001079,3290,2622,983,821,688,67,91,7,1639
48113001133,450,353,247,61,20,9,19,2,106
48113003049,2953,2224,41,778,1406,43,11,1,2183
48113003097,206,146,10,37,99,0,0,0,136
48113003615,4132,3123,257,385,2454,49,34,1,2866
48113003612,4206,3310,392,410,2445,73,37,4,2918
48113001038,8072,5966,680,1284,3666,104,333,12,5286
48113003054,2917,2390,103,374,1892,34,14,5,2287
48113003056,2474,2037,159,294,1577,38,11,5,1878
48113004514,3591,2553,686,1562,225,91,35,2,1867
48113004515,6461,4559,574,3809,133,187,32,5,3985
48113003006,6037,5838,4198,600,437,96,489,2,1640
48113003318,2327,1738,505,524,622,45,73,3,1233
48113003312,4946,3671,1198,1028,1081,116,315,7,2473
48113004086,6359,4848,535,3533,646,139,100,4,4313
48113004117,236,227,82,32,110,3,2,0,145
48113004118,0,0,0,0,0,0,0,0,0
48113004019,4931,4301,1258,1022,958,56,1028,8,3043
48113002004,2374,1768,1449,156,45,30,87,0,319
48245000043,4016,3059,2074,670,195,56,109,2,985
48245000103,109,77,41,15,9,6,6,0,36
48245000074,4081,3201,2520,418,107,50,100,3,681
48245000067,4037,2904,328,467,2044,41,49,4,2576
48245000031,1788,1402,1148,142,39,36,22,1,254
48245000106,14,14,10,3,1,0,0,0,4
48003000004,4119,2880,985,1769,72,96,24,2,1895
48245000054,684,521,36,58,423,5,5,0,485
48203000020,3955,3083,2063,406,502,117,9,1,1020
48203000012,7798,5493,4455,354,406,179,72,17,1038
48203000009,2546,1902,1277,234,317,46,11,8,625
48179000001,682,506,427,39,4,37,3,0,79
48255000015,237,187,59,117,4,3,3,0,128
48451000304,6362,4724,2238,2181,135,165,49,17,2486
48179000004,898,709,615,67,8,20,1,0,94
48491000122,4664,3356,2098,370,98,45,732,9,1258
48491000396,4594,4490,4150,183,34,55,40,3,340
48491000393,2268,2260,2126,58,12,29,16,0,134
48245000083,1952,1463,1146,172,56,38,62,0,317
48245000008,1275,941,111,124,688,8,16,7,830
48281000007,1303,976,641,274,15,32,8,1,335
48281000005,709,611,549,28,12,15,5,1,62
48281000009,2474,1956,1465,226,114,96,59,20,491
48473000313,1992,1478,440,874,96,38,49,0,1038
48367000235,1488,1183,961,132,14,50,9,1,222
48367000205,3263,2416,1784,471,42,116,17,8,632
48367000225,1806,1458,1273,111,17,40,11,1,185
48113004063,5642,4261,742,3281,169,171,25,3,3519
48113004057,3320,2427,174,2034,195,78,8,2,2253
48113004043,2893,2043,75,1499,450,55,13,0,1968
48113003041,897,617,24,417,175,12,0,0,593
48113004513,7997,5585,1025,3106,1304,162,95,7,4560
48439002411,1858,1351,190,721,385,66,31,6,1161
48113003207,5350,3754,976,1598,1088,154,56,4,2778
48113002225,2328,1698,1408,111,24,36,114,0,290
48113001014,4988,4223,1713,1525,613,130,319,13,2510
48113001130,3304,2785,1094,840,653,48,194,3,1691
48113001138,264,252,137,36,58,4,18,0,115
48113003940,6428,4447,875,2210,1285,134,17,8,3572
48113004511,5138,3684,834,2407,341,127,52,1,2850
48113004507,2421,1676,176,849,641,21,21,2,1500
48113004085,1924,1438,55,1335,42,26,5,5,1383
48113004116,0,0,0,0,0,0,0,0,0
48113004083,2450,2095,613,931,448,66,106,0,1482
48113004080,845,694,498,120,24,30,31,1,196
48113004079,5686,4791,2716,1065,779,144,155,4,2075
48113004124,0,0,0,0,0,0,0,0,0
48113004123,0,0,0,0,0,0,0,0,0
48113004068,3841,2902,380,2412,77,113,24,1,2522
48113004114,3819,2785,167,2557,42,102,6,2,2618
48113004062,4929,3543,168,3328,38,142,11,7,3375
48113004506,3509,2579,593,1605,254,105,73,12,1986
48113004538,2408,1659,276,940,343,68,68,6,1383
48113004530,2038,1258,79,842,310,39,25,1,1179
48113004509,3439,2530,710,1563,134,95,84,3,1820
48113004510,5157,3695,498,2767,203,118,213,5,3197
48113004534,191,123,25,93,4,9,0,0,98
48113004533,2196,1562,234,1015,188,46,106,1,1328
48113003807,3643,2756,333,477,1936,48,16,4,2423
48113002928,3564,2919,1938,353,349,78,233,1,981
48113002925,4089,3306,1986,546,385,118,304,7,1320
48113003302,2438,1831,752,635,271,58,137,4,1079
48113001023,2571,2058,1650,221,58,62,70,3,408
48349000401,1355,1035,431,378,195,30,12,4,604
48349000204,390,308,194,49,51,15,3,0,114
48349000108,772,591,368,170,30,20,2,2,223
48349000107,3258,2211,903,1156,103,61,8,5,1308
48201000864,6740,4753,220,3585,783,149,180,7,4533
48201000824,6379,4750,386,2721,1519,139,165,9,4364
48201000266,5872,4134,682,3257,166,149,26,0,3452
48113004025,885,625,14,453,148,19,4,0,611
48113004028,2107,1566,42,933,544,32,21,0,1524
48113001057,4221,3193,873,2049,183,129,40,1,2320
48029004149,1085,829,200,542,58,24,16,0,629
48029001111,7299,5488,1298,3396,510,148,289,18,4190
48029001085,4158,2934,390,2360,134,106,47,11,2544
48029001036,6823,4779,718,3597,324,173,118,18,4061
48029002127,3883,2995,960,1655,203,110,137,23,2035
48029001031,3035,2290,118,2112,37,37,12,4,2172
48029003068,5998,4610,1061,2724,551,148,272,33,3549
48003000002,5107,3558,1980,1417,47,112,35,2,1578
48451000436,5748,4491,3063,1150,99,132,53,17,1428
48451000435,2562,1887,860,904,65,59,24,6,1027
48451000422,1607,1238,1007,172,15,43,8,1,231
48391000001,943,684,192,404,95,11,0,2,492
48391000004,742,557,118,320,110,11,13,1,439
48157004129,12368,8620,2279,568,608,57,5116,12,6341
48157001007,2179,1616,784,233,398,30,157,3,832
48157004102,3467,2691,480,114,84,9,1993,8,2211
48157001074,7898,5865,1591,2275,1437,91,522,7,4274
48157003005,5935,4346,2972,599,436,93,243,11,1374
48339000068,7869,5684,3540,1223,513,200,239,19,2144
48339000067,4069,3298,2292,525,132,82,237,15,1006
48339000026,6826,4804,2287,2151,142,224,66,17,2517
48339000093,10936,7237,3434,3163,342,261,179,19,3803
48339000077,5280,4506,3915,346,60,97,83,4,591
48339000050,5128,4179,3478,402,97,112,68,4,701
48339000023,8119,5705,3081,1749,658,167,62,24,2624
48339000057,4257,3424,2724,452,80,107,24,2,700
48157002137,1469,1002,99,479,239,35,183,0,903
48157002060,7855,5794,561,927,1892,52,2432,5,5233
48157001073,2586,1909,741,899,244,32,27,1,1168
48491000371,3940,3144,2265,584,168,92,67,11,879
48491000341,2954,2312,1659,484,78,82,36,6,653
48491000436,1292,965,641,261,23,38,10,3,324
48193000001,1490,1179,1015,122,11,26,3,2,164
48479000133,6548,4480,50,4409,8,43,7,3,4430
48479000169,5501,3231,85,3122,20,48,8,2,3146
48479000132,13717,9493,920,8468,87,112,28,9,8573
48423000011,4601,3246,304,1506,1400,66,25,10,2942
48423000039,527,408,106,65,228,16,1,0,302
48113004056,7864,5640,338,3502,1755,192,56,8,5302
48113001073,5793,4539,1330,2604,416,184,138,8,3209
48113003039,3218,2474,47,817,1607,46,15,4,2427
48113004039,1710,1201,33,841,330,36,8,2,1168
48113003102,5657,4008,571,1088,2236,115,92,6,3437
48113002039,3794,3076,2410,380,79,79,137,0,666
48113004529,1048,768,219,213,256,21,87,0,549
48113003007,2428,2345,1729,247,134,22,212,6,616
48113003606,3723,2919,227,291,2360,39,41,6,2692
48113004037,358,276,26,221,32,12,0,0,250
48491000381,3203,3185,3048,66,6,42,15,3,137
48491000420,16244,11526,5639,3415,1691,355,582,90,5887
48337000012,208,179,138,24,1,20,0,0,41
48337000009,1568,1329,1211,41,3,59,4,0,118
48337000004,1154,839,677,117,6,35,1,0,162
48337000002,3431,2768,2313,301,15,116,14,0,455
48337000003,1924,1481,1328,86,7,55,9,1,153
48337000007,1309,1038,909,62,3,41,1,0,129
48303000102,852,627,513,69,14,24,5,0,114
48303000026,5749,4195,650,3054,452,118,22,2,3545
48303000051,350,252,128,110,8,13,3,0,124
48303000034,1942,1650,772,609,260,13,5,3,878
48303000142,254,210,125,71,7,9,2,0,85
48303000004,2259,1665,154,1357,143,37,16,6,1511
48303000128,2281,1860,1516,240,37,38,26,0,344
48303000062,3623,2947,1949,669,119,75,137,4,998
48421000202,202,142,99,33,4,6,3,1,43
48039000025,3678,2768,1442,1229,33,49,27,1,1326
48241000013,658,519,378,15,104,16,0,0,141
48423000001,1538,1031,203,581,225,32,6,1,828
48423000031,5602,4540,3642,569,160,126,62,5,898
48113001075,2812,2383,1163,700,358,50,116,4,1220
48113001071,4030,3373,2131,738,297,135,113,3,1242
48113002700,4952,3884,1687,826,549,130,741,4,2197
48113004607,5734,4129,706,3078,156,153,165,5,3423
48113004652,3734,2559,241,2175,69,67,70,4,2318
48113004609,6371,4579,508,2843,918,198,290,8,4071
48113004653,919,638,49,511,66,21,7,0,589
48349000106,1116,797,366,364,30,30,13,4,431
48349000104,1441,1066,614,370,47,41,0,3,452
48349000402,3466,2739,1799,455,361,76,32,28,940
48451000215,4095,3099,2012,768,134,106,99,10,1087
4839100001A,801,638,200,389,39,10,8,0,438
48451000228,4899,4005,2631,935,253,99,109,4,1374
48451000319,5241,4090,2699,1015,179,99,128,11,1391
48113004611,4965,3653,935,2319,249,136,106,2,2718
48113004612,544,443,192,217,29,24,4,2,251
48113004655,82,68,40,19,3,3,1,0,28
48113004601,7025,5413,1901,2688,282,217,441,11,3512
48113004649,744,465,23,422,10,12,8,0,442
48199000007,1070,837,790,15,10,15,2,0,47
48199000009,3970,3062,2407,126,415,63,49,3,655
48263000101,283,227,205,19,1,2,1,1,22
48155000101,215,186,151,26,7,6,3,0,35
48157001152,16010,11084,3415,2583,2784,232,2147,32,7669
48157001154,6034,4338,1200,1694,1024,112,334,10,3138
48157004044,6863,4694,867,227,365,34,3221,11,3827
48189000111,2082,1522,425,1033,46,48,6,7,1097
48189000102,289,199,52,123,12,13,4,0,147
48189000105,448,295,86,186,16,9,8,0,209
48189000213,696,477,172,268,10,15,6,0,305
48189000316,1909,1455,588,805,34,45,1,0,867
48259001110,6066,4825,3806,805,47,114,71,9,1019
48259001010,4393,3332,2222,917,62,86,73,12,1110
48259004100,4125,3328,2675,501,20,89,47,10,653
48077000015,720,568,488,37,8,23,7,1,80
48451000108,1359,1050,776,230,12,28,3,1,274
48179000002,5876,4687,2473,1609,471,138,24,3,2214
48233000042,4733,3489,1753,1344,211,224,36,2,1736
48203000004,3471,2529,1152,664,672,114,17,7,1377
48203000002,4487,3461,1193,674,1529,49,17,10,2268
48203000022,3769,2826,930,650,1191,87,27,3,1896
48203000026,848,656,418,137,84,37,1,1,238
48203000018,937,788,636,65,62,30,0,0,152
48203000025,5844,4287,3504,314,268,130,60,2,783
48203000001,3242,2424,1492,303,529,64,41,0,932
48203000003,3700,2855,573,379,1847,21,13,3,2282
48203000010,1442,1140,783,81,222,28,21,1,357
48203000024,928,716,564,21,96,30,3,1,152
48245000093,1890,1439,202,676,489,57,59,1,1237
48245000096,1153,826,90,377,307,31,47,0,736
48245000045,3119,2206,370,1305,424,83,117,6,1836
48245000070,4591,3330,836,648,1238,37,605,1,2494
48349000105,550,376,233,107,19,14,3,2,143
48473000312,2390,1880,1185,544,70,50,33,2,695
48473000208,2906,2098,1032,694,304,94,17,1,1066
48009000007,292,224,194,15,1,11,1,0,30
48155000201,234,186,153,24,3,6,2,2,33
48155000401,326,270,219,37,8,7,3,2,51
48113003105,3597,2740,669,682,1269,67,108,9,2071
48113002226,3771,2606,2251,99,28,32,172,3,355
48113004018,1538,1418,916,222,150,50,118,6,502
48113004021,7002,6214,2686,1851,1130,202,458,18,3528
48113002400,258,212,143,47,16,7,2,3,69
48113003601,2384,1970,416,199,1301,46,46,1,1554
48113004610,4979,3803,1268,2065,259,179,152,10,2535
48113004654,4491,3156,427,2545,136,162,41,3,2729
48113002006,1930,1463,1180,135,36,30,64,3,283
48373000015,1381,1081,977,57,5,28,10,1,104
48485000205,6337,4706,3834,379,182,206,96,9,872
48485000206,5158,3914,3197,381,166,161,42,14,717
48485000106,1311,1018,853,69,6,79,3,3,165
48485000101,388,294,263,11,3,14,3,1,31
48485000410,449,322,248,34,14,15,15,0,74
48485000404,3770,2926,2196,298,137,81,226,5,730
48485000409,6,2,0,2,0,0,0,0,2
48439001080,2843,1933,69,791,1053,45,22,3,1864
48439001083,3061,1994,135,1344,499,45,25,3,1859
48439001380,2569,2165,1046,390,608,80,97,4,1119
48439001631,477,358,127,50,168,3,9,0,231
48439003183,6598,4999,2246,947,727,173,892,126,2753
48439001076,1454,1117,887,107,82,22,29,0,230
48439003054,5502,3955,2824,513,216,103,300,7,1131
48337000013,1298,1002,862,72,4,54,1,1,140
48337000016,452,340,297,30,1,10,2,0,43
48337000005,1518,1123,932,119,8,38,16,0,191
48337000015,759,614,531,42,7,30,7,1,83
48111000002,119,79,56,20,0,4,0,0,23
48321000008,1230,940,545,302,61,29,1,3,395
48321000004,2052,1594,1024,497,29,52,3,0,570
4832100001C,1581,1137,229,232,648,24,13,1,908
4832100001D,3453,2500,621,1589,262,64,17,1,1879
4832100001A,3869,2897,1562,1113,127,97,42,2,1335
48281000003,3942,3028,1935,891,73,91,39,12,1093
48281000002,4890,3746,3009,492,58,122,54,1,737
48409000113,1914,1388,153,1207,18,18,11,1,1235
48409000108,7944,5733,2750,2548,142,193,123,27,2983
48407000005,4167,2995,1821,969,83,122,18,3,1174
48439003387,2738,2141,1765,213,41,53,60,3,376
48439002449,3914,2935,698,1009,840,101,356,14,2237
48439001111,4837,3479,2673,452,124,104,128,7,806
48439004480,1366,961,766,100,31,12,48,1,195
48439003287,4264,3273,2108,653,156,100,253,18,1165
48373000017,1921,1575,1319,127,83,22,7,0,256
48373000010,3576,2758,1475,670,564,56,21,3,1283
48497000012,2663,2060,1704,265,16,73,11,2,356
48211000401,597,430,231,180,1,24,5,2,199
48211000101,827,553,334,193,2,20,1,1,219
48121002010,7296,5608,2730,1618,550,159,622,13,2878
48121003010,10410,7652,2818,2884,885,294,959,12,4834
48121003015,4367,3388,1430,720,682,105,507,11,1958
48121003012,2827,2115,1210,365,224,47,295,2,905
48121004041,4799,3307,1427,1018,464,109,330,10,1880
48121004012,4410,3223,1905,521,407,119,308,5,1318
48121002027,7226,5558,3469,887,466,176,600,11,2089
48121002025,3534,2762,1590,740,239,90,117,6,1172
48121001056,2999,2115,1115,220,220,40,519,10,1000
48121001050,4613,2900,1630,217,239,40,762,2,1270
48121001049,1720,1085,451,126,164,15,326,6,634
48121001055,3111,1972,839,232,290,40,568,2,1133
48121001029,5733,3845,2110,468,558,110,611,13,1735
48121001040,4402,2814,2007,258,209,49,301,0,807
48121002029,5677,3985,1743,670,748,116,761,5,2242
48121001051,3497,2204,1483,172,146,33,377,5,721
48497000027,6359,4894,4009,530,32,252,37,6,885
48497000023,3226,2410,1944,292,19,130,13,6,466
48497000024,6327,4625,3343,873,120,230,61,2,1282
48497000011,957,753,649,68,6,23,4,0,104
48497000005,3119,2330,1790,397,25,92,8,3,540
48497000001,2841,2115,1628,369,23,76,17,4,487
48497000006,3556,2554,1798,541,91,99,33,1,756
48497000013,2334,1660,1023,554,9,53,17,1,637
48497000018,2263,1764,929,655,137,33,11,0,835
48141000162,7592,5356,100,5226,18,107,9,5,5256
48141000156,5461,4157,75,4031,35,176,1,3,4082
48141000207,4343,3072,52,3001,26,36,10,3,3020
48141000171,5773,3998,53,3909,22,69,10,2,3945
48141000208,4387,3130,51,3064,20,38,9,2,3079
48141000165,7796,5480,108,5235,22,463,18,5,5372
48141000142,1781,1405,50,1344,11,45,10,0,1355
48141000136,3626,2695,93,2577,18,64,13,4,2602
48141000034,2331,2115,245,1458,262,39,166,2,1870
48141000032,2807,2322,461,1703,67,78,77,1,1861
48141000031,4555,3711,695,2644,185,45,167,7,3016
48141000201,5161,3425,288,2924,173,64,34,20,3137
48141000181,10146,6391,927,4665,566,179,228,61,5464
48141000199,1546,1201,268,885,19,47,25,0,933
48141000203,11376,7318,587,6282,308,141,141,37,6731
48141000200,4109,2607,287,2045,202,61,89,13,2320
48141000202,4859,3110,253,2718,103,68,44,1,2857
48141000204,3151,2017,116,1825,50,33,33,4,1901
48141000158,2321,1765,302,1400,51,35,22,7,1463
48141000128,8230,5351,618,4235,386,97,112,24,4733
48141000129,10082,6299,839,4791,522,153,181,44,5460
48141000131,4618,2938,221,2487,157,75,62,14,2717
48141000159,5107,3536,40,3467,20,67,21,6,3496
48141000160,5441,3981,101,3829,40,72,21,8,3880
48141000180,4903,3638,236,3294,97,22,24,1,3402
48141000205,8628,5655,217,5338,73,105,19,2,5438
48141000206,1958,1396,19,1375,3,28,0,0,1377
48141000168,9363,6000,419,5362,184,120,52,11,5581
48141000169,9169,6113,151,5896,32,113,25,1,5962
48141000170,7040,4957,308,4604,38,82,13,4,4649
48141000173,3700,2569,64,2499,6,15,6,2,2505
48141000172,7918,5747,153,5567,28,62,15,10,5594
48141000138,3712,2924,107,2761,60,61,19,8,2817
48141000176,1458,1132,286,780,33,41,27,2,846
48141000020,1744,1377,374,938,33,48,28,1,1003
48141000073,2138,1748,90,1621,30,58,9,5,1658
48121004025,5233,3718,2390,287,124,67,838,1,1328
48121004043,4759,3307,2542,251,127,44,302,5,765
48121004046,5038,3445,2657,300,188,86,210,9,788
48121004020,1093,899,778,47,19,37,27,0,121
48121004018,3311,2347,1780,234,107,63,149,8,567
48121004017,5730,4196,3679,274,45,130,65,1,517
48121004019,575,423,354,37,5,6,23,0,69
48121004023,4951,3584,2648,336,103,75,422,6,936
48121004021,2318,1759,1430,229,11,54,45,0,329
48121001032,9450,6117,3219,508,385,102,1895,10,2898
48121001052,6778,4827,2648,433,508,87,1159,12,2179
48121001033,9618,6062,2695,526,563,80,2203,8,3367
48121001019,5414,3815,1996,1108,377,128,239,9,1819
48121004016,19,11,3,2,0,4,2,0,8
48121001020,5759,4339,3255,461,261,125,239,14,1084
48121001034,9109,6043,3044,485,574,104,1833,9,2999
48121001036,4927,4831,4348,157,105,65,141,3,483
48121001057,2197,1550,617,503,255,47,152,1,933
48121002006,5250,4219,1959,517,356,78,1309,16,2260
48121002005,5539,4602,2493,740,269,118,1018,14,2109
48121003032,5130,4277,1659,873,1354,95,341,8,2618
48121002007,8328,6259,1535,556,855,96,3283,14,4724
48121003019,9795,7961,2932,1338,1899,191,1627,24,5029
48121003022,294,247,144,22,18,9,56,1,103
48121003023,728,549,224,57,45,11,210,1,325
48121003016,4820,3731,1466,803,952,76,452,15,2265
48121003017,10511,8140,2492,2342,2694,249,524,20,5648
48121003099,0,0,0,0,0,0,0,0,0
48415000005,143,112,79,27,1,3,1,0,33
48415000007,3430,2484,1567,808,49,58,22,1,917
48415000012,2972,2189,1139,888,101,54,15,1,1050
48415000015,3619,2526,822,1524,118,66,17,1,1704
48267000004,651,536,339,166,8,20,9,3,197
48267000002,788,638,461,143,2,11,22,0,177
48407000001,3855,3167,2455,182,404,106,22,2,712
48407000002,7103,5198,3488,1078,447,194,23,9,1710
48155000301,320,257,204,49,1,3,1,2,53
48409000110,2790,2117,631,1425,30,59,12,0,1486
48407000014,994,797,545,88,139,32,4,2,252
48407000007,2546,2199,1755,95,268,59,17,3,444
48409000109,5277,3818,1810,1762,87,159,73,5,2008
48409000111,85,60,16,42,2,3,3,0,44
48409000124,5609,4187,912,3125,105,50,26,3,3275
48409000117,934,721,284,412,7,17,1,0,437
48409000104,2666,1949,608,1280,31,28,6,4,1341
48263000401,177,149,121,21,4,4,2,3,28
48391000002,1084,851,556,261,19,17,4,0,295
48439002402,93,88,39,12,28,2,13,0,49
48439002274,19,12,0,3,9,1,0,0,12
48439002158,3765,3096,1552,548,695,79,210,11,1544
48439002561,0,0,0,0,0,0,0,0,0
48439001119,6315,4853,1690,949,1917,126,275,11,3163
48439001718,1456,1159,485,205,299,15,156,5,674
48439004373,411,336,257,51,0,19,8,0,79
48439004242,1017,845,624,119,45,22,27,2,221
48439003530,3928,2965,2137,263,83,64,408,6,828
48439002442,4423,3468,1659,378,524,50,875,8,1809
48439001404,80,60,21,10,13,7,16,0,39
4832100001B,6019,4472,2153,1672,544,72,76,0,2319
48339000008,4793,3634,2796,594,87,146,44,2,838
48339000066,7260,5282,3507,1354,158,155,102,9,1775
48339000013,8096,6149,4651,1117,152,178,67,7,1498
48157002056,1831,1394,122,985,275,33,16,1,1272
48157004119,3982,3146,1637,215,84,27,1183,6,1509
48157001134,7090,5511,913,1278,2081,90,1242,3,4598
48185000001,2628,2052,1693,169,140,35,4,2,359
48319000101,1000,798,643,127,7,22,1,1,155
48319000405,1072,875,695,149,11,22,5,2,180
48319000210,854,678,417,247,4,20,0,1,261
48207000005,584,448,310,99,13,20,0,1,138
48479000338,600,394,21,366,0,6,3,0,373
48479000350,34,33,8,25,0,0,0,0,25
48401000113,4942,3695,2625,467,418,154,30,5,1070
48251000017,8084,6148,3801,1782,319,168,44,58,2347
48251000014,722,537,419,78,13,36,2,3,118
48251000030,2476,1775,1449,176,48,85,18,4,326
48251000033,2380,1759,1230,420,41,59,6,0,529
48141000096,4348,3436,609,2689,97,78,53,6,2827
48141000077,4610,3712,349,3160,163,82,68,5,3363
48141000088,7465,5258,2188,1346,951,226,619,135,3070
48141000001,3872,2704,244,2401,39,55,20,6,2460
48141000002,8686,6520,810,5337,207,207,106,8,5710
48141000003,5733,4228,453,3652,67,87,38,8,3775
48141000071,2985,2464,230,2192,27,97,15,7,2234
4832100003A,4248,3129,842,1814,107,45,352,4,2287
48321000007,335,255,192,48,0,0,13,1,63
48321000002,769,691,600,59,12,10,4,2,91
48321000010,501,401,313,67,10,8,3,1,88
48321000005,3008,2251,1342,604,240,57,16,5,909
4832100003B,1261,904,484,349,13,17,42,1,420
48171000001,3249,2675,2121,417,25,65,29,2,554
48171000012,3364,2700,2083,537,12,55,6,1,617
4841100003A,666,548,460,60,8,10,6,2,88
48209000226,3398,2682,1993,517,39,71,46,8,689
48209000222,3206,2515,1403,871,125,92,65,0,1112
48209000115,3851,3099,1276,1378,329,91,117,3,1823
48209000114,3022,2542,938,1320,186,102,62,2,1604
48209000113,2173,1692,579,912,154,76,33,1,1113
48209000110,3676,2778,1146,1396,120,97,67,6,1632
48209000112,3806,3010,1029,1694,203,90,66,17,1981
48209000414,3583,3194,1198,1220,372,93,383,233,1996
48209000413,1882,1848,376,666,148,12,643,547,1472
48209000332,5792,4994,3074,1279,239,176,293,32,1920
48209000317,754,600,306,249,24,18,9,1,294
48209000316,2811,2241,1210,826,120,42,68,2,1031
48209000128,5683,4274,1553,2236,345,129,91,12,2721
48209000125,7130,5197,1636,3008,334,177,152,15,3561
48209000416,658,411,103,225,58,21,14,1,308
48209000417,3744,2809,1423,1078,155,86,119,7,1386
48209000126,5693,4054,1660,1923,291,156,128,16,2394
48209000127,2008,1369,451,738,111,46,40,4,918
48209000229,8783,5885,764,4968,103,217,32,4,5121
48209000223,4590,3377,1290,1733,183,119,86,10,2087
48209000418,39,22,3,13,4,3,1,0,19
48209000130,5038,3730,1420,1921,230,133,68,9,2310
48245000040,4584,3441,2768,431,59,103,83,0,673
48267000001,943,727,542,164,6,20,9,4,185
48267000009,721,591,452,119,4,13,6,3,139
48415000009,680,505,406,79,0,14,1,1,99
48415000010,2078,1647,1076,436,88,43,7,2,571
48415000014,1139,1086,518,377,190,5,0,0,568
48121004004,5126,4421,2010,1323,673,132,341,13,2411
48121004037,3050,2475,1365,596,251,100,193,16,1110
48121003005,2504,1948,1657,166,38,58,28,5,291
48121003006,5802,4425,2640,782,466,164,434,13,1785
48121004034,9213,6188,3973,1146,627,230,230,26,2215
48121004048,8446,5863,4005,662,528,155,491,22,1858
48121004035,11191,7859,5683,984,490,255,463,29,2176
48121002015,6409,4954,2516,658,590,80,1138,22,2438
48121002017,7082,5043,3036,354,217,89,1322,6,2007
48121003000,8048,5975,3661,1487,421,300,188,12,2314
48121003001,4759,3823,2797,498,200,128,218,12,1026
48121004031,5400,4107,3521,278,96,103,95,7,586
48121004030,722,540,400,60,23,15,34,1,140
48439003500,688,548,436,55,24,17,20,0,112
48439003529,3891,2583,1686,156,87,63,598,2,897
48439003286,1431,985,738,36,30,34,143,0,247
48121001012,3566,2805,2235,302,108,91,69,0,570
48121002009,3877,3070,1665,504,250,106,559,11,1405
48121002008,6177,4749,1852,704,764,117,1361,6,2897
48121002028,8720,6193,2628,2228,877,211,276,4,3565
48121002035,6444,4812,2090,945,786,123,881,6,2722
48195000007,56,49,44,5,0,0,0,0,5
48195000006,1110,820,439,362,3,23,0,2,381
48231000323,3876,3060,2595,259,54,103,25,3,465
48409000106,2733,2116,1145,805,82,74,29,8,971
48409000116,7169,5182,3140,1512,130,138,277,10,2042
48409000105,2729,1931,284,1600,29,28,5,0,1647
48407000006,2475,2102,1758,77,161,67,9,0,344
48497000010,812,616,513,77,2,22,3,0,103
48251000019,8863,6771,5303,905,239,228,79,37,1468
48251000016,840,665,494,142,10,14,4,2,171
48251000013,3124,2445,1907,364,33,108,29,0,538
48251000018,7429,5691,3974,1142,248,219,52,86,1717
48251000036,3253,2274,973,1120,98,80,26,19,1301
48251000015,2137,1709,1345,256,18,71,7,7,364
48251000004,11379,8364,6432,1109,407,264,181,6,1932
48251000003,7801,5684,4236,853,267,191,132,10,1448
48251000002,10691,7509,5320,1627,169,298,82,12,2189
48251000023,3829,2923,2382,354,49,96,18,7,541
48139000105,8241,5898,4056,772,818,160,86,5,1842
48139000102,7759,5639,3804,1155,419,174,82,14,1835
48139000103,7868,5380,3850,740,503,194,79,18,1530
48139000148,5613,4098,1513,1896,587,140,33,2,2585
48139000142,3956,2905,1621,1053,113,99,28,7,1284
48139000128,564,403,146,224,26,7,2,3,257
48139000123,2354,1575,127,850,552,35,4,30,1448
48039000024,8287,6255,3374,2219,415,228,118,3,2881
48039000023,7727,5731,3253,1831,379,222,128,3,2478
48497000002,5662,4177,2828,1127,72,115,55,4,1349
48497000022,1654,1318,1094,169,9,44,2,3,224
48497000008,3315,2571,2098,324,23,110,11,2,473
48479000221,1633,1229,76,1142,6,18,4,0,1153
48479000122,1004,775,27,744,7,11,1,0,748
48185000002,1133,872,726,93,12,14,8,1,146
48207000004,414,341,225,87,16,11,2,1,116
48251000020,3366,2294,928,1035,240,96,14,35,1366
48251000021,2538,2009,1656,246,30,82,3,4,353
48251000022,8579,6494,3769,1777,330,255,149,302,2725
48139000117,4694,3668,2290,901,336,113,41,21,1378
48195000001,1384,970,463,470,12,24,8,4,507
48409000112,1968,1497,87,1378,29,18,4,1,1410
48409000122,1036,864,473,362,6,7,10,2,391
48245000038,3182,2440,2026,240,49,53,61,6,414
48245000085,1704,1429,328,195,883,13,22,1,1101
48245000013,461,360,7,21,332,1,0,0,353
48245000059,1730,1225,23,83,1120,10,5,1,1202
48245000012,662,525,29,33,458,10,0,0,496
48291000010,5552,4184,2795,654,518,130,72,3,1389
48291000021,5031,3769,2980,543,95,104,10,5,789
48291000004,796,588,415,99,38,29,6,0,173
48291000022,8666,6094,2646,2828,408,215,77,20,3448
48251000026,2336,1676,1380,172,44,60,17,0,296
48139000135,6002,4468,3426,630,194,167,47,7,1042
48251000012,4589,3388,2671,517,60,110,26,4,717
48251000005,6564,4780,3719,621,185,150,72,7,1061
48139000132,1045,761,486,221,28,17,4,0,275
48139000131,3032,2290,1496,435,304,60,12,7,794
48139000133,1015,774,436,277,32,15,9,0,338
48139000114,4326,3247,1922,725,427,102,30,5,1325
48139000101,6256,4598,2868,938,553,135,125,8,1730
48439002644,6068,3990,1060,590,1708,69,608,20,2930
48189000214,1154,867,311,532,10,15,9,0,556
48189000215,723,530,183,322,17,11,6,1,347
48189000317,222,166,115,47,0,3,0,0,51
48339000073,3002,2250,1413,406,269,61,115,7,837
48339000021,7592,6071,3559,1467,689,193,191,7,2512
48339000011,3780,2871,2029,560,141,112,39,3,842
48339000086,4048,3087,2194,572,171,112,59,2,893
48339000099,4812,3646,3002,373,90,78,90,4,644
48157001103,9001,6550,3371,1531,1140,166,394,12,3179
48157002055,1662,1282,18,370,899,36,4,7,1264
48265000416,2639,2223,1549,564,11,62,11,3,674
48265000417,2335,1918,1561,247,20,47,32,6,357
48289000005,623,497,457,21,4,15,0,0,40
48473000416,3828,2791,754,1461,511,73,30,1,2037
48473000417,2170,1571,320,651,559,43,17,7,1251
48473000418,4976,3305,1959,838,274,108,171,10,1346
48373000002,923,742,635,64,11,21,7,1,107
48291000011,889,707,407,50,229,12,3,0,300
48291000014,4866,4578,2234,1390,903,42,16,1,2344
48291000006,1566,1181,899,155,57,57,8,0,282
48291000001,1255,964,790,99,23,30,5,0,174
48401000319,406,340,190,6,139,3,0,0,150
48421000401,759,532,324,195,5,17,4,3,208
48421000102,609,429,146,255,13,22,4,8,283
48497000014,3950,2872,1747,984,39,85,27,3,1125
48385000001,799,669,511,143,5,16,2,0,158
48385000002,801,645,501,109,11,21,8,1,144
48385000006,350,307,248,48,1,9,0,0,59
4841100004A,1505,1302,852,331,111,21,10,0,450
4841100002B,690,513,295,197,1,6,14,0,218
48411000001,1402,1100,680,389,10,22,8,1,420
48491000253,7809,5573,3534,1223,364,183,292,25,2039
48039000026,7585,5498,1805,2200,849,181,575,9,3693
48039000020,2501,1955,1262,504,135,56,12,1,693
48039000033,2857,2308,1586,318,338,78,4,0,722
48039000028,6216,4349,1955,1134,508,87,695,6,2394
48039000046,7502,5718,3186,1327,733,162,340,13,2532
48291000009,4051,2990,2650,211,57,49,10,1,340
48291000002,1759,1285,1076,112,59,27,8,1,209
48291000028,1402,1064,897,111,16,16,1,1,167
48291000023,13313,8203,1607,6399,101,345,38,5,6596
48291000020,1524,1287,250,240,793,7,11,3,1037
48089000102,422,359,232,72,39,7,1,1,127
48005000024,4866,3395,2108,756,376,126,42,4,1287
48005000007,1938,1347,1151,121,29,22,12,0,196
48005000008,2885,2113,1796,165,72,46,29,3,317
48005000019,1952,1535,1022,124,247,43,95,1,513
48005000014,3034,2268,1419,383,375,69,33,3,849
48005000017,2299,1891,1737,47,26,62,5,1,154
4800500017B,577,430,387,9,3,21,0,0,43
48005000032,535,415,370,18,4,15,1,1,45
48321000009,183,142,82,20,36,3,1,0,60
48149000003,554,442,340,74,11,8,3,1,102
48149000006,551,493,435,35,5,13,0,0,58
48157001015,2475,1829,885,801,101,42,25,1,944
48497000016,3685,2885,2395,309,26,126,24,3,490
48113001108,6572,4548,285,3272,958,481,13,3,4263
48113003047,5638,4070,433,781,2456,64,216,5,3637
48113004048,12,8,0,7,1,0,0,0,8
48113004046,3118,2131,30,1632,458,46,11,0,2101
48113003050,4062,2845,79,1498,1303,78,1,2,2766
48113003098,428,312,3,112,197,3,1,0,309
48113003108,3612,2775,1170,531,942,67,75,3,1605
48113003111,0,0,0,0,0,0,0,0,0
48113004523,653,521,171,88,210,12,46,1,350
48113002201,2334,1734,1538,78,19,19,64,0,196
48113004052,10702,7569,1010,3727,2382,258,428,20,6559
48113004050,7133,5096,808,1444,2537,150,273,4,4288
48113004111,770,562,27,473,23,41,23,0,535
48113003053,5986,4410,208,1043,3117,83,43,12,4202
48113003208,4425,3219,667,1642,835,168,55,2,2552
48265000118,884,797,596,129,45,13,20,2,201
4828900001A,265,226,192,13,13,8,1,0,34
48289000001,2181,1759,1386,126,180,51,13,1,373
48265000113,2119,1747,1427,234,15,36,33,3,320
48181000201,5876,4468,3262,515,363,293,48,7,1206
48147000003,940,749,498,40,163,46,3,0,251
48147000002,1771,1411,1264,54,14,70,12,0,147
48147000010,4097,3033,2447,356,72,144,22,4,586
48181000106,5166,3663,2738,578,145,171,36,5,925
48181000101,9553,6917,3327,2363,910,336,64,4,3590
48181000108,2369,1800,1592,98,20,69,13,1,208
48181000205,5526,4434,3802,222,65,286,35,4,632
48205000101,628,432,275,142,11,2,2,0,157
48205000201,412,300,232,52,7,12,3,2,68
48259003040,5733,4367,3125,1042,35,122,50,8,1242
48259002080,5935,4320,3167,921,50,106,76,15,1153
48113004110,2095,1499,11,914,577,54,9,2,1488
48113003018,2678,2135,87,373,1687,34,11,0,2048
48113002058,1766,1411,753,334,215,44,95,0,658
48113001035,622,451,95,332,8,15,8,0,356
48113003201,2721,2108,759,723,542,78,38,7,1349
48113002603,8233,5974,1205,483,606,58,3635,15,4769
48113004645,488,320,25,16,5,3,270,0,295
48113002605,4750,3195,460,116,94,31,2485,5,2735
48113002501,4234,3699,2705,489,207,92,167,22,994
48113003303,6883,5041,1278,1574,1849,91,283,10,3763
48113001009,5080,3499,489,1026,895,231,1077,13,3010
48113001312,2226,1573,462,891,191,45,14,6,1111
48113001317,14,14,4,3,1,6,0,0,10
48113003313,8743,6105,1478,1715,2534,220,333,22,4627
48113003317,4239,2927,613,1091,1094,109,87,4,2314
48113003314,6347,4543,1022,1531,1785,129,166,2,3521
48113002502,2460,1723,1475,90,14,42,104,2,248
48113004033,7021,6896,2740,1366,2574,43,225,7,4156
48113003094,42,28,14,0,7,0,3,0,14
48113003089,116,104,72,10,5,9,6,0,32
48113003005,2012,1831,1070,270,314,31,145,2,761
48113002066,2364,1599,1338,97,75,37,50,2,261
48113004604,6762,4997,1208,3132,283,200,306,9,3789
48339000019,5620,4329,3416,398,338,132,24,5,913
48339000082,9013,6901,4384,1487,468,154,425,16,2517
48339000037,5977,4395,2523,1223,300,192,197,23,1872
48339000095,8349,6440,3526,1427,808,139,569,32,2914
48157004035,2812,2198,601,298,186,32,1094,5,1597
48157003098,5446,4115,762,1795,541,83,985,6,3353
48157004020,4332,3416,1902,724,206,102,508,8,1514
48473000310,2435,1893,291,471,1106,57,10,0,1602
48071000006,3044,2337,1505,383,364,50,26,1,832
48071000014,720,528,302,158,42,23,5,0,226
48071000003,729,557,220,197,113,10,15,0,337
48071000007,3875,2947,2026,701,125,66,34,4,921
48289000006,1466,1201,1094,36,10,46,4,0,107
48265000314,3902,3050,1539,1188,187,89,42,9,1511
48245000006,2518,1892,462,514,876,33,26,1,1430
48245000089,1241,900,216,132,532,30,8,0,684
48245000004,2135,1676,1226,137,248,43,44,0,450
48233000023,670,484,367,76,10,22,9,1,117
48231000210,1724,1216,711,407,35,60,17,1,505
48231000106,4295,3363,1941,636,664,93,54,13,1422
48231000109,2162,1626,1230,296,21,69,16,3,396
48113002504,2007,1598,1097,258,79,54,122,1,501
48245000095,1069,843,374,151,144,10,165,1,469
48245000009,5296,4155,3141,534,173,71,238,2,1014
48113002033,3324,3088,2052,431,298,51,260,3,1036
48291000012,2807,2032,1071,819,63,92,20,1,961
48291000007,4240,3141,1743,798,465,118,52,4,1398
48391000003,960,746,368,324,45,5,1,0,378
48451000401,293,218,119,65,21,8,6,0,99
48451000137,4723,3703,1428,2036,147,66,50,1,2275
48451000306,3747,2538,1284,943,150,69,93,1,1254
48451000348,1421,1056,575,445,5,34,10,1,481
48309000056,1878,1339,376,785,159,66,10,2,963
48139000137,1701,1370,1105,164,52,51,7,0,265
48139000138,3515,2516,1561,796,65,101,18,1,955
48139000134,1302,964,644,233,51,29,8,0,320
48139000130,1125,840,479,173,163,34,9,2,361
48139000112,3404,2518,1490,829,106,67,14,5,1028
48139000111,3811,2886,1932,450,375,85,48,1,954
48113004531,1276,899,282,555,54,35,14,0,617
48113004508,2294,1541,293,1070,146,49,14,0,1248
48113004532,601,457,99,313,18,20,16,3,358
48157002112,2257,1509,36,1421,44,33,11,3,1473
48157001025,9033,6388,1907,3243,976,148,223,4,4481
48113001093,3941,2783,127,1680,938,64,45,3,2656
48295000303,512,399,303,68,1,25,2,0,96
48295000202,244,186,133,42,3,10,3,0,53
48295000207,579,419,249,161,1,10,2,1,170
48295000409,296,214,82,124,2,4,0,0,132
48295000106,770,565,251,295,7,15,4,1,314
48245000062,3698,2864,2027,260,393,58,108,3,837
48295000404,468,364,318,22,1,20,0,0,46
48113002009,2690,2005,1544,311,48,44,51,1,461
48113004092,305,229,72,128,21,7,1,0,157
48113004002,1528,1204,673,399,66,47,51,2,531
48113004007,250,198,107,47,26,12,7,2,91
48113004097,2198,1652,343,1159,106,64,31,3,1309
48113004008,7387,4781,131,4488,138,155,33,11,4650
48113004632,5111,3840,608,693,1028,71,1473,15,3232
48089000101,4035,3080,1759,796,469,40,35,0,1321
48005000016,4391,3308,1089,1419,765,31,13,7,2219
48005000031,705,515,288,195,23,7,2,0,227
48005000028,1600,1227,898,237,66,18,12,3,329
48057000001,1384,966,132,779,14,23,29,5,834
48057000008,1288,954,145,655,105,14,63,1,809
48367000320,2945,2268,1931,223,23,65,12,6,337
48367000335,5483,3812,3362,238,42,112,29,3,450
48367000415,5142,3629,2932,365,109,103,112,4,697
48367000435,4320,2978,2522,299,19,85,41,7,456
48121001008,1803,1471,1174,186,29,59,9,6,297
48005000013,1258,885,407,228,217,35,7,2,478
48005000009,373,297,231,17,42,1,8,0,66
48339000051,6783,4984,1937,1934,932,150,121,18,3047
48157003014,12328,8222,4079,1552,820,120,1655,11,4143
48157001012,5740,4145,908,2911,269,106,31,1,3237
48157003032,5282,3983,664,1355,907,96,1047,2,3319
48157002099,6540,5092,666,1490,1277,88,1686,8,4426
48113004076,9031,6509,566,4896,964,222,63,5,5943
48113003311,4786,3396,1356,1310,572,156,70,4,2040
48113003316,4503,3357,1114,1073,926,109,195,5,2243
48113004004,3446,2783,687,1712,226,77,131,4,2096
48113001131,2775,2296,943,743,458,82,127,5,1353
48113001070,4037,3244,1069,1514,494,165,131,10,2175
48113001132,67,60,28,10,13,6,4,0,32
48449000016,4283,3186,1862,916,330,97,34,1,1324
48193000007,2186,1715,1389,220,8,73,14,4,326
48157004131,2567,1990,923,261,179,23,616,6,1067
48157001001,3990,3313,1424,1197,605,53,65,10,1889
48157001072,125,109,69,38,0,0,2,0,40
48157003133,5730,4105,2481,563,185,78,775,9,1624
48339000010,7269,4991,658,3221,1049,231,37,3,4333
48157001068,813,577,376,147,37,21,4,1,201
48157004045,2999,2255,807,606,369,44,438,4,1448
48157002066,8243,6387,495,2271,2356,120,1298,9,5892
48157001040,6201,4457,349,3290,823,107,52,8,4108
48157002115,2866,2170,366,562,1131,82,112,3,1804
48145000303,611,486,440,31,10,9,1,0,46
48159000401,1590,1303,1132,103,7,47,8,5,171
48113002708,7684,6043,2666,979,726,176,1570,10,3377
48113003024,3345,2221,36,729,1456,33,7,2,2185
48113003500,7910,5742,2925,596,596,106,1500,20,2817
48113003501,14,9,2,2,0,0,5,0,7
48139000127,1129,788,406,194,172,26,2,3,382
48139000125,7885,5768,3279,1817,524,151,46,7,2489
48139000115,3133,2164,1213,653,200,81,19,6,951
48139000116,3398,2499,1603,669,110,97,33,10,896
48139000136,738,559,475,41,19,8,3,1,84
48195000002,109,71,50,18,0,0,1,0,21
48387000018,260,208,177,9,7,14,2,0,31
48159000201,806,606,506,61,5,20,6,0,100
48441000205,7283,5366,2439,1764,913,219,129,19,2927
48441000108,1747,1363,1123,132,38,44,17,2,240
48441000202,7302,5286,1813,2913,471,209,35,7,3473
48441000106,4834,3202,1888,606,456,129,175,37,1314
48441000403,4756,3907,2395,646,675,99,125,10,1512
48071000012,2400,1709,973,414,273,55,6,0,736
48473000101,3157,2337,1161,813,310,68,3,8,1176
48473000102,2805,2149,727,634,742,60,27,3,1422
48387000013,1212,918,792,32,60,30,2,2,126
48245000052,663,528,16,46,458,6,6,0,512
4832100001F,1748,1287,381,801,67,36,21,0,906
48281000008,3023,2344,1718,307,169,93,63,28,626
4850500001B,134,85,4,80,4,1,0,0,81
48145000404,1278,969,714,126,95,26,4,2,255
48481000102,3517,2797,1655,751,331,43,14,3,1142
48185000006,3281,2531,1199,720,575,46,22,0,1332
48473000104,1430,1020,462,402,132,23,7,0,558
48473000415,2426,1805,884,761,127,65,13,0,921
48361000015,2550,1980,1545,124,231,54,22,4,435
48361000029,1911,1462,1320,58,9,60,8,3,142
48005000038,686,507,357,118,17,8,5,3,150
48005000015,1621,1300,770,401,103,27,6,0,530
48005000030,1499,1167,1094,26,10,31,1,1,73
48057000012,1553,1239,832,371,13,12,17,0,407
48421000201,449,305,112,190,2,9,0,0,193
48139000147,6016,4628,2783,1184,457,171,44,4,1845
48139000120,1535,1087,513,515,26,55,3,2,574
48251000006,626,509,430,41,18,18,3,2,79
48251000035,6303,4955,3744,864,117,175,51,7,1211
48021003015,10054,6811,1331,5174,190,299,41,6,5480
48021001004,8349,6131,2231,3340,444,171,33,4,3900
48021004021,2990,2206,1272,750,78,98,28,5,934
48021002010,2512,1955,1250,595,42,70,12,7,705
48021002011,3698,2936,2086,650,77,115,23,1,850
48021004020,7943,5783,2237,2796,617,165,37,6,3546
48021004019,4823,3709,1982,1404,161,147,40,7,1727
48053000019,5552,4416,3569,628,60,126,45,2,847
48053000003,3268,2409,1117,1197,18,75,21,1,1292
48053000018,2564,2022,1361,547,21,89,14,2,661
48053000012,2787,2157,1625,382,30,97,19,3,532
48053000016,749,602,512,60,6,14,10,0,90
48053000015,1281,1008,802,148,16,44,5,1,206
48053000009,3366,2745,2110,538,15,68,14,2,635
48053000020,6675,5127,3438,1238,147,188,143,5,1689
48021002006,2403,1909,1434,325,68,55,16,4,475
48021002005,4325,3375,2311,552,386,95,40,2,1064
48021002008,1397,1111,888,146,53,14,14,2,223
48021002007,3202,2518,1966,372,75,76,24,4,552
48121002000,8486,7034,1959,1532,2811,180,668,14,5075
48121002002,11168,8588,2575,2485,2641,221,769,22,6013
48121004028,5890,4412,3481,411,106,119,269,13,931
48121001046,6650,4840,3201,827,428,145,259,8,1639
48121001017,1790,1405,977,129,123,48,146,3,428
48121004029,2371,1595,1018,242,99,38,200,5,577
48121004022,3054,2385,2030,151,39,64,82,9,355
48121004049,4140,3016,2104,628,108,118,47,11,912
48121004036,5108,3771,3030,425,122,137,45,6,741
48121004002,6709,4790,3742,700,126,178,71,5,1048
48121001044,11727,7449,4158,856,1133,211,1116,26,3291
48121001041,9671,6699,3469,1171,1572,190,330,28,3230
48121001004,7343,4965,2891,745,911,160,266,14,2074
48121001043,2203,1485,741,373,253,56,75,2,744
48121001042,420,330,230,80,3,19,5,0,100
48121004027,6021,4132,2602,274,131,78,1035,2,1530
48121002036,1210,834,339,48,29,4,412,0,495
48121002034,6135,4564,1366,491,688,68,1955,2,3198
48121003020,3077,2125,432,1091,265,59,334,1,1693
48121002021,7585,5827,2946,1223,805,167,741,9,2881
48121002096,0,0,0,0,0,0,0,0,0
48121002022,4171,3274,2030,591,277,93,290,14,1244
48059000004,1937,1539,1418,75,7,34,5,1,121
48361000032,2555,1984,1794,102,11,47,16,1,190
48361000026,3822,2826,2403,220,39,51,104,0,423
48361000019,2955,2311,2059,152,16,61,20,0,252
48059000006,1321,1038,889,80,23,36,5,1,149
48265000406,4481,3625,2781,664,43,100,34,10,844
48289000012,1013,806,562,46,169,23,7,0,244
48361000014,2651,2162,1498,179,391,55,24,1,664
48361000008,3194,2376,1883,120,271,55,53,0,493
48011000404,41,30,30,0,0,0,0,0,0
48321000013,440,360,240,26,84,5,6,0,120
48121004000,7628,5528,4096,954,158,254,77,17,1432
48121004042,74,65,46,14,2,4,0,0,19
48121004038,510,377,247,110,5,11,8,0,130
48121001009,6941,5101,2658,1455,650,176,174,12,2443
48121004005,3584,2944,2044,436,248,104,119,3,900
48113002926,5182,4073,2058,931,745,126,262,13,2015
48113003043,3679,2569,44,974,1530,38,8,1,2525
48113002804,3613,2614,1570,297,96,62,591,0,1044
48113004066,4196,2895,93,2725,51,176,19,2,2802
48181000210,3196,2351,1994,136,41,128,21,6,357
48147000006,1005,770,683,30,12,24,5,0,87
48147000015,1408,1059,906,71,25,43,11,5,153
48147000009,1219,1022,885,66,16,53,6,0,137
48181000301,4004,3166,2087,395,370,165,161,16,1079
48181000102,5436,4050,1503,1532,748,170,166,11,2547
48181000103,825,652,530,98,10,23,0,1,122
48107000011,1141,836,305,474,32,23,7,3,531
48107000027,1371,1032,550,451,26,7,4,2,482
48113001007,490,373,320,21,3,8,24,0,53
48113003610,789,622,154,173,283,15,2,0,468
48113002923,5570,4250,2231,882,805,127,219,11,2019
48113002714,8464,6285,1653,1542,1437,129,1572,7,4632
48113001723,645,413,81,173,134,10,21,0,332
48113003309,3824,2950,1125,825,894,89,67,6,1825
48113003310,5680,4151,1671,1614,678,180,91,5,2480
48113001010,3737,3237,991,865,1101,87,232,9,2246
48113002023,1861,1662,1323,163,88,38,63,1,339
48113002026,3776,3211,2795,169,49,27,164,1,416
48113002027,1796,1626,1341,153,40,27,73,1,285
48113001012,729,682,404,82,88,19,88,0,278
48113001008,4548,4097,1959,876,834,76,377,17,2138
48113001020,1848,1795,1361,224,82,27,96,5,434
48113002037,2252,2168,1778,157,70,33,117,0,390
48113004060,6995,4651,226,3155,1165,115,117,9,4425
48113004112,1888,1860,1259,305,113,41,117,9,601
48113001121,5783,4255,577,2469,719,110,445,3,3678
48113003920,7069,5726,2785,1802,957,182,56,5,2941
48113002043,2908,2125,1669,204,80,41,149,5,456
48113002070,1952,1369,1126,123,26,38,47,1,243
48113002050,3162,2381,1245,710,324,56,76,1,1136
48113002063,977,706,594,56,17,17,17,0,112
48113002062,3199,2458,2060,195,63,48,69,6,398
48113003033,1193,782,42,329,408,13,4,0,740
48113003027,1901,1443,20,269,1172,8,1,0,1423
48113003052,4552,3287,84,679,2522,49,12,2,3203
48281000004,1685,1345,1092,161,34,49,17,9,253
48113003600,3957,3368,496,686,2144,42,47,3,2872
48113003621,0,0,0,0,0,0,0,0,0
48113004030,287,40,1,36,3,6,0,0,39
48113004031,4496,3152,122,1698,1282,99,46,5,3030
48113004084,1496,1090,17,890,183,14,2,0,1073
48113003205,2967,2182,125,702,1324,50,42,0,2057
48073000037,891,652,364,164,91,28,3,0,288
48265000107,1296,1083,768,256,8,34,7,3,315
48265000303,1092,959,825,108,4,12,4,1,134
48265000308,1077,816,390,395,3,24,2,2,426
48113004032,5217,5009,2982,951,551,139,443,9,2027
48113004102,301,292,246,22,13,6,7,0,46
48113004105,19,17,9,5,1,3,1,0,8
48113004106,323,322,232,27,17,11,29,0,90
48113004104,41,41,31,7,2,1,4,1,10
48113004103,183,182,98,36,23,7,20,1,84
48113004500,4086,3005,777,1094,724,76,378,4,2228
48113004522,5652,4131,1030,1356,1192,127,507,7,3101
48113004539,0,0,0,0,0,0,0,0,0
48113001715,4700,3240,492,2538,170,137,33,5,2748
48113001729,4355,3107,464,1832,497,107,261,9,2643
48113004616,4969,3373,449,2607,179,155,122,3,2924
48113004020,2152,1875,459,1007,284,86,85,2,1416
48113004054,1501,1079,30,1001,42,41,12,5,1049
48113004035,2313,1561,372,321,841,44,16,0,1189
48113004036,2046,1471,59,1015,389,36,21,0,1412
48113002034,2164,1727,1454,114,34,33,92,0,273
48113001021,1984,1883,1468,203,84,24,106,6,415
48113004600,4442,3318,902,1235,316,111,811,4,2416
48141000125,8369,6309,403,5586,212,163,124,14,5906
48089000303,775,649,589,30,7,18,3,1,60
48439003361,4436,3665,2727,542,160,109,144,14,938
48439002727,804,629,445,56,59,13,59,3,184
48439002307,5112,3915,2240,487,620,129,457,3,1675
48439001641,5623,4157,1518,758,1360,82,474,11,2639
48439001723,2899,2091,746,289,849,28,231,4,1345
48439003386,3206,2405,1972,163,79,59,130,2,433
48439003040,4932,3931,2934,457,176,116,232,5,997
48439003716,3239,2430,1773,250,127,41,241,11,657
48439002505,2552,1945,1201,441,176,57,74,6,744
48439001120,4747,3402,277,1054,2013,62,58,6,3125
48439001094,3103,2595,1172,888,379,64,108,6,1423
48439001676,674,525,233,166,102,17,14,3,292
48469000033,6503,5006,3298,1240,229,86,182,4,1708
48265000220,2740,2477,2207,162,15,36,29,1,270
48265000215,4499,3605,2607,808,30,93,46,5,998
48265000211,3301,2807,1653,874,120,74,100,15,1154
48289000008,1618,1194,812,280,52,21,22,2,382
48113002703,2981,2309,586,507,434,45,771,9,1723
48113003040,3943,2639,102,881,1635,54,11,2,2537
48113003300,4745,3727,1591,1117,667,108,310,5,2136
48113004071,1689,1172,50,1033,82,49,5,0,1122
48113003608,4464,3285,131,326,2787,71,52,2,3154
48113002601,6192,4539,958,436,643,68,2414,3,3581
48113002606,0,0,0,0,0,0,0,0,0
48113001056,2020,1491,516,835,85,33,26,1,975
48113003808,7620,5515,1377,1835,2214,171,45,6,4138
48113003805,7867,5730,262,604,4850,68,38,3,5468
48113004512,3978,2796,782,1632,343,75,29,0,2014
48113001710,4135,2918,127,2149,593,108,52,0,2791
48113001037,6785,4801,648,3293,741,173,120,4,4153
48113001127,2590,1841,302,1161,298,67,57,1,1539
48113002903,4257,4040,2426,575,507,115,434,4,1614
48113002902,3709,3127,1304,600,879,75,308,10,1823
48113002905,521,455,376,22,13,5,39,1,79
48113002904,50,38,6,11,5,7,7,0,32
48113002048,8044,7069,3367,1542,1572,160,511,25,3702
48113001111,4933,3223,287,2327,558,141,42,3,2936
48113001110,50,40,0,38,2,0,0,0,40
48113001107,2303,1599,142,1326,119,96,7,1,1457
48113001136,26,23,8,15,0,1,0,0,15
48113003093,55,39,3,33,3,8,1,0,36
48439003063,2338,1858,1445,226,54,56,67,10,413
48439003725,3806,2957,1973,491,203,82,225,6,984
48439004397,833,647,316,284,18,25,8,0,331
48439004598,0,0,0,0,0,0,0,0,0
48439004121,4742,3595,1788,1624,68,104,52,10,1807
48439004687,717,514,114,392,3,14,2,0,400
48439004243,3787,2954,1490,1146,158,100,71,14,1464
48439001717,4339,3102,1467,785,650,113,86,10,1635
48439001294,4990,3701,2215,691,614,114,106,5,1486
48439004128,6407,4828,2886,1378,297,191,94,24,1942
48439001066,2444,1776,452,879,381,42,55,1,1324
48439001170,5102,3750,1386,1289,876,101,132,4,2364
48439001277,1943,1641,910,240,363,35,71,8,731
48439001679,0,0,0,0,0,0,0,0,0
48439004233,3542,2689,629,1813,171,99,54,0,2060
48439003326,1822,1492,967,276,162,48,56,3,525
48439003661,0,0,0,0,0,0,0,0,0
48161000008,779,668,586,53,19,17,1,0,82
48073000034,2200,1639,1463,89,27,47,21,1,176
48073000024,3288,2496,1588,257,570,46,36,0,908
48113001300,6489,4531,1117,2704,579,152,94,9,3414
48113001315,58,41,8,22,9,7,0,1,33
48113001068,130,91,41,48,3,4,2,0,50
48113001045,7585,5746,901,2581,2094,259,137,6,4845
48113001129,976,618,20,336,186,15,80,0,598
48113001712,3974,2966,1332,1286,200,126,74,0,1634
48113001727,608,432,112,303,13,25,5,0,320
48113003950,7389,5581,1422,1962,2149,120,33,7,4159
48113001718,3341,2493,981,1176,238,89,63,5,1512
48113001078,3757,2664,262,1289,1086,72,25,3,2402
48113002301,3009,2569,1847,419,130,75,103,0,722
48113002409,5428,4005,656,3039,126,173,152,4,3349
48113002203,1978,1535,1311,80,15,32,84,1,224
48113002038,4592,3886,3078,387,122,85,230,4,808
48439004202,3950,2896,1002,1776,43,89,32,4,1894
48439002309,5218,3560,686,2616,169,146,56,8,2874
48439002100,1128,845,351,405,41,58,33,2,494
48439001023,6766,4719,2235,1034,1219,121,154,8,2484
48439001710,2833,2137,1064,764,205,71,62,4,1073
48439001264,2533,1941,1255,404,160,71,48,7,686
48439004534,6959,5155,3098,1206,531,146,189,10,2057
48439002354,4228,3093,880,1118,708,61,377,19,2213
48439001206,3937,3105,2427,434,83,117,51,1,678
48497000004,412,328,288,28,3,6,0,0,40
48181000305,2119,1674,1422,109,13,101,19,2,252
48181000209,1769,1420,1202,118,60,22,12,1,218
48439002225,7694,5104,426,2957,1475,152,235,16,4678
48439002428,2316,1601,207,989,358,70,58,3,1394
48439002673,0,0,0,0,0,0,0,0,0
48439002180,5167,3546,466,1493,1422,74,197,9,3080
48439001011,3175,2255,195,1634,370,49,51,0,2060
48439002161,5083,4589,1695,925,1063,124,839,4,2894
48439002143,2311,1660,479,1007,97,81,45,0,1181
48439002263,6776,4653,873,3190,336,220,187,8,3780
48439003443,3211,2500,1713,384,165,80,154,23,787
48201000030,5736,4904,2157,941,1278,84,490,12,2747
48201000899,2244,1581,760,196,102,33,484,2,821
48201000400,6275,4599,1915,829,442,62,1367,11,2684
48201000410,2002,1456,147,858,421,46,27,2,1309
48201000703,2456,1941,1452,206,76,37,192,3,489
48201000090,5721,4352,3201,624,174,160,212,11,1151
48201000383,5503,4041,596,2502,813,257,115,8,3445
48201000966,5736,4134,441,2377,1236,144,100,1,3693
48201000244,6291,4795,1340,1890,895,129,653,8,3455
48201000240,4398,3145,65,600,2466,56,21,3,3080
48113004077,1592,1257,457,660,89,51,42,2,800
48113004073,3242,2502,659,1650,118,114,9,6,1843
48113004630,2653,2128,921,635,270,64,257,4,1207
48113001113,592,416,12,287,115,13,1,0,404
48113003029,1935,1329,31,309,980,34,7,0,1298
48113003028,1700,1272,28,327,915,36,1,1,1244
48113003206,3354,2605,1053,866,563,66,77,5,1552
48113003003,3256,2367,230,992,1097,61,32,3,2137
48113003002,3576,2460,126,1499,790,72,38,0,2334
48113004093,210,174,24,29,117,9,0,0,150
48113003088,191,117,19,63,38,3,0,0,98
48113003001,1338,824,58,248,508,8,18,1,766
48113004088,3376,2433,87,2182,145,107,18,7,2346
48113003301,4492,3414,1570,975,641,81,182,3,1844
48113003304,5361,4124,1628,1225,817,124,352,6,2496
48113001711,6720,4763,941,3492,261,205,45,2,3822
48113001708,1566,1218,477,438,246,37,27,9,741
48449000009,893,649,412,126,72,28,2,2,237
48201000404,7134,5252,1071,3886,205,185,68,9,4181
48201000143,9776,6858,2612,1366,1399,151,1408,25,4246
48201000511,16383,11111,4328,2121,1892,192,2657,17,6783
48201000443,816,613,468,57,16,10,59,0,145
48201000274,3704,2982,1879,553,243,61,276,1,1103
48201000863,953,700,32,238,430,12,5,0,668
48147000011,3933,2959,2394,278,84,154,22,2,565
48147000007,763,610,509,55,9,32,2,0,101
48181000306,6222,4675,3964,390,32,213,46,6,711
48201000672,7691,5292,2427,1823,592,165,354,11,2865
48201000575,8882,6206,2180,1821,1211,176,912,17,4026
48201000340,5987,4501,3032,973,257,119,142,15,1469
48201000603,9807,7216,2798,2737,1058,237,569,17,4418
48201000785,10995,7342,2223,2655,1495,179,941,20,5119
48291000018,2125,1580,413,276,831,37,19,0,1167
48291000003,2992,2264,1889,202,103,51,22,5,375
48291000027,699,480,293,171,15,12,2,0,187
48291000013,988,691,593,37,31,25,1,3,98
48291000005,4153,3163,2040,664,344,73,49,3,1123
48441000409,1278,953,779,92,16,56,8,2,174
48441000101,6315,4632,2746,1217,482,159,78,8,1886
48441000401,3165,2645,1550,658,344,70,36,7,1095
48113004300,3815,2727,178,2469,56,69,18,2,2549
48113003011,2607,2524,1456,419,407,52,192,6,1068
48113003090,2093,2041,1125,301,445,32,150,0,916
48113001069,64,50,17,17,14,6,1,0,33
48113002715,4448,3536,1369,626,637,68,863,2,2167
48023000001,877,679,600,51,17,10,1,2,79
484990004-1,1185,907,780,72,14,39,9,0,127
48121001007,8436,5881,3487,1024,1055,212,182,17,2394
48121001045,2135,1641,1413,127,17,69,21,2,228
48121001037,1598,1149,887,122,85,42,7,2,262
48121001025,7841,6070,3816,1092,747,204,205,15,2254
48121001047,2309,1597,493,1018,26,54,23,3,1104
48121001048,1296,1021,724,175,40,36,41,4,297
48121001053,5626,4050,2864,731,201,187,49,6,1186
48121001002,2685,2047,1575,310,61,57,42,1,472
48121003018,4616,3239,808,2078,223,158,85,7,2431
48121001035,4218,3456,2318,312,274,71,496,9,1138
48449000006,1967,1402,911,344,73,59,8,0,491
48449000010,1426,1077,827,200,12,38,5,1,250
48449000015,1728,1257,692,461,68,31,12,1,565
48451000114,1769,1370,112,1202,57,37,20,5,1258
48439003465,6551,4597,2697,981,507,144,320,18,1900
48439003417,4562,3149,1765,588,427,105,282,13,1384
48439004705,5354,3748,1576,929,700,91,545,16,2172
48439004599,9298,6255,3062,1103,937,140,1069,19,3193
48439004375,4418,3388,2412,491,252,109,143,6,976
48439001005,1471,1037,56,381,578,22,17,1,981
48439001444,112,101,30,10,60,1,0,0,71
48439001677,347,335,231,63,22,6,14,1,104
48439001001,2240,2026,1302,276,306,53,86,8,724
48113002019,2064,1600,1329,84,43,27,123,2,271
48113004016,2449,2057,639,649,679,49,73,2,1418
48023000002,814,602,460,98,18,16,2,1,142
48439002174,4546,3664,1897,663,777,83,271,9,1767
48439003321,4252,3414,2381,726,96,129,124,16,1033
48439003335,3227,2554,1727,429,182,74,135,30,827
48439004350,1896,1607,1227,226,57,47,57,5,380
48439002488,4017,2945,647,503,1109,54,653,2,2298
48439002349,2692,1999,500,414,593,41,465,1,1499
48439002275,1753,1280,328,558,287,66,82,4,952
48439004638,5656,3718,1993,745,615,132,264,24,1725
48053000002,5550,4405,3089,967,160,114,66,5,1316
48053000010,2158,1739,1429,208,14,68,8,0,310
48053000017,2566,1981,1644,230,31,55,24,1,337
48295000308,190,157,125,25,0,4,0,1,32
48449000007,1901,1428,945,311,119,39,13,0,483
48449000004,893,728,553,128,13,34,4,1,175
48449000014,3580,2542,974,1136,378,65,11,3,1568
48449000002,1032,758,382,225,129,29,10,0,376
48141000186,1272,965,177,701,64,31,18,3,788
48141000060,3392,2772,922,1459,280,78,107,20,1850
48141000188,207,159,35,101,16,9,9,3,124
48141000064,5367,4025,283,3587,130,72,44,8,3742
48141000166,5906,4407,541,3773,56,98,16,8,3866
48141000167,8042,5857,135,5675,50,124,18,3,5722
48141000005,6611,4683,497,4018,89,127,83,11,4186
48141000192,6897,4922,832,3790,160,119,110,12,4090
48073000036,2391,1916,1452,318,95,53,5,0,464
48073000014,2095,1612,1270,253,44,35,12,2,342
48113001033,2894,2056,788,978,185,49,84,2,1268
48113002300,2632,1979,566,1234,91,90,72,4,1413
48113002311,2432,1644,144,1358,98,42,36,0,1500
48113001060,5123,4094,3326,451,84,91,134,7,768
48113001051,325,282,192,52,13,14,9,4,90
48441000404,3999,3076,1876,895,201,118,41,3,1200
48441000103,4665,3474,2133,841,328,126,54,11,1341
48441000105,7824,6062,3406,1188,891,227,424,15,2656
48441000308,2384,1779,1548,132,27,54,21,2,231
48441000307,9532,6705,5195,807,284,150,287,21,1510
48441000306,7664,5673,4319,659,268,117,310,20,1354
484990003-2,3718,3309,3008,142,23,106,14,0,301
48175000022,338,268,127,134,0,8,4,0,141
48175000042,876,695,571,88,17,19,3,1,124
48053000011,563,451,413,17,5,11,2,0,38
48053000004,3068,2585,2192,270,28,63,23,1,393
48053000005,1230,1063,919,90,10,33,10,1,144
48053000001,1933,1570,1324,168,10,45,8,0,246
48161000014,559,468,387,17,56,5,5,2,81
48201000152,8175,5922,472,4878,544,213,21,6,5450
48201000185,4337,3223,302,2445,372,129,104,1,2921
48201000595,5501,3875,247,2440,1075,95,129,16,3628
48201000194,3753,3335,1635,501,661,71,502,6,1700
48201000576,4225,3077,180,857,1984,62,45,5,2897
48201000569,8985,7904,3646,1498,1085,114,1543,15,4258
48201000436,7015,6080,3426,1006,633,115,885,22,2654
48201000591,5856,4145,277,3685,178,114,18,2,3868
48201000795,3143,2311,186,2082,32,92,5,1,2125
48201000835,779,527,28,486,13,18,2,0,499
48201000077,75,51,2,49,0,0,0,0,49
48201000029,6488,4655,318,4256,32,77,44,1,4337
48439002712,4633,3319,1474,458,851,79,471,12,1845
48439002221,2541,1802,911,205,456,44,205,0,891
48439002548,2300,1675,1217,171,137,69,95,5,458
48439002636,4997,3693,2108,751,633,115,136,9,1585
48439002525,6097,4265,938,1378,1506,114,445,14,3327
48439001197,6495,4714,2432,741,721,100,706,55,2282
48439001722,626,463,193,114,127,17,17,2,270
48439001701,2077,1502,713,243,239,43,255,33,789
48439004452,6659,4553,1689,1044,518,107,1252,15,2864
48439004711,4222,3049,1183,717,355,82,738,12,1866
48439004707,3662,2402,991,904,326,99,145,7,1411
48439004232,7904,5468,2086,1602,732,145,1005,19,3382
48439003185,0,0,0,0,0,0,0,0,0
48073000044,2218,1690,1212,360,44,64,17,3,478
48021004018,1540,1141,736,335,21,32,13,3,405
48021004017,5277,3849,1666,1443,638,135,34,4,2183
48201000356,6761,5133,2180,1507,973,90,443,10,2953
48201000593,9264,6908,1077,3918,620,274,1289,7,5831
48201000628,5957,4281,456,3393,292,176,114,10,3825
48201000061,4751,3380,286,2916,151,122,39,5,3094
48201000423,7941,5245,209,4667,347,204,68,15,5036
48201000704,5057,3770,2464,1044,50,99,116,6,1306
48201000228,1483,1284,124,57,1025,17,63,9,1160
48201000659,8864,6755,3844,1343,1134,141,317,25,2911
48201000379,3190,2458,78,1206,1182,32,16,1,2380
48201001012,4583,3199,145,2008,461,100,581,5,3054
48201000990,278,200,5,153,5,2,41,0,195
48201000755,13697,9900,1294,5876,1578,226,1163,22,8606
48201000972,14,9,1,7,0,1,0,0,8
48201000849,4813,3639,298,2876,326,119,180,3,3341
48201000843,2620,1970,179,1075,688,36,56,5,1791
48201000455,2829,2186,40,719,1436,62,6,1,2146
48201000307,5347,4360,2907,812,330,143,230,9,1453
48201000560,2632,1939,64,1848,29,73,5,0,1875
48201000068,5952,4253,122,547,3586,52,25,3,4131
48201000401,3653,2702,59,1179,1466,94,15,2,2643
48121003003,3777,2788,2098,230,153,50,242,1,690
48121001010,4682,3558,2313,830,213,133,86,11,1245
48121001005,3584,2787,2247,334,52,127,31,1,540
48121001031,4783,3434,2210,321,371,61,448,5,1224
48439004342,3200,2482,1909,308,134,74,59,1,573
48439002413,1380,992,127,420,338,32,103,1,865
48439002484,8214,6161,1123,1680,2266,129,1104,18,5038
48439002308,6298,4644,2365,1156,868,165,129,11,2279
48439001085,2169,1451,269,788,298,40,93,3,1182
48439001227,3169,2263,497,412,1120,60,246,5,1766
48439001714,6552,4878,1327,1196,2022,161,259,3,3551
48439004096,1420,1143,778,239,35,56,48,5,365
48439004060,3210,2637,1516,762,114,82,182,13,1121
48439004492,2421,2271,1540,328,287,31,98,5,731
48439004046,6815,5109,4243,473,121,185,63,2,866
48439003156,2187,1734,1339,197,55,72,55,11,395
48439001348,1212,965,728,124,56,20,30,2,237
48439001424,12,10,8,2,2,0,0,0,2
48439001186,913,809,648,61,35,11,54,2,161
48439001237,2773,1866,254,1476,106,34,34,1,1612
48439002267,5889,4227,1160,1517,1138,97,373,8,3067
48439001273,6207,4362,796,3277,158,154,88,4,3566
48439001165,415,297,140,145,10,10,2,1,157
48439001133,2985,2289,1257,868,109,71,25,0,1032
48439001715,1668,1250,550,251,288,48,142,6,700
48439001347,5182,3868,1485,660,1209,97,455,4,2383
48439001479,507,368,62,217,77,14,10,0,306
48439001415,5020,3461,482,1713,1127,100,85,1,2979
48439004141,7771,6110,2561,1633,1116,149,722,15,3549
48201000663,3766,2987,1737,839,143,71,211,14,1250
48201000927,2815,2012,1285,494,57,50,134,4,727
48201000324,3695,2809,1932,571,178,62,98,5,877
48201000058,5138,4279,2592,1065,161,121,349,8,1687
48201000086,6625,5689,3358,1204,412,134,615,14,2331
48201000197,4162,3138,47,965,2100,62,39,2,3091
48201000482,7864,5759,2918,1531,689,171,549,19,2841
48201000176,1745,1299,787,158,45,20,289,0,512
48201000220,8616,5877,1642,4022,121,213,51,6,4235
48201000063,3841,2985,1948,798,138,107,30,3,1037
48201000238,3012,2247,25,1023,1190,54,9,0,2222
48201000206,5080,4166,1545,2311,111,154,148,6,2621
48201000412,884,688,58,297,339,13,9,1,630
48201000321,7736,5359,420,4813,105,171,29,2,4939
48201000779,4371,2931,178,2684,43,92,15,4,2753
48201000590,2732,2053,1608,243,71,77,56,11,445
48201000563,4991,4037,2799,607,367,73,168,11,1238
48201000032,5321,5032,2737,988,562,100,650,26,2295
48201000419,6426,4606,1305,3097,109,96,41,14,3301
48201000204,5497,4581,2919,1023,322,101,239,3,1662
48201000254,6294,4126,207,3621,265,192,25,9,3919
48201000937,0,0,0,0,0,0,0,0,0
48021003013,2682,1998,1344,482,98,98,10,4,654
48021003012,1659,1278,837,304,88,67,8,3,441
48021001022,5656,4322,2754,890,442,115,150,14,1568
48439001074,2544,1774,86,1348,331,39,4,6,1688
48439002210,2601,1795,287,1340,128,101,30,1,1508
48439002168,6001,4427,1554,1544,1036,153,265,19,2873
48439003176,6482,5050,2930,1078,668,188,198,34,2120
48439001501,1104,774,294,192,258,15,34,5,480
48439001642,4490,3180,754,762,1448,54,202,8,2426
48439001436,2500,1739,486,383,773,40,96,3,1253
48439001345,841,616,287,152,129,21,27,6,329
48439001388,6931,5175,1269,804,2088,93,926,37,3906
48439003282,2456,1956,1421,286,130,68,52,5,535
48439003664,0,0,0,0,0,0,0,0,0
48439004091,4605,3540,2188,1120,55,126,51,24,1352
48439004551,7228,5089,2749,1340,654,179,231,20,2340
48439004285,3260,2292,992,661,531,45,74,11,1300
48439003510,3472,2810,2261,180,75,50,213,0,549
48439001257,3649,2587,725,1061,709,91,84,3,1862
48439003729,6,5,3,1,2,1,0,0,2
48439003637,4461,3209,1577,635,451,87,465,22,1632
48439003698,5856,3982,2235,704,459,132,498,9,1747
48201000158,4734,3319,31,311,2978,40,31,6,3288
48201000142,2256,1641,60,1548,29,52,12,1,1581
48201000258,4877,3390,2555,287,45,55,457,5,835
48201000439,7594,5789,3089,660,291,75,1643,7,2700
48201000335,11171,7525,434,5908,767,193,428,8,7091
48113003106,6100,4310,634,1137,2507,134,62,7,3676
48113003064,3283,2521,55,441,2019,44,14,0,2466
48113004664,5634,4702,1335,663,734,72,1949,6,3367
48113004009,4230,3085,174,2829,59,108,10,1,2911
48113002061,4327,3133,2219,379,406,66,72,3,914
48265000109,1880,1577,1263,241,23,26,13,4,314
48265000312,6152,4982,3106,1535,149,136,82,15,1876
48337000010,1762,1319,1001,246,11,61,10,0,318
48201000629,2374,1574,74,517,969,22,22,9,1500
48439001674,0,0,0,0,0,0,0,0,0
48439004540,5972,4456,2140,1105,589,120,560,17,2316
48439004508,7370,5523,2728,1257,739,190,636,23,2795
48439001117,2697,2209,1644,337,70,78,80,1,565
48439003209,5028,3877,3161,306,143,86,141,11,716
48439003517,4753,3956,2159,607,858,82,265,25,1797
48439004272,969,826,599,110,39,26,51,3,227
4828900014A,300,263,200,20,35,12,1,0,63
48289000014,206,174,144,15,8,1,2,0,30
48289000013,869,756,652,63,29,13,5,0,104
48289000011,1849,1358,815,347,134,45,20,4,543
48321000006,1674,1479,1139,94,178,34,10,0,340
48321000012,552,376,189,166,2,26,5,0,187
48439004328,4316,3200,1304,1411,243,121,165,13,1896
48439004640,1082,962,502,323,82,14,43,0,460
48439004253,987,935,656,172,65,10,26,0,279
48439004615,0,0,0,0,0,0,0,0,0
48439004683,0,0,0,0,0,0,0,0,0
48439004218,3322,2424,806,1349,37,96,213,6,1618
48439004602,0,0,0,0,0,0,0,0,0
48439004123,5406,3798,242,3477,61,100,17,0,3556
48439004231,4744,3201,216,2793,161,80,20,7,2985
48439003322,2561,2117,1676,214,73,44,109,2,441
48439003574,1835,1480,721,227,202,23,316,0,759
48439001270,1289,957,420,356,145,31,23,5,537
48439004195,4544,3075,213,2779,36,82,42,1,2862
48439004201,2645,1882,55,1790,35,37,9,2,1827
48439004129,1468,1077,941,76,14,19,22,2,136
48113003086,5604,5458,3977,694,282,79,416,5,1481
48113003000,5488,5260,3858,561,256,83,463,4,1402
48113001309,1393,979,82,332,560,20,8,0,897
48113001085,3913,2746,190,2437,98,80,5,2,2556
48245000039,2827,2032,70,205,1752,19,13,2,1962
48439001617,88,68,26,31,2,12,0,0,42
48439003049,4034,3131,2514,263,115,99,156,0,617
48439003140,2860,2201,1585,362,85,93,74,2,616
48439003421,1840,1429,1183,99,26,42,87,2,246
48439004182,4618,3537,2637,316,179,91,314,6,900
48265000202,3759,2931,2029,769,23,90,22,7,902
48289000003,766,639,510,57,49,23,6,0,129
48289000004,1183,956,751,98,63,28,10,1,205
48285000023,1882,1455,1130,281,23,20,0,2,325
48285000002,2070,1583,1208,166,191,8,5,0,375
48439003507,4311,3181,2049,688,232,105,112,6,1132
48439003324,4070,3160,2096,569,291,112,113,19,1064
48439004016,2016,1731,1319,228,128,51,25,3,412
48439002262,1728,1327,894,259,83,65,49,5,433
48439002355,2721,1932,1095,368,345,62,88,4,837
48195000004,1080,761,430,316,6,15,0,1,331
48409000103,621,501,295,181,5,10,4,0,206
48409000101,749,554,201,336,6,17,2,0,353
48439004649,5479,4032,2406,1091,240,134,200,9,1626
48439004068,3900,2807,171,2548,84,52,24,5,2636
48439004685,18,8,1,5,2,2,0,0,7
48439002220,3381,2647,1843,244,234,59,276,2,804
48439001346,2536,1629,85,665,874,26,2,6,1544
48439001251,7513,5024,838,1222,2674,132,292,11,4186
48439001255,5268,3908,1161,1125,1317,140,274,3,2747
48439004702,2724,1836,1002,482,206,42,112,2,834
48441000206,4060,3089,2458,477,43,97,12,9,631
48441000107,1217,935,670,185,29,42,7,1,265
48113002021,3911,3059,2546,187,44,37,229,2,513
48113002018,1201,874,688,52,31,14,91,0,186
48113002008,1535,1228,1036,56,24,23,73,0,192
48113003022,3716,2593,55,743,1797,37,13,5,2538
48439004137,1865,1487,1263,134,31,25,26,3,224
48441000102,4344,3360,2198,847,179,128,48,3,1162
48441000402,5965,5131,3661,747,501,111,121,5,1470
48441000405,3353,2454,1465,705,177,87,41,7,989
48441000301,5281,4038,2561,873,414,127,120,13,1477
48245000036,2691,2121,1631,262,104,58,53,3,490
48245000077,2802,1803,89,91,1602,22,7,4,1714
48439003390,5176,3914,2915,216,92,88,563,3,999
48439003332,6240,4463,2235,1080,472,145,548,11,2228
48439003667,180,145,82,10,20,1,32,4,63
48439002052,8585,7857,2897,1214,1574,118,2050,13,4960
48439003254,4203,3257,1863,619,468,107,167,63,1394
48439001550,73,45,3,25,16,1,0,0,42
48439001544,26,23,5,17,0,0,0,0,18
48439003329,5374,4143,1709,831,690,100,753,108,2434
48439002027,3054,2214,472,846,441,86,428,8,1742
48439002002,0,0,0,0,0,0,0,0,0
48439004069,2438,1983,1541,232,85,56,62,2,442
48439003248,5098,3983,3190,308,132,101,244,6,793
48439003663,18,10,2,1,0,5,0,0,8
48439003364,1954,1526,860,238,279,39,114,5,666
48439003215,3199,2635,2007,299,168,62,94,2,628
48119000007,334,271,243,11,2,16,2,0,28
48113003044,5506,3764,74,1474,2201,61,34,5,3690
48113002507,3011,2331,1734,311,135,69,112,0,597
48113001096,4038,2844,150,2416,252,106,16,0,2694
48113004069,6091,4557,591,3793,138,161,26,4,3966
48113003092,3571,2555,96,596,1851,43,10,9,2459
48113002051,3538,2531,1849,381,162,65,101,4,682
48441000203,5625,4016,1790,1424,652,123,67,13,2226
48441000204,2993,2315,1593,371,185,85,100,4,722
48441000201,4091,3079,1230,1430,320,116,42,13,1849
48121004009,8868,7373,3040,2823,1048,273,344,29,4333
48121004006,3761,3024,2023,508,270,108,117,8,1001
48121002004,6245,4923,1828,1368,580,135,1052,16,3095
48121003002,5610,4161,3368,324,145,80,242,1,793
48121001030,7237,4911,3302,597,342,112,577,7,1609
48121004011,12019,9406,4195,2217,2549,282,310,31,5211
48121002014,3747,2940,1739,367,195,89,561,8,1201
48121003008,4092,3208,2177,490,228,126,219,4,1031
48121004033,5805,4449,2985,757,210,167,362,9,1464
48121004032,7645,5213,3933,424,190,125,510,12,1280
48121004047,3863,2588,1731,417,138,85,217,8,857
48439003646,6000,4346,2695,735,485,161,286,15,1651
48285000020,129,106,92,4,3,3,1,1,14
48439002657,102,80,21,11,46,3,1,2,59
48439002656,322,248,90,106,44,4,7,1,158
48439002148,8712,6220,1110,3549,1239,246,303,14,5110
48439002655,2343,1915,730,547,535,49,80,1,1185
48439002190,613,480,193,218,42,15,16,3,287
48439001423,2904,2386,1892,136,64,49,246,2,494
48439004591,5231,3600,1793,896,516,138,335,10,1807
48439004261,5927,4489,2079,1273,534,118,523,15,2410
48439004057,955,915,635,119,86,26,42,2,280
48439002506,6832,5262,3422,808,741,160,142,17,1840
48439002356,5009,4004,1897,755,907,93,389,7,2107
48439001149,7717,5340,881,2142,2220,115,80,9,4459
48439003330,1369,1120,909,81,36,15,72,7,211
48439001109,3437,2598,608,1716,147,48,92,3,1990
48439001416,228,181,102,65,13,3,2,0,79
48201000036,8983,6465,490,3954,1238,115,879,19,5975
48201000345,9177,6613,691,3726,1603,239,634,19,5922
48201000432,9341,6840,795,5067,722,561,232,11,6045
48201000169,3793,2701,45,538,2114,26,4,4,2656
48201000494,7787,5335,196,3411,1558,139,201,14,5139
48201000987,2036,1501,48,813,631,31,15,0,1453
48201000725,5474,3937,668,1812,1395,88,88,8,3269
48201000467,2620,1989,102,1005,570,72,314,3,1887
48201000977,2890,2055,184,1191,253,88,438,4,1871
48201000720,9985,7763,3604,2368,1116,204,598,11,4159
48201000809,391,275,51,179,19,17,22,0,224
48201000886,1653,1466,704,247,84,7,411,7,762
48201000003,2708,2242,1519,404,129,35,159,7,723
48201000887,747,726,477,124,53,4,67,0,249
48201000320,4713,3395,458,2788,104,194,51,2,2937
48439004086,2872,2400,2121,163,35,55,25,2,279
48439002226,5156,3654,727,1412,928,109,562,0,2927
48439002393,1019,742,154,428,88,23,66,1,588
48439002699,6264,4337,1289,599,1716,74,701,2,3048
48439003486,6496,4323,2846,621,377,145,345,25,1477
48439003709,2285,1560,1033,246,111,39,139,6,527
48201000186,1637,1226,14,941,274,30,4,2,1212
48201000011,3492,2784,275,2294,173,98,49,1,2509
48201000426,2504,1971,400,839,196,57,525,4,1571
48181000409,6388,5084,3779,576,356,259,108,8,1305
48181000408,2594,2070,1664,146,86,119,42,1,406
48181000206,1803,1417,1184,59,67,80,24,4,233
48181000403,3930,3361,2993,103,26,170,19,9,368
48181000302,10606,8116,5361,1196,844,370,367,21,2755
48203000011,940,740,382,128,212,31,5,3,358
48203000017,2314,1863,876,243,673,56,16,6,987
48203000007,1192,969,703,50,182,19,7,1,266
48203000005,1095,961,768,30,117,40,6,2,193
48203000015,1570,1152,1062,34,20,27,3,0,90
48203000019,6214,4526,3309,517,447,213,31,3,1217
48203000014,1987,1534,1073,122,263,54,7,3,461
48147000013,1201,983,849,70,8,36,16,1,134
48181000105,9002,6537,5356,647,189,239,68,4,1181
48147000016,444,352,325,3,5,8,4,1,27
48201000338,11128,8376,685,3346,1979,216,2424,7,7691
48201000225,9225,7175,2066,2233,2434,138,456,14,5109
48201000671,5588,4351,1573,1508,672,148,542,3,2778
48201000108,9902,7131,1728,2905,2101,236,234,135,5403
48201000911,1512,1199,494,400,221,35,46,30,705
48201000366,10509,7254,369,4582,1408,182,910,6,6885
48201000697,7082,5185,491,3140,1161,172,420,11,4694
48201000161,1842,1393,77,462,871,27,12,10,1316
48201000450,7985,5780,795,3088,1815,178,103,9,4985
48201000975,264,202,92,65,41,0,5,0,110
48367000135,2659,2001,1597,247,32,76,17,0,404
48367000100,5395,4264,3551,446,58,156,51,3,713
48367000215,5262,3897,3229,401,46,166,25,11,668
48367000440,5368,3720,3237,266,61,104,39,7,483
48367000430,4566,3023,2521,314,36,60,69,12,502
48157002050,3845,3011,78,437,2480,40,46,1,2933
48157002059,3216,2522,114,509,1875,47,38,5,2408
48339000028,5525,4094,2831,1027,64,175,47,3,1263
48339000071,6368,4435,3193,641,95,57,416,6,1242
48263000202,113,96,83,12,2,0,2,1,13
48439002522,7209,5299,2971,901,1013,169,277,20,2328
48439002145,6010,4179,684,2763,582,193,114,4,3495
48189000318,1795,1285,782,448,23,43,6,4,503
48189000204,1732,1204,266,881,33,33,1,6,938
48021001001,4746,3715,2711,662,131,125,82,14,1004
48021002009,2767,2292,1458,530,169,87,49,13,834
48021001002,3793,2931,1635,662,495,113,36,4,1296
48021003016,5714,4224,2087,1664,290,206,66,1,2137
48021001003,4827,3914,2430,994,263,139,90,12,1484
48243000005,251,234,197,23,2,10,3,2,37
48201000257,11659,8004,566,4861,2251,172,371,17,7438
48201000547,4321,3318,1886,967,240,119,139,7,1432
48201000252,2915,2218,39,582,1585,50,11,0,2179
48201000406,958,719,10,218,494,20,1,0,709
48201000042,1422,1042,12,273,767,18,1,1,1030
48201000442,5618,4407,3319,579,227,119,157,6,1088
48201000006,8814,6379,1945,2277,1916,212,224,28,4434
48201000493,6466,4783,741,2035,1049,129,980,5,4042
48201000359,14523,9869,356,5461,3734,183,431,19,9513
48157001094,21,18,5,7,6,3,0,0,13
48157002034,7699,5267,208,919,4007,75,165,11,5059
48157003069,569,475,194,69,75,4,134,1,281
48453000452,8958,6127,747,4638,686,223,56,11,5380
48453000429,14130,12537,5237,4314,1794,342,1075,27,7300
48453000108,2852,2278,753,1111,281,92,148,0,1525
48453000102,2752,2047,600,885,320,63,235,6,1447
48221000015,1237,817,597,123,75,21,8,1,220
48099000310,1187,967,786,135,19,20,4,0,181
48355000023,3206,2440,1543,798,24,48,32,2,897
48355000002,4043,3301,1374,1706,109,109,68,4,1927
48355000087,2379,1814,372,1346,70,42,19,0,1442
48355000095,1284,986,118,846,17,16,10,2,868
48355000020,5480,4048,616,3056,238,88,108,10,3432
48355000054,2040,1543,136,1375,22,11,8,0,1407
48215000060,8119,5402,262,5073,12,78,23,3,5140
48215000146,5846,3689,47,3621,8,53,6,1,3642
48215000206,2734,1873,109,1690,35,43,35,1,1764
48215000207,3984,2915,351,2389,30,62,127,3,2564
48215000074,2342,1542,148,1369,10,26,25,0,1394
48215000092,1626,978,38,935,4,11,1,0,940
48215000180,895,530,11,512,0,15,1,0,519
48215000018,818,560,15,543,1,7,0,0,545
48215000215,3427,2519,194,2077,38,43,195,3,2325
48215000233,22,9,0,4,0,1,2,2,9
48215000057,2270,1552,36,1497,10,15,6,1,1516
48215000250,753,464,14,443,4,13,4,0,450
48343000101,1236,910,311,125,440,22,15,3,599
48051000215,910,669,420,182,30,44,5,3,249
48099000104,7204,5351,3067,887,936,225,256,116,2284
48463000007,772,592,311,266,2,6,0,0,281
48453000306,4492,3603,3048,274,55,63,126,4,555
48453000349,8579,6858,4496,1399,260,204,529,12,2362
48453000228,3029,2657,1615,466,128,58,410,5,1042
48289000007,782,603,516,61,11,3,2,0,87
48113002307,1247,992,437,352,100,37,83,3,555
48215000028,7206,4852,452,4351,32,77,20,1,4400
48465000023,271,212,85,113,4,5,4,0,127
48465000042,43,30,19,11,0,0,0,0,11
48215000025,6485,4567,694,3812,20,51,39,2,3873
48453000325,197,188,141,24,20,3,5,1,47
48453000329,7971,7679,5331,952,651,134,565,18,2348
48113002071,2750,1872,1665,94,19,37,51,2,207
48113003404,7574,5139,1027,2979,1060,173,34,4,4112
48113003308,5403,3643,955,1998,614,161,39,11,2688
48113003083,4283,2948,547,1947,425,119,8,4,2401
48215000062,5132,4145,897,2924,72,77,211,2,3248
48215000160,902,750,270,380,31,11,69,0,480
48215000140,89,64,13,39,0,3,9,0,51
48149000009,372,295,251,36,4,6,0,0,44
48149000005,332,261,231,21,4,5,0,1,30
48351000019,256,197,168,3,19,5,0,0,29
48351000014,365,303,117,7,168,7,0,0,186
48453000263,4344,3710,2374,711,230,83,345,9,1336
48215000042,5498,3884,270,3548,33,56,38,2,3614
48215000021,988,700,15,680,2,8,4,0,685
48215000095,8579,6096,102,5944,12,94,34,0,5994
48215000004,8553,6011,303,5649,19,60,37,3,5708
48355000089,1139,874,230,600,13,16,17,3,644
48355000070,5698,4109,864,2857,253,106,126,8,3245
48355000007,1361,1014,86,827,100,22,11,3,928
48113004520,2242,1599,279,1111,127,71,65,7,1320
48113004535,1934,1396,146,1008,150,47,75,7,1250
48113004536,113,92,22,40,8,7,15,0,70
48113004081,7706,5302,151,4672,431,179,33,3,5151
48113004065,3211,2283,172,2028,56,100,12,2,2111
48113004517,5155,4193,2028,1189,705,156,157,13,2165
48201000652,4352,3480,157,816,1894,36,630,3,3323
48201000581,1399,1045,19,279,749,22,4,3,1026
48201000137,5863,3822,1729,1260,515,180,229,18,2093
48201000880,4681,3285,1883,753,204,68,409,5,1402
48201000135,5096,4458,3025,549,333,55,438,3,1433
48201000342,3106,2161,215,1254,653,84,37,10,1946
48201000738,5074,3504,194,1615,1628,54,66,28,3310
48201000794,12294,8296,400,4607,3264,229,131,10,7896
48201000326,2060,1502,171,1295,20,51,6,1,1331
48163000004,2341,1708,510,1165,15,25,11,1,1198
48457000016,915,689,638,12,8,28,8,2,51
48457000013,1066,872,794,25,35,13,1,0,78
48453000252,3790,3331,2250,640,193,74,188,4,1081
48453000441,7836,6897,3410,2635,450,208,320,16,3487
48453000136,4507,3524,1846,880,483,142,240,3,1678
48113002224,5812,5255,3495,396,350,89,931,4,1760
48439003216,5914,4585,2543,660,451,133,799,23,2042
48051000207,654,524,287,64,163,11,4,0,237
48215000138,1095,805,12,792,2,18,1,0,793
48215000067,3400,2674,378,2210,40,48,37,0,2296
48261000004,62,52,21,31,2,1,1,0,31
48355000106,3782,2912,883,1731,197,68,48,3,2029
48355000058,1512,1270,692,501,19,37,27,1,578
48439003558,4618,3313,2576,202,68,52,386,6,737
48439003538,5453,3718,2549,310,124,59,649,3,1169
48439002173,1266,1031,735,93,68,29,97,0,296
48439001211,4839,3241,186,1093,1926,57,38,6,3055
48439001184,2522,1839,735,727,312,49,54,6,1104
48439001034,4883,3719,2675,663,191,130,61,10,1044
48439001504,3220,2525,1934,392,86,92,24,6,591
48439001352,975,800,586,128,40,41,8,0,214
48439002450,4864,3537,730,1012,971,65,803,11,2807
48439001337,3264,2605,2089,274,101,78,58,7,516
48439004340,3716,2962,2465,325,35,86,28,4,497
48439004284,398,299,243,29,13,12,4,0,56
48439002033,4976,3562,1663,1296,465,143,66,12,1899
48439001142,2018,1534,890,401,155,49,32,2,644
48439003545,3280,2392,1806,148,73,43,289,1,586
48439003172,5120,3840,2268,905,446,124,110,32,1572
48039000055,5246,3893,2131,1019,629,81,53,1,1762
48039000018,6753,4844,2857,1023,534,111,318,6,1987
48039000052,4394,3250,1906,665,329,51,308,8,1344
48039000029,5486,3973,1080,693,990,71,1203,4,2893
48099000309,1036,806,700,63,11,27,2,0,106
48215000064,8793,5640,56,5558,14,118,12,1,5584
48215000254,1134,709,8,692,0,23,6,1,701
48215000099,18981,12751,343,12353,44,172,15,4,12408
48215000218,2127,1447,29,1409,8,16,1,0,1418
48215000219,3942,2539,58,2446,16,30,18,0,2481
48215000183,1882,1280,20,1254,4,26,2,0,1260
48215000217,610,422,8,413,0,8,1,2,414
48215000243,132,82,9,71,2,0,0,0,73
48215000032,4191,2857,157,2679,21,37,14,1,2700
48355000093,5086,3636,294,3114,193,64,58,6,3342
48051000406,1863,1394,671,345,324,29,7,1,723
48051000113,972,768,563,107,67,25,8,0,205
48051000305,730,609,488,56,39,16,3,1,121
48051000308,567,454,357,33,64,3,0,0,97
48099000206,5527,3411,1571,764,782,129,201,74,1840
48215000224,241,196,61,112,0,5,19,0,135
48215000108,4110,3044,100,2914,22,74,12,0,2944
48215000196,1762,1484,650,811,5,24,18,0,834
48215000186,371,320,28,292,2,3,0,0,292
48215000052,7053,5248,611,4187,101,120,334,3,4637
48453000337,5969,4751,3385,621,164,118,479,9,1366
48453000451,6397,5290,2217,2294,487,169,195,9,3073
48455000011,2269,1935,1668,127,55,53,14,2,267
48227000035,769,599,303,231,34,23,16,1,296
48283000002,1408,1240,524,667,54,11,1,0,716
4828300003A,40,40,24,16,0,0,0,0,16
48035000009,1556,1210,824,292,37,32,9,2,386
48035000011,1061,854,740,60,5,36,2,0,114
48035000008,3467,2732,2078,489,79,82,20,3,654
48283000004,113,87,45,38,0,4,1,1,42
48027000205,9596,6931,1870,1835,2791,257,375,147,5061
48027000305,4062,3349,2295,559,314,130,91,6,1054
48027000302,7629,6024,3506,1190,1038,175,185,22,2518
48063001001,3187,2319,1291,598,364,60,17,7,1028
48201000617,8799,6309,1078,3080,1694,198,471,5,5231
48201000898,4393,3135,656,1521,734,138,238,7,2479
48201000421,3551,2677,885,662,931,89,191,4,1792
48201000964,9882,6846,2467,1775,2091,159,474,11,4379
48201000965,1053,727,264,407,16,25,29,0,463
48201000380,9107,6360,2375,1706,1791,99,468,31,3985
48201000604,5707,4340,3319,674,121,181,45,3,1021
48201000360,6015,5001,2941,683,319,64,956,5,2060
48201000177,3362,2967,1809,431,223,36,458,5,1158
48201000452,10342,7526,3695,2316,805,273,547,22,3831
48215000164,4128,2896,467,2275,23,50,111,3,2429
48215000084,2553,1699,96,1550,14,15,42,0,1603
48027000406,7387,5619,1875,1486,1869,173,291,105,3744
48235000400,379,309,251,37,3,19,6,6,58
48035000003,1642,1266,925,233,73,29,18,0,341
48439001132,3789,2687,104,1514,1061,45,11,7,2583
48439002281,2127,1798,987,298,362,49,125,6,811
48055000303,1799,1312,516,722,39,39,13,2,796
48055000306,1170,857,210,612,12,17,16,3,647
48055000307,0,0,0,0,0,0,0,0,0
48061000077,6337,4524,73,4436,13,42,7,3,4451
48061000101,1245,936,87,823,4,12,18,0,849
48061000076,2446,1798,189,1584,6,21,18,0,1609
48061000061,3894,2975,282,2603,23,49,58,0,2693
48061000024,2908,1992,89,1884,3,22,0,1,1903
48369000303,264,204,58,142,1,7,0,0,146
48375000427,2578,1853,351,1218,195,60,81,2,1502
48055000203,2075,1533,831,558,97,47,10,2,702
48201000364,6963,5206,1189,2946,800,147,228,6,4017
48225000010,386,301,240,17,34,9,3,1,61
48225000015,288,244,187,6,41,3,3,2,57
48343000303,1582,1265,1043,68,100,43,7,2,222
48215000081,8435,6122,511,5326,56,158,222,3,5611
48507000001,854,654,76,572,2,2,7,2,578
4850700001A,1010,666,60,594,8,9,8,3,606
48215000245,1454,932,5,922,5,10,2,1,927
48215000117,9923,7173,145,6975,27,103,3,4,7028
48479000406,1974,1429,32,1380,4,15,4,1,1397
48479000404,3737,2554,38,2513,9,33,2,2,2516
48061000013,1443,1030,22,1000,2,12,2,2,1008
48227000026,1361,936,435,440,34,48,10,2,501
48227000025,1727,1281,822,338,40,50,39,5,459
48369000402,1865,1237,103,1113,17,59,7,2,1134
48201000475,4393,3225,618,1334,353,56,900,3,2607
48201000850,293,224,52,115,39,3,17,0,172
48201000277,6433,4468,590,3673,173,118,25,6,3878
48201000430,8546,5879,583,2917,1093,114,1333,9,5296
48201000567,11399,8371,865,5308,1500,248,752,14,7506
48183000009,5863,4792,3265,441,853,105,138,3,1527
48227000207,1518,1175,913,212,10,25,10,2,262
48227000205,1870,1384,1118,191,23,46,15,1,266
48249000003,1512,1148,645,451,12,49,2,0,503
48455000005,735,575,330,129,102,5,10,2,245
48283000005,1866,1520,319,1028,168,16,4,3,1201
48035000004,724,598,464,92,14,23,6,0,134
48455000018,140,117,34,13,66,4,0,0,83
48209000315,4172,3527,2643,633,55,96,69,4,884
48209000336,3943,3430,2101,950,211,111,95,12,1329
48209000301,0,0,0,0,0,0,0,0,0
48209000120,3150,2284,834,1155,153,91,100,11,1450
48209000338,2831,2322,2050,172,8,68,22,3,272
48209000337,3809,3009,2471,340,23,110,36,3,538
48209000227,5592,4119,1647,2047,239,127,154,1,2472
48209000224,3484,2299,1479,607,71,70,70,2,820
48209000235,5347,3637,2470,937,67,90,92,3,1167
48209000228,6905,5103,2054,2398,329,159,299,12,3049
48209000232,2305,1758,1237,368,71,62,31,5,521
48055000402,3642,2688,791,1629,211,63,33,4,1897
48055000107,0,0,0,0,0,0,0,0,0
48055000115,8,5,1,1,2,3,2,0,4
48055000114,0,0,0,0,0,0,0,0,0
48055000116,0,0,0,0,0,0,0,0,0
48061000015,3389,2606,214,2357,18,15,19,2,2392
4822700207C,911,640,402,214,10,9,5,1,238
48227000104,225,165,100,57,5,14,3,3,65
48463000006,213,186,142,41,1,11,0,0,44
4841900001S,3118,2296,1377,504,330,51,49,8,919
48371000006,280,226,51,173,0,3,1,0,175
48343000302,1698,1279,846,59,308,61,12,8,433
48343000103,932,760,448,69,215,18,6,3,312
48061000018,4823,3530,198,3297,20,36,14,6,3332
48201000120,10001,7639,2792,2983,735,202,1048,2,4847
48135000409,3201,2230,350,1829,31,41,11,0,1880
48201000351,6698,5152,3627,801,382,148,206,25,1525
48201000872,216,144,25,116,5,3,1,0,119
48201000831,165,118,16,93,8,2,3,0,102
48201000925,0,0,0,0,0,0,0,0,0
48201000627,8559,6338,540,2559,1314,166,1872,10,5798
48225000017,2861,2762,979,796,980,6,10,0,1783
48225000009,573,462,401,26,13,19,1,0,61
48225000012,171,139,113,10,5,7,0,0,26
48225000020,302,241,212,14,7,5,0,0,29
48201000521,5526,4130,1177,1793,820,100,352,8,2953
48201000992,2237,1649,492,893,193,61,65,8,1157
48201001009,0,0,0,0,0,0,0,0,0
48201000534,6979,5322,2351,2625,114,127,187,4,2971
48201000088,1931,1475,931,342,126,57,24,5,544
48201000290,3656,2842,1502,998,197,88,54,9,1340
48201000377,4831,3787,2725,728,148,128,55,2,1062
48201000637,4554,3629,583,2687,272,85,67,3,3046
48061000064,5592,4052,690,3260,36,96,41,7,3362
484190001SW,1883,1466,1043,216,166,34,16,4,423
48201000141,3591,2401,573,1730,41,96,20,4,1828
48201000484,7458,5873,2661,1245,1071,136,812,23,3212
48201000479,5673,4233,2692,725,494,74,236,4,1541
48201000486,6664,4998,3135,864,321,122,566,7,1863
48201000104,2978,2194,33,750,1391,35,13,0,2161
48201000165,5294,3985,1612,1900,218,173,229,12,2373
48201000211,8809,6440,500,4888,397,183,622,2,5940
48201000038,4104,3594,2488,553,111,78,357,6,1106
48453000435,9739,7710,4178,2569,489,243,342,19,3532
48453000309,3978,3075,1995,729,130,84,185,6,1080
48453000145,4503,3483,1360,1176,616,123,269,8,2123
48355000109,705,555,196,310,16,11,22,0,359
48355000116,7233,5634,1718,3320,363,119,198,7,3916
48355000035,1335,984,50,913,15,2,4,1,934
48455000014,864,714,629,33,8,30,3,2,85
48239000002,3596,2706,1594,972,75,60,13,4,1112
48239000009,797,642,501,96,15,19,11,0,141
48239000005,943,700,466,183,27,24,8,1,234
48375000425,5564,3569,672,1728,789,83,350,3,2897
48201000512,10464,8009,1660,3867,1569,267,876,16,6349
48201000991,11,4,0,3,2,1,1,0,4
48201000235,2467,1891,74,312,1492,24,25,0,1817
48453000207,9518,7979,3937,1468,671,190,1808,19,4042
48491000162,4890,4008,2422,757,365,84,410,7,1586
4827700004F,2607,1912,1525,96,147,104,44,2,387
4827700004G,2309,1802,1451,103,72,106,58,4,351
48201000388,11095,7531,2286,2427,2378,162,376,38,5245
48201000447,10909,7204,3469,1774,1552,183,330,22,3735
48201000968,5023,3421,435,1168,1623,85,163,11,2986
48201000967,501,358,73,80,191,0,12,0,285
48201000717,4185,3090,124,1561,1136,123,267,3,2966
48201000694,5994,4367,1020,1368,1414,95,585,6,3347
48201000823,5872,4364,1287,1735,633,134,663,16,3077
48201000478,9079,7202,3139,1799,1507,172,695,10,4063
48201000969,792,625,2,46,567,7,4,2,623
48201000402,3976,2880,107,946,1760,82,66,6,2773
48201000589,9455,7327,2094,3170,1560,246,500,16,5233
48201001006,15,8,0,6,5,0,2,0,8
48201000655,8123,5993,2760,1520,752,144,852,26,3233
48201000300,8179,5667,4010,646,190,91,706,3,1657
48201000688,6499,4860,3318,719,294,102,392,5,1542
48227000013,5481,5133,751,3944,383,86,46,1,4382
48227000037,0,0,0,0,0,0,0,0,0
48227000011,3081,2258,604,1350,237,79,31,5,1654
48035000001,886,693,601,73,0,16,3,0,92
48227000404,1016,777,514,232,10,28,0,1,263
48227000409,877,649,470,143,2,23,5,0,179
48201000609,8055,6082,2032,2256,494,143,1254,7,4050
48201000656,4203,3088,65,1064,1959,41,9,0,3023
48201000585,5047,3412,83,1310,2016,90,19,5,3329
48201000385,2696,2137,1654,176,37,26,234,0,483
48249000014,295,201,44,149,1,2,1,0,157
48183000008,7193,5624,3789,537,934,132,191,3,1835
48135000108,5895,4330,2091,1957,99,147,39,26,2239
48135000111,1724,1128,344,678,86,40,10,0,784
48135000106,2626,1949,878,811,198,50,33,1,1071
48135000305,1537,1161,192,863,59,32,38,0,969
48135000304,1691,1271,201,976,89,35,9,4,1070
48201000897,3853,3053,1097,828,882,91,194,24,1956
48201000261,5093,3695,317,3013,332,119,18,3,3378
48201000280,4460,3173,290,2198,637,70,71,4,2883
48113002047,3326,2406,1817,310,139,63,89,3,589
48113002900,4458,3787,2243,826,404,105,262,4,1544
48113001030,6456,4862,1058,1207,2129,107,441,7,3804
48113002514,4587,3503,1772,748,424,76,488,5,1731
48201000605,9161,6439,529,4025,1733,183,179,7,5910
48201000741,4898,3411,283,2209,799,132,144,10,3128
48201000381,13095,8767,1260,6222,1090,272,174,0,7507
48201000719,4143,2987,769,2010,149,117,26,4,2218
48201000405,6245,4176,2663,711,364,72,379,6,1513
48201000124,9090,6343,4355,920,502,133,404,18,1988
48201000305,12919,8941,1346,4834,1937,333,809,18,7595
48201000951,871,607,76,355,142,17,36,1,531
48453000367,11094,7176,4669,990,179,107,1234,15,2507
48429002-19,236,191,165,12,3,9,0,0,26
48429002-11,1848,1437,1130,242,24,35,11,6,307
48201000034,4297,3945,2416,744,312,101,423,38,1529
48201000896,2440,2269,1531,297,166,27,248,6,738
48201000895,1136,894,705,89,22,11,63,0,189
48201000040,638,515,424,43,15,5,29,0,91
48201000123,2479,2310,1240,449,352,77,249,9,1070
48201000210,4301,3781,1058,559,1702,72,469,13,2723
48201000387,10301,7398,3319,2953,910,228,95,12,4079
48201000121,2736,1920,668,1042,169,102,15,0,1252
48201000049,12869,9077,3725,3798,1204,282,216,9,5352
48201000395,2422,1935,1370,280,102,43,139,4,565
48201000043,5249,3868,713,2725,141,163,255,5,3155
48085000110,3595,3098,1818,302,321,65,599,0,1280
48085000078,7808,6990,3369,800,1078,126,1611,16,3621
48085000094,5778,4293,2002,270,310,74,1662,3,2291
48085000152,995,740,87,623,10,55,21,3,653
48085000019,2019,1617,1216,129,77,38,147,3,401
48085000015,3499,2726,1179,802,263,57,449,10,1547
48085000023,7236,5638,1569,1909,1244,154,855,12,4069
48113002701,8718,7232,3734,1014,1260,144,1098,5,3498
48227000012,1241,896,175,639,57,41,6,1,721
48227000103,321,257,132,86,20,15,9,1,125
48283000001,1413,1056,265,759,11,30,10,3,791
48479000311,3031,2271,74,2189,18,18,6,0,2197
48453000258,4081,3339,1808,974,253,97,253,8,1531
48201000250,1503,1116,38,265,805,30,5,1,1078
48201000700,3158,2299,1481,627,94,76,28,1,818
48201000098,5802,4225,3204,570,199,141,87,7,1021
48113003408,5157,3485,588,1916,929,115,37,11,2897
48453000420,4893,4427,2266,1471,379,146,273,18,2161
48453000431,15140,12531,4677,5246,1599,500,820,39,7854
48201000661,10341,7758,2241,3146,1292,206,1047,18,5517
48201000614,9322,7035,844,2729,2264,279,1210,15,6191
48201000825,51,26,3,8,13,0,2,2,23
48201000981,94,76,7,55,2,4,14,0,69
48201000660,6543,4713,166,1716,2349,102,480,7,4547
48201000678,5221,3748,209,1082,2380,40,127,12,3539
48029001014,2642,1948,67,1836,30,49,15,4,1881
48029001015,2640,1977,59,1888,16,47,8,1,1918
48029004162,4322,3154,1057,1445,495,129,129,31,2097
48029004199,3124,2120,601,1081,295,68,144,11,1519
48029004098,2894,2181,796,1032,271,91,78,7,1385
48029003164,2819,2054,1209,603,109,50,103,2,845
48029003201,6426,4426,2319,1301,417,105,338,32,2107
48029003137,8621,5786,2436,2259,484,180,586,37,3350
48029003144,559,447,208,126,79,8,36,5,239
48029004094,2754,2227,1035,931,157,99,62,8,1192
48029004022,508,366,76,247,25,17,14,1,290
48029002128,5421,3715,181,3340,154,101,48,8,3534
48167000280,2823,2027,950,543,373,52,133,3,1077
48167000144,4149,3181,1878,789,266,103,126,7,1303
48167000341,4544,3090,835,1926,250,108,40,4,2255
48423000015,5458,4489,3985,219,114,109,35,3,504
48213002GBN,5739,4404,3698,348,110,153,79,8,706
48085000089,4633,3593,1730,196,211,28,1405,2,1863
48085000235,3269,2381,897,184,176,27,1084,11,1484
48453000447,6516,5501,2520,2407,313,181,145,5,2981
48453000419,986,759,422,247,26,34,40,2,337
48029001099,4202,3319,740,1948,398,127,189,26,2579
48029001149,4220,3087,667,1789,393,83,237,9,2420
48029002062,1714,1374,289,1031,20,42,20,8,1085
48029002059,4858,3775,459,3108,164,111,48,9,3316
48345000006,224,178,139,29,6,5,2,2,39
48345000005,154,119,92,17,2,5,5,2,27
48083000004,1870,1553,1342,149,20,29,10,2,211
48169000001,798,619,414,174,27,10,3,0,205
48423000018,3110,2271,228,383,1597,78,29,4,2043
48423000020,1726,1233,211,792,200,37,16,2,1022
48355000027,1260,909,124,766,11,15,3,2,785
48029001109,44,19,0,18,0,2,1,0,19
48201000127,4354,3521,2361,669,346,83,63,6,1160
48201000726,3249,2430,1843,430,51,65,47,5,587
48453000411,4432,3796,1638,1398,359,104,352,12,2158
48453000416,1631,1469,624,584,189,31,63,0,845
48141000052,4038,3042,470,2339,182,96,62,17,2572
48141000053,5225,3995,662,2906,346,82,99,18,3333
48029002083,1043,856,186,640,23,29,7,0,670
48029004108,6844,5091,1822,2413,666,139,164,26,3269
48029002149,6206,4643,1151,1729,659,121,1084,24,3492
48029002122,4078,3202,777,1412,395,124,613,18,2425
48029003041,637,506,279,196,10,7,20,1,227
48029003038,1553,1245,509,651,35,28,30,5,736
48029002067,361,326,58,250,5,11,11,1,268
48029003008,100,80,40,21,3,3,15,0,40
48029003101,3644,2880,1340,1140,173,53,203,10,1540
48029003160,2208,1751,872,689,75,52,91,5,879
48029003055,4759,3454,2307,905,71,66,127,12,1147
48029003194,6921,4727,2693,1424,203,122,336,18,2034
48029003095,5519,4747,1591,1919,574,111,621,14,3156
48029003045,1900,1573,1027,408,17,28,86,5,546
48029002014,2078,1632,133,1473,17,50,7,1,1499
48029002087,2414,1881,686,986,115,66,70,8,1195
48029002133,548,389,139,207,26,16,11,3,250
48029003100,5543,3944,1628,1656,410,107,208,14,2316
48029003110,4322,3296,1396,1473,246,85,147,23,1900
48201000584,2250,1535,38,860,615,28,8,1,1497
48201000435,5052,4596,3153,638,254,61,479,5,1443
48201000129,9876,8001,4170,1734,1227,157,790,5,3831
48201000552,5627,4216,3172,550,239,111,161,14,1044
48027000301,6390,4626,3471,829,130,156,40,8,1155
48027000309,1077,889,752,80,15,37,10,1,137
48201000905,1934,1468,221,1186,54,38,11,2,1247
48201000080,5822,4348,452,2697,1183,125,31,6,3896
48201000354,8372,6130,696,2629,2590,132,216,12,5434
48201000064,5686,4292,243,3882,123,144,23,3,4049
48201000171,3991,2682,78,1480,1095,68,31,2,2604
48201000701,1780,1292,177,1048,40,44,37,1,1115
48201000971,0,0,0,0,0,0,0,0,0
48113003700,9130,6849,1942,1483,2350,163,1013,14,4907
48113002035,3499,3262,2046,446,299,69,396,18,1216
48037000020,843,669,366,46,229,17,12,1,303
48141000037,6797,5227,412,4734,88,72,18,12,4815
48141000069,6883,5461,302,5035,83,138,24,5,5159
48141000110,5274,4053,458,3332,164,64,101,9,3595
48141000123,5432,4263,272,3873,76,86,54,20,3991
48141000014,6038,4269,1179,2443,214,101,415,2,3090
48141000184,0,0,0,0,0,0,0,0,0
48141000043,2864,2289,745,1080,287,46,180,12,1544
48141000194,5579,3679,964,1954,587,113,194,43,2715
48141000044,6381,4562,1213,2353,713,155,280,38,3349
48141000065,4790,2899,1299,804,535,117,148,97,1600
48141000087,1254,928,227,546,66,18,50,24,701
48141000089,5892,4600,484,3789,232,134,86,20,4116
48141000086,6798,5310,2800,1024,785,200,668,130,2510
48141000094,4582,3523,509,2855,113,81,32,13,3014
48141000035,3088,2629,736,1629,149,91,87,7,1893
48013000015,3217,2334,723,1525,36,65,14,7,1611
48013000003,3367,2457,981,1366,31,68,22,3,1476
48201000711,10264,7835,2601,1689,1613,121,1866,7,5234
48201000145,2479,1698,25,347,1326,6,5,0,1673
48201000237,3210,2348,31,768,1565,38,7,1,2317
48201000023,3628,2510,37,2193,236,105,46,3,2473
48201000309,6030,4029,3012,367,142,43,437,10,1017
48201000183,3386,2380,1846,189,14,17,293,2,534
48201000973,3304,2164,845,1070,122,56,127,2,1319
48201000262,13486,9877,2566,6133,563,454,620,7,7311
48201000130,3092,2569,1754,342,185,41,284,7,815
48013000007,3502,2528,737,1726,34,58,6,5,1791
48013000018,2530,1905,567,1287,20,34,6,0,1338
48461000002,304,257,130,101,11,15,4,1,127
4832300004C,2271,1662,34,1615,2,12,10,1,1628
48199000006,8047,5933,5233,388,54,150,67,11,700
48201000653,3737,2526,100,2033,421,69,22,5,2426
48201000801,835,608,44,454,78,18,40,3,564
48201000334,2165,1681,305,449,811,51,89,22,1376
48201000035,30,20,4,14,2,0,0,0,16
48201000122,2846,2168,73,1003,1078,67,17,0,2095
48201000836,427,398,22,130,245,1,7,0,376
48063003003,3081,2252,1036,512,619,54,40,5,1216
48211000301,704,531,432,86,0,7,6,0,99
48317000003,1021,769,520,231,7,15,3,0,249
48317000001,1470,1083,550,497,22,49,8,2,533
48201000636,7672,5758,4604,711,159,178,74,5,1154
48201000674,6964,5193,3192,1037,560,140,271,11,2001
48201000413,5199,3878,817,1996,963,141,87,4,3061
48201000818,1734,1325,382,575,356,14,12,6,943
48201000506,5861,4574,384,1809,2071,95,315,2,4190
48211000303,127,98,80,15,0,3,3,1,18
4822900003N,273,216,96,108,2,7,0,0,120
48113003070,3909,2900,86,551,2246,51,21,4,2814
48113003075,333,254,22,107,121,4,1,0,232
48113003073,261,186,3,42,136,4,5,0,183
48113004623,5978,4340,1029,2823,234,186,195,20,3311
48113004625,4399,3457,1286,1201,554,129,383,8,2171
48113002802,6820,4930,2645,794,151,113,1240,7,2285
48201000294,2437,1906,22,337,1546,29,13,0,1884
48201000444,7376,5535,1919,2853,299,273,414,13,3616
48201000209,0,0,0,0,0,0,0,0,0
48201000218,6362,4848,756,3754,191,173,129,5,4092
48113003701,6906,5256,2031,1579,1108,202,434,10,3225
48113003703,99,64,27,24,11,2,3,1,37
48113001721,3184,2550,1203,870,331,106,95,3,1347
48113003306,4593,3169,953,1471,634,121,80,5,2216
48113001098,4771,3344,203,2188,930,61,26,2,3141
48113001135,3733,2668,113,1895,636,90,8,6,2555
48113004122,0,0,0,0,0,0,0,0,0
48113001036,2833,1987,383,1283,202,46,110,3,1604
48113004648,6507,5071,757,992,1719,77,1596,16,4314
48113004628,5574,4306,683,922,1729,71,960,17,3623
48037000025,1880,1412,1094,69,179,58,13,0,318
48037000019,1024,832,723,12,25,48,14,5,109
48037000029,555,452,392,16,9,32,0,0,60
48037000012,3078,2349,2048,75,125,84,10,2,301
48469000024,1924,1488,1115,300,41,35,5,1,373
48469000021,5849,4363,2803,1178,146,98,143,4,1560
48469000007,3708,2706,399,1896,395,41,28,0,2307
48083000002,1465,1140,893,179,34,34,2,0,247
48327000003,524,452,345,90,6,11,5,1,107
48201000330,7885,5992,1341,3643,449,227,533,8,4651
48201000311,8103,6254,761,2837,546,156,2121,13,5493
48201000001,4252,3584,2004,934,237,84,355,9,1580
48201000999,0,0,0,0,0,0,0,0,0
48201000053,5012,4053,2676,854,176,97,286,4,1377
48211000302,40,30,29,1,0,0,0,0,1
48201000393,3476,2711,1096,814,480,87,261,7,1615
48201000416,8713,7000,3216,1806,1259,219,598,9,3784
48201000597,8621,6305,780,2519,1744,145,1246,22,5525
48201000516,5186,3972,1091,1188,1076,114,591,9,2881
48201000227,2139,1625,1385,112,11,10,104,7,240
48201000154,4912,3658,174,3416,37,123,22,4,3484
48085000129,7174,5293,3022,688,1048,151,430,12,2271
48085000156,5225,3904,2359,630,486,112,322,8,1545
48085000131,4191,3126,2175,351,296,73,235,10,951
48085000222,6088,4297,1758,345,460,65,1665,11,2539
48085000040,4481,3540,2521,456,216,122,200,9,1019
48085000171,10019,7419,3803,786,785,134,1907,24,3616
48085000223,2975,1947,1124,140,115,32,522,7,823
48085000117,7053,5284,2806,772,657,110,922,8,2478
48477000406,3367,2827,1536,401,795,69,51,11,1291
4832300003B,8068,5595,148,5409,18,38,16,2,5447
4832300002D,157,119,9,108,3,2,1,1,110
48085000118,6370,4711,3088,463,242,103,790,17,1623
48085000101,6353,4923,2693,521,465,96,1129,12,2230
48085000048,5805,4798,2967,492,470,106,767,22,1831
48453000311,8214,7655,4199,1430,355,76,1615,13,3456
48453000313,602,544,301,110,21,12,106,9,243
48309000074,1115,858,658,142,38,20,9,1,200
48309000035,2539,1744,472,789,450,46,17,3,1272
48309000071,1367,1001,672,108,181,56,1,0,329
48453000132,4506,3723,1508,1041,940,82,176,13,2215
48309000006,2352,1684,175,1414,79,51,9,5,1509
48309000005,2434,1678,130,1425,117,80,13,11,1548
48309000043,1244,1008,621,208,135,30,28,1,387
48309000090,705,561,326,153,64,12,5,0,235
48309000013,51,39,34,4,1,0,1,0,5
48343000202,1340,1087,953,55,56,17,5,1,134
48399000006,180,140,115,22,0,2,0,0,25
48231000101,1788,1327,1070,131,44,83,2,0,257
48231000212,2623,1994,1326,293,234,67,67,3,668
48231000324,2575,1968,1550,189,84,55,30,4,418
48231000107,5029,3878,2789,435,395,122,118,10,1089
48223000024,1096,853,737,61,10,47,4,3,116
48395000023,1486,1072,311,531,210,25,6,0,761
48031000401,3146,2571,2004,460,35,56,14,6,567
48395000003,690,560,479,61,13,12,1,0,81
48233000014,2795,2060,1665,227,44,104,35,2,395
48231000102,2165,1612,1246,173,125,56,12,4,366
48029004015,2949,2450,479,1864,73,74,31,3,1971
48029002152,1100,924,174,686,53,26,9,3,750
48477000311,1598,1308,1055,88,98,25,22,1,253
48477000410,1519,1216,951,106,118,18,7,1,265
48309000024,1408,973,631,91,237,23,3,0,342
48309000070,707,509,376,59,16,34,3,1,133
48309000064,2013,1568,1074,294,118,58,27,3,494
48029001032,4117,3157,107,3029,14,61,8,1,3050
48029001061,6261,4308,248,3916,134,104,40,14,4060
48029004019,6575,4687,723,3417,522,143,38,7,3964
48029004024,5070,3888,771,2795,257,97,49,11,3117
48029003032,3612,2999,1001,1380,280,87,314,7,1998
48029003003,140,102,49,48,2,1,6,1,53
48029002005,1599,1309,171,1086,31,54,19,0,1138
48309000054,970,735,536,108,60,35,16,4,199
48309000083,845,639,504,91,27,26,0,0,135
48067000017,4922,3735,2984,133,513,77,24,2,751
48113002404,4463,3334,920,1704,305,103,372,5,2414
48121002003,3837,2907,1058,1362,238,109,210,0,1849
48113003014,11696,7435,1360,5086,892,255,57,14,6075
48113003921,12272,8336,2625,3955,1585,265,59,15,5711
48113004072,791,545,42,455,29,28,4,0,503
48341000203,149,108,73,25,1,14,1,0,35
48037000017,2419,1841,1582,52,146,54,8,1,259
4803700005B,7,6,1,4,1,2,0,0,5
4803700004A,2075,1511,599,102,730,44,36,4,912
4803700002D,166,120,54,5,60,0,0,1,66
48107000044,1403,1060,525,487,32,28,11,4,535
48469000030,820,631,261,318,34,17,6,1,370
48199000003,835,655,617,29,1,4,0,0,38
48469000012,1060,812,292,471,25,22,6,1,520
48469000025,7016,5360,2810,1897,400,107,215,3,2550
48199000013,4000,2978,2649,184,30,55,41,0,329
48159000301,1277,991,782,142,17,46,5,3,209
48387000004,1480,1173,654,82,403,27,11,2,519
48279000001,1717,1217,416,784,6,19,1,2,801
48167000309,138,114,77,28,6,0,3,0,37
48167000192,1666,1195,499,560,89,49,19,4,696
48167000439,5612,4273,2774,937,356,125,108,7,1499
48167000172,1069,961,589,211,137,3,19,1,372
48233000041,84,63,50,5,4,3,0,0,13
48011000202,119,101,92,3,2,4,2,1,9
48395000001,1487,1141,595,116,383,30,16,1,546
48167000168,12,12,1,8,0,0,4,0,11
48167000151,6252,4959,3131,1359,124,162,171,4,1828
48167000338,9063,6663,2294,1527,2584,174,155,8,4369
48167000219,4833,3489,1597,876,814,97,159,22,1892
48167000389,1311,929,238,335,304,52,19,1,691
48167004391,30,22,13,1,7,1,3,1,9
48167000227,5227,3967,3115,609,70,115,41,6,852
48167000347,3664,2839,887,823,1065,48,35,5,1952
48167000142,4553,3483,1706,1112,564,106,40,3,1777
48201000554,6026,4248,338,2310,1337,79,317,5,3910
48085000079,6200,5151,1865,984,784,99,1477,9,3286
4803700001A,3155,2172,306,286,1537,64,11,3,1866
4803700002C,2512,1813,314,278,1200,39,4,6,1499
48067000011,1030,806,549,12,215,36,6,0,257
48361000017,3033,2341,2164,96,15,40,17,4,177
48361000002,2618,2091,818,234,991,38,16,5,1273
48361000030,1540,1207,948,127,19,29,72,0,259
48361000023,3836,2745,2450,146,16,59,42,2,295
48059000001,3593,2756,2345,250,39,87,14,6,411
48361000009,2784,2163,1899,104,44,77,23,1,264
48317000002,1246,792,284,472,28,32,4,2,508
48389000001,801,597,35,540,15,19,1,1,562
48085000033,6821,4839,3115,950,425,187,184,3,1724
48085000194,31,24,17,4,2,1,0,0,7
48085000176,7726,6831,3371,883,962,178,1460,19,3460
48085000124,6341,4853,2003,367,357,112,2023,13,2850
48085000014,8369,5905,1453,257,426,41,3716,8,4452
48279000002,1275,902,182,622,90,20,4,1,720
48381000418,8092,5993,4440,997,272,222,95,9,1553
48381000208,10902,8214,6116,1293,303,179,308,4,2098
48381000230,4060,3200,2585,363,89,109,46,2,615
48381000228,6437,5176,4093,633,134,134,205,4,1083
48381000227,6848,5376,4132,706,182,159,207,5,1244
48381000306,6172,4741,3693,722,110,154,70,1,1048
4847500003S,482,353,164,175,13,6,3,2,189
4847500003N,2542,1824,886,832,69,46,7,4,938
4839700001A,6545,5055,3113,947,615,157,222,18,1942
48345000002,100,84,71,9,0,3,0,1,13
48395000004,625,499,437,36,6,4,14,0,62
48285000009,1865,1402,1163,104,111,19,6,2,239
48425000002,2373,1844,1584,179,17,55,5,5,260
48167000391,532,367,80,255,22,26,3,2,287
48167000398,1027,770,241,349,151,25,20,2,529
48167001651,0,0,0,0,0,0,0,0,0
48167000453,9217,7323,4483,1868,536,175,268,10,2840
48167000152,6368,4928,3735,633,258,78,221,5,1193
48167000487,10544,7216,4582,1304,475,172,687,16,2634
48381000111,9444,6707,2747,3042,357,239,416,10,3960
48305000014,594,413,123,268,13,11,0,2,290
48305000006,617,455,256,150,34,8,7,3,199
48305000009,492,343,248,79,5,10,5,0,95
48085000140,6339,4699,3542,397,370,84,301,10,1157
48085000155,4172,2937,1784,302,398,64,387,3,1153
48085000046,6783,5242,1664,2660,519,220,318,3,3578
48135000408,1762,1314,218,1017,72,38,10,2,1096
48135000412,2074,1591,428,989,138,32,24,5,1163
48483000010,127,101,85,12,0,4,0,0,16
48097000001,3073,2262,1461,567,145,92,30,1,801
48097000005,2853,2031,1253,583,96,85,37,2,778
48097000003,653,559,422,67,43,12,15,10,137
48065000101,679,515,461,31,2,19,3,1,54
48065000402,408,323,291,14,4,18,0,2,32
48045000001,253,184,102,72,7,4,4,0,82
48305000008,102,83,52,29,0,3,0,0,31
48381000222,6058,4672,3675,608,157,130,87,4,997
48381000309,6780,5107,3825,950,115,193,16,7,1282
4847500004W,98,74,49,24,0,2,1,0,25
4847500001W,331,257,46,202,3,8,1,0,211
48381000123,3692,3300,2075,707,371,83,51,21,1225
48217000016,579,433,301,92,22,15,2,0,132
4806700020E,286,256,186,9,47,8,0,0,70
48151000001,965,732,521,169,14,33,4,0,211
48135000208,7710,5941,2635,2454,439,139,337,6,3306
48135000206,1343,1093,616,322,66,39,43,1,477
48107000039,1218,884,380,461,39,15,0,0,504
48361000034,2528,1920,1698,97,11,64,39,3,222
48011000301,362,258,230,12,1,9,6,0,28
48011000303,63,53,47,6,2,0,2,2,6
48361000025,2904,2164,1784,229,23,72,56,0,380
48361000018,3107,2363,2143,100,8,53,32,4,220
48361000022,2005,1566,1391,93,19,38,24,0,175
48201000471,4400,3326,1890,1179,117,123,46,1,1436
48201000214,2558,1935,1161,243,59,24,450,8,774
48201000103,13675,9392,2479,4039,2137,209,679,32,6913
48201000531,4307,3275,1860,1128,204,65,23,4,1415
48201000268,3238,2318,1516,197,55,14,524,3,802
48201000182,6482,4694,2494,531,466,71,1145,9,2200
48493000205,2777,2085,1172,852,27,35,12,2,913
48493000209,595,506,445,51,3,5,0,0,61
48493000208,837,655,474,160,3,9,0,0,181
48201000469,4407,3425,2506,517,179,80,142,10,919
48201000336,12583,9168,710,1996,5577,132,911,31,8458
48085000064,4518,3403,1900,390,258,68,792,4,1503
48085000063,2454,1964,1508,161,62,50,170,4,456
48201000438,6032,4124,2754,647,345,62,319,9,1370
48201000409,5554,3838,332,3304,178,132,31,4,3506
48201000970,4793,3383,151,2141,1014,129,88,18,3232
48201000934,323,261,40,36,185,9,4,3,221
48201000518,7077,5683,2185,1370,1021,157,1030,23,3498
48201000939,18,8,0,6,0,6,0,0,8
48201000260,2882,2213,533,523,260,39,862,1,1680
48201000904,0,0,0,0,0,0,0,0,0
48201000600,8181,6379,1104,2968,1343,191,975,4,5275
48201000251,5197,3626,376,1342,1867,95,25,3,3250
48389000007,1272,985,190,749,19,18,18,2,795
48361000033,2080,1515,1399,70,6,29,8,2,116
48361000016,3563,2729,2388,194,21,100,8,2,341
48085000036,2253,1795,1366,86,99,23,206,2,429
48085000104,5905,4686,1463,1207,1616,102,341,15,3223
48085000088,5448,4359,1203,1505,1292,98,339,17,3156
48389000012,1485,1117,249,832,21,11,17,1,868
48389000010,2120,1506,169,1262,29,34,38,4,1337
48201000885,5026,3607,1506,981,840,80,203,22,2101
48201000375,12400,8203,938,6848,348,249,91,7,7265
48201000639,3953,3134,1930,903,156,91,69,0,1204
48473000420,3103,2260,1548,372,126,51,141,0,712
48201000727,6933,5164,947,1281,2719,87,275,14,4217
48329000404,3850,3029,1972,691,159,81,114,16,1057
48093000006,488,391,273,99,6,20,0,1,118
48143000010,3048,2623,1925,507,143,55,20,1,698
48439004713,5489,3892,1999,1059,615,117,144,2,1893
48439003160,6317,4685,1735,1168,730,156,671,261,2950
48439002030,7433,4842,1216,1057,2101,124,489,6,3626
48439001291,3526,2491,123,945,1405,52,14,11,2368
48439001153,3099,2254,115,956,1161,54,23,1,2139
48201000456,9852,7281,2584,2639,1743,184,252,10,4697
48201000155,7397,5614,2674,1255,285,103,1311,6,2940
48201000950,4,4,0,3,1,0,2,0,4
48201000084,2726,1958,1118,708,56,73,28,3,840
48201000705,3690,2402,107,448,1861,32,16,4,2295
48201000834,789,515,29,37,448,1,6,0,486
48201000099,5666,4146,985,2407,649,127,31,10,3161
48201000012,1786,1259,291,757,172,57,15,0,968
48059000007,621,516,462,36,3,13,0,1,54
48011000201,333,257,215,21,4,12,6,2,42
48361000004,947,651,54,41,552,7,2,0,597
48361000001,739,552,396,54,86,8,5,2,156
48361000010,1360,1041,726,213,66,16,15,1,315
48085000081,4525,3612,2022,538,402,59,598,14,1590
48085000180,1080,723,485,103,92,29,20,2,238
48427000005,181,133,2,131,0,2,0,1,131
48427000007,1343,939,26,911,2,5,2,0,913
48131000003,455,386,23,358,0,10,1,1,363
48187000125,275,233,158,50,11,10,3,1,75
48187000410,206,164,81,68,4,2,1,0,83
48187000101,943,751,474,223,34,13,1,2,277
48187000217,342,253,77,150,19,3,0,0,176
48187000112,675,663,282,271,89,9,7,7,381
48187000124,10,9,0,9,0,0,0,0,9
48187000118,67,51,40,10,0,0,1,0,11
48111000005,40,36,36,0,0,0,0,0,0
48111000003,36,32,32,0,0,0,0,0,0
48403000006,2118,1780,1512,63,118,65,16,2,268
48403000001,2487,2056,1759,77,115,63,38,4,297
48403000008,463,353,308,11,23,11,1,1,45
48303000036,3630,2714,1539,1010,95,78,2,0,1175
48303000155,3094,2252,1831,316,26,59,31,2,421
48303000121,4780,3389,2414,682,98,111,85,8,975
48303000110,4905,3655,2968,352,71,83,176,2,687
48303000138,707,532,376,111,12,25,11,1,156
48303000057,6246,5073,3020,1381,301,135,260,4,2053
48303000178,380,277,221,43,9,1,1,0,56
48303000092,755,566,354,150,32,30,13,0,212
48303000041,3539,2544,1587,890,21,37,7,4,957
48303000043,888,659,457,185,5,21,5,0,202
48303000046,4927,3436,2390,883,19,126,22,1,1046
48303000151,1536,1151,796,284,10,40,6,1,355
48303000031,2467,1889,1286,493,26,58,21,6,603
48303000135,524,379,263,89,8,10,9,0,116
48303000113,5076,3676,1714,1188,404,88,331,5,1962
48303000016,1828,1480,1048,283,52,42,59,3,432
48303000022,3441,2501,1390,822,193,75,33,7,1111
48303000076,3422,2528,1435,815,144,83,77,1,1093
48303000013,3322,2637,1581,760,196,69,69,2,1056
48303000124,2389,1939,1406,388,43,45,43,1,533
48175000021,1161,904,396,441,51,26,11,2,508
48053000014,745,611,515,53,10,27,1,0,96
48053000013,1948,1459,1005,374,6,53,19,0,454
48427000004,882,716,40,669,7,5,1,2,676
48489000005,1239,925,63,857,1,12,1,0,862
48187000211,151,124,79,38,7,4,1,0,45
48187000221,45,44,16,28,0,0,0,2,28
48187000210,1329,1025,480,492,27,11,17,2,545
48245000100,4277,3304,1712,227,693,41,628,4,1592
48245000024,639,487,346,54,73,14,1,1,141
48245000056,4803,3651,2748,575,111,77,131,4,903
48245000101,0,0,0,0,0,0,0,0,0
48245000073,2973,2323,1555,211,379,69,138,1,768
48245000020,2758,1901,216,537,1105,42,36,4,1685
48303000009,3432,2799,2128,411,72,75,116,11,671
48303000152,2856,2615,1580,606,194,55,178,5,1035
48303000047,4655,3549,1985,1075,263,144,144,2,1564
48303000059,5600,4259,2107,1515,396,129,150,8,2152
48303000024,3996,3041,1397,1230,313,111,54,9,1644
48303000012,2725,2030,1472,414,82,44,34,4,558
48303000019,5686,4087,592,2908,550,147,24,0,3495
48303000054,3828,3094,2545,374,63,70,45,0,549
48303000109,5253,3692,2895,468,134,84,108,5,797
48303000039,2730,2122,1581,418,29,82,14,5,541
48303000014,2022,1628,941,515,79,64,48,2,687
48245000019,2946,2124,131,580,1376,57,38,2,1993
48485000318,720,545,375,120,21,19,14,4,170
48485000105,5121,4126,2805,662,385,128,144,16,1321
48485000109,5387,4234,3252,536,206,189,71,14,982
48485000301,288,261,209,23,23,8,0,0,52
48485000302,4567,3402,1616,1345,275,165,64,8,1786
48485000304,707,470,211,116,123,22,9,0,259
48485000112,92,73,37,17,12,2,4,0,36
48485000319,102,82,48,25,3,6,0,0,34
48485000107,34,26,25,0,1,0,0,0,1
48485000316,195,147,69,47,18,6,3,1,78
48485000308,2026,1490,679,639,146,50,20,1,811
48479000312,2544,1732,29,1678,9,36,3,2,1703
48479000458,8225,5581,168,5336,27,71,35,4,5413
48479000447,7985,5157,277,4837,15,85,16,1,4880
48479000255,4122,2952,178,2610,111,35,68,1,2774
48479000239,11215,8335,381,7664,108,91,177,20,7954
48479000267,5019,3458,99,3280,60,23,18,1,3359
48201000128,3148,2315,1561,182,52,16,484,0,754
48201000316,2038,1587,1001,153,44,22,357,10,586
48201000369,1139,1043,257,262,464,13,64,8,786
48201000866,0,0,0,0,0,0,0,0,0
48201000048,1637,1282,126,494,663,13,25,5,1156
48201000347,8019,5783,1721,3571,183,150,262,2,4062
48201000696,5345,4064,1493,2205,188,171,89,7,2571
48201000536,12578,9110,758,5565,1080,240,1709,4,8352
48201000434,2381,2226,1334,394,219,31,250,5,892
48201000940,50,39,0,23,15,2,0,0,39
48201000852,0,0,0,0,0,0,0,0,0
48201000339,4260,3197,298,2584,269,105,42,7,2899
48303000002,3611,2662,836,1529,239,71,34,8,1826
48303000065,2163,1647,842,701,61,66,9,3,805
48485000405,3762,2901,1720,819,197,132,59,11,1181
48485000407,4029,3046,1691,831,319,197,70,8,1355
48485000402,1301,970,704,155,59,40,19,0,266
48485000401,3525,2894,2165,412,128,92,101,6,729
48485000110,886,769,586,69,41,41,30,0,183
48297000010,693,558,314,214,0,15,4,0,244
48297000005,328,272,209,46,1,10,4,0,63
48103000003,1269,906,230,604,48,20,15,2,676
48489000002,2266,1662,138,1491,5,38,10,1,1524
4846700004B,2994,2182,1786,242,46,66,27,0,396
4846700004D,5247,4192,3388,391,227,159,17,1,804
4846700001C,2501,1924,1639,205,10,61,9,0,285
48201000024,1620,1334,291,228,698,16,117,1,1043
48201000732,3618,2779,1323,834,192,89,387,8,1456
48201000920,110,94,61,15,14,0,7,1,33
48201000858,622,432,12,106,316,20,2,2,420
48201000756,3418,2507,455,1118,818,55,103,11,2052
48201000599,7753,5627,1019,2094,2128,183,333,49,4608
48201000841,7726,5378,651,2269,2263,132,153,65,4727
48201000397,2233,1580,186,1260,113,61,16,0,1394
48303000127,3927,3200,2219,671,138,78,112,4,981
48193000022,1337,1055,957,55,8,21,10,2,98
48193000023,1490,1158,952,162,7,23,16,4,206
48085000068,3581,2724,1185,1096,256,127,112,15,1539
48085000071,2320,1941,1346,182,117,58,249,0,595
48485000403,4153,3072,2168,536,166,110,106,9,904
48077000032,276,225,203,13,6,2,2,0,22
484990001-4,1015,790,664,78,12,27,3,1,126
48313000202,2872,2160,1401,396,295,66,27,1,759
48255000003,154,127,104,20,2,2,1,0,23
48485000113,1726,1242,756,174,266,38,19,5,486
48485000117,93,78,68,5,0,3,1,0,10
48349000300,6454,4744,1935,1703,757,133,92,196,2809
48349000306,513,381,241,81,17,18,1,10,140
48193000014,240,200,178,18,0,2,0,0,22
48207000008,212,176,141,30,0,5,0,1,35
48077000020,589,472,444,13,5,7,1,0,28
48331000210,764,628,467,83,68,8,4,1,161
48287000303,2125,1617,1256,255,32,55,17,2,361
48287000102,381,309,142,42,122,6,0,0,167
48303000129,5145,4011,2580,883,251,90,234,9,1431
48303000052,8441,5834,3636,1582,297,135,203,8,2198
48303000033,6010,4316,2852,1290,34,127,22,5,1464
48303000058,2320,1937,1282,381,78,32,167,1,655
48477000109,1429,1143,876,141,99,11,5,0,267
48185000004,1942,1491,1200,138,101,39,8,3,291
48207000003,882,670,448,171,37,10,7,0,222
48479000417,1441,1034,34,996,1,14,5,1,1000
4846700001E,1452,1048,819,121,72,27,10,1,229
48483000006,155,120,116,2,1,1,0,0,4
48349000403,2242,1694,1409,153,67,49,9,6,285
48349000307,935,709,422,216,33,28,9,1,287
48349000304,990,788,645,68,23,41,7,0,143
48349000205,1638,1348,1187,103,18,37,7,0,161
48349000406,385,301,256,30,5,13,2,1,45
48161000015,460,350,291,19,27,9,1,1,59
48329000206,2716,2033,1533,351,84,58,32,2,500
4846700003A,1886,1457,1184,114,106,35,15,1,273
48349000103,2831,2132,1437,352,269,35,36,15,695
48349000400,2494,1863,1313,282,214,54,25,15,550
48303000005,1978,1760,434,1028,287,4,8,1,1326
48303000015,2379,1955,1533,236,42,47,86,3,422
48303000001,6673,5242,1767,2738,511,123,205,11,3475
48303000063,424,294,151,129,10,8,0,0,143
48303000125,2939,2298,1628,464,84,64,91,2,670
48077000010,354,306,275,24,0,7,0,0,31
48365000001,2924,2220,1515,289,340,61,22,2,705
48365000012,526,407,355,17,27,6,3,2,52
48459000011,897,676,581,42,16,31,1,1,95
48459000016,2714,2089,1497,134,331,91,23,5,592
48459000008,1632,1237,953,127,120,31,1,0,284
48459000017,3711,2741,1936,252,421,95,31,6,805
48459000012,1412,1040,886,74,43,34,2,0,154
48365000018,2457,1935,1639,46,172,60,9,4,296
48053000007,803,693,602,42,9,31,3,2,91
483930004-1,99,76,69,1,1,7,1,0,7
48119000004,832,685,538,49,61,27,12,1,147
48267000007,413,371,323,36,7,11,5,1,48
48415000011,205,168,133,23,3,8,6,0,35
48415000006,357,271,230,40,0,1,0,1,41
48415000013,663,491,339,138,3,18,3,1,152
48415000008,1646,1170,701,391,47,36,11,1,469
48267000006,459,425,381,32,3,12,1,1,44
48267000003,311,269,215,44,6,8,4,1,54
48405000009,1145,956,885,19,16,23,3,1,71
48405000002,411,347,170,25,147,13,6,4,177
48003000003,4235,2940,1264,1522,68,110,16,2,1676
48303000006,2758,1875,119,579,1184,26,4,1,1756
48303000003,5403,4433,777,2637,366,131,605,8,3656
48303000045,730,522,288,222,12,10,1,1,234
48303000044,2260,1710,1101,536,26,38,10,1,609
48303000021,4112,2984,1385,1272,212,106,45,8,1599
48303000126,2584,2039,1251,552,145,66,51,1,788
48303000159,82,57,18,31,1,6,4,1,39
4846700002A,5843,4405,3822,293,102,155,44,5,583
48405000005,610,450,353,36,42,15,6,0,97
48405000006,372,291,259,14,11,4,0,0,32
48393000003,225,166,140,15,2,6,1,2,26
48393000001,232,167,150,6,5,5,0,2,17
48485000314,17,12,9,1,0,0,1,0,3
48485000207,1456,1099,607,302,131,36,23,1,492
48485000315,250,202,148,32,6,13,0,2,54
48485000408,29,24,11,12,0,2,0,0,13
48077000017,1141,968,906,26,0,22,9,0,62
48485000102,1210,963,762,85,50,28,47,6,201
48315000006,1257,1012,656,22,305,21,6,0,356
48403000003,875,630,407,28,175,27,2,0,223
48403000005,1667,1266,1161,27,52,21,2,1,105
48303000053,6597,5205,2436,2052,434,179,206,6,2769
48291000008,3274,2456,2130,179,72,66,13,2,326
48491000424,5264,3828,2675,546,202,87,323,15,1153
48315000009,600,491,403,21,45,13,3,0,88
48303000153,2534,1895,133,834,954,32,7,2,1762
48303000072,5233,3881,2040,1285,307,116,148,3,1841
48303000078,4108,3120,2310,445,79,69,206,0,810
48471000205,3964,3392,3013,152,88,51,59,6,379
48039000006,2323,1738,1239,366,42,81,18,7,499
48039000035,2487,1949,1375,457,27,65,15,1,574
48009000006,1579,1228,1079,70,30,42,7,2,149
48421000101,150,117,66,46,4,4,1,1,51
48025000010,2838,1987,338,1543,64,55,29,2,1649
48449000008,3467,2378,401,1623,317,81,10,2,1977
48449000020,2339,1724,871,571,185,59,59,2,853
48303000056,1052,771,476,241,30,17,6,0,295
48303000075,1481,1192,940,167,29,31,35,0,252
48303000122,1630,1265,851,303,68,34,26,1,414
48139000139,1429,1042,766,196,56,23,13,0,276
48139000140,10032,7123,4300,1279,1148,178,195,18,2823
48139000141,2912,2172,1505,412,160,67,26,8,667
48251000011,5403,4238,3396,538,70,162,52,10,842
48251000034,4000,3015,2411,365,66,113,27,14,604
48485000313,111,84,37,11,31,5,0,0,47
48485000202,3539,2541,1554,525,269,148,80,3,987
48005000010,2659,1848,746,494,515,55,56,1,1102
48005000033,1249,948,874,28,18,17,7,0,74
48057000023,396,307,188,100,8,5,5,0,119
48005000027,574,433,352,48,11,23,2,2,81
48367000250,1724,1357,1176,110,13,40,5,2,181
48367000200,3198,2497,1766,534,69,103,18,1,731
48367000420,2945,2237,1936,186,35,46,37,8,301
48367000110,2996,2285,1809,313,21,102,27,1,476
48121001000,4478,3494,2721,546,52,155,25,4,773
48121003021,10872,8364,3502,2337,1339,251,1031,23,4862
48459000002,4302,3224,2789,172,78,145,21,11,435
48245000078,3044,2203,676,390,1021,46,94,1,1527
48245000058,44,44,38,0,6,0,0,0,6
48245000025,3620,2737,1963,201,445,53,68,1,774
48121001006,10375,6893,4226,1170,1043,277,212,15,2667
48121003028,5918,4419,3160,367,175,129,577,5,1259
48349000404,1780,1339,943,270,71,46,8,4,396
48141000111,5544,4086,395,3475,140,75,78,18,3691
48141000112,7634,5575,320,5040,188,121,64,6,5255
48141000114,8012,6015,346,5428,171,141,90,13,5669
48141000039,1824,1521,169,1259,70,14,17,2,1352
48141000108,2860,2282,448,1679,101,56,57,3,1834
48141000070,4057,3253,304,2901,37,91,28,7,2949
48141000116,7419,5127,484,4212,309,118,121,30,4643
48141000197,6548,4599,271,4126,142,87,81,9,4328
48141000196,6494,4377,371,3699,212,115,80,19,4006
48141000115,6045,4152,567,3186,281,104,113,19,3585
48141000190,0,0,0,0,0,0,0,0,0
48141000127,2075,1742,314,1256,159,13,7,1,1428
48141000126,8484,6267,506,5367,253,141,160,5,5761
48185000010,2135,1719,1436,162,29,65,17,1,283
48319000302,1027,851,727,109,3,9,2,0,124
48209000122,2660,2375,995,974,293,49,102,7,1380
4841100002A,715,584,507,51,3,29,0,0,77
48209000441,4233,3286,2697,384,24,98,65,1,589
48209000448,2520,1862,1544,214,23,27,31,2,318
48209000443,6137,4007,3102,489,89,93,235,7,905
48209000446,3327,2252,1757,257,52,50,126,9,495
48209000442,4467,3376,2643,373,55,61,232,3,733
48203000006,2095,1594,1248,73,234,35,7,0,346
48203000008,3899,2960,1908,332,576,96,71,1,1052
48189000407,2048,1592,943,553,50,34,24,0,649
48189000103,1215,864,123,703,30,35,2,2,741
48315000010,772,649,516,31,77,18,4,1,133
48241000012,920,717,544,42,93,28,5,0,173
48349000405,1255,977,754,131,40,30,8,4,223
48189000419,460,322,204,111,0,3,1,2,118
48189000104,1344,967,267,615,45,47,5,3,700
48241000020,1905,1525,597,127,763,23,12,3,928
48251000010,8414,6174,3727,1723,326,225,173,6,2447
48251000028,2947,2336,1873,304,55,65,20,5,463
48139000110,7692,5508,2236,1105,1989,167,78,6,3272
48139000144,3412,2491,841,568,1008,92,15,4,1650
48139000143,4301,3269,2086,729,316,130,44,10,1183
48139000104,5466,3873,2932,449,317,112,60,9,941
48251000008,18081,12762,5850,4858,1357,585,316,19,6912
48139000118,4817,3726,2425,656,507,117,30,7,1301
48139000113,3596,2443,550,613,1209,51,23,10,1893
48139000124,3884,2796,687,1569,501,60,8,4,2109
48251000007,9184,6924,5633,761,222,200,85,16,1291
48251000031,2747,2063,1591,319,48,102,12,8,472
48089000401,545,412,185,131,84,12,4,0,227
48241000003,1388,1136,981,19,88,27,7,2,155
48365000022,542,443,246,13,172,11,0,0,197
48365000005,741,546,422,51,53,15,2,1,124
48459000006,2092,1520,1247,77,106,68,16,0,273
48459000009,2894,2228,1793,102,242,83,6,3,435
48459000001,2397,1853,1491,127,133,69,9,0,362
48459000019,29,26,14,5,7,2,0,0,12
48459000020,166,126,105,2,14,2,6,0,21
48459000005,1164,906,661,71,137,34,2,0,245
48459000021,10,9,2,0,6,0,0,1,7
48121003004,4009,3131,2606,267,62,77,108,1,525
48121003026,3611,2721,1785,340,187,78,345,2,936
48141000179,1689,1113,25,1075,14,26,5,0,1088
48141000151,4729,3539,60,3423,37,70,8,7,3479
48141000189,16,10,3,7,1,0,0,0,7
48141000015,3608,2705,931,1488,90,63,210,11,1774
48141000047,3674,2816,769,1607,260,71,150,24,2047
48141000062,4190,3086,334,2471,231,81,59,16,2752
48141000145,5360,4069,158,3836,58,92,10,4,3911
48141000130,7151,5253,434,4504,219,149,123,17,4819
48141000016,5256,4137,591,3381,78,111,90,12,3546
48141000101,3575,2838,428,2256,117,76,44,1,2410
48141000139,3344,2605,123,2447,27,41,23,2,2482
48141000049,3441,2511,584,1487,349,69,97,15,1927
48141000050,5482,3899,558,2954,256,128,107,48,3341
48141000195,8737,5895,1285,3628,746,197,194,58,4610
48141000090,2323,1848,327,1449,47,36,26,3,1521
48141000092,5239,4343,850,3100,320,99,83,12,3493
48157001118,11103,7320,3630,732,1673,131,1163,9,3690
48189000420,576,445,322,108,4,3,4,0,123
48241000005,173,151,122,4,15,7,3,0,29
48203000023,768,586,525,23,16,13,2,1,61
48409000107,359,293,135,150,6,2,0,0,158
48409000123,254,166,44,112,0,8,4,0,122
48139000126,2008,1425,744,531,112,47,8,2,681
48139000121,3855,2825,1742,813,185,68,36,4,1083
48251000024,2424,1840,1336,360,37,68,26,1,504
48139000145,7499,5379,2187,1381,1620,136,78,2,3192
48139000107,5048,3715,2828,360,378,108,45,7,887
48139000109,2257,1862,1363,215,229,33,23,0,499
48139000108,4730,3474,2519,439,366,102,52,4,955
48171000005,2283,1836,1580,178,9,67,2,1,256
48409000125,84,61,29,30,0,1,1,0,32
48409000102,3656,2766,795,1900,29,54,11,0,1971
48003000001,5149,3570,1407,2023,60,88,24,4,2163
48121002026,5300,4175,2700,733,354,131,253,13,1475
48121002024,3659,2838,1501,874,259,102,107,7,1337
48121002023,6683,4998,2454,1283,533,164,616,2,2544
48121003007,6984,5435,2734,939,919,126,758,6,2701
48141000198,6524,4145,466,3361,240,94,65,35,3679
48141000191,0,0,0,0,0,0,0,0,0
48141000036,3919,3384,397,2697,140,120,123,3,2987
48141000041,1682,1381,79,1275,19,54,11,3,1302
48141000066,4065,3185,257,2741,166,68,39,11,2928
48141000107,3146,2519,326,2066,104,62,27,1,2193
48141000093,2208,1751,202,1508,28,65,12,1,1549
48025000011,366,286,106,168,1,10,4,1,180
48291000030,2872,2130,1410,326,292,90,13,2,720
48113002028,5,3,0,1,0,0,2,0,3
48113004661,3551,2456,197,2092,102,71,66,6,2259
48113004620,5002,3645,824,2424,230,103,132,4,2821
48121003027,6073,4473,3254,466,153,131,487,15,1219
48121001013,7533,5450,2521,2285,405,219,88,5,2929
48121001024,2769,2187,1789,186,58,80,54,0,398
48121002032,4453,3038,1602,578,575,74,218,6,1436
48121002030,9361,6602,3075,1692,1308,260,358,19,3527
48121002031,8118,5024,2178,613,874,141,1264,11,2846
48121004008,2474,2090,1492,309,126,85,78,6,598
48121004040,1872,1646,1255,229,87,50,47,5,391
48121003011,13057,9203,2554,4469,1173,387,883,13,6649
48121001003,5846,4464,2972,1098,167,238,39,11,1492
48121003025,6383,4889,3446,378,190,84,742,14,1443
48121003024,5383,3852,2295,307,178,47,1021,2,1557
48039000056,7232,5319,3025,1398,657,143,104,4,2294
48251000001,1973,1371,1095,184,40,34,12,1,276
48139000106,4294,3268,2649,306,163,104,46,4,619
48171000002,1875,1536,1054,428,13,36,12,1,482
48171000010,1597,1329,994,301,4,28,4,2,335
48385000003,581,466,282,163,7,18,3,1,184
48171000009,202,171,147,18,1,4,1,1,24
48157004049,5470,4356,763,465,1459,59,1660,4,3593
48157003113,14424,10176,594,2191,3825,130,3629,16,9582
48367000245,1992,1579,1244,249,12,50,8,1,335
48367000310,3201,2634,2110,303,108,73,47,4,524
48365000002,3164,2383,1750,210,354,54,22,3,633
48365000003,1824,1337,1028,98,189,38,5,6,309
48365000007,1044,786,563,23,190,9,0,0,223
48365000009,887,689,560,20,77,26,4,1,129
48459000003,2385,1835,1428,222,107,70,6,1,407
48479000407,1284,923,19,898,1,3,1,0,904
48157001085,5332,3955,1705,1244,692,113,244,9,2250
48157002022,4785,3785,1749,811,416,58,765,7,2036
48157002070,3355,2643,540,855,802,59,403,5,2103
48157003132,9553,6584,2823,1137,570,95,1983,10,3761
48157003160,4391,3078,1384,657,421,55,600,5,1694
48157004140,4170,3336,1466,339,292,37,1193,3,1870
48157004064,1785,1362,621,278,75,26,369,5,741
48157004028,2927,2437,1177,304,742,65,172,2,1260
48367000340,1317,934,832,62,6,22,5,1,102
48367000220,1100,889,794,58,6,17,2,1,95
48141000150,3361,2638,108,2495,21,73,4,2,2530
48365000019,500,381,317,25,13,13,4,1,64
48113003080,3430,2318,363,1379,550,120,9,6,1955
48113002500,5099,4338,2457,594,268,92,939,7,1881
48113001709,7567,5462,701,3017,1218,150,526,14,4761
48113002716,3154,2404,670,889,471,57,356,7,1734
48113001048,3342,2741,2044,453,90,93,82,4,697
48113003048,3755,2840,113,715,2019,44,9,3,2727
48185000007,1883,1457,1036,213,121,57,17,2,421
48157001024,2035,1457,638,749,45,24,14,0,819
48373000012,654,469,80,22,2,378,4,8,389
48157001013,5519,4035,1278,2152,490,95,99,8,2757
48157002106,11207,8068,888,2235,2819,130,2178,16,7180
48497000007,2305,1764,1317,341,21,47,29,1,447
48339000074,5440,3976,2102,1527,164,189,58,7,1874
48157002017,4005,3024,92,893,2029,78,22,0,2932
48201000286,6922,5264,167,2892,2184,243,58,9,5097
48157002031,4779,3538,80,1442,2009,89,38,0,3458
48157004124,9818,7633,2116,1056,1200,62,3235,8,5517
48157004039,1357,1056,351,138,137,10,432,2,705
48263000301,88,66,54,10,3,4,1,1,12
48005000012,1571,1208,865,203,86,22,28,3,343
48057000019,665,568,457,81,7,21,8,2,111
48251000025,3848,3148,1618,978,381,73,128,5,1530
48263000302,46,39,38,1,0,0,0,0,1
48409000118,3234,2406,479,1860,36,30,9,2,1927
48407000004,1079,837,725,49,28,31,11,2,112
48339000012,6338,4301,1761,2374,69,214,38,1,2540
48479000361,3473,2556,78,2457,14,47,14,0,2478
48479000360,1303,917,33,884,1,9,0,0,884
48171000008,420,347,261,65,0,19,0,0,86
48497000009,3285,2480,2105,218,23,116,28,3,375
48141000011,5855,4443,700,3505,108,117,143,7,3743
48141000193,3634,2652,639,1732,109,78,173,7,2013
48141000013,4835,3629,726,2595,100,98,199,6,2903
48141000012,2531,1878,546,1151,72,55,116,3,1332
48141000109,2518,2024,322,1596,84,51,47,6,1702
48141000134,2065,1660,89,1546,8,15,12,3,1571
48141000175,447,344,36,299,9,1,0,1,308
48141000072,2530,1978,106,1835,36,65,9,1,1872
48141000074,4336,3449,167,3211,62,73,22,3,3282
48141000019,6786,5391,1187,3767,207,151,187,16,4204
48121002018,8633,7692,4080,1046,975,180,1482,25,3612
48121002020,5538,4736,3416,328,240,61,662,10,1320
48121002098,0,0,0,0,0,0,0,0,0
48121002019,0,0,0,0,0,0,0,0,0
48121002099,0,0,0,0,0,0,0,0,0
48121002097,0,0,0,0,0,0,0,0,0
48409000114,3825,2802,1512,1127,56,81,45,9,1290
48121001011,5304,4090,2458,1080,383,168,72,6,1632
48245000061,3971,2950,1110,1193,466,60,185,5,1840
48245000050,4559,3320,210,1333,1413,84,347,2,3110
48245000071,127,90,67,15,2,4,4,0,23
48245000102,290,201,122,60,5,2,12,0,79
48245000014,2845,2092,83,714,1183,42,106,8,2009
48473000207,5707,4218,3208,731,78,134,35,1,1010
48141000121,2615,2153,189,1864,41,40,62,2,1964
48141000164,6732,4991,121,4811,26,138,25,4,4870
48141000183,0,0,0,0,0,0,0,0,0
48141000157,2751,2143,64,1978,17,252,12,9,2079
48291000026,6468,4551,2488,1795,108,170,36,4,2063
48115000005,255,179,106,67,1,3,0,3,73
48401000404,2350,1826,1356,228,203,46,20,2,470
48401000303,3400,2525,944,650,885,47,20,4,1581
48491000394,3781,3758,3554,93,25,39,38,0,204
48491000278,7255,5623,3780,1020,281,178,410,30,1843
48071000015,4343,3030,1287,1071,523,74,92,5,1743
48071000011,3547,2653,1600,718,250,59,44,8,1053
48071000008,7624,5225,3785,1076,175,157,45,7,1440
48141000106,4760,3606,332,3119,99,79,44,6,3274
48141000004,3115,2385,287,2008,43,57,37,1,2098
48141000148,3604,2740,99,2621,10,89,3,2,2641
48141000143,3820,2997,57,2920,9,47,10,2,2940
48141000046,2515,1889,358,1318,167,45,67,3,1531
48141000045,6273,4620,948,2902,573,124,188,39,3672
48141000028,591,493,9,480,7,8,1,0,484
48141000042,4995,3528,100,3386,35,91,20,5,3428
48245000027,2428,1811,698,402,631,44,69,2,1113
48245000079,2915,2278,1280,154,635,32,169,1,998
48245000037,3756,2918,2297,384,97,86,63,1,621
48245000015,2660,2005,133,868,925,52,80,1,1872
48245000055,443,368,9,43,312,7,3,2,359
48245000022,7045,5347,1948,621,2490,100,223,9,3399
48053000006,717,603,537,38,8,14,6,0,66
48141000029,4771,3885,600,3005,159,138,136,1,3285
48401000314,1546,1143,838,173,101,28,4,0,305
48401000317,921,731,379,30,290,24,13,0,352
48491000273,4334,3283,2313,527,126,91,250,8,970
48181000208,2352,1785,1440,133,119,72,12,2,345
48181000307,3358,2537,2168,236,28,82,6,2,369
48441000207,516,386,313,43,4,15,7,2,73
48441000407,2264,1650,1190,225,100,63,76,8,460
48441000406,5732,4607,3212,671,597,96,69,4,1395
48245000011,944,822,320,125,368,6,2,1,502
48071000004,5771,4134,3186,518,171,125,112,3,948
48245000047,3377,2374,382,1341,500,62,140,5,1992
48245000049,1556,1123,76,771,168,25,105,0,1047
48245000051,909,666,31,314,289,18,30,1,635
48245000016,1141,815,58,446,266,22,35,0,757
48121004014,3292,3045,1240,698,886,94,218,8,1805
48121003013,4819,3662,1761,1147,376,147,309,14,1901
48121003098,0,0,0,0,0,0,0,0,0
48039000044,6973,4881,1744,663,1219,60,1224,9,3137
48121001028,6146,3808,1418,445,809,98,1051,19,2390
48121001027,3307,2501,1079,409,739,71,227,6,1422
48121001026,5840,4065,1914,607,1215,136,256,9,2151
48121001054,6361,4484,1876,679,1585,139,288,4,2608
48071000010,8634,5826,4290,987,298,159,91,3,1536
48473000206,4384,3313,2249,858,84,95,31,0,1064
48473000105,1311,981,680,225,35,40,8,2,301
48245000053,2263,1706,90,464,1143,36,18,3,1616
48245000030,1661,1284,1111,88,30,38,10,4,173
48121002011,6226,4883,1898,1998,416,186,493,10,2985
48121002016,6686,5275,2576,891,696,100,995,20,2699
48477000101,1721,1344,734,116,463,17,10,2,610
48477000104,3422,2538,624,636,1226,54,23,8,1914
48113001029,5191,3766,638,766,1639,89,721,4,3128
48113001502,6298,4833,2091,650,1051,114,937,22,2742
48157002061,8493,5599,1873,575,1043,64,2072,7,3726
48157002157,6840,4831,982,454,1108,82,2268,6,3849
48157002151,3758,2846,687,280,1365,35,520,2,2159
48039000047,4860,3476,1567,1286,402,118,136,13,1909
48009000004,911,681,524,142,2,17,1,1,157
48367000330,3230,2454,1671,624,27,103,16,6,783
48113004613,2491,1743,204,1354,109,78,54,4,1539
48113004656,284,205,33,108,10,9,52,0,172
48113004657,328,263,11,198,46,5,22,2,252
48113002031,6644,6023,3489,960,686,135,807,15,2534
48113001091,5506,3919,284,2706,901,187,30,2,3635
48157002016,5875,4677,901,589,575,53,2604,3,3776
48157003053,100,85,55,8,12,0,10,0,30
48157004027,0,0,0,0,0,0,0,0,0
48157002123,4021,2747,50,864,1830,64,21,1,2697
48157004046,4771,3780,1484,544,357,51,1370,11,2296
48157004011,2054,1613,805,176,95,22,514,5,808
48157001002,1025,794,61,351,367,7,9,2,733
48157002090,885,730,358,89,227,21,43,1,372
48157002033,1470,1154,285,247,561,9,66,0,869
48157004105,3330,2690,963,396,324,55,967,5,1727
48157004029,2380,1939,1297,313,90,30,206,2,642
48157004125,7113,5373,999,615,1059,69,2649,5,4374
48157002051,3807,2735,50,491,2142,36,58,4,2685
48365000013,390,309,221,23,51,10,5,1,88
48121003009,4815,3871,2246,847,456,131,252,3,1625
48121004001,2674,1994,1408,429,51,75,17,5,586
48181000303,1476,1143,899,134,30,71,18,2,244
48005000006,1267,928,664,182,58,26,10,0,264
48259002120,6599,4773,3781,744,61,116,79,10,992
48189000406,2212,1458,222,1079,139,34,6,2,1236
48189000205,481,344,38,279,27,16,0,0,306
48189000408,1161,871,453,363,23,29,12,0,418
48241000015,3733,2879,2549,74,160,72,12,1,330
48241000014,3990,2956,2379,108,371,83,2,2,577
48189000307,945,712,253,367,80,21,1,4,459
48365000029,436,331,313,14,2,1,0,0,18
48121001023,6419,4966,3360,762,444,180,258,11,1606
48121002013,2389,1947,1271,324,121,47,195,2,676
48121002033,6426,5024,1883,600,1134,116,1332,16,3141
48477000208,2707,1997,1309,502,107,39,42,1,688
48113003202,3359,2572,513,786,1200,83,63,2,2059
48113001700,5318,3868,858,2568,294,158,107,10,3010
48113002709,2235,1867,915,427,264,40,224,3,952
48113002503,3431,2426,2105,112,35,44,125,3,321
48113004075,2551,1969,300,1510,109,59,27,4,1669
48113004107,322,236,3,188,42,8,2,1,233
48113004038,3654,2696,261,1518,908,84,21,2,2435
48113004058,2375,1751,144,1473,112,65,15,2,1607
48113002506,3017,2186,1589,370,84,66,84,0,597
48439002313,3006,2384,1673,308,230,52,132,8,711
48439004155,7923,5492,710,4184,165,159,419,2,4782
48439004429,4290,2837,1524,629,480,109,167,7,1313
48439004343,3223,2684,2121,242,136,45,115,12,563
48439003166,7236,5173,1984,1730,1115,118,246,54,3189
48181000405,1312,939,571,127,155,41,51,3,368
48181000406,3782,3180,2864,132,15,145,16,0,316
48477000316,528,418,304,32,61,4,17,0,114
48477000312,1674,1298,968,195,89,33,13,0,330
48477000202,432,381,243,72,42,5,5,0,138
48439002581,4123,3054,1018,823,904,86,273,10,2036
48439003331,5795,4344,3288,221,174,65,560,11,1056
48439003590,0,0,0,0,0,0,0,0,0
48113004621,8997,6523,1155,1959,1945,144,1430,15,5368
48113002511,2840,2306,1324,321,288,53,336,7,982
48113001504,2349,1909,1204,159,245,39,246,3,705
48121002001,8886,7352,2251,1743,2766,232,473,12,5101
48121002012,2528,2057,1435,151,167,60,251,6,622
48161000006,734,583,494,42,33,21,3,1,89
48401000201,3750,3295,1646,898,723,23,14,0,1649
48181000401,2980,2308,1453,234,434,169,27,4,855
48439001150,3485,2476,439,1252,711,87,39,5,2037
48439001559,369,267,59,93,105,14,9,1,208
48439001549,0,0,0,0,0,0,0,0,0
48439001543,0,0,0,0,0,0,0,0,0
48439001014,1842,1279,322,843,85,49,16,3,957
48439002726,3993,2986,758,688,904,54,609,4,2228
48439002635,3188,2293,485,475,901,46,433,4,1808
48439001482,2393,1599,136,1230,226,35,12,1,1463
48439003249,6085,4869,2601,786,759,109,591,59,2268
48439002462,3315,2423,671,665,850,72,213,3,1752
48439002541,3886,2817,652,637,985,98,541,1,2165
48121003033,4214,3360,2377,383,206,93,311,2,983
48121003030,3680,2716,2011,322,115,93,176,5,705
48145000203,1104,987,348,198,444,5,7,0,639
48019000102,3173,2594,2040,424,23,67,21,8,554
48019000101,2400,1993,1563,319,33,59,19,2,430
48481000402,3034,2214,818,1222,149,42,6,3,1396
48439003193,4009,3132,2478,203,90,85,281,4,654
48439003662,27,21,13,2,5,1,0,0,8
48439004042,3466,2499,865,1191,110,86,293,3,1634
48439004239,345,257,124,112,9,5,10,1,133
48439004290,5109,3759,1820,1590,120,127,158,18,1939
48439001082,1633,1200,290,789,46,38,51,0,910
48439001378,7391,5235,985,2105,1897,109,220,11,4250
48439001431,3402,2542,1805,385,212,67,65,4,737
48439001024,6522,4657,2666,1126,642,156,94,7,1991
48245000046,2917,2139,293,1266,461,75,112,4,1846
48245000086,2895,2302,1117,163,888,18,124,0,1185
48251000032,5996,4479,3125,995,115,187,42,2,1354
48439001293,3159,2225,283,1226,693,61,22,2,1942
48439002401,914,768,400,209,141,31,12,4,368
48439001704,3982,2720,1801,466,252,89,112,14,919
48439001627,526,326,218,51,18,18,21,0,108
48439001271,4666,3407,2496,492,232,138,81,11,911
48201000587,7025,4981,813,1956,1958,90,209,36,4168
48201000315,2352,1852,1128,383,174,64,158,6,724
48201000952,94,57,45,6,2,2,4,0,12
48201000635,5500,4062,2775,830,224,110,146,8,1287
48201000193,1532,1248,155,205,866,27,32,1,1093
48201000329,4550,3295,370,2165,513,82,276,3,2925
48201000285,5233,3904,121,2154,1607,108,28,4,3783
48201000945,32,25,0,25,0,3,0,0,25
48201000946,44,34,2,32,1,0,0,0,32
48201000325,5995,4187,377,2684,1075,90,51,6,3810
48201000989,0,0,0,0,0,0,0,0,0
48201000914,276,247,50,128,60,15,2,0,197
48201000116,4229,3027,2352,271,35,62,303,0,675
48439001297,5407,3835,183,892,2716,60,31,6,3652
48439001300,4815,3471,828,1179,1250,93,186,3,2643
48439003139,2756,2052,1092,588,243,85,47,29,960
48439004592,0,0,0,0,0,0,0,0,0
48439004125,1759,1256,433,739,54,35,6,2,823
48439003516,2313,1949,1582,157,64,50,89,3,367
48439004159,4182,3038,1040,1437,67,130,438,7,1998
48439003365,5654,4089,3365,315,111,72,186,3,724
48439003194,4272,3146,1804,945,149,123,166,21,1342
48439001339,4710,3914,2459,569,658,93,153,16,1455
48439004047,5972,4654,3829,503,54,193,44,4,825
48439002537,4781,3532,813,1083,1474,108,132,2,2719
48141000010,8056,5920,518,5228,138,118,86,5,5402
48201000059,3732,3226,2319,561,149,59,125,4,907
48201000544,580,448,25,275,148,2,3,0,423
48201000645,12649,10277,3040,2356,3281,218,1539,24,7237
48141000009,4518,3541,1031,2365,67,90,71,0,2510
48141000153,3860,3097,80,2968,36,59,15,1,3017
48141000152,4428,3271,82,3161,39,68,7,2,3189
48141000154,3399,2611,32,2551,28,44,16,2,2579
48141000038,4379,3508,286,3124,93,114,37,3,3222
48141000017,2646,2037,506,1386,27,41,120,1,1531
48141000057,3620,2783,510,1964,197,96,90,11,2273
48141000059,4644,3480,474,2790,169,93,44,5,3006
48141000056,3554,2699,660,1806,199,75,69,4,2039
48439003720,2788,2147,1821,141,35,66,59,4,326
48439002031,10394,7166,1549,1534,2839,152,1200,21,5617
48439002613,2646,1849,310,507,824,35,197,3,1539
48439001088,3747,2595,225,1974,341,73,28,5,2370
48439001672,0,0,0,0,0,0,0,0,0
48181000107,2622,2074,1786,126,29,96,21,1,288
48181000207,1454,1163,952,123,14,55,10,3,211
48215000026,2323,1773,74,1664,9,29,11,5,1699
48215000225,682,480,23,451,1,10,4,0,457
48307000102,204,177,108,62,2,9,0,0,69
48047000001,1764,1292,97,1173,9,20,13,2,1195
48215000094,6036,4069,194,3849,17,53,16,2,3875
48135000110,10841,7048,2692,3495,432,172,310,35,4356
48249000004,1849,1345,182,1152,3,33,3,2,1163
48211000201,912,622,410,193,4,20,4,3,212
48423000061,3995,3146,1689,741,599,93,46,9,1457
48423000050,3105,2455,1889,238,242,60,27,8,566
48113002942,8913,6419,3430,1132,639,215,1022,26,2989
48113002407,8241,6235,1856,3156,464,195,690,6,4379
48113002401,5020,4095,2336,1031,383,131,265,2,1759
48113002707,7391,5498,1703,2094,731,201,899,5,3795
48231000428,3896,3298,1885,336,844,163,85,6,1413
48231000213,1519,1131,909,143,17,44,6,1,222
48201000076,4596,3386,810,1951,415,108,214,2,2576
48201000181,5135,3834,288,3430,73,157,21,0,3546
48201000343,5267,4043,294,3421,251,135,76,3,3749
48201000166,2013,1639,863,556,100,45,108,1,776
48227000042,1590,1126,429,606,61,45,14,2,697
48227000032,308,226,130,88,5,5,1,0,96
48113002221,4804,3076,2767,118,15,36,116,0,309
48231000321,2455,2039,1732,169,19,97,16,0,307
48231000432,1068,856,736,73,22,22,4,2,120
48067000007,3350,2487,1922,134,341,67,9,2,565
4803700008C,3336,2878,1930,299,536,109,9,1,948
48013000001,1305,1041,466,526,15,35,14,2,575
48015000208,902,731,635,42,21,14,1,0,96
48269000002,67,41,31,9,1,1,1,2,10
48293000206,554,441,348,45,39,7,2,0,93
48293000201,1082,807,418,165,208,22,8,0,389
48201000612,4566,3382,2587,486,128,98,85,2,795
48201000901,0,0,0,0,0,0,0,0,0
48015000206,780,607,462,96,27,11,4,0,145
48201000454,3588,2653,46,655,1955,45,15,1,2607
48201000396,2622,2056,24,379,1645,33,7,2,2032
48201000398,8765,6447,1533,2976,1135,208,798,5,4914
48201000298,4199,3429,1399,1077,569,92,387,4,2030
48201000504,3003,2442,1709,384,92,36,209,4,733
48201000055,4718,4349,2540,798,339,70,604,10,1809
48293000102,834,642,532,49,21,20,6,0,110
48135000401,1854,1406,473,736,147,43,29,1,933
48067000004,622,484,337,23,117,11,1,0,147
48095000102,125,95,52,39,2,4,2,0,43
48135000203,5117,3961,2147,1321,298,108,115,20,1814
48279000012,354,243,180,59,1,3,0,0,63
48217000023,739,540,416,68,30,29,0,0,124
4832500001B,2177,1742,1291,392,8,36,12,0,451
48383000001,859,594,63,491,14,18,19,3,531
48219000044,1157,860,450,355,29,39,2,0,410
48167000456,4821,3594,2851,368,87,81,188,10,743
48167000340,1520,1010,86,446,465,46,9,2,924
48115000012,124,92,51,40,0,0,1,0,41
48209000440,3094,2433,1981,303,29,78,35,5,452
48075000101,1484,1182,654,349,149,27,12,7,528
48025000005,548,403,210,184,0,7,2,0,193
48025000012,324,262,159,94,1,8,0,1,103
48365000027,1651,1249,597,156,477,14,14,4,652
48367000350,3571,2803,2313,324,22,103,18,8,490
48367000305,4178,3058,2548,299,73,88,39,5,510
48439003509,3483,2646,1737,530,142,118,122,17,909
48439003502,1948,1463,1259,94,16,36,50,0,204
48439003323,4198,3324,2624,197,72,81,330,1,700
48439002435,4458,3403,1702,496,846,106,287,16,1701
48439002557,2424,1684,354,360,684,55,261,5,1330
48439002660,743,541,156,332,27,19,20,1,385
48367000400,4413,3379,2734,410,74,92,54,13,645
48339000040,9421,7266,5181,994,597,161,329,20,2085
48339000081,6104,4788,3421,737,201,107,273,10,1367
48339000060,8597,6639,2074,3582,641,199,270,14,4565
48141000091,1200,1052,149,789,105,18,14,0,903
48141000095,4212,3345,534,2624,112,103,61,15,2811
48141000178,1975,1478,243,1146,77,35,18,4,1235
48141000058,3384,2532,511,1636,265,110,121,20,2021
48141000085,4017,2937,107,2799,17,46,18,4,2830
48141000163,4951,3812,71,3712,18,86,11,4,3741
48373000009,1058,850,525,139,163,21,2,1,325
48373000020,1172,958,861,45,11,30,2,3,97
48141000122,5404,4185,251,3806,80,94,52,13,3934
48385000004,157,137,122,7,1,5,1,0,15
48245000076,3199,2158,260,879,909,45,125,0,1898
48245000104,81,72,59,10,3,0,0,0,13
48245000091,923,689,586,56,27,13,8,0,103
48141000113,4255,3297,297,2841,122,66,48,6,3000
48141000119,5385,4107,440,3422,181,76,82,6,3667
48245000087,2086,1504,200,261,1016,19,19,1,1304
48409000121,4045,3085,1475,1381,103,73,97,16,1610
48113003800,7245,5152,215,840,4053,100,43,5,4937
48113003802,6606,4727,375,1042,3293,61,33,3,4352
48113003026,1428,1090,19,232,830,34,6,3,1071
48439004456,1467,1178,938,120,54,26,29,2,240
48439002229,3870,2939,1617,629,495,108,119,5,1322
48439004179,3066,2326,1035,850,345,75,55,3,1291
48439002520,2930,2205,1211,370,373,40,211,5,994
48439003579,1212,932,724,62,35,15,78,0,208
48439004312,237,190,74,100,10,10,0,0,116
48439004077,339,277,207,57,6,15,1,0,70
48439001455,0,0,0,0,0,0,0,0,0
48439001013,4090,2966,374,1330,1221,42,53,0,2592
48113001088,6607,4669,577,3418,690,154,20,11,4092
48113001134,1217,792,26,347,400,22,11,0,766
48113002713,2300,1944,1240,260,230,37,184,0,704
48113001103,1310,953,87,774,95,48,3,4,866
48439002217,7309,5186,1816,1773,1344,164,193,19,3370
48439002058,7,4,4,0,0,0,0,0,0
48439004118,2368,1937,1110,285,399,49,122,3,827
48439001207,4391,3330,1610,631,957,88,69,5,1720
48439002353,2604,1844,514,711,460,69,143,4,1330
48439002466,2052,1522,427,587,388,37,106,0,1095
48021003014,6859,4919,1640,3038,140,198,25,1,3279
48481000202,1178,932,288,176,459,6,1,0,644
48439002169,6121,4111,411,2364,1121,160,181,4,3700
48439004113,2506,2398,1280,649,348,101,44,6,1118
48201000588,6645,5034,2354,1400,911,213,213,26,2680
48201000916,6687,4779,2969,1044,437,141,230,21,1810
48201000915,11,7,1,2,3,2,0,0,6
48201000027,5791,4736,945,3367,273,193,109,3,3791
48355000022,649,508,121,377,6,21,11,0,387
48355000122,6052,4382,2388,1465,185,120,285,14,1994
48355000090,1357,1072,326,664,37,24,27,6,746
48061000062,5095,3846,199,3605,28,62,24,4,3647
48027000207,7617,6056,1777,1473,2273,160,535,132,4279
48453000314,10569,8651,5661,1578,285,159,973,11,2990
48453000319,3288,2624,2242,246,21,67,43,9,382
48029003161,5586,4480,1438,2327,510,168,186,13,3042
48453000463,5954,4988,2313,2044,340,162,224,13,2675
48453000408,6136,4559,2177,1650,323,206,360,9,2382
48453000240,1440,1055,869,95,11,18,47,0,186
48051000309,923,756,615,68,44,25,1,1,141
48027000410,8608,6397,1669,2096,2367,233,247,105,4728
48355000077,611,471,34,429,9,3,0,2,437
48355000069,3168,2409,481,1793,94,47,19,1,1928
48257000012,3430,2562,1971,413,74,110,13,7,591
48029003050,1853,1502,803,550,106,18,32,5,699
48029002003,4510,3408,119,3236,47,80,9,7,3289
48029003121,7479,5547,2550,1970,428,135,534,26,2997
48061000029,4430,3351,891,2407,18,54,21,0,2460
48299000102,779,724,658,44,3,17,1,0,66
48355000080,2554,1894,80,1529,276,30,11,1,1814
48355000014,695,461,146,290,12,15,8,0,315
48355000088,3723,2838,928,1688,118,77,68,7,1910
48453000245,2089,1645,1114,283,92,34,130,5,531
48351000022,588,468,219,9,231,9,0,0,249
48457000006,466,400,380,11,2,2,1,0,20
48307000403,158,150,141,1,1,5,0,1,9
48463000011,779,581,251,297,9,28,1,0,330
48213004NYL,1495,1200,1023,78,56,28,3,0,177
48061000103,1003,712,68,611,9,11,24,2,644
48061000069,7743,5412,159,5218,21,59,14,1,5253
48041000078,416,297,168,110,7,10,0,0,129
48453000237,2474,1986,1721,117,16,19,98,2,265
48479000219,3193,2329,96,2159,17,22,70,2,2233
48479000220,2872,1973,69,1891,6,12,3,3,1904
48453000417,4144,3461,1411,1443,340,145,230,20,2050
48215000097,5518,3946,264,3637,20,75,17,1,3682
48215000216,2568,2058,85,1951,8,57,13,0,1973
48215000014,1867,1438,90,1322,9,25,7,0,1348
48215000152,3663,2606,334,2194,11,40,38,0,2272
48215000151,1308,904,35,863,5,14,3,0,869
48215000136,2567,2002,263,1691,15,46,28,1,1739
48457000009,570,446,396,13,14,16,1,0,50
48457000014,2085,1635,1465,58,39,47,11,1,170
48215000103,4912,3755,519,3164,21,61,44,3,3236
48363000020,235,210,196,3,2,6,3,1,14
48501000305,1006,715,192,497,11,16,6,0,523
48453000274,3604,3324,2201,479,78,54,518,7,1123
48041000018,1118,861,126,462,263,19,5,1,735
48201000420,7589,5641,3805,1441,117,166,108,19,1836
48201000126,6344,4656,3239,1001,158,142,141,5,1417
48201000733,1985,1277,79,912,273,53,12,8,1198
48201000644,9199,6607,2729,1548,677,133,1605,8,3878
48201000459,4995,3712,2876,424,137,81,169,6,836
48201000679,7201,5661,2474,2313,234,99,563,6,3187
48215000031,4145,2882,294,2527,30,31,39,0,2588
48215000037,2098,1577,134,1419,10,25,22,1,1443
48215000071,482,285,17,265,2,5,0,1,268
4827700001E,1072,817,711,58,6,43,3,0,106
4827700001D,824,600,501,22,43,24,12,0,99
4827700003F,1313,894,762,86,6,33,5,0,132
48041000057,919,637,137,268,206,21,19,4,500
48041000021,6050,5679,3053,943,314,60,1325,21,2626
48041000012,6816,5324,3467,987,607,144,152,18,1857
48029004036,4623,3427,424,1664,1354,56,21,3,3003
48369000203,119,88,57,28,3,3,1,1,31
48453000243,2442,1955,1471,274,50,55,114,7,484
48453000414,7319,6123,2778,2214,565,197,527,18,3345
48463000009,2138,1599,127,1455,5,15,6,3,1472
48201000031,4832,3304,85,392,2841,27,35,1,3219
48201000499,3137,2566,1801,328,114,38,286,1,765
48355000104,1308,919,52,858,14,8,1,0,867
48355000043,1320,941,105,757,70,21,7,1,836
48029003109,5647,4335,1191,2646,302,152,182,14,3144
48029002026,3691,2813,580,1964,176,106,86,8,2233
48029002157,0,0,0,0,0,0,0,0,0
48029002040,4831,3745,601,2836,234,115,62,11,3144
482130004CC,2455,2006,1610,131,183,66,16,2,396
4827700004B,2530,2022,1748,66,70,118,3,0,274
48355000084,1281,1000,272,673,31,16,15,2,728
48355000083,1888,1392,103,1214,67,44,13,0,1289
48201000712,10110,7052,1385,3499,1779,252,432,7,5667
48201000488,4962,3738,394,2068,700,133,591,7,3344
48201000984,1263,765,37,420,244,13,29,0,728
48201000117,6701,4696,603,3778,252,168,78,4,4093
48201000107,5752,4026,229,2934,829,139,34,8,3797
48041000036,7255,5889,3285,1295,964,129,213,20,2604
48215000059,5076,3504,54,3421,17,56,4,0,3450
48215000159,1518,1085,24,1048,3,16,3,0,1061
48201000747,9822,6900,1757,2751,2131,209,194,43,5143
48453000260,7054,5283,1338,2935,694,191,261,11,3945
48453000124,8316,6760,2950,1907,1489,211,321,24,3810
48453000440,2175,1955,975,715,142,57,111,5,980
48453000461,6913,6364,4391,1083,267,153,478,6,1973
48453000209,5049,3670,579,2637,315,131,144,2,3091
48453000222,5692,4428,1715,2080,315,149,232,7,2713
48453000350,6836,5684,3254,1616,334,171,379,20,2430
48453000118,3060,2338,683,1076,477,73,81,2,1655
48453000220,2197,1731,1456,139,18,20,74,1,275
48453000213,0,0,0,0,0,0,0,0,0
48055000110,1235,1182,615,375,177,11,1,1,567
48453000318,1491,987,400,80,11,16,465,4,587
48201000386,5537,4185,2242,1323,488,141,57,7,1943
48423000060,2272,1562,435,926,166,27,14,2,1127
48423000054,4876,4159,3040,365,470,91,174,7,1119
48423000023,3636,2843,1770,545,412,86,69,1,1073
48423000034,2234,1631,340,497,771,26,19,3,1291
48423000077,622,462,210,119,105,23,5,2,252
48423000078,227,166,104,47,12,7,3,0,62
48423000072,464,417,293,31,92,3,0,0,124
48201000676,6877,5007,840,3137,680,240,333,13,4167
48201000553,6610,4840,907,2136,1123,131,671,21,3933
48201000216,3892,2874,94,1710,1052,69,20,1,2780
48201000541,12330,10199,1335,1523,6264,147,1148,16,8864
48201000072,4588,3505,319,2984,182,90,32,1,3186
48201000632,25,25,6,4,11,0,4,0,19
48201000314,9511,6923,2848,1640,1177,117,1199,8,4075
48201000862,6473,4685,1867,1036,807,113,919,7,2818
48201000418,10152,7289,866,3533,1792,166,1079,7,6423
48201000079,6115,4618,134,4331,148,121,13,4,4484
48041000052,32,21,8,4,1,4,5,2,13
48041000003,1890,1363,621,519,197,44,1,1,742
48453000424,4099,3283,1889,941,257,99,135,9,1394
48041000049,858,780,476,156,80,7,68,1,304
48029003018,2180,1690,1235,358,27,27,40,10,455
48113002312,470,380,64,260,35,6,21,3,316
48029004157,2514,2052,483,1480,54,72,22,9,1569
48029004123,199,165,31,118,13,9,7,1,134
48029004203,363,347,164,133,27,6,21,0,183
48029003059,3522,2760,1216,1076,253,86,183,18,1544
48029004087,3094,2350,750,520,970,53,132,15,1600
48029004068,1246,957,217,431,284,29,42,16,740
4827700001I,246,191,159,3,9,15,2,1,32
48423000027,3303,2734,1729,446,397,80,104,4,1005
48113003605,4876,3772,445,587,2718,82,19,2,3327
48113002064,3560,2628,1359,537,282,83,399,5,1269
48113003101,1093,809,175,131,468,15,26,2,634
48029002079,1633,1049,33,981,27,31,9,0,1016
48423000045,1887,1459,1266,83,46,43,16,2,193
48029004006,833,738,248,403,44,16,39,3,490
48029003206,285,249,82,136,20,8,12,1,167
48029004128,219,194,77,95,12,9,4,2,117
48029003208,119,116,74,27,6,1,7,0,42
48029004211,43,40,19,12,1,2,8,0,21
48029003138,182,71,36,26,6,7,3,0,35
48029002057,4521,3467,252,3127,61,127,23,6,3215
48029001041,4128,3108,145,2894,55,68,27,9,2963
48029002052,2037,1561,117,1404,27,66,10,1,1444
48029002100,2282,1671,251,1333,53,70,26,0,1420
48029003028,3132,2460,968,1107,205,96,154,4,1492
48029003023,3676,2951,1045,1472,180,95,220,4,1906
48201000392,1816,1369,17,213,1141,26,9,2,1352
48113004023,155,141,61,19,62,4,0,0,80
48113003803,6685,4769,239,741,3714,71,50,7,4530
48029001077,2745,2114,93,2001,12,31,4,0,2021
48029002025,4480,3276,328,2851,71,106,12,8,2948
48029004034,2968,2292,394,1463,422,70,25,4,1898
48201001007,4844,3391,385,1448,1347,66,152,59,3006
48201000764,8411,6039,2669,1739,1234,170,282,21,3370
48201000758,6906,4761,3296,652,213,76,470,9,1465
48201000546,3016,2232,1906,156,44,37,81,2,326
48201000350,6869,5977,2619,984,724,84,1630,18,3358
48201000956,26,18,12,6,0,3,1,0,6
48201000643,8745,6444,1603,3378,977,236,451,11,4841
48201000882,9478,7004,959,2111,1883,175,2085,18,6045
48113002077,2126,1618,985,360,135,25,122,2,633
48113002015,2683,2067,980,766,254,42,51,2,1087
48029001096,384,248,35,190,13,10,1,8,213
48029002002,2105,1659,72,1555,24,41,7,4,1587
48029001104,5214,4108,912,2607,398,130,172,15,3196
48029001055,3105,2289,526,1392,209,85,124,18,1763
48029002068,5538,4424,1558,2398,273,117,152,10,2866
48029004004,1889,1666,464,872,276,38,55,4,1202
48029004045,4273,3332,979,1812,384,111,136,15,2353
48029004096,5783,4482,1263,2282,803,149,135,20,3219
48029002054,2957,2465,693,1616,83,69,56,5,1772
48027000303,8666,6542,3402,1700,1236,211,97,21,3140
48113002509,3720,2999,2150,280,175,59,325,4,849
48085000073,3125,2711,1287,355,553,56,453,6,1424
48201000082,5259,4013,2315,778,336,96,485,9,1698
48029002022,2866,2113,94,1990,35,56,6,4,2019
48029004032,3098,2368,314,1891,155,72,8,2,2054
48029004027,2556,2059,327,1533,173,56,19,2,1732
48029003034,3053,2478,2027,305,38,45,41,0,451
48029004033,6659,4872,829,3055,967,157,38,3,4043
48201000138,2859,2152,56,875,1223,60,11,0,2096
48201000611,4042,2946,34,953,1958,52,14,0,2912
48201000654,8840,6755,1663,3150,785,144,1128,20,5092
48113003411,22,18,3,14,1,0,0,0,15
48113001106,690,478,25,354,97,23,3,0,453
48029002074,1976,1463,71,1369,13,38,8,0,1392
48029004158,990,874,375,270,185,21,28,7,499
48029001029,3653,2761,107,2571,67,73,23,0,2654
48029001088,1646,1241,44,1177,16,33,5,1,1197
48029003011,1220,1010,541,379,33,29,45,1,469
48029003182,951,796,374,368,17,27,26,2,422
48029003024,0,0,0,0,0,0,0,0,0
48029003175,821,723,295,379,29,27,10,0,428
48029002071,1711,1252,32,1206,17,39,3,3,1220
48029002030,3001,2028,73,1905,42,55,16,1,1955
48029003098,1781,1333,685,508,38,36,104,2,648
48029001078,924,657,18,627,9,22,4,3,639
48029002032,1158,805,21,757,17,18,7,0,784
48029003118,1629,1304,602,441,185,65,53,12,702
48417000404,72,53,44,7,0,2,0,0,9
48029004042,591,409,88,144,136,14,34,2,321
48029002094,194,152,108,28,1,15,6,0,44
48029003026,1863,1389,1079,225,16,29,30,4,310
48029004205,205,172,50,112,3,5,4,0,122
48029004021,2037,1545,384,941,194,56,39,3,1161
48029001084,4461,3270,355,2653,197,95,60,16,2915
48029002007,3491,2628,92,2484,43,69,11,5,2536
48113001089,5137,3483,159,1485,1789,70,56,9,3324
48113001092,13127,8964,508,4973,3433,264,55,3,8456
48029002090,4807,3688,881,2097,447,131,248,9,2807
48029003054,2268,1826,592,957,111,59,154,2,1234
48029003081,3356,2787,1395,1003,256,88,120,13,1392
48231000429,434,361,341,9,4,5,1,0,20
48469000016,666,525,360,112,24,28,3,0,165
48135000309,2354,1728,748,834,99,51,17,9,980
48309000002,1403,1046,314,383,299,43,17,0,732
48309000039,2915,2033,283,1277,448,63,18,1,1750
48029002102,3653,2808,844,1570,279,110,122,14,1964
48113003034,2538,1826,76,788,960,40,13,3,1750
48113002807,3956,2812,1511,237,94,54,916,2,1301
48309000045,1110,861,422,172,233,30,15,0,439
48113003077,5110,3773,557,1478,1551,117,194,3,3216
48113004501,3855,2888,957,941,667,100,297,2,1931
48351000016,426,327,245,15,52,17,0,0,82
48097000031,581,400,168,169,35,30,6,0,232
48097000030,572,390,193,168,8,30,1,0,197
48037000024,732,569,512,29,16,11,1,0,57
48201000651,7331,5499,1786,2455,730,194,477,17,3713
48309000068,1692,1333,1093,150,30,53,8,2,240
48013000017,3226,2360,412,1906,13,43,3,1,1948
48029003036,7354,5726,1819,2527,478,153,889,17,3907
48029004172,2498,1939,723,1004,126,60,60,6,1216
48029001053,499,345,42,276,21,7,10,0,303
48029001087,3780,2624,262,2090,246,97,46,10,2362
48363000029,2010,1456,921,433,56,43,17,1,535
48029004206,1077,757,225,405,100,18,34,4,532
48029004052,3596,2886,1224,986,511,61,147,19,1662
48029004131,869,638,157,316,140,17,28,6,481
48029004134,19,16,6,7,2,4,0,0,10
48029004115,266,219,106,84,15,12,7,0,113
48029004200,5204,3586,451,2836,215,96,100,10,3135
48029004023,4053,3074,630,2273,104,103,60,9,2444
48029001025,1416,1005,53,944,6,12,2,1,952
48029001011,975,801,46,751,3,22,1,3,755
48029001017,452,385,95,263,23,12,8,0,290
48029003066,2542,2064,955,997,79,72,32,8,1109
48029001020,4129,3128,295,2775,38,87,16,5,2833
48029004043,5072,3598,1018,1441,967,120,156,26,2580
48029004083,1373,890,287,297,247,34,51,9,603
48029003159,5165,3963,1189,1699,961,116,79,19,2774
48311000001,172,143,70,68,3,2,4,2,73
48029002123,3438,2420,811,1298,150,72,145,6,1609
48029003106,2121,1695,1015,516,36,54,70,7,680
48029004176,1397,1167,655,412,47,24,45,2,512
48029004171,1744,1332,608,603,76,50,28,4,724
48029003048,2117,1780,1193,392,84,52,85,2,587
48015000211,478,380,328,28,9,7,0,0,52
4822900003S,206,157,12,144,0,15,0,0,145
48309000007,3456,2539,715,1171,603,106,34,4,1824
48309000050,3757,2848,1107,874,731,91,70,2,1741
48309000020,1218,950,378,247,277,17,38,3,572
48333000008,705,586,529,37,2,16,1,1,57
48013000024,2789,2049,717,1243,28,61,22,1,1332
48469000001,1053,793,153,560,75,10,2,2,640
48363000021,1240,910,681,153,37,30,11,0,229
48201000267,3639,2568,364,2109,60,62,19,4,2204
48201000332,7963,5791,183,3902,1445,202,280,12,5608
48201000173,8213,5528,3302,870,380,87,910,4,2226
48201000926,2638,1881,782,387,219,35,464,1,1099
48015000210,958,780,629,74,48,3,1,0,151
48085000027,4480,3071,1767,511,439,106,267,12,1304
48085000195,1235,910,703,128,22,27,31,1,207
48085000076,5145,3881,2357,330,368,74,727,11,1524
48085000174,7116,4996,2817,851,724,207,445,4,2179
48085000217,4121,2827,1755,411,327,71,278,5,1072
48085000232,5369,3690,2175,521,549,110,338,4,1515
48223000005,986,710,541,106,11,28,26,1,169
48201000403,2265,1668,1279,183,60,13,121,0,389
48201000474,5127,3877,2302,921,361,101,231,7,1575
48029003117,3836,3188,1906,1032,99,68,114,10,1282
48469000035,1313,873,103,690,75,30,2,2,770
48469000028,727,586,403,156,4,15,4,0,183
48199000004,1168,885,822,19,6,24,8,0,63
48387000009,393,304,273,15,6,11,1,0,31
48087000202,101,70,39,31,0,0,2,0,31
48201000085,4117,3893,957,540,1445,20,960,44,2936
48201000689,4463,3635,594,1833,264,96,962,0,3041
48029002148,8046,6627,1932,3093,862,203,727,24,4695
48029003044,2184,1794,944,667,97,35,81,4,850
48029003193,239,176,108,53,7,1,7,0,68
48029003105,5326,3984,1689,1793,337,184,116,9,2295
48029003087,2390,1936,965,767,95,81,53,5,971
48029003001,6129,4943,2335,1794,385,98,392,17,2608
48029004054,5553,4268,1486,1622,769,159,358,30,2782
48029004140,0,0,0,0,0,0,0,0,0
48029004185,8,3,0,1,2,0,0,0,3
48029004138,0,0,0,0,0,0,0,0,0
48029004089,5797,4150,1501,1567,746,141,282,55,2649
48029004130,1321,998,360,406,179,21,41,10,638
48029004132,3569,2614,716,824,938,64,157,27,1898
48029004201,71,67,55,9,0,1,3,0,12
48029002029,3279,1954,43,1808,81,56,33,2,1911
4832900309A,150,136,71,37,17,10,2,1,65
4831100002B,83,67,31,33,0,2,0,1,36
48065000401,990,761,642,65,4,52,3,0,119
48065000102,128,90,79,4,1,3,0,0,11
48133000005,1160,879,562,283,6,24,2,3,317
48217000007,701,522,442,48,11,9,4,0,80
48097000015,409,320,294,12,0,10,2,0,26
48329000204,4111,3177,2398,528,125,45,46,0,779
48041000096,11,8,7,1,0,1,0,0,1
48041000099,7,5,0,4,0,1,0,0,5
48041000100,2,0,0,0,0,0,0,0,0
48041000095,0,0,0,0,0,0,0,0,0
48041000102,9,4,3,0,1,0,0,0,1
48223000013,1815,1307,865,333,47,49,13,0,442
48387000002,997,825,525,43,235,17,5,3,300
48097000007,2447,1853,1550,178,29,69,15,2,303
48097000028,187,128,104,19,2,3,1,1,24
48331000207,1159,870,482,266,112,14,7,1,388
48495000101,1927,1355,588,718,24,44,11,2,767
48309000046,937,616,123,369,112,26,1,0,493
48061000020,2503,1877,359,1508,10,27,3,1,1518
48223000008,364,275,237,26,8,4,2,0,38
4832300004D,5804,4019,27,3981,7,56,5,5,3992
48061000045,4245,2879,29,2844,6,33,1,1,2850
48293000404,537,430,334,45,30,13,2,0,96
48293000304,1130,862,595,160,86,20,4,2,267
48015000312,860,674,552,86,15,29,1,1,122
48027000106,10850,7838,2272,1862,3186,290,446,179,5566
48043000007,268,230,175,51,1,2,0,2,55
48417000307,394,317,276,20,7,17,5,0,41
48215000156,3903,2804,77,2721,4,24,1,0,2727
48215000039,4890,3313,68,3223,26,30,3,0,3245
48223000016,1571,1215,1046,100,6,38,5,0,169
48167000462,7484,5154,3735,558,139,85,607,9,1419
48167000401,109,62,43,6,2,1,10,0,19
48167000279,2008,1557,1156,302,17,58,15,2,401
48167001051,824,723,507,89,17,20,84,3,216
48041000058,1495,1396,960,160,96,30,156,5,436
48135000302,2096,1498,502,908,52,39,12,1,996
48085000097,1530,1236,1068,79,26,22,38,2,168
48113003809,735,506,72,219,201,11,11,1,434
48113001104,7020,4796,249,3225,1287,175,13,16,4547
48113002067,1877,1557,1176,198,95,38,55,2,381
48285000031,1625,1259,985,154,86,7,19,0,274
48201000682,7019,5424,3260,1651,272,187,89,12,2164
48073000035,1617,1276,806,211,217,29,7,0,470
48097000012,1048,798,707,48,5,28,0,1,91
4839700001C,4483,3278,2676,272,124,112,107,2,602
48029001028,1804,1368,84,1251,19,32,18,11,1284
48377000006,85,49,19,27,0,2,1,1,30
48445000201,1854,1350,450,793,81,18,12,1,900
48201000367,2717,2183,492,1052,560,58,71,2,1691
48285000008,913,737,665,39,20,15,0,2,72
48437000003,1130,882,534,278,42,26,5,2,348
48049000214,1112,949,849,53,9,29,4,1,100
48049000212,985,806,686,89,8,25,0,0,120
48049000204,3671,2651,1349,919,293,72,32,40,1302
48001000009,2131,1612,1194,143,192,65,26,1,418
48085000170,2822,2014,1242,307,246,60,194,4,772
48425000001,2045,1531,1119,308,15,76,14,8,412
48143000041,967,769,663,72,11,22,5,0,106
48113001043,4318,3195,1700,571,614,86,268,2,1495
48113003004,2722,2156,609,893,623,63,16,0,1547
48387000019,532,428,381,22,15,13,3,1,47
48093000010,694,566,457,93,2,9,1,0,109
48097000019,661,487,429,40,0,15,5,0,58
48097000022,2254,1998,1847,42,11,67,14,3,151
48097000004,476,380,327,30,5,19,2,0,53
48329000310,1651,1117,327,639,125,31,16,4,790
48219000036,982,725,155,533,34,21,3,1,570
48201000582,3386,2326,70,962,1290,48,10,2,2256
48241000002,774,667,623,13,7,16,1,0,44
48189000203,1352,970,107,796,55,22,8,1,863
48339000017,7532,5453,3511,1577,154,164,44,3,1942
48339000083,2623,2001,1436,452,38,53,19,1,565
48477000418,874,686,438,141,92,9,8,0,248
48477000121,133,108,65,19,18,7,0,0,43
48339000064,4880,3456,1683,1585,63,128,30,3,1773
48339000042,1629,1248,854,316,21,40,29,3,394
48339000027,7283,5530,3442,1082,531,184,309,22,2088
48205000202,839,621,506,108,7,6,4,0,115
48223000014,1790,1361,1011,264,19,66,21,2,350
4822300001A,2683,2020,1541,238,136,72,22,5,479
48481000301,3653,2864,1951,798,78,44,9,0,913
48241000008,1628,1188,550,48,561,25,5,0,638
48373000013,479,388,349,12,4,21,0,0,39
48091000204,5479,4363,2917,1212,62,144,70,1,1446
48091000208,2652,2111,1566,382,48,50,58,2,545
48091000102,5432,4292,3191,846,62,125,69,3,1101
48329000205,1294,973,774,146,19,31,8,0,199
48187000214,1054,760,431,267,11,39,18,3,329
48187000204,3188,2262,509,1526,170,53,46,5,1753
48329000104,2344,1681,460,1105,90,31,11,2,1221
48025000017,1839,1377,341,947,59,28,20,1,1036
48201000431,22307,15519,975,10085,3207,615,1309,38,14544
48359000202,222,168,134,19,6,5,2,1,34
48297000014,1356,1049,664,363,1,18,2,0,385
48297000003,1332,1060,352,682,13,19,5,1,708
48143000033,1998,1640,1185,286,50,92,34,1,455
48143000035,398,385,208,104,64,15,0,2,177
48255000010,412,333,273,49,4,2,0,0,60
48093000015,555,449,392,38,1,12,4,0,57
48273000011,3514,2640,969,1367,100,62,148,3,1671
48273000012,1926,1435,471,888,21,38,30,2,964
48287000401,1160,893,513,144,210,31,5,2,380
48439004093,5273,3667,273,3296,75,117,13,3,3394
48439003164,3752,2950,1841,765,162,117,68,24,1109
48303000120,5712,4173,2640,1281,67,141,42,5,1533
48439002645,3121,2178,1403,241,328,62,158,6,775
48439001295,2031,1410,294,845,245,46,8,0,1116
48439001605,0,0,0,0,0,0,0,0,0
48181000309,1590,1131,699,311,16,101,13,7,432
48439001518,2127,1760,472,293,946,22,53,2,1288
48439001489,3949,2992,765,525,1377,82,311,3,2227
48439001651,0,0,0,0,0,0,0,0,0
48439001311,2994,2246,526,478,1097,35,140,1,1720
48439001490,1258,947,248,115,530,17,55,2,699
48093000011,789,586,450,112,3,21,0,0,136
48471000303,1124,864,427,252,170,26,2,1,437
48471000204,3576,2891,1838,264,707,63,16,2,1053
48439004144,2585,2056,1306,494,113,101,64,8,750
48439001106,3434,2504,72,739,1691,37,3,1,2432
48439002519,1886,1422,431,300,465,35,201,3,991
48297000008,132,100,69,27,1,3,1,1,31
48439004531,4676,3551,2227,955,165,131,78,13,1324
48119000009,358,289,265,9,5,9,3,1,24
48479000414,2881,1921,34,1881,1,21,1,0,1887
48329000408,2854,2141,1598,380,49,48,81,5,543
48091000201,8174,5949,3579,1790,281,173,161,16,2370
48433000003,296,252,213,32,7,3,1,2,39
48175000012,573,450,303,100,37,9,2,2,147
48175000043,477,376,306,38,21,2,0,0,70
48439002269,998,717,172,269,150,28,117,0,545
48439004053,2223,1688,1009,520,85,36,33,13,679
48439003213,3106,2348,1556,568,119,97,22,7,792
48187000203,1913,1440,482,805,128,29,14,3,958
48245000035,2049,1692,1083,236,245,30,92,0,609
48145000301,871,708,557,62,56,21,2,0,151
48145000201,952,747,600,70,68,14,1,0,147
48447004006,236,178,150,19,1,7,2,0,28
48379000408,1553,1183,1003,91,27,40,11,5,180
48379000305,1226,1011,811,96,40,52,14,5,200
48287000201,762,629,561,47,12,3,3,0,68
48287000403,380,315,250,42,19,9,0,1,65
48439001463,5447,4167,893,1019,2145,120,125,15,3274
48439001684,633,506,370,116,5,9,13,2,136
48439002448,5309,4031,1071,970,1268,100,684,12,2960
48439004136,6096,4477,1931,2101,282,173,61,6,2546
48329000207,4356,3415,2055,891,345,89,43,4,1360
48297000002,1452,1226,952,218,18,36,7,2,274
48447000001,348,284,264,15,0,5,0,0,20
48379000102,1088,878,782,34,11,27,13,2,96
48493000313,5577,4148,2727,1173,78,122,45,6,1421
48493000312,3541,2705,2006,522,55,106,31,2,699
48403000007,255,189,90,3,87,4,1,0,99
48215000035,7037,5067,297,4711,29,89,34,0,4770
48215000089,39,24,9,14,0,2,0,0,15
48077000026,238,192,178,7,1,5,1,1,14
48145000104,925,762,609,84,38,23,2,0,153
48485000104,1990,1738,1207,184,268,44,68,5,531
48485000111,1901,1817,794,381,526,26,39,4,1023
48215000027,1962,1510,52,1445,2,29,7,1,1458
48201000729,639,549,186,236,103,12,17,7,363
48201000830,110,97,41,12,23,0,22,0,56
48149000004,868,748,672,44,11,16,4,1,76
48207000006,500,386,282,74,13,12,1,1,104
48405000007,443,353,294,27,27,7,1,0,59
48245000082,6020,4408,1231,660,2191,52,319,6,3177
48245000105,770,515,178,53,269,13,11,0,337
48245000005,2569,1905,764,315,754,36,53,2,1141
48479000134,4450,2937,54,2876,5,21,3,0,2883
48185000012,1336,1066,641,284,116,19,3,0,425
48185000005,5094,4520,2324,1178,969,68,28,2,2196
48157004082,11790,8444,3946,1360,1619,126,1421,5,4498
48149000007,650,576,523,21,15,10,0,0,53
48297000001,721,624,421,167,2,14,9,0,203
48297000007,65,50,28,18,1,3,0,0,22
48401000214,3048,2470,1824,190,343,91,9,5,646
48057000018,635,473,262,156,17,15,13,1,211
48157003104,8139,6028,3487,934,722,99,826,3,2541
48379000203,2072,1656,1518,84,7,39,6,1,138
48379000204,1026,775,623,84,25,42,1,1,152
48209000447,3317,2835,1730,755,176,88,95,3,1105
48209000415,6326,5411,2460,2002,741,125,196,4,2951
48459000014,763,591,434,62,39,34,11,1,157
48245000069,5429,4127,2775,712,251,70,297,3,1352
48001000002,3811,2880,2453,173,172,64,11,3,427
48113002710,4503,3511,1329,1117,516,152,464,2,2182
48113003017,1320,1124,186,190,747,15,5,2,938
48113004010,1842,1501,872,499,41,53,50,2,629
48113002010,1738,1297,1028,139,27,21,81,0,269
48113004011,1574,1237,249,922,35,45,19,2,988
48039000022,5193,4018,2951,714,162,87,90,8,1067
48399000009,1163,872,537,312,11,23,5,2,335
48049000318,2731,2179,1749,283,32,83,25,0,430
48479000351,1680,1290,204,1076,2,15,12,0,1086
48161000003,249,182,144,12,12,6,3,0,38
48161000011,848,691,357,23,288,18,4,2,334
48491000395,4646,3722,2962,439,96,114,107,3,760
48287000304,332,274,241,11,21,4,1,0,33
48339000032,4848,3785,2285,878,272,115,234,0,1500
48203000016,886,678,591,22,48,17,1,0,87
48179000006,4282,3146,2349,616,38,110,22,1,797
48113001076,2997,2226,1611,311,140,69,110,6,615
48113001013,6088,5865,4241,665,293,98,541,12,1624
48113002046,2383,1730,1412,135,36,34,107,6,318
48113004646,1615,1230,334,799,64,56,30,1,896
48113004662,757,537,105,403,14,13,8,0,432
48113002060,4745,3087,2163,493,242,49,151,4,924
48029004063,2146,1617,271,1046,245,79,90,10,1346
48029002019,3209,2424,89,2299,17,45,23,6,2335
48029002048,3665,2760,208,2485,48,70,25,4,2552
48029003077,2923,2392,1451,766,53,73,92,9,941
48029003179,0,0,0,0,0,0,0,0,0
48029003057,910,733,364,286,44,16,32,1,369
48491000216,3301,2568,1829,394,89,53,216,1,739
48339000078,7079,5213,3615,758,135,65,578,12,1598
4832100001E,3332,2332,798,915,563,62,45,2,1534
48423000016,2435,1740,221,639,869,38,2,0,1519
48113001017,1910,1647,1262,206,51,35,92,7,385
48113001018,368,325,218,70,14,11,13,2,107
48113001120,2116,1834,1188,484,42,45,90,0,646
48303000060,1533,1166,912,194,25,18,10,0,254
48303000028,4354,3306,1945,936,195,81,150,7,1361
48113001112,1442,1059,35,796,215,59,13,1,1024
48113003020,312,289,134,48,94,8,5,1,155
48113004047,1914,1309,11,743,565,34,0,0,1298
4839100003A,918,718,401,266,47,8,1,1,317
48157004080,2422,1916,601,105,153,9,1033,3,1315
48157004107,2355,2032,1035,135,95,23,742,2,997
48241000021,2491,1880,1006,191,623,27,23,4,874
48113002030,2597,2010,1816,73,21,29,65,2,194
48113003200,2721,2258,928,500,728,63,68,9,1330
48113002712,7752,5813,1696,1922,1024,151,1092,6,4117
48113002717,12,10,3,5,1,1,1,0,7
48113004022,6949,5880,1568,2321,1199,171,761,9,4312
48113004100,65,21,16,5,3,0,0,0,5
48343000401,3156,2421,1755,191,431,47,5,4,666
48485000115,18,8,7,1,0,1,0,0,1
48485000116,79,66,56,7,0,5,0,0,10
48485000210,3,1,0,1,0,1,0,0,1
48485000209,0,0,0,0,0,0,0,0,0
48439003131,3106,2463,1592,510,206,99,68,14,871
48439001075,2626,1859,219,1364,264,50,16,1,1640
48439002219,3487,2663,1611,329,330,81,318,7,1052
48497000019,707,612,520,65,5,27,0,0,92
48497000015,1748,1395,1210,115,21,44,8,3,185
48121001001,2803,2093,1621,329,52,78,14,3,472
48141000182,7871,5662,1145,3782,526,129,160,38,4517
48141000025,5514,4563,1043,3059,221,110,236,15,3520
48141000068,1661,1387,410,752,150,74,58,8,977
48141000063,5743,4263,387,3659,219,97,46,3,3876
48141000051,3788,3042,827,1740,351,86,138,17,2215
48141000008,3282,2563,1196,1261,27,61,41,3,1367
48141000007,4153,3244,913,2201,66,82,58,5,2331
48141000076,2031,1680,116,1517,30,30,21,0,1564
48121001022,5753,4300,2731,819,376,182,212,8,1569
48339000029,7502,5483,4360,734,126,198,58,7,1123
48157003063,4241,3332,2387,520,207,70,133,4,945
48157002052,4133,3084,110,786,2184,75,30,9,2974
48141000022,4562,3680,900,2554,105,102,94,10,2780
48281000006,607,507,431,47,4,18,7,0,76
48171000007,3890,3210,2496,594,22,62,18,0,714
48171000003,2000,1576,1136,377,9,29,29,1,440
48373000001,597,476,413,37,10,15,0,0,63
48121004045,7036,6628,2805,1601,1255,180,880,30,3823
48121004007,3961,3497,2237,607,262,96,304,3,1260
48315000001,851,732,532,22,140,36,0,0,200
48067000005,1019,836,695,37,81,18,6,1,141
48245000023,2939,2307,610,208,1440,33,28,0,1697
48157003004,5592,4126,2164,800,289,63,795,4,1962
48139000122,2255,1747,1165,398,127,29,18,4,582
4841100004B,164,143,134,7,2,2,0,0,9
48005000026,2256,1788,1526,162,64,31,6,2,262
48005000023,802,600,560,27,8,5,1,0,40
48497000017,4419,3331,2836,295,30,134,15,4,495
48157001018,3884,2852,1666,1010,67,74,52,4,1186
48205000102,274,200,149,45,4,6,2,0,51
48189000304,1503,1077,495,478,67,29,18,1,582
48113001707,5209,3393,224,2347,558,93,271,0,3169
48113003604,4276,3322,509,491,2247,87,58,3,2813
48113003061,2920,2070,48,543,1478,26,7,3,2022
48339000005,407,340,299,26,5,8,1,1,41
48373000003,3365,2844,2280,219,220,79,29,3,564
48265000119,3106,2548,1940,472,26,67,59,3,608
48245000075,1448,1205,224,220,539,11,222,1,981
48181000304,5327,4055,2778,425,447,165,246,5,1277
48113001116,3449,2439,512,1798,80,99,24,6,1927
48113001062,104,78,14,62,0,3,0,0,64
48113001137,57,33,7,25,0,1,0,0,26
48091000402,6292,5234,4248,649,51,190,68,16,986
48195000005,962,664,323,332,2,6,1,0,341
48309000037,2171,1555,579,628,311,58,16,4,976
48113003211,3180,2162,377,1542,212,73,22,1,1785
48113004503,7754,5726,1035,2220,1696,148,748,11,4691
48113004525,3722,2628,409,1529,549,107,107,15,2219
48113003058,2890,2238,39,546,1644,50,8,4,2199
48113002049,2256,1818,1194,252,204,50,132,5,624
48113002405,4886,4109,2284,883,360,125,477,3,1825
48113002042,3936,2961,2256,264,174,40,208,1,705
48113001059,2455,1936,1176,564,96,65,35,1,760
48113001047,2899,2208,720,1317,112,98,18,3,1488
48113001052,5335,4315,2590,1030,480,114,128,1,1725
48113001728,3317,2427,694,1395,228,109,80,1,1733
48113001713,2766,1999,689,1139,103,76,19,2,1310
48113001726,5236,3707,959,2208,412,145,99,7,2748
48057000005,343,264,152,104,4,5,2,0,112
48339000061,6462,4790,3457,628,144,100,456,7,1333
48005000022,863,652,532,67,29,22,6,0,120
48451000107,978,690,320,301,47,29,9,2,370
48339000022,7870,5973,4465,895,318,190,71,11,1508
48339000044,5774,4138,2134,1307,553,116,93,8,2004
48309000084,3547,2663,2075,312,212,45,24,1,588
48113001701,4648,3443,989,1875,229,128,284,3,2454
48113001314,5671,3935,826,2317,708,121,61,8,3109
48113002025,3073,2654,2346,136,24,37,103,1,308
48441000408,5577,4116,3377,411,87,115,90,17,739
48441000304,5097,4203,2691,683,401,132,324,22,1512
48441000302,3690,2853,2141,450,153,63,59,7,712
48479000401,3136,2457,156,2245,36,47,5,3,2301
48473000103,2053,1510,553,461,480,61,7,3,957
48059000005,164,125,116,4,2,4,2,0,9
48139000129,1508,1100,583,419,72,36,4,0,517
48121004003,4358,4288,3982,133,50,59,49,6,306
48121004044,5623,4056,3179,451,188,128,110,3,877
48121001016,4905,3775,2539,619,328,103,213,9,1236
48361000024,2631,1943,1663,138,21,28,82,2,280
48361000011,1449,1093,682,233,134,43,21,0,411
48361000013,2726,1985,1150,234,502,44,48,0,835
48361000020,2603,1968,1790,103,13,50,8,2,178
48113002223,2302,1597,1279,124,21,31,119,1,318
48113003063,7029,5020,178,901,3942,61,35,3,4842
48113003046,4465,3247,436,1111,1629,70,40,2,2811
48337000011,1704,1308,1028,194,8,58,21,1,280
48113002512,2188,1758,998,243,188,44,292,3,760
48113002705,3918,3074,920,829,538,84,770,4,2154
48113001006,2163,1561,1352,73,47,25,50,4,209
48113001109,2264,1462,128,1257,70,45,13,0,1334
48113002020,3300,2803,2056,353,207,43,157,2,747
48113004024,4604,3035,203,789,1772,51,266,11,2832
48113004101,264,196,1,177,17,11,1,1,195
48113002505,4515,3693,2206,747,354,77,314,2,1487
48113001706,8680,6257,870,4003,433,235,954,11,5387
48113002044,2143,1712,879,265,199,56,341,2,833
48113001083,4589,3327,443,2621,228,116,17,3,2884
48113003031,2783,1781,297,1172,282,83,6,1,1484
48113003032,3207,2401,315,1622,430,100,14,3,2086
48113003084,1992,1768,615,508,543,46,91,1,1153
48113003620,1841,1428,141,223,1058,10,22,2,1287
48439004116,2603,2252,1826,184,53,53,121,7,426
48439002266,4108,3228,2330,404,263,96,150,1,898
48199000018,6964,5336,4773,270,48,118,73,4,563
48199000019,1667,1217,1048,108,11,32,10,4,169
48265000101,3807,3159,2370,611,60,72,49,13,789
48439001265,3175,2441,975,523,844,55,65,6,1466
48477000115,1528,1183,694,280,173,19,12,2,489
48113003305,7063,5297,1798,1755,1228,168,407,8,3499
48113003109,4751,3845,1714,618,1190,97,253,5,2131
48113004537,30,21,3,9,10,3,0,0,18
48113002803,1564,1180,951,100,20,16,94,3,229
48113002510,2672,2115,1166,351,202,71,342,5,949
48113003203,3446,2567,644,844,1013,86,51,3,1923
48439002134,3565,2678,356,679,1044,57,610,6,2322
48439002569,786,520,27,307,152,23,33,1,493
48439003406,0,0,0,0,0,0,0,0,0
48439004497,8917,6512,2269,1428,2613,153,139,15,4243
48147000012,1725,1363,1213,79,14,46,7,0,150
48113004090,270,220,32,139,44,4,4,0,188
48201000075,2831,2327,1504,540,90,50,166,3,823
48201000341,3733,2495,151,1942,396,91,7,1,2344
48201000253,3522,2467,62,757,1641,46,5,4,2405
48201000293,2907,2264,997,788,256,87,183,3,1267
48201000943,3015,2081,70,1407,484,60,133,4,2011
48201000429,9533,6763,439,3221,2122,187,954,12,6324
48291000019,2846,2152,1225,484,377,56,20,2,927
48291000025,1504,1122,971,111,9,15,3,3,151
48441000303,2860,2057,1802,155,12,65,5,4,255
48113001302,5115,3926,1291,937,1557,93,121,9,2635
48113001139,36,28,7,4,2,0,9,0,21
48121001039,273,189,105,13,30,4,36,0,84
48121001038,666,540,309,90,111,13,19,0,231
48451000225,119,99,91,5,0,0,0,0,8
48449000012,487,369,228,120,9,13,3,0,141
48439002268,2990,2252,688,758,450,58,337,0,1564
48439002026,3059,2476,1620,567,188,65,51,10,856
48439002670,306,234,97,95,43,1,1,2,137
48439001175,3312,2397,891,428,452,72,567,16,1506
48439001589,377,317,155,38,76,3,49,0,162
48439001586,32,24,0,5,11,0,5,3,24
48439001199,424,369,261,35,44,2,19,8,108
48439001622,62,45,16,11,7,1,8,0,29
48439004191,2453,1839,964,610,74,51,142,13,875
48113004070,3376,2537,180,2245,105,86,9,2,2357
48113002222,3969,2577,2254,93,19,66,130,3,323
48009000005,195,136,121,6,1,8,0,0,15
48439001090,4101,2601,162,975,1379,17,75,9,2439
48439004344,1770,1522,1286,122,50,27,49,2,236
48439001126,2324,1864,596,271,867,53,97,15,1268
48439004163,1700,1192,1003,104,25,25,27,3,189
48439004070,3629,2948,1620,668,479,78,109,5,1328
48449000005,367,279,248,17,4,10,0,0,31
48073000025,1827,1329,1059,76,153,42,9,2,270
48073000033,2972,2297,1853,117,181,121,20,3,444
48201000189,2458,1616,1139,299,44,26,119,3,477
48201000074,4281,3531,2512,546,117,91,235,1,1019
48439001296,4050,3411,2216,417,540,66,192,2,1195
48201000224,4379,3639,1797,569,421,47,817,8,1842
48201000933,1260,1053,283,140,414,6,216,0,770
48201000931,164,133,82,16,4,3,28,0,51
48201000932,0,0,0,0,0,0,0,0,0
48201000201,1470,1067,27,437,611,29,8,1,1040
48439002658,1414,1000,217,438,304,22,52,1,783
48439004092,2798,2029,105,1886,31,37,9,1,1924
48201000039,4889,4375,2847,678,262,72,527,10,1528
48201000157,4367,3184,115,1336,1712,47,26,0,3069
48439001382,5902,4698,1093,753,2577,93,280,24,3605
48439004130,3068,2286,1977,117,66,41,89,2,309
48201000750,2908,2077,596,1075,264,84,107,7,1481
48201000941,2337,1884,876,572,232,63,168,8,1008
48201000175,3876,2753,1810,341,152,32,402,8,943
48201000233,9637,8743,5084,1479,755,147,1333,21,3659
48113001003,6693,5297,771,1014,3291,91,248,7,4526
48113002069,3880,2956,2514,226,50,58,115,1,442
48439003392,3062,2244,1792,191,57,35,149,2,452
48439003668,506,355,272,31,1,3,45,3,83
48439002521,2054,1572,931,286,196,56,103,0,641
48439002524,2744,2246,1862,171,89,54,73,2,384
48439004097,2482,1792,350,1314,49,69,57,3,1442
48439004475,79,57,42,10,1,2,4,0,15
48439004478,0,0,0,0,0,0,0,0,0
48289000010,1689,1224,821,323,59,35,7,0,403
48439001198,1507,1071,250,725,32,47,53,2,821
48439001623,0,0,0,0,0,0,0,0,0
48439001625,0,0,0,0,0,0,0,0,0
48439004101,3357,2422,527,1510,52,68,296,0,1895
48439003398,2566,1963,1339,342,115,69,107,6,624
48439003554,3978,2994,2337,230,94,64,224,9,657
48439004454,4941,3593,2085,1047,301,85,105,7,1508
48439001009,2252,1748,1144,351,169,51,33,4,604
48439004494,238,219,115,33,65,8,3,0,104
48113003055,2479,2041,189,258,1580,42,12,5,1852
48113003078,4922,3567,385,1327,1794,104,67,5,3182
48113004659,740,528,90,403,23,46,1,0,438
48439003648,6198,4177,2613,630,407,142,412,23,1564
48439004503,2626,1895,407,1364,58,57,43,2,1488
48439001377,6849,5559,2834,861,1494,116,318,11,2725
48439004222,2420,1760,649,996,57,54,31,10,1111
48439004138,2490,1774,612,1087,27,62,16,3,1162
48439004691,67,41,13,28,0,0,0,0,28
48439004693,33,23,3,20,0,0,0,0,20
48439004593,1647,1165,314,672,150,45,22,1,851
48439004595,220,154,54,95,3,6,0,0,100
48439004692,89,56,19,31,4,2,0,0,37
48439004690,29,23,10,13,0,0,0,0,13
48439001079,2558,1793,100,933,735,36,27,1,1693
48439004204,7905,5993,3310,1674,556,226,227,45,2683
48439002304,2844,2296,1572,214,211,79,226,5,724
48439004087,1503,1087,88,966,28,21,4,0,999
48439001089,2928,2085,111,883,1103,32,10,1,1974
48439001619,89,45,1,32,15,2,0,0,44
48439001098,4597,3109,106,2083,915,45,6,1,3003
48439001059,1572,1091,155,437,403,31,98,0,936
48439004498,660,518,463,30,8,5,10,1,55
48113004015,2408,2033,610,681,664,41,45,3,1423
48439004369,5684,4209,2833,775,298,140,210,4,1376
48201000272,6545,5285,1414,2207,1248,170,405,16,3871
48203000021,988,794,521,62,189,24,4,1,273
48181000203,2306,1708,1037,271,297,109,17,2,671
48201000634,6209,4528,1646,1738,928,175,137,23,2882
48201000753,813,578,136,184,240,19,32,1,442
48201000800,7238,5448,2383,1658,1071,138,303,14,3065
48201000050,8131,6135,1758,1551,1508,141,1282,7,4377
48439004122,5837,4006,378,3493,87,113,19,4,3628
48439004568,102,85,56,19,2,10,0,0,29
48439004689,328,247,96,142,5,3,5,0,151
48439004688,148,105,26,78,0,1,0,0,79
48439004487,0,0,0,0,0,0,0,0,0
48439004565,96,75,26,45,0,4,0,0,49
48053000008,1607,1337,1061,177,48,33,8,2,276
48201000730,3537,3106,2000,577,228,38,288,0,1106
48201000942,214,155,104,23,12,6,21,0,51
48201000540,4107,3748,2097,442,314,36,866,1,1651
48441000110,129,106,98,2,0,2,0,0,8
48221000016,5990,5363,4922,219,24,99,54,5,441
48099000308,6413,4794,3965,478,141,171,58,4,829
48215000009,4858,3606,251,3286,23,53,33,4,3355
48453000135,11400,9309,5616,1934,615,210,1018,25,3693
48453000142,3195,2648,939,1228,306,112,147,5,1709
48113004644,2478,1574,139,38,57,12,1337,2,1435
48113003057,4573,3375,183,1753,1430,118,14,1,3192
48125000004,426,315,199,97,15,17,7,1,116
48453000109,4209,3402,1573,1027,321,122,408,17,1829
48215000019,285,221,37,181,2,6,1,0,184
48201000574,818,562,12,436,117,17,1,1,550
48201000670,4164,3130,2525,381,52,81,85,8,605
48453000235,4203,3808,2603,637,187,98,307,14,1205
48479000343,3473,2753,155,2549,12,38,15,1,2598
48113001118,3532,2871,998,454,1238,65,148,8,1873
48439003511,5496,4425,1958,770,1065,130,570,42,2467
48215000192,1262,855,48,805,2,5,2,0,807
48439001022,1654,1281,772,339,99,33,26,5,509
48439002535,3086,2427,1577,307,327,45,177,3,850
48039000041,3187,2367,864,342,560,31,577,5,1503
48099000412,6652,4814,2723,797,873,160,246,94,2091
48355000060,1953,1457,58,1359,28,25,2,4,1399
48215000077,3828,2692,323,2345,8,24,13,1,2369
48215000253,721,576,129,437,3,8,1,0,447
48227000016,293,213,87,90,21,7,9,2,126
48227000046,1858,1309,518,675,88,42,18,1,791
48227000045,1494,1082,648,354,51,22,30,3,434
48035000005,2374,1956,1758,85,6,91,4,1,198
48027000109,5373,4096,1236,920,1723,131,215,61,2860
48201000698,6573,4654,132,2195,1944,99,358,14,4522
48439004110,2063,1525,166,1337,17,36,8,0,1359
48215000107,4575,3313,210,3016,29,91,32,0,3103
48215000030,10018,6966,385,6340,148,100,108,0,6581
48061000011,3929,2861,92,2745,7,43,8,3,2769
48099000414,539,402,362,21,4,16,0,0,40
48055000109,43,37,21,10,5,0,0,0,16
48027000409,3505,2492,923,542,807,126,177,40,1569
48055000100,623,518,241,256,6,16,5,2,277
48055000407,34,22,0,11,0,5,4,2,22
48055000408,37,24,7,14,0,5,1,0,17
48055000105,167,113,35,74,1,2,0,0,78
48375000124,3599,2650,1915,503,76,112,71,1,735
48375000225,4613,3245,742,2296,99,113,48,0,2503
48201000577,3368,2418,1191,771,73,78,363,2,1227
48201001003,0,0,0,0,0,0,0,0,0
48201000677,4411,3057,206,2704,98,173,41,4,2851
48343000102,483,389,169,12,200,8,2,0,220
48249000005,301,239,27,205,1,6,1,0,212
48249000020,1135,862,52,789,8,9,9,0,810
48249000009,1362,921,118,798,4,7,2,0,803
48463000014,84,76,51,22,1,2,0,0,25
48463000004,421,366,263,91,0,9,2,1,103
48201000665,4408,3260,2015,994,81,123,57,5,1245
48061000083,1770,1340,419,877,14,41,9,1,921
48201000483,9387,7156,3127,1766,1314,141,891,17,4029
48201000139,5786,5274,3482,709,321,78,677,6,1792
48201000558,9582,7326,1420,2252,2583,171,1035,26,5906
48201000743,746,537,65,446,18,7,4,1,472
48423000006,1406,1100,848,133,74,38,6,0,252
48201000568,4896,3790,2311,580,161,94,644,4,1479
48201000810,604,438,27,388,25,4,1,1,411
48201000530,2549,1971,73,1845,52,73,10,1,1898
48201000549,5612,4158,158,2327,1434,189,285,4,4000
48419000007,1017,794,538,34,208,13,6,0,256
48453000249,3609,2989,2226,427,81,73,204,2,763
48453000253,4373,3428,2795,304,54,62,177,3,633
48355000003,5044,3958,1435,2061,190,85,217,8,2523
48227000105,1,0,0,0,0,0,0,0,0
48239000008,830,626,449,148,7,13,9,1,177
48239000004,525,433,321,88,4,11,6,0,112
48239000007,158,127,107,20,1,0,1,0,20
48201000573,3163,2065,37,394,1618,25,31,1,2028
4827700004C,491,391,310,24,23,32,1,0,81
48455000004,331,280,249,12,6,5,7,0,31
4822700012A,407,318,120,158,19,22,11,0,198
48201000203,2487,1825,147,1302,359,50,12,2,1678
48201000159,2484,1805,388,387,906,37,130,3,1417
48201001005,0,0,0,0,0,0,0,0,0
48201000424,2450,1856,795,658,191,57,190,3,1061
48201000179,3990,3151,1074,1602,213,88,222,3,2077
48423000073,1076,834,346,218,249,26,6,1,488
48201000284,14660,10513,1523,6575,1564,252,861,9,8990
48113002800,0,0,0,0,0,0,0,0,0
48201000069,3430,2540,106,2360,42,95,34,1,2434
48085000074,2881,2328,1505,232,251,41,289,0,823
48227000405,639,490,357,117,8,5,4,2,133
48201000807,6420,4996,589,2104,2070,118,307,10,4407
48113003112,74,48,8,11,26,2,8,0,40
48113003113,22,19,0,1,19,3,0,0,19
48113002041,6689,6152,3901,742,862,108,551,4,2251
48463000010,1020,747,40,694,12,20,0,0,707
48201000089,1855,1431,956,154,80,18,219,2,475
48201000728,1988,1466,652,610,116,94,59,4,814
48201000626,8653,6987,2974,1609,1667,133,672,17,4013
48201000473,2394,1887,1352,280,75,47,101,9,535
48201000709,7824,5672,2241,1408,980,131,995,9,3431
48029002021,5490,3927,117,3714,68,117,23,9,3810
48029004078,2097,1633,1044,456,85,34,20,4,589
48029003122,3459,2815,1501,946,184,83,129,28,1314
48167000460,6814,5294,4208,635,133,121,186,6,1086
48423000010,5061,3847,1575,741,1454,72,9,1,2272
48249000019,643,452,168,270,8,15,0,0,284
482130004MS,711,567,307,5,232,18,4,1,260
48029001005,1516,1182,62,1109,14,32,2,3,1120
48029001119,318,228,12,214,2,7,1,1,216
48029002047,2541,2051,308,1636,79,54,18,4,1743
48453000421,3344,3048,2409,362,73,59,137,3,639
48469000020,1889,1475,1028,385,34,28,6,0,447
48469000032,2891,2138,446,1395,247,39,56,1,1692
48469000006,883,711,90,466,141,18,25,5,621
48199000014,1826,1328,1142,71,41,55,8,0,186
48261000001,108,70,15,53,2,2,0,0,55
48029004016,4008,3209,325,2783,79,116,26,6,2884
48141000124,6219,4588,285,4156,104,108,45,9,4303
48029002042,3268,2246,105,2010,117,47,22,4,2141
48029002027,2028,1672,288,1277,55,55,39,4,1384
48029002092,992,792,224,459,70,29,28,1,568
48029004145,26,24,11,5,3,1,5,0,13
48201000178,2933,2473,1723,278,183,26,266,1,750
48201000873,1488,1148,110,478,298,50,264,6,1038
48201000980,1694,1417,769,195,122,20,316,1,648
48201000528,161,122,2,52,70,9,0,0,120
48201000641,6950,5314,1901,1714,987,155,658,7,3413
48201000477,8819,6400,3101,1503,809,162,871,17,3299
48037000015,805,625,547,13,45,16,5,4,78
48141000097,3609,2795,425,2190,113,67,56,5,2370
48141000098,2308,1913,344,1483,37,45,33,4,1569
48141000030,381,280,5,262,2,7,7,2,275
48201000842,7314,5473,1029,2822,1211,137,425,8,4444
48013000008,900,681,272,391,5,12,9,2,409
48201000555,7019,4961,271,2718,1873,117,209,10,4690
48201000572,7319,6301,2382,1696,1625,130,591,8,3919
48113004051,42,28,7,12,6,4,4,0,21
48113004053,973,695,97,359,164,14,76,0,598
48113004541,0,0,0,0,0,0,0,0,0
48113004528,0,0,0,0,0,0,0,0,0
48113003021,1803,1390,35,313,1041,37,5,1,1355
48113001050,250,162,136,17,3,1,5,0,26
48113002011,2531,1897,1515,175,33,27,136,5,382
48201000695,5105,3531,1293,1871,241,123,75,0,2238
48201000519,5519,4233,2071,956,756,103,342,20,2162
48201000667,3052,2442,1436,582,233,70,170,3,1006
48201000256,7817,5864,1030,4016,447,290,339,15,4834
48201000938,2207,1453,55,1145,205,38,28,1,1398
48113003315,4372,3030,704,1232,993,102,68,2,2326
48113002065,3571,2859,1986,484,249,75,73,7,873
48113002801,4754,3601,2292,477,163,83,583,6,1309
48037000009,4978,3727,2111,453,999,129,41,6,1616
48201000445,5046,3797,1314,1911,306,121,244,7,2483
48201000557,6156,4698,272,2689,594,188,1077,6,4426
48201001001,4029,3006,176,1159,1171,73,441,3,2830
48201000781,8633,6449,473,4117,442,186,1376,15,5976
48201000765,12797,9685,1426,2728,4317,193,1165,18,8259
48201000025,1992,1620,133,249,1199,34,45,3,1487
48201000308,4399,3226,269,2153,756,104,69,9,2957
48201000596,7848,5580,1649,2193,1530,217,152,32,3931
48085000126,7019,4995,2922,631,685,140,649,18,2073
48085000112,3974,3084,1868,165,103,25,917,4,1216
48453000439,5795,5114,2631,1730,408,119,267,2,2483
48309000022,1193,822,245,289,254,18,9,0,577
48395000016,253,195,157,11,8,10,11,1,38
48477000203,2336,1935,1440,210,237,31,18,6,495
4821300003B,4265,3273,2683,367,121,87,9,4,590
48395000019,840,692,617,48,10,12,2,1,75
48029003047,2257,1648,1227,324,23,37,31,2,421
48029003123,1827,1249,486,652,48,41,35,11,763
48029003043,4096,3055,1857,818,174,98,110,12,1198
48029003039,7009,4916,2498,1708,306,116,323,15,2418
48029001012,4222,3115,417,2418,216,100,63,12,2698
48029004008,1236,1170,528,455,145,26,40,3,642
48223000001,3583,2696,2011,320,261,61,43,5,685
48113004614,707,534,347,122,25,14,25,0,187
48113004615,470,359,87,252,9,24,8,0,272
48113004658,199,140,38,90,8,2,5,0,102
48113001704,2986,2238,513,767,348,72,577,8,1725
48469000011,521,412,264,119,14,18,3,0,148
48095000203,136,115,101,8,1,4,2,1,14
48201000282,5455,4232,1507,1210,1053,93,514,5,2725
48201000020,4190,3801,1490,688,1132,110,459,17,2311
48011000402,221,177,161,6,1,5,1,1,16
48361000012,2216,1709,1261,196,204,47,16,1,448
48085000006,2409,1686,712,188,265,25,494,4,974
48085000227,6417,4385,2432,524,467,107,878,7,1953
48085000059,5890,4289,2648,522,423,117,614,5,1641
48201000095,6213,5101,2551,915,947,70,624,4,2550
48087000301,583,424,250,130,37,9,6,5,174
48177000011,322,259,194,50,8,11,0,0,65
48285000012,442,354,324,16,7,5,2,0,30
48135000205,3541,2547,1308,1009,123,86,33,12,1239
48167000150,4099,3176,1751,939,328,99,58,7,1425
48135000107,2346,1775,1025,624,52,72,15,2,750
48361000031,3564,2715,2436,136,34,63,25,0,279
48201000106,966,681,114,507,45,24,12,3,567
48201000489,3491,2717,553,1329,680,101,157,1,2164
48201000542,5177,3819,42,2317,1452,124,56,2,3777
48201000995,3698,2811,223,1164,1209,81,229,4,2588
48361000021,359,281,226,42,1,10,2,0,55
48201000125,4939,3695,1379,1220,740,114,287,12,2316
48201000052,4246,3832,2303,757,235,82,495,12,1529
48201000205,2646,1988,43,423,1521,34,6,1,1945
48093000016,118,89,80,2,1,7,0,0,9
48429005-11,113,91,90,0,0,1,0,0,1
48439003368,944,809,646,89,12,28,28,1,163
48201000273,2945,2280,1694,173,35,34,329,0,586
48201000622,8451,6446,1874,2812,582,171,1128,12,4572
48329000402,535,416,302,60,19,29,10,1,114
4832900402A,1060,768,582,149,14,19,11,0,186
48297000006,269,219,165,45,0,4,1,3,54
48303000020,2296,1722,90,368,1276,30,8,2,1632
48303000067,3766,2878,1535,1054,174,106,53,7,1343
48245000066,2061,1582,1147,193,197,28,7,0,435
48303000007,3496,2724,1777,680,164,69,61,2,947
48303000118,3056,2284,1103,886,228,64,26,4,1181
48303000141,4325,3301,1839,1079,265,105,46,4,1462
48245000072,4952,3943,1582,405,1621,82,289,5,2361
48303000027,7226,5526,2353,2154,728,136,246,8,3173
48479000340,3220,2490,207,2225,13,33,48,4,2283
48201000230,2011,1445,32,648,759,31,7,1,1413
48303000029,4604,3299,942,1835,456,78,47,5,2357
48297000004,1316,1003,610,354,6,22,10,5,393
48201000263,6513,4779,2614,915,535,89,666,4,2165
48303000030,4987,3805,2008,1285,304,123,107,4,1797
48193000012,225,180,163,5,4,7,1,0,17
48207000007,165,144,102,35,4,3,0,1,42
48255000013,64,51,25,20,1,2,2,0,26
48077000014,227,175,160,5,1,7,2,0,15
48465000041,2850,1994,152,1828,13,24,6,0,1842
48161000012,246,204,148,7,46,0,0,0,56
48161000009,993,753,507,167,65,21,3,7,246
48485000411,1605,1211,807,215,104,48,44,3,404
48365000020,543,397,335,20,12,19,5,0,62
48459000004,1837,1284,999,90,138,37,11,0,285
48291000017,834,661,588,37,7,24,0,0,73
48009000008,371,307,281,12,0,12,3,1,26
48471000403,2554,1962,1250,457,184,46,9,1,712
48449000001,1489,1025,104,576,328,39,8,1,921
48251000027,3569,2675,2216,270,74,106,25,4,459
48209000121,4328,3952,1601,1565,557,101,211,37,2351
48209000111,402,345,233,80,31,7,4,1,112
48121004010,3673,2931,1596,811,383,125,104,1,1335
48365000014,680,494,410,32,23,13,4,0,84
48491000218,4647,3606,2327,656,206,95,330,13,1279
48141000100,5149,4001,435,3420,102,93,34,4,3566
48141000133,3907,3144,87,2977,76,51,19,8,3057
48141000067,5164,3977,408,3288,211,99,74,8,3569
48259004050,4291,3477,2203,1089,32,119,23,7,1274
48209000129,4829,3531,1402,1667,298,109,122,6,2129
48241000017,1543,1157,1081,34,17,13,6,2,76
48209000340,3261,2811,1833,751,126,65,68,8,978
48459000018,1221,974,694,77,176,22,5,1,280
48141000082,3361,2691,69,2569,27,42,32,5,2622
48121004013,713,603,367,145,39,46,35,3,236
48121004039,3924,3755,1939,699,663,76,432,5,1816
48141000117,4650,3681,370,3170,89,86,70,5,3311
48141000084,3375,2633,85,2537,18,35,8,1,2548
48141000120,4841,3844,292,3424,95,63,33,7,3552
48141000135,4088,3174,84,3058,16,48,22,7,3090
48291000024,1754,1317,964,275,32,54,3,1,353
48291000029,2220,1703,1312,297,48,45,6,2,391
48291000016,513,415,356,35,9,14,0,4,59
48157004065,8491,6403,1601,457,791,61,3526,5,4802
48157002101,7602,5626,520,2944,1447,185,717,6,5106
48157002100,4988,3800,525,2061,861,98,404,3,3275
48259002020,2721,2221,1844,251,21,33,53,5,377
48259003030,3143,2509,2041,334,22,79,29,8,468
48491000403,5895,4078,2019,1341,537,127,129,8,2059
48121003031,4717,3420,2180,324,235,84,623,2,1240
48113002022,891,678,562,50,9,10,45,2,116
48121001021,4697,3529,2528,462,217,121,211,5,1001
48265000410,339,288,229,40,0,8,11,1,59
48157002036,1444,1140,36,161,931,7,18,0,1104
48479000128,1153,810,0,809,0,7,0,0,810
48157001037,6371,4753,1229,3022,426,151,25,10,3524
48157004110,4717,3720,1413,447,289,48,1559,1,2307
48367000300,2563,2023,1623,247,62,77,7,2,400
48449000019,1670,1194,507,529,130,44,4,2,687
48339000069,5821,4340,3178,538,137,71,373,10,1162
48373000018,1229,914,379,165,313,37,10,0,535
48157002089,1698,1321,28,188,1085,6,24,0,1293
48339000002,4947,3613,1888,1255,297,123,102,6,1725
48157002091,1018,765,225,175,333,16,27,6,540
48157002096,5898,4690,967,854,1441,58,1410,16,3723
48057000011,1097,800,242,375,22,11,151,0,558
48139000119,2542,1910,1191,542,114,50,20,5,719
48185000015,1110,869,634,155,34,33,6,3,235
48193000017,292,240,187,38,3,10,1,0,53
48185000008,828,643,468,95,57,25,3,1,175
48141000026,2504,1991,518,1361,50,65,49,1,1473
48141000054,5616,3991,549,3089,278,96,97,26,3442
48071000005,3606,2760,2208,351,53,81,44,2,552
48141000147,2798,2130,85,2029,14,45,4,4,2045
48401000405,1808,1345,911,249,126,28,22,0,434
48113004639,2548,1782,288,1094,243,88,141,2,1494
48113003067,7015,4673,181,422,4054,65,45,10,4492
48071000001,697,530,402,44,56,19,6,0,128
48113002032,3859,3556,1835,597,473,81,594,13,1721
48157004030,3472,2826,1618,408,591,52,213,0,1208
48009000009,223,196,185,3,0,6,0,0,11
48057000007,1031,773,221,517,21,17,16,0,552
48113003096,0,0,0,0,0,0,0,0,0
48113001316,2551,1952,434,575,879,42,36,4,1518
48113003611,1738,1287,352,270,628,31,22,4,935
48147000001,5275,4636,2812,800,921,75,31,9,1824
48367000325,2494,1913,1627,189,8,66,5,4,286
48439001594,0,0,0,0,0,0,0,0,0
48439004050,4648,3108,264,2320,499,56,28,1,2844
48439001188,949,724,37,205,468,12,2,1,687
48161000013,469,381,316,21,33,7,4,0,65
48113002024,2353,1991,1496,206,131,41,130,1,495
48291000015,669,552,451,50,37,15,0,0,101
48161000004,524,396,328,50,8,14,2,0,68
48121001018,8179,6391,4216,1176,505,180,327,22,2175
48175000032,766,619,525,68,3,17,4,1,94
48147000005,841,659,607,14,1,30,2,0,52
48439004256,2907,1988,152,1780,45,54,5,0,1836
48439004020,3962,2976,1673,862,243,142,103,4,1303
48181000204,1483,1239,1047,51,50,66,25,1,192
48439004703,5706,3852,1590,1365,561,106,273,12,2262
48439004650,5584,3782,1879,891,638,135,267,8,1903
48439004666,0,0,0,0,0,0,0,0,0
48439004528,6015,4440,2512,850,371,164,576,13,1928
48439004620,545,364,85,233,32,9,9,3,279
48251000009,1654,1278,1077,118,15,49,5,2,201
48201000826,582,383,231,72,12,23,62,0,152
48201000760,2540,1865,1545,139,66,24,67,0,320
48201000007,1294,987,27,328,627,25,9,0,960
48201000060,4209,3674,2303,694,200,73,421,6,1371
48439001476,360,247,57,175,12,10,2,0,190
48439002205,3567,2807,1988,454,160,117,115,13,819
48439001418,0,0,0,0,0,0,0,0,0
48439001394,0,0,0,0,0,0,0,0,0
48439004065,5963,4635,3462,722,172,132,124,6,1173
48439002003,1253,990,707,161,60,26,32,1,283
48439002303,3668,2838,1623,741,306,82,110,6,1215
48201000664,8437,5810,322,4933,473,143,78,9,5488
48201000570,3793,3387,1510,652,489,71,688,18,1877
48455000007,250,192,169,10,4,9,0,0,23
48231000103,1005,818,671,85,13,33,6,1,147
48201000793,8417,5923,1307,4040,432,161,108,8,4616
48201000417,5260,3862,762,1931,793,87,383,10,3100
48201000721,3816,2955,1989,397,84,69,432,3,966
48201000140,5214,4528,1431,600,2038,44,478,6,3097
48201000113,4809,3639,1151,1141,965,91,358,4,2488
48201000022,5700,4033,344,1256,2302,108,130,13,3689
48201000073,3305,2576,1259,954,211,69,123,0,1317
48015000207,435,361,316,28,4,10,1,1,45
48293000405,387,317,282,22,4,5,1,0,35
48201000344,2037,1482,33,738,707,27,8,2,1449
48201000606,1824,1191,11,319,867,5,7,4,1180
48167000312,14,6,0,3,3,2,0,0,6
48167000457,6183,4681,3505,695,116,97,280,9,1176
48471000203,902,709,593,30,60,23,1,0,116
48025000018,2417,1876,905,852,60,43,30,4,971
48025000019,1022,720,108,582,21,14,8,4,612
48157001021,982,776,597,134,10,26,9,0,179
48141000161,2549,1910,61,1833,14,16,2,0,1849
48141000055,3993,3105,576,2048,334,74,159,12,2529
48141000103,2844,2269,473,1699,81,48,34,3,1796
48141000140,4555,3157,97,3039,24,30,0,0,3060
48409000120,960,812,589,175,12,46,9,0,223
48113003071,3306,2502,58,456,1976,27,29,2,2444
48113003072,170,120,8,62,53,1,1,0,112
48113004108,146,88,0,63,24,3,0,1,88
48439004203,6753,4600,1364,1477,1555,151,159,14,3236
48113001097,6913,4872,435,3533,873,186,27,6,4437
48439001597,1419,986,83,805,73,27,20,0,903
48439002341,739,568,126,178,185,22,78,0,442
48439001610,0,0,0,0,0,0,0,0,0
48201000822,2543,1911,20,770,1109,25,22,1,1891
48355000046,770,596,57,518,18,25,2,2,539
48453000344,2474,2023,1350,474,80,55,85,7,673
48029003005,4496,3153,1803,908,245,101,134,11,1350
48029004135,0,0,0,0,0,0,0,0,0
48453000246,2547,2044,1542,265,55,46,143,3,502
48061000034,760,540,65,455,11,8,14,0,475
48355000016,1521,995,390,542,17,16,45,1,605
48355000030,239,192,30,92,65,8,1,1,162
48029004012,1752,1186,47,783,360,29,9,7,1139
48029003049,2700,2120,1469,465,74,48,55,2,651
48029003136,651,545,241,274,4,19,26,3,304
48029003139,2490,1995,697,1059,135,53,90,7,1298
48029002112,2384,1997,598,1223,86,59,80,0,1399
48457000015,1357,1009,933,28,11,30,5,0,76
48215000116,4589,3368,419,2865,24,50,56,2,2949
4841900009S,1374,1065,802,77,136,38,2,0,263
48453000410,6088,5212,2173,2338,418,166,261,8,3039
48363000026,287,194,136,39,4,8,8,1,58
48363000004,654,513,449,49,4,11,4,0,64
48055000411,0,0,0,0,0,0,0,0,0
48029001037,5861,4234,528,3320,280,145,68,18,3706
48029003167,50,50,16,28,8,0,1,0,34
48029002134,4251,3246,653,1823,548,126,204,28,2593
4827700003G,741,583,548,7,2,20,3,0,35
48029002085,2652,1978,276,1627,42,72,19,3,1702
48029004198,2976,2121,485,944,614,76,87,1,1636
48029004168,4164,2919,653,1379,818,60,98,7,2266
48029004197,57,29,7,17,7,0,0,0,22
48041000059,45,33,22,11,0,0,0,0,11
48029004040,2480,1727,159,652,838,75,96,13,1568
48375000426,2108,1324,453,682,117,57,39,2,871
48453000335,3869,2933,1589,249,85,41,970,6,1344
48453000326,3462,2528,1280,139,40,29,1032,3,1248
48453000217,5821,4378,1397,2342,303,205,266,12,2981
48453000223,2570,1974,402,1284,255,92,29,1,1572
48453000224,1679,1121,138,868,69,40,44,0,983
48201000763,3020,2134,165,1874,47,62,33,1,1969
48355000010,1436,1123,679,412,10,12,2,4,444
48355000096,1521,1200,152,1010,32,18,1,2,1048
48029004195,7,7,4,1,2,0,0,0,3
48029002140,3468,2526,465,1540,369,79,140,26,2061
48029001024,5007,3811,698,2671,300,98,150,16,3113
48453000140,5445,4041,834,2572,542,282,96,11,3207
48183000018,4687,3723,1677,548,1412,98,26,2,2046
48041000038,750,533,37,237,256,13,2,1,496
48041000062,0,0,0,0,0,0,0,0,0
48041000064,0,0,0,0,0,0,0,0,0
48453000323,3513,3205,1886,603,175,81,467,15,1319
48453000345,8,8,0,5,0,0,3,0,8
48453000363,1978,1555,1182,229,36,34,77,1,373
48453000454,3466,3022,1924,765,177,108,75,9,1098
48029003126,2863,2035,1021,831,42,53,116,6,1014
48029003012,1616,1220,714,372,47,38,57,2,506
48029003128,86,68,48,12,4,1,3,0,20
48029003021,2911,2140,1818,238,11,23,49,2,322
48029004163,3210,2331,583,844,761,66,133,14,1748
48029004196,0,0,0,0,0,0,0,0,0
48351000015,572,436,360,8,53,12,1,0,76
48201000772,6199,4681,3202,520,212,91,665,8,1479
48201000187,921,693,23,661,15,21,1,0,670
48231000211,912,702,512,128,23,29,14,0,190
48201000532,2349,1727,725,620,314,50,48,6,1002
48201000202,2868,1941,86,637,1240,31,15,1,1855
48201000929,0,0,0,0,0,0,0,0,0
48041000063,7337,6219,4641,871,317,145,235,12,1578
48423000056,5178,4386,3080,429,603,120,151,3,1306
48029004160,4335,2914,442,1633,781,79,93,13,2472
48029004188,0,0,0,0,0,0,0,0,0
48029002035,1606,1425,664,690,38,39,27,1,761
48029003204,4,4,4,0,0,0,0,0,0
48113003307,5504,3695,935,1823,821,114,66,6,2760
48113001119,4249,3226,139,2114,951,120,19,2,3087
48029002114,5527,3959,681,2923,311,151,52,9,3278
48029001048,3996,2918,255,2623,35,63,12,3,2663
48029002076,3474,2629,913,1433,158,112,94,8,1716
48029003141,3010,2363,656,1351,233,79,97,15,1707
48029003119,6743,5400,2360,2309,431,197,244,24,3040
48029004190,19,15,5,3,5,5,2,0,10
48029004150,3066,2316,544,964,716,80,94,12,1772
48029004189,1766,1205,267,580,334,46,41,2,938
48029004109,2567,1739,412,695,547,39,109,4,1327
48029004191,23,13,0,5,11,4,1,0,13
48029004110,1963,1588,652,787,106,41,39,8,936
48029004178,8,7,0,3,1,1,1,2,7
48029004183,80,71,35,36,1,0,0,0,36
48029004184,26,26,0,25,0,0,1,0,26
48029001018,4626,3516,237,3211,43,147,28,9,3279
48029002056,2438,1878,240,1597,18,44,15,2,1638
48201000752,3252,2440,946,1251,150,49,83,2,1494
48225000022,386,338,236,39,52,7,0,0,102
48201000633,5486,4218,2448,707,483,83,485,8,1770
48201000168,995,751,22,319,411,19,0,1,729
48201000363,12473,9374,2230,3550,3365,165,184,36,7144
48201000960,3557,2569,343,673,1406,77,153,3,2226
48029003142,1254,1080,372,495,129,5,94,2,708
48029002037,1945,1571,643,752,85,48,94,2,928
48113001027,8276,6115,1450,1281,2186,103,1186,21,4665
48029002155,0,0,0,0,0,0,0,0,0
48029002138,2185,1706,436,1055,165,64,51,3,1270
48029003093,6875,4963,2635,1433,255,107,578,19,2328
48029003129,4489,3539,1231,1799,185,95,320,3,2308
48029003134,4147,3462,1091,1750,398,81,208,18,2371
48085000008,5813,4333,2545,1536,76,170,48,4,1788
48085000095,4495,3253,1792,372,403,81,633,3,1461
4803700008B,5168,3989,2901,195,710,133,33,12,1088
48201000132,2885,2234,31,330,1881,25,11,1,2203
48363000012,575,474,393,62,5,18,2,0,81
48387000014,305,244,212,9,7,9,3,0,32
48029001021,3139,2240,145,2062,24,72,11,7,2095
48029002028,3346,2733,602,2016,96,106,35,5,2131
48029003140,669,487,105,347,26,21,15,0,382
48029003074,3122,2602,1543,850,93,53,90,9,1059
48029003176,76,48,19,13,3,2,11,0,29
48387000011,205,171,161,6,2,2,0,0,10
48029001051,3743,2834,460,2301,54,72,18,2,2374
48029004062,1400,987,167,615,201,30,4,0,820
48029004164,3394,2657,1365,896,214,63,111,31,1292
48029004116,77,56,25,13,10,3,8,0,31
48029003083,2573,2071,1091,784,96,58,55,5,980
48309000091,2421,1879,1553,157,92,56,33,1,326
48201000782,3230,2526,1320,667,275,63,208,4,1206
48201001002,9545,6409,317,4390,1433,156,314,9,6092
48201000565,8509,5789,133,4155,1245,166,337,6,5656
48201000580,1502,1187,67,319,792,10,9,6,1120
48201000415,3208,2602,1963,329,147,79,90,1,639
48293000403,541,433,324,49,42,6,6,2,109
48085000132,4176,3425,2066,443,474,74,389,4,1359
4822300004A,2934,2178,1503,448,133,57,26,4,675
48387000020,211,179,107,25,46,2,2,0,72
48201000319,3925,2814,80,1311,1435,79,19,3,2734
48469000029,3463,2669,1678,694,130,33,115,1,991
48223000011,1191,923,815,47,14,31,4,0,108
48029003085,1853,1518,822,542,96,59,41,4,696
48029003192,0,0,0,0,0,0,0,0,0
48029003042,3735,2590,1258,888,134,44,303,14,1332
48029003155,4377,3093,1555,1024,160,69,290,16,1538
48029004119,922,826,392,334,56,26,46,1,434
48029004186,141,108,69,30,4,10,2,0,39
48029004073,3092,2288,794,1358,94,73,10,4,1494
48029004153,339,246,90,140,9,14,2,0,156
48029002077,3297,2553,850,1450,144,107,81,12,1703
48045000003,348,273,194,61,3,14,1,0,79
48013000010,2609,1974,594,1276,31,67,25,3,1380
48347000032,6267,5724,3627,974,889,126,140,3,2097
48347000031,1084,1020,693,183,111,11,29,1,327
48159000302,1477,1108,878,135,19,40,16,3,230
48159000202,1681,1226,754,241,197,47,8,3,472
48097000009,2187,1739,1525,98,4,82,6,1,214
48097000006,804,611,550,40,1,14,1,0,61
48085000133,4742,3386,1737,553,665,111,322,3,1649
48029002159,308,232,62,131,15,8,26,2,170
48029003089,6042,4630,2849,1430,141,111,142,15,1781
48309000069,2479,1908,1569,178,67,63,15,4,339
48061000084,3171,2315,447,1782,31,49,43,3,1868
48061000056,4237,2909,552,2174,55,44,121,1,2357
48333000004,376,317,263,33,4,17,2,0,54
48327000006,102,90,83,7,0,0,0,0,7
4832500002A,3949,2821,1153,1225,316,82,77,9,1668
48167000301,2024,1533,545,389,524,26,70,1,988
48305000013,228,172,143,23,0,6,0,0,29
48305000010,35,22,17,3,0,2,0,0,5
48113002014,598,478,410,26,9,9,19,0,68
48113002036,3112,2631,2022,265,123,49,120,9,609
48085000093,403,315,274,28,4,10,1,0,41
48085000185,91,61,59,2,0,0,0,0,2
48113002513,4164,3298,1443,454,564,50,799,0,1855
48085000100,94,69,13,39,8,8,8,1,56
48167000170,3871,2918,2117,438,156,105,132,6,801
48049000316,290,250,227,19,0,4,0,0,23
48113001049,4306,3335,1804,640,747,60,118,5,1531
48157001128,4777,3562,2265,413,280,48,558,2,1297
48339000065,8523,6519,4520,1614,104,272,50,9,1999
48347000030,1060,902,408,134,324,29,10,0,494
48157004086,5214,3879,571,400,636,32,2264,8,3308
48195000003,389,300,185,105,0,9,0,1,115
48273000022,1673,1423,409,839,85,34,79,2,1014
48187000108,1139,922,550,334,21,14,9,0,372
48127000006,1365,1016,122,863,14,23,14,4,894
48439003157,4688,3469,1918,829,519,85,105,35,1551
48439002314,4560,3700,2656,421,328,99,224,10,1044
48439003192,1338,1110,809,129,95,35,50,2,301
48439002319,3448,2695,1838,375,262,94,151,9,857
48439001472,419,396,319,42,15,0,20,0,77
48119000010,534,438,390,18,16,12,3,3,48
48119000001,1006,764,694,28,18,19,2,1,70
48245000063,1724,1282,68,145,1048,16,8,3,1214
48439004124,1389,1179,834,234,26,46,44,2,345
48439004573,19,16,3,3,8,1,0,0,13
48439004596,295,211,28,114,1,4,65,0,183
48439003385,3587,2769,2208,194,66,78,209,7,561
48297000011,1389,1352,215,958,172,6,0,0,1137
48127000007,1001,752,144,596,4,4,9,0,608
48187000306,5091,3920,2197,923,571,89,201,5,1723
48439002318,2720,2208,1388,426,271,82,79,2,820
48439002600,0,0,0,0,0,0,0,0,0
48439001021,3791,3039,2341,391,130,91,81,0,698
48255000008,224,171,126,40,2,2,0,0,45
48329000410,2416,1631,1207,289,23,46,58,2,424
48255000002,191,169,144,23,3,1,1,0,25
48491000152,4677,3772,2118,768,459,119,341,14,1654
48287000203,578,455,376,51,18,11,2,1,79
48349000305,1003,733,485,158,34,32,13,13,248
48329000405,4673,3505,2035,957,236,91,213,4,1470
48077000011,1206,976,864,68,3,29,4,1,112
48491000185,2245,1672,1041,277,95,49,240,9,631
48201000289,3790,2743,340,2317,63,108,37,4,2403
48001000005,405,325,274,24,11,12,1,0,51
48273000021,602,502,42,456,1,6,4,0,460
48453000321,801,702,566,54,18,10,60,2,136
48453000254,7037,5612,2621,635,254,95,2003,3,2991
48453000360,6316,4990,3118,1060,224,157,472,18,1872
48349000109,741,529,292,194,22,10,4,0,237
48365000028,3231,2541,1875,280,319,60,29,3,666
48149000021,313,243,215,21,4,3,0,0,28
48001000017,1371,1082,698,191,168,24,4,0,384
48149000026,803,651,456,83,102,13,1,0,195
48113002029,2108,1636,1486,67,7,23,44,2,150
48149000023,271,225,215,9,0,1,0,0,10
48245000018,2458,1653,47,65,1540,7,10,3,1606
48113004055,6714,4915,311,3415,1000,195,156,14,4604
48113001061,1690,1438,1074,222,60,48,34,3,364
48113003100,3462,2530,474,532,1467,41,57,6,2056
48113004082,2841,2592,863,801,775,78,170,0,1729
48113002059,1961,1409,917,151,291,31,24,2,492
48113001041,2400,1770,225,332,1178,49,18,1,1545
48201001010,2930,2019,160,986,718,44,182,2,1859
48201000607,3163,1931,57,629,1245,67,26,0,1874
48113004026,402,293,20,222,48,5,6,0,273
48029004155,3435,2909,843,1902,79,137,47,6,2066
48029003116,2069,1691,573,991,44,67,61,5,1118
48113002013,1520,1179,967,95,5,18,95,2,212
48337000014,337,268,237,6,3,17,2,2,31
48113002220,2292,1578,1397,61,17,29,72,0,181
48113001016,329,298,228,39,17,8,10,0,70
48343000203,1546,1189,777,118,251,36,11,4,412
48337000008,1052,855,766,41,9,32,1,0,89
48385000007,70,58,42,12,1,2,1,1,16
48157004084,2214,1696,649,197,71,20,753,4,1047
48171000006,831,698,528,153,4,14,1,0,170
48373000011,612,471,295,55,107,10,5,0,176
4841100003B,588,416,226,176,0,12,2,0,190
48407000008,1651,1358,1108,79,114,44,14,0,250
48497000020,1775,1351,1170,104,13,56,6,3,181
48113001501,4109,3045,1598,889,308,69,212,1,1447
48113004005,2656,1995,462,1246,167,68,116,2,1533
48113004094,930,724,156,479,48,15,27,3,568
48113002001,65,57,7,47,3,5,0,0,50
48113002057,689,519,405,54,13,13,35,0,114
48113002410,3866,3105,1196,1141,586,105,141,13,1909
48339000062,3547,2784,2148,295,91,31,186,4,636
48339000058,2995,2273,1922,185,27,32,98,2,351
48157003009,3533,3028,2010,251,137,28,595,2,1018
48245000028,1164,924,311,73,527,13,10,1,613
48113001055,2542,1829,234,1439,100,61,40,1,1595
48113001054,3920,2972,729,1874,179,91,170,4,2243
48113003035,3232,2297,55,872,1357,36,7,1,2242
48057000022,838,613,273,331,3,3,2,0,340
48339000079,3523,2716,1870,480,186,76,120,6,846
48339000049,3240,2417,1770,401,57,62,124,1,647
48309000018,1905,1702,994,284,243,50,151,9,708
48139000146,4559,3335,1800,898,513,107,47,3,1535
4850500001A,149,107,5,101,2,0,0,0,102
48387000010,305,223,207,9,1,2,1,0,16
48449000003,1096,857,566,196,66,28,4,0,291
48113003051,1261,945,31,277,641,15,1,1,914
48113003613,1054,790,192,206,391,12,0,2,598
48113001005,3224,2779,1452,567,599,78,118,4,1327
48439001103,1881,1563,999,296,185,60,39,1,564
48497000003,1127,857,739,87,3,19,3,0,118
48439003200,3877,3125,2031,427,361,80,224,35,1094
48439001146,4050,3095,1221,603,1130,78,102,4,1874
48201000239,2658,2050,33,605,1426,40,10,7,2017
48201000832,1560,1062,98,764,175,51,30,0,964
48201000156,4878,4025,288,676,2957,57,106,0,3737
48201000724,1761,1334,583,180,87,39,445,3,751
48441000305,3964,3186,2473,395,164,41,101,5,713
48439001127,2373,1790,78,567,1115,32,32,7,1712
48439003247,4387,3205,1321,594,1099,76,110,60,1884
48113003023,1939,1506,31,328,1134,25,0,0,1475
48113003042,2699,1864,13,756,1081,39,7,1,1851
48113004017,584,531,353,98,62,7,16,1,178
48141000078,1879,1609,84,1487,16,34,19,2,1525
48113002306,2157,1667,789,707,54,71,90,5,878
48113001002,4306,3272,442,1464,1113,114,248,18,2830
48113001126,3776,2699,278,1156,810,80,456,3,2421
48073000023,1340,1025,921,58,20,22,1,1,104
48439003039,2355,1741,1418,102,47,32,121,7,323
48439003728,3974,2749,1633,168,100,43,805,2,1116
48439003470,267,195,99,64,7,11,23,2,96
48201000372,2315,1708,93,614,855,54,169,0,1615
48201000819,202,157,93,29,20,5,15,0,64
48201000974,0,0,0,0,0,0,0,0,0
48201000180,4871,3556,113,951,2482,79,25,0,3443
48439002316,3163,2707,1285,422,682,76,288,10,1422
48439002055,2690,2232,1421,281,358,56,134,0,811
48439001440,4802,3363,536,1455,1176,111,187,6,2827
48337000006,1489,1089,904,102,4,61,12,2,185
48439001095,942,766,694,37,4,11,13,0,72
48439003526,1642,1225,924,73,37,26,152,4,301
48439002360,5061,3898,2734,409,488,97,205,4,1164
48113003617,3882,2856,158,319,2333,34,33,0,2698
48113003602,689,590,70,37,460,8,23,1,520
48285000017,381,322,289,22,4,5,0,0,33
48439003527,3522,2745,2062,340,123,95,112,8,683
48439002536,2832,2358,1046,356,664,43,244,13,1312
48439002467,5153,4265,1523,757,1759,98,214,11,2742
48441000109,421,326,285,18,9,11,1,0,41
48439003072,3497,2718,2203,177,74,61,194,8,515
48439001460,7568,5579,1023,1065,3289,123,178,21,4556
48439003582,108,85,41,26,4,11,9,0,44
48439002556,2526,1986,1451,210,166,50,119,4,535
48441000104,3281,2535,2113,229,91,61,45,1,422
48113002309,3801,3397,990,488,777,45,1117,3,2407
48439002280,2363,2026,1352,253,308,39,105,5,674
48439003177,3323,2664,2117,265,105,79,109,6,547
48113003210,3768,2863,836,1060,835,95,91,9,2027
48113001019,3483,3053,2207,460,149,104,154,10,846
48439001459,3571,2532,554,908,919,52,166,5,1978
48439003542,3533,2703,1911,400,116,67,208,10,792
48201000579,4368,3086,180,1896,979,100,40,17,2906
48201000692,5408,4396,3018,699,358,115,180,4,1378
48439003695,6326,4189,2741,556,286,101,494,11,1448
48201000281,3086,2127,1493,199,123,21,281,3,634
48439002553,2809,2089,610,783,502,63,161,10,1479
48439002171,4150,3139,2195,522,251,103,75,6,944
48243000003,428,357,227,120,1,6,4,3,130
48243000002,382,314,201,106,2,5,6,4,113
48201000105,6232,4454,275,4022,128,200,37,1,4179
48201000910,571,424,53,357,11,8,1,0,371
48201000909,66,43,3,40,1,2,0,0,40
48149000024,339,279,252,24,1,4,0,0,27
48049000215,304,269,244,8,8,11,0,0,25
48215000234,3256,2390,51,2324,15,24,3,0,2339
48201000051,2676,2146,1396,627,31,55,46,4,750
48453000448,10232,7532,1359,5375,583,251,201,17,6173
48113003065,3826,2773,65,927,1777,108,11,1,2708
48439001292,4292,3144,548,1303,1132,80,150,1,2596
48355000115,3279,2622,957,1312,183,74,123,20,1665
48201000564,7897,7164,1923,846,1766,103,2588,17,5241
48215000242,120,83,7,73,1,2,1,0,76
48215000130,3044,2170,218,1933,3,16,7,0,1952
48201000323,5619,4115,999,2515,516,99,87,3,3116
48201000602,2336,1744,881,277,203,55,341,9,863
48201000828,2547,1919,1471,222,66,56,100,0,448
48055000400,87,69,43,24,1,1,2,0,26
48201000524,7462,5450,752,2581,1479,191,650,5,4698
48225000018,177,143,90,10,36,6,1,1,53
48419000003,421,309,263,33,4,5,3,0,46
48201000891,2924,2502,1177,339,429,22,558,5,1325
48201000017,2055,1625,457,650,291,55,223,2,1168
48201000291,2481,1776,662,806,180,81,112,3,1114
48455000009,744,574,511,23,26,18,3,2,63
48201000407,7186,5694,2277,2211,415,170,741,10,3417
48201000449,507,314,6,27,276,0,4,1,308
48201000087,3831,2752,2077,209,42,35,373,1,675
48201000906,29,23,19,0,0,0,4,0,4
48201000792,3947,2881,162,2229,455,106,37,12,2719
48453000340,5160,4889,3628,650,132,75,364,16,1261
48201000472,1804,1398,791,145,62,17,371,0,607
48201000232,2682,1919,1231,214,83,25,362,5,688
48423000004,4498,3150,971,1640,462,89,13,5,2179
48225000008,461,390,347,12,15,10,3,0,43
48225000016,399,329,277,24,4,13,4,1,52
48355000029,5126,3822,1548,1806,142,103,262,7,2274
48029004014,820,663,58,576,18,27,5,1,605
48201000497,4353,3149,155,1182,1783,69,20,14,2994
48201000586,8551,6207,2271,2363,1275,204,180,29,3936
48201000799,417,290,25,152,96,32,9,14,265
48201000346,3,1,0,1,1,0,0,0,1
48029004084,1411,1040,158,632,261,22,14,4,882
48029004127,212,141,27,84,31,3,1,0,114
48029004167,166,138,44,85,2,2,4,2,94
48201000874,4561,3466,2246,705,269,104,170,9,1220
48201000713,4310,3246,950,984,786,63,478,5,2296
48201000236,3664,2626,29,1377,1232,79,8,5,2597
48201000583,2298,1701,42,625,1038,23,7,3,1659
48201000759,4678,3597,1374,1070,465,92,653,7,2223
48141000174,5,5,0,5,0,0,0,0,5
48141000081,736,567,6,559,0,9,4,0,561
48141000006,3160,2360,850,1416,40,55,37,8,1510
48201000847,7037,4733,507,2397,1687,138,136,17,4226
48333000011,285,201,180,12,5,4,0,0,21
48113004003,4659,3057,215,2660,101,161,65,5,2842
48037000007,6117,4552,2819,260,1247,154,67,3,1733
4803700005A,409,308,173,19,111,8,0,1,135
4803700002B,1005,667,212,48,373,18,10,2,455
4803700004D,139,100,44,26,23,4,4,0,56
48201000306,2092,1718,1250,155,48,33,217,3,468
48201000136,2752,2283,277,193,1756,35,74,7,2006
48201000357,5680,4040,2747,750,189,115,241,8,1293
48085000119,6680,5235,2931,294,277,71,1638,6,2304
48453000333,6189,4475,2369,607,225,107,1182,12,2106
48309000034,1867,1507,1140,223,104,30,14,1,367
48029002036,1917,1624,978,537,39,46,51,3,646
48309000004,147,136,85,27,18,5,1,0,51
48309000028,1855,1406,747,363,257,58,19,6,659
48029003120,5039,3906,1810,1676,192,139,162,14,2096
48029004013,1576,1253,123,1082,32,44,5,2,1130
48113004006,1853,1434,768,531,60,53,53,3,666
48113004095,99,77,22,49,5,0,1,0,55
48113004096,160,154,149,2,1,1,0,1,5
48469000017,1576,1063,389,531,115,28,12,0,674
48199000017,1620,1207,1110,37,9,39,10,3,97
48201000441,2380,1744,1182,217,36,42,274,3,562
48201000390,5734,5551,1604,983,1506,15,1462,37,3947
48389000002,1369,1023,121,862,22,7,9,1,902
48031000304,375,324,265,36,2,16,2,1,59
48381000220,2991,2225,1659,406,72,80,17,0,566
48167002801,0,0,0,0,0,0,0,0,0
48201000299,6127,4318,602,3164,467,184,80,4,3716
48303000018,2408,1933,930,771,164,92,22,3,1003
48303000040,2006,1526,114,630,773,26,11,2,1412
48303000008,4579,4182,2300,928,461,80,405,16,1882
48201000008,3110,2456,1164,951,197,80,99,7,1292
48201000811,539,414,15,386,12,19,1,0,399
48201000997,5313,3879,462,717,2621,53,99,6,3417
48201000515,3949,3106,2272,321,148,67,303,1,834
48163000005,1047,803,412,360,6,22,2,0,391
48477000413,1024,860,729,74,13,28,3,3,131
48077000013,174,144,128,1,0,8,2,0,16
48077000012,451,366,301,36,3,19,3,0,65
48185000009,456,336,220,40,59,24,5,1,116
48287000402,189,167,69,3,89,7,0,0,98
48303000049,381,375,59,15,190,17,96,0,316
48025000003,10625,9616,2046,5551,1936,37,76,2,7570
48303000114,1383,1010,278,583,94,51,30,7,732
48251000029,1778,1303,1084,117,25,45,13,6,219
48209000123,3182,2378,714,1390,225,81,38,7,1664
48057000016,1911,1491,581,553,26,23,309,1,910
48057000015,420,324,112,196,4,7,6,0,212
48057000002,1564,1154,186,913,44,27,23,1,968
48057000020,273,193,26,146,11,0,9,0,167
48141000102,4389,3315,307,2828,126,92,42,3,3008
48141000137,2790,2214,53,2050,108,40,21,1,2161
48141000033,2334,1899,622,1177,26,38,56,7,1277
48209000238,329,210,113,32,0,5,61,0,97
48209000236,2191,1551,1192,210,39,20,76,4,359
48373000004,2361,1840,1382,244,132,38,27,0,458
48259003060,842,668,531,90,1,21,7,3,137
48259004070,431,359,285,49,3,16,2,1,74
48241000007,1790,1384,570,277,501,19,13,6,814
48203000013,1924,1348,1122,94,64,28,30,1,226
48157002078,1014,793,52,190,222,11,336,1,741
48141000185,905,725,221,434,45,23,19,7,504
48141000061,2540,1875,358,1319,134,50,66,16,1517
48141000079,1727,1274,45,1194,17,44,13,3,1229
48157004127,4269,3360,914,331,546,42,1546,11,2446
48141000155,2115,1652,45,1592,16,16,4,0,1607
48141000075,2192,1803,257,1511,21,39,17,1,1546
48367000410,2994,2286,2004,161,33,60,21,3,282
48057000004,695,509,208,267,10,0,20,0,301
48025000016,1760,1336,474,794,46,9,19,0,862
48141000146,2058,1673,58,1583,31,49,12,2,1615
48449000011,622,422,134,273,6,19,6,0,288
48245000080,394,306,238,45,7,7,7,0,68
48121004015,1754,1507,810,315,215,45,112,1,697
48157002116,2856,2198,61,333,1803,18,18,2,2137
48113003076,0,0,0,0,0,0,0,0,0
48113004542,0,0,0,0,0,0,0,0,0
48113004640,7297,5295,982,1659,1783,167,820,32,4313
48113004629,3946,2853,523,1345,620,94,343,6,2330
48439002358,3388,2640,1789,360,353,83,86,2,851
48113004605,5577,4079,1145,2269,395,171,225,5,2934
48477000414,1030,826,681,98,31,3,3,1,145
48181000407,667,457,272,60,79,33,8,2,185
48439001004,4000,3122,1406,739,818,69,115,3,1716
48245000044,1598,1112,241,560,272,33,34,2,871
48439001445,92,65,21,38,2,8,1,0,44
48201000414,8759,6200,2667,2656,706,175,55,13,3533
48201000278,6757,4803,671,3982,136,123,31,8,4132
48439004400,873,671,333,306,16,22,4,1,338
48439002438,5331,4102,969,1085,1785,68,252,5,3133
48141000132,1031,799,70,674,46,28,25,0,729
48215000013,8781,6650,590,5609,135,102,301,2,6060
48201000312,10599,8615,3047,2263,1747,140,1559,15,5568
48201000004,2509,2009,1416,347,94,54,110,4,593
48293000104,902,794,704,32,17,26,14,0,90
48279000005,810,594,220,368,2,6,2,1,374
48025000008,254,210,124,76,0,17,0,0,86
48141000118,3332,2703,347,2220,102,70,55,1,2356
48141000105,3775,3000,385,2489,104,67,47,6,2615
48141000080,2731,2030,29,1988,18,24,5,3,2001
48407000013,1250,955,564,354,14,16,6,1,391
48439003334,3559,2893,1773,452,442,85,148,25,1120
48439004018,2130,1565,971,464,60,54,34,0,594
48145000302,1747,1663,695,458,506,4,10,1,968
48261000005,45,37,1,36,2,1,1,0,36
48029002061,2015,1563,388,775,117,27,279,6,1175
48355000120,3542,2684,982,1494,104,71,60,4,1702
48355000044,2089,1564,86,1456,22,32,1,0,1478
48355000049,1864,1422,628,713,46,48,10,0,794
48029003132,3373,2834,871,1545,344,62,109,6,1963
48029001009,3048,2077,538,1201,220,75,108,13,1539
48029001027,800,554,118,319,62,18,53,9,436
48029001100,4440,3243,711,2062,334,101,157,16,2532
48355000119,5399,4338,1625,2238,265,142,117,12,2713
48355000025,908,716,324,373,3,18,1,1,392
48453000412,491,380,111,221,27,20,6,0,269
48351000011,711,552,518,7,7,17,2,0,34
48215000072,2057,1555,120,1379,27,28,36,2,1435
48351000018,379,293,277,1,13,2,1,0,16
48355000110,3241,2349,870,1340,56,52,54,2,1479
48201000502,6379,4497,2471,1497,372,171,44,7,2026
48201000988,252,183,112,46,14,9,3,3,71
48201000229,2209,1632,142,1426,50,85,6,2,1490
48201000935,124,75,12,58,4,1,2,0,63
48453000236,4108,3374,2606,393,110,83,187,2,768
48201000147,5910,4279,322,1536,2352,102,61,3,3957
48201000384,4921,3593,641,839,1906,48,207,6,2952
48453000262,7739,6511,3943,1108,306,126,1062,13,2568
48453000247,1106,801,651,78,24,11,28,2,150
48029003195,2945,2621,773,1238,357,38,255,1,1848
48029003058,6314,5554,1913,2625,452,148,544,12,3641
48423000009,774,529,80,276,159,23,6,1,449
48423000022,1726,1568,934,267,392,22,30,4,634
48027000308,5810,4388,2131,946,1064,159,197,20,2257
48227000408,58,52,45,7,0,0,0,0,7
48041000087,0,0,0,0,0,0,0,0,0
48041000053,312,296,194,66,10,13,14,0,102
48029004102,2217,1754,373,890,438,18,61,3,1381
48029004124,5121,4056,564,3078,378,97,39,6,3492
48029003060,2604,2124,993,926,113,69,76,4,1131
48113001082,1254,867,74,709,76,27,2,1,793
48029002098,2733,2027,334,1568,89,68,39,5,1693
48029003071,4087,3357,1216,1726,225,121,199,16,2141
48201000091,4131,3417,1903,677,446,71,351,8,1514
48201000907,584,347,66,52,219,8,10,0,281
48423000043,1238,978,742,134,62,25,11,4,236
48029002135,1648,1214,265,835,77,49,31,2,949
48029002131,846,785,303,392,51,11,41,0,482
48201000857,0,0,0,0,0,0,0,0,0
48201000860,0,0,0,0,0,0,0,0,0
48029001065,4461,3259,595,2621,31,74,13,2,2664
48029003013,2826,2322,913,1181,101,75,96,14,1409
48029002086,5054,3892,1251,2055,245,92,299,19,2641
48113003806,1707,1210,45,123,1045,22,7,0,1165
48029003153,1993,1642,829,563,152,22,86,11,813
48029001113,5119,4117,1234,1982,629,89,295,19,2883
48029003061,3682,2848,952,1520,246,86,109,11,1896
48029002084,4320,3483,1696,1449,163,106,121,13,1787
48029002108,1549,1251,642,525,38,56,34,4,609
48029002099,2714,2126,773,1058,149,58,129,6,1353
48135000312,2556,1871,882,828,95,50,16,4,989
48029002023,3841,2976,309,2578,60,114,19,1,2667
48113002005,1267,987,730,159,40,12,38,4,257
48309000085,1549,1150,463,292,361,29,15,1,687
48201000184,2790,2152,274,1514,340,77,21,2,1878
48201000501,3115,2546,1748,397,160,50,197,0,798
48201000798,889,689,203,421,50,12,12,1,486
48201000714,1056,733,73,629,23,17,6,3,660
48013000011,79,65,40,20,0,3,0,1,25
48029003149,4776,4491,1082,2178,879,148,408,19,3409
48029004092,2698,2086,970,764,285,51,56,7,1116
48029003102,4481,3503,2022,1106,187,77,123,5,1481
48029002130,3147,2432,714,1364,202,91,131,6,1718
48029002141,1957,1500,405,833,136,51,120,6,1095
48201000188,4914,3496,359,3057,41,72,24,2,3137
48461000005,166,117,47,57,4,10,2,1,70
48029003006,1342,1086,534,467,20,42,39,1,552
48029004137,199,158,116,28,3,7,5,1,42
48061000107,922,691,41,646,1,14,3,0,650
48061000049,1409,1156,180,962,7,30,10,2,976
48061000047,2428,1746,97,1634,10,12,4,2,1649
48029002038,1922,1587,501,1000,62,47,24,2,1086
48309000048,1542,1126,273,621,208,26,11,0,853
48327000005,88,71,65,6,0,2,0,0,6
48293000103,894,729,607,46,40,28,2,1,122
48201000234,5901,5282,3850,627,285,53,480,7,1432
48201000491,5779,5079,2553,939,645,73,851,10,2526
48167003311,446,371,160,92,114,11,4,0,211
48041000008,3921,3144,1619,592,480,64,404,8,1525
48389000003,1364,957,208,698,17,13,26,0,749
48177000012,280,200,111,80,3,4,3,0,89
48085000047,3658,2974,1639,759,291,88,236,3,1335
48387000029,169,155,138,7,8,1,0,0,17
48329000407,6003,4526,2342,1596,376,100,171,8,2184
48329000208,1808,1358,550,597,144,36,29,1,808
48285000015,246,206,186,14,3,1,0,0,20
4839100002A,237,201,142,52,4,2,1,0,59
48195000009,195,141,85,48,1,8,0,1,56
48273000044,943,733,135,541,49,18,8,2,598
48439002614,508,332,107,37,172,6,10,2,225
48439003626,1031,898,746,52,34,15,45,3,152
48449000017,1520,1061,191,724,136,39,15,1,870
48491000151,4268,3453,2144,649,253,115,310,11,1309
48439003384,2692,2057,1417,341,127,65,128,8,640
48439003187,2661,2004,1322,406,94,80,103,8,682
48175000041,450,366,301,47,11,9,0,0,65
48439001437,1168,917,445,237,151,29,68,4,472
48439001064,0,0,0,0,0,0,0,0,0
48201000507,17067,12391,239,7777,1388,230,3024,16,12152
48405000004,659,496,301,43,150,5,4,1,195
48009000002,1340,1076,964,61,6,36,14,2,112
48009000010,1088,821,736,49,9,19,10,1,85
48193000015,310,241,195,24,2,17,2,1,46
48479000135,2540,1758,25,1726,3,11,0,1,1733
48405000003,432,363,229,21,111,1,2,1,134
48049000109,394,320,285,17,5,6,6,0,35
48245000065,2345,1842,1425,143,177,17,69,5,417
48113002074,1914,1597,562,213,316,23,489,9,1035
48113002202,2357,1744,1478,99,18,26,117,5,266
48113001095,3529,2459,153,1963,336,104,3,0,2306
48029001070,2528,1840,271,1360,183,34,35,10,1569
4839100004B,154,128,73,52,2,4,0,0,55
48491000160,7994,5800,3235,1026,508,164,894,16,2565
48113003079,2496,1596,271,1121,177,77,12,3,1325
48113001004,2706,2000,1113,239,552,46,70,0,887
48113004606,7614,5461,1283,3669,274,286,147,15,4178
48451000351,481,374,303,45,4,18,3,0,71
48157001087,2733,1902,1183,234,220,27,240,1,719
48157001120,4118,2996,2007,421,220,61,303,3,989
48241000009,2718,2113,1933,57,64,55,8,1,180
48439004532,1578,1321,1139,99,22,44,22,0,182
48439004230,5205,4569,3417,549,328,75,224,10,1152
48439003367,2421,1858,1425,210,91,56,85,1,433
48439002224,3874,3211,1009,551,1414,84,218,7,2202
48497000025,131,114,110,0,0,1,0,0,4
48407000003,1576,1281,991,73,169,41,4,1,290
48409000119,1652,1308,846,347,35,47,30,6,462
48245000002,1659,1252,222,414,594,46,17,0,1030
48241000004,801,701,666,11,3,17,2,2,35
48157002136,481,372,95,80,181,8,9,0,277
48473000309,6106,5955,37,415,5369,23,13,2,5918
48309000049,1076,742,262,358,101,40,9,0,480
48121001015,3801,3055,2250,327,219,87,173,4,805
48339000048,3140,2577,2070,264,43,32,150,3,507
48113001015,5035,4712,3167,896,334,132,243,4,1545
48113001099,210,116,17,91,10,6,0,0,99
48281000001,2994,2343,1577,313,271,112,109,24,766
48185000011,434,331,277,28,11,4,4,2,54
48113003074,2176,1465,89,1186,184,58,3,1,1376
48113004029,104,61,6,44,6,4,1,0,55
48113002040,2236,1628,1408,115,22,23,52,0,220
48439004276,4066,2908,1673,733,300,91,142,11,1235
48439002315,3899,3070,819,456,1528,75,251,15,2251
48201000425,2551,1781,203,1309,187,59,90,2,1578
48201000276,3058,2371,28,493,1854,41,8,3,2343
48201000578,2579,1949,1410,314,65,56,84,4,539
48201001004,1163,916,485,362,30,30,25,2,431
48201000174,4371,3577,2401,370,149,58,607,3,1176
48121003014,3034,2415,1259,376,310,62,425,3,1156
48439001019,2162,1524,224,1110,166,37,14,4,1300
48113001063,3853,2879,584,2028,174,156,44,4,2295
48113002072,3940,2864,2332,258,86,56,117,6,532
48201000327,2625,1966,56,538,1350,36,15,5,1910
48201000427,3305,2416,266,1530,300,54,344,11,2150
48201000797,0,0,0,0,0,0,0,0,0
48121003029,4150,3072,2109,440,204,89,226,2,963
48439001208,2649,2055,1638,176,96,69,87,5,417
48439001719,3917,2991,2223,363,201,101,134,11,768
48201000594,4976,3728,614,1511,1465,97,121,4,3114
48201000615,3786,2916,915,892,840,79,256,5,2001
48439002007,2749,2286,1690,218,218,41,106,4,596
48439001376,4116,4086,1779,761,1577,0,3,0,2307
48201000464,4602,3471,1600,1125,507,73,201,11,1871
48201000373,339,252,8,146,90,15,1,0,244
48201000562,1403,1040,29,745,272,25,5,3,1011
48439003433,839,709,553,65,36,21,32,6,156
48439002468,3434,2698,1562,423,331,71,304,16,1136
48439003391,5875,4669,2092,882,916,127,634,66,2577
48439002383,4348,3192,990,990,938,107,278,9,2202
48439002112,2495,2014,1604,176,104,57,55,3,410
48201000723,3847,2933,256,1242,1034,85,411,3,2677
48201000548,5225,3894,952,1727,835,129,325,13,2942
48439003260,2015,1606,1267,155,75,45,59,1,339
48453000437,2970,2622,1898,445,52,62,159,13,724
48453000341,623,604,458,60,21,5,60,2,146
48113003060,1653,1252,19,164,1064,22,2,4,1233
48453000413,4996,4189,1568,1818,547,117,220,3,2621
48453000418,30,25,3,17,0,1,5,2,22
48215000001,2664,1699,43,1654,0,4,2,1,1656
48113004602,4107,3093,867,1786,163,130,249,1,2226
48113004651,373,251,14,233,5,11,1,0,237
48439001652,800,419,16,45,351,2,7,0,403
48439001555,72,58,9,16,32,3,0,0,49
48439002357,4466,3280,2024,378,599,76,204,11,1256
48355000111,1981,1364,442,852,50,29,8,1,922
48215000012,287,215,4,207,0,4,1,1,211
48215000034,1574,1195,67,1091,8,20,33,0,1128
48215000246,23,23,0,18,1,6,0,0,23
48215000102,1560,1427,828,567,2,14,10,1,599
48439004135,2410,1905,1053,577,170,69,40,1,852
48061000010,3781,2746,48,2691,9,36,3,1,2698
48419000002,1171,889,760,103,10,14,1,0,129
48201000917,158,115,6,88,20,5,0,0,109
48201000846,497,366,35,242,80,8,3,2,331
48201000978,0,0,0,0,0,0,0,0,0
48201000953,20,11,5,6,0,1,0,0,6
48113002045,2651,2096,1463,313,113,50,152,4,633
48201000437,4267,3194,1847,578,412,67,333,1,1347
48201000871,10,1,0,1,0,0,0,0,1
48085000103,2933,2098,696,985,251,92,108,5,1402
48453000234,3374,2401,1800,230,38,41,292,3,601
48201000780,2186,1500,150,1258,53,65,28,2,1350
48029003033,3184,2653,1558,778,119,37,161,9,1095
48453000362,3868,3019,2144,540,78,75,184,5,875
48141000018,4314,3334,1254,1769,125,60,182,11,2080
48201000433,1598,1195,237,632,254,31,81,4,958
48201000559,13317,10593,1697,3081,4901,198,1015,26,8896
48201000422,5387,3987,43,543,3405,61,20,4,3944
48261000002,64,54,13,41,0,0,0,0,41
48113001307,885,618,50,78,486,2,6,0,568
48113001114,2242,1628,95,620,866,94,34,2,1533
48113004044,3107,2157,36,1731,378,71,8,4,2121
48113004109,131,95,1,63,31,0,0,0,94
48085000082,4522,3365,1900,790,380,95,232,2,1465
48085000007,2272,1809,1027,280,252,54,219,0,782
48309000036,1265,1008,810,119,36,27,23,2,198
48309000001,804,658,291,154,164,15,43,1,367
48113003087,0,0,0,0,0,0,0,0,0
48167003301,0,0,0,0,0,0,0,0,0
48037000028,888,731,654,35,6,32,1,2,77
48167000464,4239,3153,2184,515,187,74,194,4,969
48201000310,2621,2218,1098,737,150,73,222,5,1120
48361000007,2566,1925,1406,166,245,55,61,3,519
48303000023,2121,1659,1094,405,126,32,20,2,565
48479000446,6622,4919,135,4751,12,49,20,0,4784
48303000066,3202,2658,2053,304,83,49,141,0,605
48303000025,4213,3039,728,1853,384,111,30,8,2311
48365000010,410,333,212,15,94,16,2,0,121
48009000011,140,109,100,2,0,6,2,0,9
48077000009,675,526,469,26,5,16,9,0,57
48039000062,7585,5454,1874,1424,1646,135,473,14,3580
48189000409,1593,1163,357,698,83,25,11,0,806
48141000048,3324,2575,370,1968,184,65,49,5,2205
48121004024,4254,3233,2557,308,109,108,163,9,676
48479000164,2484,1726,47,1667,12,14,3,1,1679
48157004121,1491,1289,527,215,148,18,379,0,762
48157002138,750,573,48,58,152,24,303,1,525
48367000111,2412,1796,1426,221,38,73,25,3,370
48113003107,3857,2846,295,590,1940,41,39,0,2551
48071000009,565,445,286,67,15,16,58,0,159
48141000024,4725,3801,1244,2308,96,70,139,2,2557
48401000302,1904,1370,564,232,540,16,13,1,806
48141000099,3046,2184,202,1895,48,53,23,3,1982
48147000004,2140,1647,1270,153,167,45,22,4,377
48057000003,211,159,15,137,0,3,4,0,144
48121004026,2465,1730,1117,180,79,29,325,0,613
48113003401,63,31,4,24,4,0,1,2,27
48113001105,154,107,4,81,20,8,1,3,103
48439002317,1687,1354,898,211,104,25,121,0,456
48113001081,4585,3643,1537,1429,520,135,92,14,2106
48245000048,2937,1991,103,1432,379,47,73,0,1888
48141000104,5247,4150,666,3228,204,105,62,5,3484
48455000010,395,323,308,8,1,4,1,1,15
48201000848,2990,2299,433,1025,753,94,60,3,1866
48455000006,286,231,206,10,7,4,0,0,25
48113002901,4101,3559,1293,1160,708,79,342,2,2266
48141000040,1628,1346,147,1164,27,24,6,1,1199
48439003647,6657,4990,3025,720,564,121,574,11,1965
48439003036,4784,3452,1526,965,349,112,388,174,1926
48261000003,45,38,8,30,0,0,1,0,30
48029001004,1785,1335,86,1219,33,41,0,3,1249
48355000057,1376,1074,187,837,41,15,7,3,887
48201000146,3112,2364,1341,520,239,55,209,8,1023
48029003040,2806,2222,1085,915,108,98,76,6,1137
48201000631,5317,3980,1820,1054,669,108,417,7,2160
48113001064,478,327,33,162,126,8,2,0,294
48113001313,583,431,30,178,196,12,28,1,401
48029003163,3738,2748,1477,923,136,75,194,8,1271
48029003037,3887,2946,1199,1349,156,88,222,22,1747
48113003922,151,105,0,50,48,13,3,0,105
48113003013,3396,2276,431,1377,421,116,5,6,1845
48029004174,2563,1906,494,1121,224,68,64,14,1412
48029004169,495,410,240,129,32,12,9,2,170
48085000137,3068,2338,1262,163,170,26,715,7,1076
48309000029,2000,1648,639,473,498,40,39,7,1009
48029002081,1437,1105,165,818,73,61,31,1,940
48029003053,3042,2626,1706,616,129,36,133,10,920
48029003004,0,0,0,0,0,0,0,0,0
48029004071,1897,1552,1153,315,42,46,13,3,399
48029004151,803,639,454,151,5,39,9,3,185
48029004118,117,90,47,35,5,1,2,1,43
48029001075,6333,4260,413,3599,186,78,63,19,3847
48029001076,5222,3835,690,2680,331,120,127,11,3145
48029002055,3116,2946,1780,720,139,51,283,5,1166
48201000744,3130,2416,1353,519,219,76,271,8,1063
48201000295,1411,1061,24,185,841,7,6,1,1037
48293000203,352,274,93,46,128,9,2,0,181
48293000305,409,350,315,20,5,9,1,1,35
48309000040,3087,2457,1630,363,368,74,46,1,827
48437000009,40,32,31,0,0,0,1,0,1
48215000144,94,64,4,59,0,3,1,0,60
48201000687,3724,2988,1369,488,218,43,871,3,1619
48285000007,356,294,270,15,4,3,0,0,24
48149000020,999,823,674,108,23,16,11,0,149
48201000378,3051,2264,1322,612,177,97,98,8,942
4839100004A,561,444,175,252,10,12,4,1,269
48241000001,66,54,47,0,1,2,1,1,7
48339000070,3566,2658,1993,314,55,49,224,4,665
48111000004,85,62,52,10,0,0,0,0,10
48255000006,243,189,176,10,1,1,0,0,13
48149000015,435,365,336,23,4,5,0,0,29
48245000098,1259,963,444,146,151,6,213,1,519
48113004504,2490,1826,431,958,314,83,99,2,1395
48113004642,452,345,76,239,14,7,16,1,269
48029003027,2208,1708,1006,551,45,46,77,7,702
48423000049,612,415,134,150,123,10,2,1,281
48141000144,4315,3258,122,3094,29,95,8,13,3136
48071000013,0,0,0,0,0,0,0,0,0
48245000088,2050,1639,564,218,725,27,110,0,1075
48113001001,2273,1840,483,727,536,63,85,10,1357
48157003041,2632,2015,1377,393,131,45,79,4,638
48113004622,3982,2970,787,1425,419,126,318,16,2183
48201000610,9633,6557,772,5367,200,274,196,13,5785
48201001011,55,39,17,18,1,0,3,0,22
48201000296,3044,2425,593,1208,130,101,478,1,1832
48201000787,1368,982,87,861,26,42,7,2,895
48201000470,2728,1973,1038,781,66,54,30,1,935
48201000683,955,674,59,594,18,25,2,1,615
48439002147,1945,1531,1047,249,150,49,36,1,484
48439003562,183,135,116,11,1,5,4,1,19
48439004495,239,228,84,62,80,1,1,0,144
48439004288,1054,709,27,523,147,26,3,0,682
48439004587,564,407,8,257,139,13,1,2,399
48439001078,1851,1262,74,537,644,5,13,1,1188
48439003196,2739,2226,1764,229,74,67,104,4,462
48439003669,11,8,5,0,0,1,2,0,3
48439002464,569,450,291,55,46,15,48,0,159
48201000538,2063,1545,59,298,1188,40,12,1,1486
48201000646,4631,3598,332,1200,905,67,1179,8,3266
48355000072,2799,2120,356,1674,63,25,21,6,1764
48439002028,1770,1411,1050,166,92,55,51,2,361
48457000005,265,214,164,3,41,7,0,0,50
48201000525,5414,4210,787,767,2348,93,285,6,3423
48315000005,896,745,559,17,142,23,6,2,186
48453000103,2659,2106,995,682,332,64,66,3,1111
48113002809,5466,4373,1834,740,814,107,943,11,2539
48061000071,7634,5304,203,5071,15,79,25,2,5101
48113003616,1294,918,72,285,559,22,5,0,846
48113004631,2288,1786,833,635,141,44,156,5,953
48135000204,2463,1775,912,723,66,71,29,5,863
48201000708,1807,1261,115,1084,46,30,7,6,1146
48201000814,12012,8813,1108,2409,4009,168,1349,13,7705
48201000745,4447,3542,1907,911,362,146,266,3,1635
48303000050,6437,6183,605,134,3431,295,1725,6,5578
48303000119,5526,3956,1695,1669,415,117,157,11,2261
48303000123,2704,2136,1495,427,130,70,34,10,641
48329000107,5268,4070,2373,1035,341,93,215,13,1697
48303000104,1619,1165,814,208,53,19,80,3,351
48039000054,4374,3314,1138,721,884,76,543,5,2176
48139000149,2942,2210,896,1149,121,78,3,4,1314
48479000359,7156,5319,251,4937,52,70,79,2,5068
48113001094,3641,2545,89,1823,637,71,13,2,2456
48171000015,878,775,706,49,1,13,1,0,69
48473000414,852,644,148,326,165,24,3,0,496
48157004047,1143,895,290,74,44,4,487,0,605
48157004079,670,493,176,20,7,4,287,1,317
48439004630,0,0,0,0,0,0,0,0,0
48113003614,1470,1067,91,164,801,21,5,1,976
48211000202,46,42,24,15,1,4,1,0,18
48471000302,1189,893,533,209,123,24,7,4,360
48339000059,2100,1611,1270,155,35,20,123,4,341
48141000149,4089,3228,134,3060,20,61,11,0,3094
48141000027,3373,2714,518,1986,117,47,109,0,2196
48355000112,3306,2652,903,1558,128,50,51,3,1749
48029004060,3586,2634,742,1249,516,78,110,11,1892
48029002151,309,204,22,175,4,6,1,0,182
48355000055,1317,1011,54,943,11,13,2,0,957
48453000336,3033,2197,1360,137,41,32,609,2,837
48041000079,147,103,61,31,10,0,0,0,42
48041000043,1122,1102,388,411,292,2,10,0,714
48453000354,5965,4787,3811,514,90,102,241,7,976
48029002116,0,0,0,0,0,0,0,0,0
48029002024,4262,2986,254,2587,116,91,42,1,2732
48029004106,1591,1038,133,690,189,45,32,4,905
48363000014,279,214,174,32,3,5,3,1,40
48029004111,1227,682,62,208,415,11,11,6,620
48029003051,416,360,277,67,2,6,8,2,83
48029003009,29,18,9,8,0,1,1,0,9
48029002060,2746,2191,344,1683,136,90,35,5,1847
48029004112,915,850,636,142,49,11,15,4,214
48013000002,3358,2377,457,1825,38,114,22,2,1920
48029004085,85,68,42,21,5,1,1,0,26
48029004209,72,46,20,23,3,0,0,0,26
48029004207,0,0,0,0,0,0,0,0,0
48029004208,4,4,3,1,0,0,0,0,1
48309000052,939,853,785,20,20,10,14,0,68
48201000808,1061,1044,545,188,163,8,129,0,499
48469000022,2037,1635,1357,202,23,39,5,0,278
48353000002,1535,1166,843,243,44,31,3,0,323
48029002126,3263,2463,535,1734,116,95,73,5,1928
48029003200,0,0,0,0,0,0,0,0,0
4831100004B,72,57,33,20,1,3,2,0,24
48013000023,2121,1502,388,1076,12,37,11,3,1114
48215000044,3950,2495,54,2426,3,32,6,0,2441
48029002143,3683,2923,847,1663,283,86,102,2,2076
48097000021,1568,1155,1083,29,3,30,5,0,72
48187000123,4,3,0,2,1,1,0,0,3
48193000004,247,194,166,24,0,0,0,0,28
48479000342,4189,3081,175,2825,26,29,46,0,2906
48113001303,513,336,33,124,180,6,2,0,303
48157002093,838,650,136,167,228,19,113,0,514
48189000308,126,89,44,30,13,2,0,0,45
48407000010,706,558,504,43,3,8,2,0,54
48189000206,322,250,17,206,21,6,4,0,233
48241000016,516,399,367,6,7,21,1,1,32
48309000015,398,296,192,87,12,14,2,0,104
48059000002,2760,2192,1849,170,60,66,29,6,343
48113001125,5626,4215,957,1503,1611,76,127,9,3258
48201000861,4636,3368,173,1761,1305,106,147,6,3195
48439003212,3742,3010,1741,377,610,116,176,42,1269
48439001167,2368,1811,963,627,138,56,52,1,848
48439003409,201,144,45,85,6,4,2,0,99
48439004102,3520,2432,746,1418,56,118,151,2,1686
48439004485,1686,1125,240,809,15,54,37,0,885
48439004483,138,110,20,85,1,3,3,0,90
48289000002,441,365,321,29,4,13,1,0,44
48439003327,2059,1698,1233,259,82,52,73,17,465
48439003283,2166,1762,1305,230,55,47,130,6,457
48201000681,257,253,140,53,31,2,26,0,113
48201000815,0,0,0,0,0,0,0,0,0
48465000043,73,61,46,11,1,4,1,0,15
48113003015,704,517,163,307,37,22,3,1,354
48351000017,119,106,22,3,80,0,1,0,84
48439001639,8727,5789,1042,1647,2794,149,293,15,4747
48355000099,1264,974,100,831,42,16,1,3,874
48257000002,2849,2066,1328,601,72,76,12,1,738
48455000015,151,125,115,3,2,2,2,0,10
48201000151,1611,1204,28,602,551,42,21,0,1176
48453000150,2964,2388,1529,506,221,54,73,6,859
48029002010,4015,3084,687,2023,267,96,94,6,2397
48029002078,4382,3249,686,2272,189,113,71,10,2563
48141000187,0,0,0,0,0,0,0,0,0
48201000802,32,26,17,6,2,1,1,0,9
48309000047,723,467,258,111,77,21,10,0,209
48029002124,838,685,243,369,32,11,38,1,442
48037000022,425,340,261,14,57,6,1,1,79
48067000018,759,586,523,16,29,14,3,2,63
48303000017,2183,1694,652,827,162,79,25,2,1042
48039000027,2656,2284,1376,233,314,52,318,3,908
48245000094,2621,2069,1378,190,270,28,201,2,691
48141000141,2602,1990,99,1856,26,60,5,1,1891
48141000083,2580,1967,52,1892,18,27,9,2,1915
48473000311,1419,1078,506,419,109,34,10,2,572
48157002077,3073,2325,163,354,1517,37,279,1,2162
48439003359,2930,2068,1605,108,56,46,249,3,463
48453000305,33,32,5,15,7,7,5,0,27
48355000092,2910,2338,1082,1067,81,72,47,2,1256
48355000073,2370,1815,182,1572,44,54,17,0,1633
48201000355,3236,2352,173,617,1473,75,111,4,2179
48455000020,84,75,51,2,19,4,0,0,24
48029002153,859,664,178,336,105,21,31,1,486
48029003015,1468,1211,458,606,56,44,72,4,753
48029002119,598,478,142,227,66,11,37,0,336
48029001083,4093,3027,820,1836,275,89,90,11,2207
48225000011,157,135,105,2,20,5,2,0,30
48029003114,2808,2182,1511,520,40,50,57,10,671
4803700004C,1213,869,276,66,493,28,15,2,593
48013000016,415,306,115,181,5,3,3,0,191
48029003172,972,737,216,400,43,24,75,4,521
48279000006,552,443,179,244,16,12,1,0,264
48223000025,592,480,385,65,8,16,0,0,95
48157002075,3113,2330,97,591,1546,36,108,1,2233
48189000306,214,142,36,82,17,5,3,2,106
48439003566,0,0,0,0,0,0,0,0,0
48193000005,150,128,116,3,1,4,4,0,12
48215000096,4887,3753,687,2854,55,66,132,3,3066
48215000168,385,307,95,201,9,19,6,0,212
48453000430,2996,2446,1252,913,123,95,109,4,1194
48029002150,30,17,2,12,3,0,0,0,15
48113003019,1487,1157,57,144,944,17,11,2,1100
48157002092,1169,904,303,210,350,12,38,2,601
48113003410,1275,874,111,634,129,32,3,0,763
48113002017,3597,3262,1435,549,873,69,357,0,1827
48201000303,4849,3965,3011,351,179,59,339,6,954
48439002571,0,0,0,0,0,0,0,0,0
48439002246,1405,1173,903,129,66,19,52,0,270
48201000774,1705,1255,251,361,574,24,82,1,1004
48201000446,1201,826,100,679,28,32,17,0,726
48201000921,101,81,0,61,20,0,0,0,81
48201000766,1167,871,52,780,37,20,1,1,819
48355000064,1156,897,583,229,19,33,24,1,314
48355000005,2211,1800,938,759,39,64,21,0,862
48099000103,545,416,321,73,2,15,8,1,95
48439002310,3680,2781,1469,398,738,75,115,2,1312
48201000820,0,0,0,0,0,0,0,0,0
48455000012,159,128,111,9,8,0,0,0,17
48113001730,0,0,0,0,0,0,0,0,0
48113001731,0,0,0,0,0,0,0,0,0
48113001046,473,378,168,132,39,15,22,1,210
48029004170,866,652,192,366,74,17,19,0,460
48029004173,3033,2387,992,954,318,68,87,14,1395
48029001093,2924,2460,738,1195,350,72,146,24,1722
48085000031,2619,2005,1540,164,106,51,165,0,465
48201000859,1708,1286,132,701,434,37,15,1,1154
48201000821,6952,4573,146,3401,1025,87,80,9,4427
48303000112,269,232,181,34,7,5,5,2,51
48485000305,944,729,416,242,39,31,3,2,313
48439003560,0,0,0,0,0,0,0,0,0
48439003653,0,0,0,0,0,0,0,0,0
48439003654,0,0,0,0,0,0,0,0,0
48439003471,2303,1705,1411,117,50,38,84,0,294
48201000288,2484,1939,33,297,1610,10,2,4,1906
48439002680,0,0,0,0,0,0,0,0,0
48355000053,1423,1088,129,926,34,22,3,0,959
48041000019,954,670,137,439,78,28,12,1,533
48041000033,4054,3528,1791,871,593,52,302,3,1737
48029002106,1479,977,192,693,64,39,21,0,785
48029003080,1624,1347,687,539,51,34,44,9,660
48029004097,4251,3068,1215,1179,462,86,215,25,1853
48029003035,1186,977,426,378,51,36,121,6,551
48029004139,22,16,4,8,4,7,0,0,12
48041000082,464,354,314,29,0,0,3,0,40
48029003107,2783,2211,821,1081,191,56,112,9,1390
48177000014,168,119,70,32,2,8,1,0,49
48201000693,1343,1012,206,363,403,21,46,1,806
48333000006,272,220,176,28,0,10,1,1,44
48439001351,0,0,0,0,0,0,0,0,0
48439001628,0,0,0,0,0,0,0,0,0
48201000092,2945,2291,1693,284,71,61,190,1,598
48201000535,927,676,87,580,10,21,2,0,589
48141000021,2752,2260,822,1317,46,66,62,4,1438
48141000177,828,708,256,415,16,17,17,0,452
48057000014,299,236,78,141,14,6,4,0,158
48113002054,7401,6039,1643,2327,1572,129,456,17,4396
48113003010,852,703,343,79,129,11,130,1,360
48113001122,915,856,327,194,254,20,75,1,529
48439001491,20,13,8,4,3,0,0,0,5
48113003603,278,235,68,18,143,4,4,0,167
48201000986,2176,1364,46,791,543,23,3,0,1318
48201000985,525,434,216,68,110,9,42,1,218
48201000490,3868,2974,754,835,1181,92,211,1,2220
48201000592,4342,3062,147,1987,451,141,471,8,2915
48439001514,0,0,0,0,0,0,0,0,0
48201000816,135,98,14,81,3,6,0,0,84
48201000313,112,84,10,57,11,8,8,0,74
48453000231,3553,2829,2259,234,53,30,248,0,570
48029003104,3463,2819,1642,863,174,92,92,8,1177
48029002104,475,350,33,306,9,12,7,0,317
48029003016,248,195,107,83,4,3,2,0,88
48029003113,2176,1860,666,936,153,63,79,2,1194
48387000030,209,164,148,3,10,3,0,0,16
48157004111,2123,1604,737,264,141,34,437,5,867
48201000855,156,104,0,54,32,10,21,0,104
48439003624,568,380,194,13,16,1,158,1,186
48201000761,2262,1723,1273,184,49,28,200,0,450
48355000050,899,710,200,448,44,20,17,0,510
48355000113,1001,741,53,604,86,9,4,0,688
48029002139,2663,2072,663,1174,147,75,87,11,1409
48029004099,2395,1851,499,1182,110,63,43,1,1352
48045000006,124,86,63,23,0,0,2,0,23
48141000023,1931,1564,585,901,39,30,41,2,979
48071000002,1016,783,406,96,231,15,11,0,377
48057000013,78,53,14,29,5,1,5,0,39
48057000010,253,213,109,94,1,1,8,0,104
48113002403,40,20,3,8,5,4,6,0,17
48113003400,1333,996,185,368,411,41,31,1,811
48113004059,1155,735,38,443,214,9,43,1,697
48113004027,776,543,7,527,12,13,4,1,536
48201000150,3059,2089,34,654,1406,19,4,2,2055
48201000461,7964,6247,3244,893,727,98,1304,2,3003
48201000191,7021,4664,449,3941,238,121,9,3,4215
48113004603,224,151,22,125,4,2,0,0,129
48395000013,230,176,166,9,0,0,0,0,10
48085000145,2372,1726,892,176,261,27,375,1,834
48395000018,120,96,89,5,1,0,1,0,7
48365000026,206,152,111,6,33,3,0,0,41
48113004012,127,98,46,38,9,1,4,0,52
48113004098,51,37,26,4,0,0,4,0,11
48201000365,1445,1204,201,165,805,20,21,0,1003
48365000008,335,243,207,6,27,1,3,0,36
48453000415,1827,1494,842,516,40,58,70,2,652
48029004152,3707,2748,802,1321,545,120,64,18,1946
48029004055,2283,1878,913,696,188,68,67,5,965
48201000702,1269,927,12,775,141,53,5,1,915
48029003029,1605,1324,538,614,51,42,94,4,786
48029003090,4718,3814,1843,1446,304,128,166,10,1971
48201000625,3026,2449,1232,466,418,49,306,0,1217
48201000829,125,94,47,28,15,8,9,1,47
4839700002B,2771,2183,1370,326,293,70,141,3,813
48439001236,1075,860,489,226,108,25,20,0,371
48439001420,0,0,0,0,0,0,0,0,0
48439003539,34,27,17,1,1,0,5,0,10
48439001473,382,260,59,189,4,10,6,0,201
48113001724,401,254,59,74,116,5,7,0,195
48355000042,545,457,276,150,19,15,9,0,181
48439002601,0,0,0,0,0,0,0,0,0
48029004125,258,208,51,81,70,5,4,0,157
48029002145,503,389,115,221,18,8,31,0,274
4803700004E,0,0,0,0,0,0,0,0,0
48113003618,801,606,38,99,443,18,16,1,568
48439001241,1282,849,202,161,350,30,118,0,647
48355000068,1921,1436,191,1202,27,31,6,1,1245
48363000011,551,430,340,72,4,8,3,0,90
48339000004,3314,2627,1681,490,258,62,127,7,946
48057000017,1150,898,409,348,39,25,92,0,489
48423000065,162,141,60,17,56,8,1,0,81
48201000566,8161,6440,1112,2521,2077,142,783,9,5328
48113003402,1368,907,152,524,216,32,6,0,755
48395000008,284,252,242,8,0,1,0,0,10
48439004362,17,11,5,6,0,1,0,0,6
48013000009,224,180,139,33,1,1,5,0,41
48439002513,0,0,0,0,0,0,0,0,0
48439002403,255,189,37,81,78,7,6,0,152
48029003030,2782,2202,1477,547,61,33,113,5,725
48201000749,1320,952,60,498,368,16,54,2,892
48201000791,60,45,6,29,7,3,0,0,39
48423000048,1879,1303,388,758,132,42,7,0,915
48029003073,2105,1727,803,662,97,32,160,7,924
48029004090,4099,3066,1154,1149,529,105,212,38,1912
48029003166,875,722,246,395,50,10,29,3,476
48029003111,0,0,0,0,0,0,0,0,0
48029003147,3566,2856,1111,1340,178,82,230,16,1745
48439004399,343,290,216,44,15,2,11,1,74
48113003619,1079,699,142,393,164,33,1,0,557
48201000374,1288,992,60,901,28,20,5,1,932
48457000011,170,131,108,14,0,8,1,0,23
48085000136,2776,2375,1536,290,298,59,204,0,839
48201000317,4030,3022,569,859,1427,56,185,7,2453
48157002043,2093,1551,208,551,391,35,402,0,1343
48465000012,726,551,78,422,39,10,13,1,473
48041000056,15,15,15,0,0,0,0,0,0
48041000028,477,368,319,26,2,15,7,0,49
48113001725,635,553,347,136,46,31,4,3,206
48201000838,0,0,0,0,0,0,0,0,0
48439002606,44,28,10,9,6,3,0,0,18
48439001151,2565,1916,598,273,951,34,70,2,1318
48439002258,1328,999,580,316,80,26,11,0,419
48423000070,781,610,428,78,82,21,11,1,182
48245000099,1479,1255,459,108,620,11,65,1,796
48029004103,13,10,4,4,0,1,1,0,6
48029004121,462,362,178,159,11,12,2,1,184
48029001002,1039,777,141,504,85,25,52,5,636
48029001090,0,0,0,0,0,0,0,0,0
48113001080,2463,1815,193,653,952,35,10,1,1622
48113001028,3971,2919,598,651,1365,41,296,3,2321
48201000556,6620,4840,277,2312,1470,133,774,9,4563
48201001000,1112,843,29,470,275,17,76,0,814
48029002129,0,0,0,0,0,0,0,0,0
48187000219,149,118,61,53,2,1,0,0,57
48187000220,177,149,52,71,24,3,2,0,97
48331000203,575,469,372,62,16,11,0,0,97
48439004496,1448,1173,431,340,297,28,80,4,742
48113003036,85,68,7,46,15,4,1,0,61
48387000031,161,138,129,3,0,6,0,0,9
48201000685,395,328,219,69,23,9,13,2,109
48057000021,215,166,101,58,0,3,2,0,65
48263000201,46,31,31,0,0,0,0,0,0
48113001000,3031,2143,232,1062,780,71,60,1,1911
48201000854,383,300,4,208,92,11,0,0,296
48477000117,228,174,42,44,81,7,5,0,132
48029004122,119,92,48,39,2,4,1,0,44
48113003081,1836,1813,1413,156,45,23,163,3,400
48201000837,344,302,142,24,16,5,117,0,160
48201000867,0,0,0,0,0,0,0,0,0
48201000243,708,565,3,70,491,0,0,0,562
48113001086,1698,1159,235,605,293,21,18,1,924
48029003143,2018,1646,628,827,74,45,110,3,1018
48215000143,63,39,0,38,0,0,0,0,39
48057000009,130,88,14,65,0,2,7,0,74
48113004125,0,0,0,0,0,0,0,0,0
48201000833,32,24,0,18,6,0,1,0,24
48157002139,105,82,7,7,34,2,34,0,75
48029002009,6076,4607,1152,1808,651,113,986,16,3455
48029002113,253,170,24,99,23,5,22,0,146
48201000737,71,61,21,31,9,1,0,1,40
48041000044,170,125,95,24,2,1,0,0,30
48029003133,0,0,0,0,0,0,0,0,0
48029003171,0,0,0,0,0,0,0,0,0
48029004177,54,37,0,37,0,0,0,0,37
48201000167,32,25,4,21,0,0,0,0,21
48201000870,0,0,0,0,0,0,0,0,0
48201000735,1515,1123,561,287,150,19,93,2,562
48439003584,0,0,0,0,0,0,0,0,0
48439004572,63,41,2,24,15,2,0,0,39
48113003025,1402,868,2,765,106,11,1,0,866
48029003156,7,0,0,0,0,0,0,0,0
48113001042,3934,2954,264,556,2069,61,70,8,2690
48201000361,2849,2831,977,510,227,7,982,1,1854
48201000675,0,0,0,0,0,0,0,0,0
48355000052,1319,995,99,836,54,17,3,4,896
48201000457,0,0,0,0,0,0,0,0,0
48029002109,0,0,0,0,0,0,0,0,0
48301000002,1,1,1,0,0,0,0,0,0
48439003580,0,0,0,0,0,0,0,0,0
48439003447,0,0,0,0,0,0,0,0,0
48439003583,0,0,0,0,0,0,0,0,0
48439004629,0,0,0,0,0,0,0,0,0
48201000371,842,642,9,171,463,21,1,0,633
48201000869,2217,1437,63,770,566,9,67,2,1374
48113003406,99,77,24,45,5,2,0,0,53
48113001077,0,0,0,0,0,0,0,0,0
48439001430,28,21,2,11,7,0,1,0,19
48439001564,0,0,0,0,0,0,0,0,0
48287000301,210,163,133,18,8,5,0,0,30
48029004182,0,0,0,0,0,0,0,0,0
48201000778,0,0,0,0,0,0,0,0,0
48439001547,0,0,0,0,0,0,0,0,0
48201000865,21,15,0,4,11,0,0,0,15
48113004540,0,0,0,0,0,0,0,0,0
48029002096,5208,4286,1344,1948,512,82,495,13,2942
48113004121,0,0,0,0,0,0,0,0,0
48121001014,674,627,349,116,113,14,43,0,278
48029004035,37,26,15,8,2,3,1,0,11
48439002419,0,0,0,0,0,0,0,0,0
48439004458,0,0,0,0,0,0,0,0,0
48439002609,0,0,0,0,0,0,0,0,0
48041000068,0,0,0,0,0,0,0,0,0
48201000856,0,0,0,0,0,0,0,0,0
48029004181,20,18,0,9,6,2,6,0,18
48113003209,266,189,74,73,35,5,3,1,115
48201000769,232,213,14,28,173,2,0,0,199
48439004370,0,0,0,0,0,0,0,0,0
48439002681,0,0,0,0,0,0,0,0,0
48439002546,417,338,52,119,165,6,10,4,286
48113004617,336,254,95,123,13,8,18,6,159
48303000096,0,0,0,0,0,0,0,0,0
48113003030,40,24,8,5,8,2,0,0,16
48439004432,280,251,151,49,51,6,1,0,100
48201000770,1997,1259,173,797,273,38,23,0,1086
48439002616,15,13,1,1,10,1,1,1,12
48113001067,38,19,5,12,0,1,1,0,14
48439004632,0,0,0,0,0,0,0,0,0
48439004512,0,0,0,0,0,0,0,0,0
48439004563,0,0,0,0,0,0,0,0,0
48439001607,0,0,0,0,0,0,0,0,0
48041000083,0,0,0,0,0,0,0,0,0
48167000281,308,252,170,70,4,5,3,2,82
48439003446,0,0,0,0,0,0,0,0,0
48201000844,10,9,0,7,2,1,0,0,9
48439002612,0,0,0,0,0,0,0,0,0
48201000775,132,124,4,25,93,1,2,2,120
48201000812,0,0,0,0,0,0,0,0,0
48215000142,90,65,0,64,0,3,1,0,65
48201000686,1069,698,119,299,123,14,165,0,579
